Date,TransactionID,BSB,AccountNumber,Description,Debit,Credit,Balance,Type,Reference,Bank,AccountType
01-08-2025 00:02,ANZ9115286010CF49F79804,012-345-678,11111111,BIGW ANZ,36.87,0,4197.12,DR,REF280388,ANZ,Savings
01-08-2025 00:02,ANZ90DB6EAC4A4B41109AB9,012-345-678,11111111,DOMINO'S PIZZA ANZ,7.54,0,4189.58,DR,REF816670,ANZ,Savings
01-08-2025 00:13,ANZA70BB60F530F4566AD76,012-345-678,11111111,MCDONALDS ANZ,34,0,4155.58,DR,REF758290,ANZ,Savings
01-08-2025 01:21,ANZ7C8B8442D4FB4F028C29,012-345-678,11111111,7-ELEVEN ANZ,155.38,0,4000.2,DR,REF797290,ANZ,Savings
01-08-2025 02:30,ANZ76BF6D6EC6F945339E28,012-345-678,11111111,MCDONALDS ANZ,108.01,0,3892.19,DR,REF802594,ANZ,Savings
01-08-2025 02:34,ANZ642C239B0DA5429398D8,012-345-678,11111111,ALDI ANZ,42.13,0,3850.06,DR,REF898832,ANZ,Savings
01-08-2025 02:45,ANZ3895BDE5AB38494A9D9E,012-345-678,11111111,UBER EATS ANZ,58.87,0,3791.19,DR,REF811766,ANZ,Savings
01-08-2025 02:47,ANZ9F20A6CAE215494484EC,012-345-678,11111111,SALARY PAYMENT ANZ,0,2417.14,6208.33,CR,REF447726,ANZ,Savings
01-08-2025 02:48,ANZ0F684C76EFA94B2EB072,012-345-678,11111111,UBER EATS ANZ,23.42,0,6184.91,DR,REF255942,ANZ,Savings
01-08-2025 02:52,ANZ6C79EFE60C4E4B23B0E3,012-345-678,11111111,BIGW ANZ,93.26,0,6091.65,DR,REF277052,ANZ,Savings
01-08-2025 03:25,ANZDA4AE7183797442D9C0C,012-345-678,11111111,7-ELEVEN ANZ,36.5,0,6055.15,DR,REF343966,ANZ,Savings
01-08-2025 03:44,ANZ7A58889BFCD34E42B230,012-345-678,11111111,PAY - SALARY ANZ,0,431.04,6486.19,CR,REF400751,ANZ,Savings
01-08-2025 04:16,ANZ0002A3396E5648DBBE5A,012-345-678,11111111,TAFE BOOKSHOP ANZ,31.78,0,6454.41,DR,REF679545,ANZ,Savings
01-08-2025 04:31,ANZ8160A1E24B274305B5C0,012-345-678,11111111,UBER EATS ANZ,55.85,0,6398.56,DR,REF179798,ANZ,Savings
01-08-2025 04:40,ANZ88DEC0BB106C46309B67,012-345-678,11111111,ALDI ANZ,18.24,0,6380.32,DR,REF919056,ANZ,Savings
01-08-2025 04:44,ANZ17C68F8AE47545688947,012-345-678,11111111,CITYLINK ANZ,113.18,0,6267.14,DR,REF792215,ANZ,Savings
01-08-2025 04:45,ANZ737D8DAACED249A3A097,012-345-678,11111111,SHELL ANZ,23.73,0,6243.41,DR,REF353754,ANZ,Savings
01-08-2025 04:49,ANZF572A24A9C2D455698CC,012-345-678,11111111,PAYMENT GATEWAY ANZ,23.43,0,6219.98,DR,REF515187,ANZ,Savings
01-08-2025 04:59,ANZ0A9D68753FFF4904A261,012-345-678,11111111,SHELL ANZ,30.12,0,6189.86,DR,REF562352,ANZ,Savings
01-08-2025 05:11,ANZ2F71216A59F144A1B2E4,012-345-678,11111111,APPLE ANZ,6.1,0,6183.76,DR,REF547504,ANZ,Savings
01-08-2025 05:17,ANZF2C7B8ADE10A4A3FA14F,012-345-678,11111111,FLIXBUS ANZ,114.15,0,6069.61,DR,REF894786,ANZ,Savings
01-08-2025 05:19,ANZA1A22FBDC0014812B65A,012-345-678,11111111,SHELL ANZ,54.61,0,6015,DR,REF362128,ANZ,Savings
01-08-2025 05:45,ANZB2B75A49C75D46EB8A8F,012-345-678,11111111,COMPANY PAYROLL ANZ,0,1656.25,7671.25,CR,REF680004,ANZ,Savings
01-08-2025 05:47,ANZ201F6DAAF77443E1B41B,012-345-678,11111111,PAYMENT GATEWAY ANZ,53.63,0,7617.62,DR,REF376459,ANZ,Savings
01-08-2025 06:06,ANZ702BE17549D942C79984,012-345-678,11111111,BANK FEE ANZ,36.1,0,7581.52,DR,REF440594,ANZ,Savings
01-08-2025 06:10,ANZ622BA6E427524B1CBD79,012-345-678,11111111,7-ELEVEN ANZ,19.97,0,7561.55,DR,REF270611,ANZ,Savings
01-08-2025 06:16,ANZE44096F17818419F914F,012-345-678,11111111,COLES ANZ,71.3,0,7490.25,DR,REF998487,ANZ,Savings
01-08-2025 06:23,ANZ904D44AF35274A499D82,012-345-678,11111111,BANK FEE ANZ,6.17,0,7484.08,DR,REF259172,ANZ,Savings
01-08-2025 06:24,ANZ2E78B41EF2C74463AB2C,012-345-678,11111111,DOMINO'S PIZZA ANZ,3.79,0,7480.29,DR,REF647288,ANZ,Savings
01-08-2025 06:29,ANZFA5008477E1041038A5B,012-345-678,11111111,HARVEY NORMAN ANZ,33.04,0,7447.25,DR,REF379753,ANZ,Savings
01-08-2025 06:39,ANZ48F2F5EB78EA40AD8419,012-345-678,11111111,SHELL ANZ,58.04,0,7389.21,DR,REF278834,ANZ,Savings
01-08-2025 06:49,ANZ4EA1F3AEF50241CDA4F7,012-345-678,11111111,HARVEY NORMAN ANZ,98.25,0,7290.96,DR,REF490875,ANZ,Savings
01-08-2025 07:10,ANZ469955F610A0439DA306,012-345-678,11111111,MCDONALDS ANZ,30.88,0,7260.08,DR,REF735835,ANZ,Savings
01-08-2025 07:17,ANZAD07097825054961A173,012-345-678,11111111,AMAZON AU ANZ,9.73,0,7250.35,DR,REF281052,ANZ,Savings
01-08-2025 08:10,ANZDD510B44858946D9B374,012-345-678,11111111,INTERNET TRANSFER ANZ,93.74,0,7156.61,DR,REF840257,ANZ,Savings
01-08-2025 08:20,ANZ577A7E3EC4B84455913C,012-345-678,11111111,ZOOM ANZ,9.13,0,7147.48,DR,REF364561,ANZ,Savings
01-08-2025 08:42,ANZ71A023B8B5B14D3CAEE4,012-345-678,11111111,BIGW ANZ,72.71,0,7074.77,DR,REF767686,ANZ,Savings
01-08-2025 08:46,ANZDFD0C66A56F2488AAFDA,012-345-678,11111111,COLES ANZ,79.42,0,6995.35,DR,REF220421,ANZ,Savings
01-08-2025 09:21,ANZD63B74D0D3B84E87ACE3,012-345-678,11111111,MENULOG ANZ,57.86,0,6937.49,DR,REF221117,ANZ,Savings
01-08-2025 09:24,ANZ18516E1174D04EF58190,012-345-678,11111111,COMPANY PAYROLL ANZ,0,9.03,6946.52,CR,REF343323,ANZ,Savings
01-08-2025 09:29,ANZE22B7B59B11D4F22B115,012-345-678,11111111,MCDONALDS ANZ,17.06,0,6929.46,DR,REF208182,ANZ,Savings
01-08-2025 09:34,ANZ8A0E7D0BD1324F1CB8A4,012-345-678,11111111,ZOOM ANZ,161.53,0,6767.93,DR,REF162120,ANZ,Savings
01-08-2025 09:36,ANZD6137F64C97D4880A714,012-345-678,11111111,PAYPAL *NETFLIX ANZ,12.38,0,6755.55,DR,REF308211,ANZ,Savings
01-08-2025 10:09,ANZBEC8940379854B75AF6A,012-345-678,11111111,PAY - SALARY ANZ,0,2568.03,9323.58,CR,REF960326,ANZ,Savings
01-08-2025 11:11,ANZ202A3C17F637446C8451,012-345-678,11111111,APPLE ANZ,19.86,0,9303.72,DR,REF377703,ANZ,Savings
01-08-2025 11:15,ANZ37EEC2E8EA4A43D1A60E,012-345-678,11111111,SALARY PAYMENT ANZ,0,6433.85,15737.57,CR,REF691577,ANZ,Savings
01-08-2025 11:15,ANZ4ADFEA5D1A99412F9116,012-345-678,11111111,BIGW ANZ,25.03,0,15712.54,DR,REF817869,ANZ,Savings
01-08-2025 11:29,ANZ226BEF7D6D4D4ADDAF4C,012-345-678,11111111,7-ELEVEN ANZ,68.18,0,15644.36,DR,REF197270,ANZ,Savings
01-08-2025 11:43,ANZ6569B52FB5D549EFBEBC,012-345-678,11111111,CITYLINK ANZ,49.29,0,15595.07,DR,REF950423,ANZ,Savings
01-08-2025 11:50,ANZ000CC5A98318471E8B85,012-345-678,11111111,BANK FEE ANZ,63.64,0,15531.43,DR,REF193790,ANZ,Savings
01-08-2025 11:51,ANZ772A6ECDC8F94468ACAC,012-345-678,11111111,SHELL ANZ,84.47,0,15446.96,DR,REF219021,ANZ,Savings
01-08-2025 11:57,ANZ0FA2DB86777543EF91BD,012-345-678,11111111,DOMINO'S PIZZA ANZ,45.19,0,15401.77,DR,REF324154,ANZ,Savings
01-08-2025 12:26,ANZ9A2E73EC972E4D8B9568,012-345-678,11111111,HARVEY NORMAN ANZ,38.48,0,15363.29,DR,REF282703,ANZ,Savings
01-08-2025 13:19,ANZE07341A7E8D24E0D813A,012-345-678,11111111,MCDONALDS ANZ,26.62,0,15336.67,DR,REF112614,ANZ,Savings
01-08-2025 14:00,ANZA1E159F9E9F948B59222,012-345-678,11111111,JB HI-FI ANZ,46.58,0,15290.09,DR,REF439797,ANZ,Savings
01-08-2025 14:40,ANZ05D9068BAB4F46C8932D,012-345-678,11111111,MENULOG ANZ,144.16,0,15145.93,DR,REF731407,ANZ,Savings
01-08-2025 15:01,ANZ3D07E8D2C2E643FEBDE5,012-345-678,11111111,HARVEY NORMAN ANZ,25.14,0,15120.79,DR,REF621098,ANZ,Savings
01-08-2025 15:36,INTB5B6D0A8C1644865A001,012-345-678,11111111,TRANSFER FROM CBA 33333333,0,243.75,15364.54,CR,INT-79238,ANZ,Savings
01-08-2025 15:56,ANZ713CC3A5FD384871B961,012-345-678,11111111,BWS ANZ,33.01,0,15331.53,DR,REF555431,ANZ,Savings
01-08-2025 16:18,ANZ038DD9B3B88E4797987A,012-345-678,11111111,BP ANZ,38.39,0,15293.14,DR,REF189195,ANZ,Savings
01-08-2025 16:39,ANZ8C3BB656982A461B872F,012-345-678,11111111,MENULOG ANZ,60.31,0,15232.83,DR,REF543073,ANZ,Savings
01-08-2025 17:21,ANZD7BF0AE4644A44668EF9,012-345-678,11111111,MCDONALDS ANZ,45.99,0,15186.84,DR,REF272819,ANZ,Savings
01-08-2025 17:41,ANZ69FB6EEBD246489FA9EC,012-345-678,11111111,MCDONALDS ANZ,50.85,0,15135.99,DR,REF700909,ANZ,Savings
01-08-2025 18:05,ANZC546D03C33714A8EB4A4,012-345-678,11111111,AMAZON AU ANZ,48.64,0,15087.35,DR,REF650263,ANZ,Savings
01-08-2025 18:25,ANZ914CFC563C32460FB835,012-345-678,11111111,PAYMENT GATEWAY ANZ,68.09,0,15019.26,DR,REF930994,ANZ,Savings
01-08-2025 18:40,ANZC71DCDDC08AF4155BCE1,012-345-678,11111111,ALDI ANZ,70.26,0,14949,DR,REF673336,ANZ,Savings
01-08-2025 18:46,ANZ9B6508A3574340B08E3E,012-345-678,11111111,STARBUCKS ANZ,51.08,0,14897.92,DR,REF512775,ANZ,Savings
01-08-2025 19:01,ANZ9236F2C40C6449A9968B,012-345-678,11111111,CITYLINK ANZ,5.07,0,14892.85,DR,REF789331,ANZ,Savings
01-08-2025 19:05,ANZ255FE3F5125540EFB491,012-345-678,11111111,7-ELEVEN ANZ,60.57,0,14832.28,DR,REF537289,ANZ,Savings
01-08-2025 19:14,ANZ3E9517044F624B30BECE,012-345-678,11111111,FLIXBUS ANZ,140.77,0,14691.51,DR,REF939761,ANZ,Savings
01-08-2025 19:22,ANZCCE081633AA64DEDB6A9,012-345-678,11111111,ALDI ANZ,38.93,0,14652.58,DR,REF103279,ANZ,Savings
01-08-2025 19:30,ANZ0FA573CA00024D7CB32C,012-345-678,11111111,FLIXBUS ANZ,13.4,0,14639.18,DR,REF547044,ANZ,Savings
01-08-2025 19:53,ANZ2BC7922D27FC4EB1B52C,012-345-678,11111111,MCDONALDS ANZ,33.07,0,14606.11,DR,REF335099,ANZ,Savings
01-08-2025 20:00,ANZ42013E870DA24560B264,012-345-678,11111111,AMAZON AU ANZ,10.26,0,14595.85,DR,REF863033,ANZ,Savings
01-08-2025 20:29,ANZD82637A2844F433E9243,012-345-678,11111111,BANK FEE ANZ,90.07,0,14505.78,DR,REF862083,ANZ,Savings
01-08-2025 22:00,ANZ2660CDA9EDA449B89FE1,012-345-678,11111111,STARBUCKS ANZ,37.84,0,14467.94,DR,REF396785,ANZ,Savings
01-08-2025 22:02,ANZA4486B22CCD749649FED,012-345-678,11111111,STARBUCKS ANZ,29.31,0,14438.63,DR,REF309918,ANZ,Savings
01-08-2025 22:06,ANZF24AC64C484A419FA3F5,012-345-678,11111111,MENULOG ANZ,60.87,0,14377.76,DR,REF119303,ANZ,Savings
01-08-2025 22:07,ANZ50AF8EE023014E19B7AC,012-345-678,11111111,COLES ANZ,223.11,0,14154.65,DR,REF549542,ANZ,Savings
01-08-2025 22:16,ANZE079F648AD9D4C67B595,012-345-678,11111111,KFC ANZ,88.51,0,14066.14,DR,REF672819,ANZ,Savings
01-08-2025 23:03,ANZ20EDA90CF6CD49838F07,012-345-678,11111111,LIQUORLAND ANZ,14.84,0,14051.3,DR,REF462933,ANZ,Savings
01-08-2025 23:05,ANZ544DAEF4D78146C2B987,012-345-678,11111111,APPLE ANZ,79.6,0,13971.7,DR,REF139900,ANZ,Savings
01-08-2025 23:12,ANZ74D8A735FC8E4CA99407,012-345-678,11111111,WAGES CREDIT ANZ,0,1575.77,15547.47,CR,REF340680,ANZ,Savings
01-08-2025 23:29,ANZCB97C8E5815E418F95B7,012-345-678,11111111,RAILWAY STATION ANZ,15.9,0,15531.57,DR,REF668180,ANZ,Savings
01-08-2025 23:40,ANZ5E385DE82BEF482C9EAD,012-345-678,11111111,FLIXBUS ANZ,52.74,0,15478.83,DR,REF379869,ANZ,Savings
01-08-2025 23:49,ANZ1D767BE6BF934FD1A52B,012-345-678,11111111,FLIXBUS ANZ,10.6,0,15468.23,DR,REF593970,ANZ,Savings
02-08-2025 00:29,ANZ38480D103CEC49B6A8A2,012-345-678,11111111,ZOOM ANZ,6.16,0,15462.07,DR,REF672966,ANZ,Savings
02-08-2025 00:34,ANZ7DB747F4710F49C980B7,012-345-678,11111111,CITYLINK ANZ,73.26,0,15388.81,DR,REF601437,ANZ,Savings
02-08-2025 00:40,ANZF5C4CE23D61E4A119F7B,012-345-678,11111111,RAILWAY STATION ANZ,23.02,0,15365.79,DR,REF592512,ANZ,Savings
02-08-2025 00:54,ANZ966B6F1955AF4558BC05,012-345-678,11111111,HARVEY NORMAN ANZ,76.94,0,15288.85,DR,REF965577,ANZ,Savings
02-08-2025 01:04,ANZ6C182B6FF7BC4BBC9305,012-345-678,11111111,BP ANZ,66.05,0,15222.8,DR,REF143591,ANZ,Savings
02-08-2025 01:15,ANZ9B1604B876884910AE30,012-345-678,11111111,BANK FEE ANZ,89.44,0,15133.36,DR,REF425207,ANZ,Savings
02-08-2025 01:27,ANZ0A7B0FC884474A8E9CEE,012-345-678,11111111,JB HI-FI ANZ,41.2,0,15092.16,DR,REF613867,ANZ,Savings
02-08-2025 01:27,ANZ20DE01B2B9384433A174,012-345-678,11111111,PAY - SALARY ANZ,0,7250.92,22343.08,CR,REF621719,ANZ,Savings
02-08-2025 01:38,ANZFBF8865796AB4759B516,012-345-678,11111111,7-ELEVEN ANZ,29.94,0,22313.14,DR,REF770655,ANZ,Savings
02-08-2025 01:54,ANZ29D33314351C4372A647,012-345-678,11111111,MENULOG ANZ,29.59,0,22283.55,DR,REF672381,ANZ,Savings
02-08-2025 02:15,ANZ11267343FEF14EF699D6,012-345-678,11111111,PAYROLL CREDIT ANZ,0,6513.75,28797.3,CR,REF600590,ANZ,Savings
02-08-2025 02:23,ANZ11845CD03A5245CBA4F9,012-345-678,11111111,SHELL ANZ,13.92,0,28783.38,DR,REF862057,ANZ,Savings
02-08-2025 02:29,ANZ076E26DD3F594341BBB3,012-345-678,11111111,COMPANY PAYROLL ANZ,0,1016.62,29800,CR,REF806310,ANZ,Savings
02-08-2025 02:47,INT11353C83918A4A55A051,012-345-678,11111111,TRANSFER FROM CBA 33333333,0,851.88,30651.88,CR,INT-16334,ANZ,Savings
02-08-2025 03:15,ANZ37C6C8040CD94693AE17,012-345-678,11111111,RAILWAY STATION ANZ,28.91,0,30622.97,DR,REF516386,ANZ,Savings
02-08-2025 03:19,ANZ3AB280BA5DBC4CA18626,012-345-678,11111111,APPLE ANZ,11.33,0,30611.64,DR,REF833499,ANZ,Savings
02-08-2025 03:34,ANZF00D5E6D50D84EF69A30,012-345-678,11111111,DOMINO'S PIZZA ANZ,17.92,0,30593.72,DR,REF513151,ANZ,Savings
02-08-2025 04:31,ANZ296C581594CE4C919891,012-345-678,11111111,PAYPAL *NETFLIX ANZ,18.41,0,30575.31,DR,REF721761,ANZ,Savings
02-08-2025 05:13,ANZ9E3E368B22C34A5EABEE,012-345-678,11111111,LIQUORLAND ANZ,71.38,0,30503.93,DR,REF446296,ANZ,Savings
02-08-2025 05:36,ANZB0FF78AE40C34973B786,012-345-678,11111111,DOMINO'S PIZZA ANZ,18.48,0,30485.45,DR,REF688220,ANZ,Savings
02-08-2025 06:04,ANZ36B8E26401704CA79613,012-345-678,11111111,DOMINO'S PIZZA ANZ,5.03,0,30480.42,DR,REF164752,ANZ,Savings
02-08-2025 06:04,ANZ9FC373F564F24819947D,012-345-678,11111111,SALARY PAYMENT ANZ,0,6108.13,36588.55,CR,REF805302,ANZ,Savings
02-08-2025 06:09,ANZ0703A83AA3544D7C8B83,012-345-678,11111111,SPOTIFY ANZ,4.75,0,36583.8,DR,REF154908,ANZ,Savings
02-08-2025 06:24,ANZFF80CE9B4DA64482AC43,012-345-678,11111111,WOOLWORTHS ANZ,92.26,0,36491.54,DR,REF891629,ANZ,Savings
02-08-2025 06:35,ANZ7C50B5BBB0D946199D38,012-345-678,11111111,UBER EATS ANZ,45.57,0,36445.97,DR,REF940472,ANZ,Savings
02-08-2025 07:14,ANZ4CE95D83E09448D59BF3,012-345-678,11111111,UBER EATS ANZ,52.58,0,36393.39,DR,REF583000,ANZ,Savings
02-08-2025 07:21,ANZ611CAAB461E74E629377,012-345-678,11111111,TAFE BOOKSHOP ANZ,12.5,0,36380.89,DR,REF506594,ANZ,Savings
02-08-2025 07:31,ANZCA8ABC13E9C14680937F,012-345-678,11111111,UBER EATS ANZ,88.13,0,36292.76,DR,REF536472,ANZ,Savings
02-08-2025 07:59,ANZ2297D36A129C481F9A28,012-345-678,11111111,JB HI-FI ANZ,55.95,0,36236.81,DR,REF326143,ANZ,Savings
02-08-2025 08:30,ANZ1A1CFCD37C2F4609AF57,012-345-678,11111111,BANK FEE ANZ,22.12,0,36214.69,DR,REF209289,ANZ,Savings
02-08-2025 08:48,ANZEF24CBA511AE4956BF7E,012-345-678,11111111,PAY - SALARY ANZ,0,5326.55,41541.24,CR,REF548157,ANZ,Savings
02-08-2025 08:57,ANZA802AFC3F32741A7808B,012-345-678,11111111,APPLE ANZ,23.65,0,41517.59,DR,REF474244,ANZ,Savings
02-08-2025 09:11,ANZ5C40D92C050449BDB93F,012-345-678,11111111,TAFE BOOKSHOP ANZ,33.2,0,41484.39,DR,REF257011,ANZ,Savings
02-08-2025 09:46,ANZE7998AB06B6C4EE2912A,012-345-678,11111111,PAYPAL *NETFLIX ANZ,108.7,0,41375.69,DR,REF923326,ANZ,Savings
02-08-2025 10:09,ANZE018DFDF397B48438F59,012-345-678,11111111,SALARY PAYMENT ANZ,0,1055.63,42431.32,CR,REF456827,ANZ,Savings
02-08-2025 10:29,ANZ899D2B6A81A74C20800E,012-345-678,11111111,CITYLINK ANZ,1.49,0,42429.83,DR,REF361258,ANZ,Savings
02-08-2025 10:30,ANZ792A63D4C019447CB18D,012-345-678,11111111,MENULOG ANZ,70.34,0,42359.49,DR,REF664328,ANZ,Savings
02-08-2025 10:33,ANZ85E4484AA98F4A1898C8,012-345-678,11111111,DOMINO'S PIZZA ANZ,8.65,0,42350.84,DR,REF344892,ANZ,Savings
02-08-2025 10:42,ANZ2ECC5DE09FC74BA1B9B5,012-345-678,11111111,HARVEY NORMAN ANZ,113.54,0,42237.3,DR,REF892476,ANZ,Savings
02-08-2025 10:50,ANZDF1FA4B04EE447408469,012-345-678,11111111,AMAZON AU ANZ,18.48,0,42218.82,DR,REF898036,ANZ,Savings
02-08-2025 11:02,ANZE27F3540693F4B6D963F,012-345-678,11111111,STARBUCKS ANZ,89.86,0,42128.96,DR,REF796880,ANZ,Savings
02-08-2025 11:20,ANZ621DC3EAA7DC4B17BFB8,012-345-678,11111111,COLES ANZ,18.5,0,42110.46,DR,REF461018,ANZ,Savings
02-08-2025 12:13,ANZ43DABFDE9B60495DBC88,012-345-678,11111111,ALDI ANZ,111.14,0,41999.32,DR,REF480478,ANZ,Savings
02-08-2025 12:45,ANZ70BFF69970064FE685C5,012-345-678,11111111,FLIXBUS ANZ,25.41,0,41973.91,DR,REF307725,ANZ,Savings
02-08-2025 12:48,ANZBF4E6BA7E98E435BA1AC,012-345-678,11111111,WOOLWORTHS ANZ,12.06,0,41961.85,DR,REF934117,ANZ,Savings
02-08-2025 12:50,INT9AD9B221217C4B9AB2F8,012-345-678,11111111,TRANSFER TO CBA 33333333,865.31,0,41096.54,DR,INT-61321,ANZ,Savings
02-08-2025 12:52,ANZ6BF71F093CCA4163ABEE,012-345-678,11111111,INTERNET TRANSFER ANZ,77.98,0,41018.56,DR,REF644518,ANZ,Savings
02-08-2025 13:33,ANZ689BA3888BEC4E5BAA2A,012-345-678,11111111,INTERNET TRANSFER ANZ,23.44,0,40995.12,DR,REF911398,ANZ,Savings
02-08-2025 13:57,ANZ080C560F98024DE7976F,012-345-678,11111111,PAYROLL CREDIT ANZ,0,176.67,41171.79,CR,REF427606,ANZ,Savings
02-08-2025 14:06,ANZEDE697EBEDE440C1815D,012-345-678,11111111,SHELL ANZ,59.61,0,41112.18,DR,REF517881,ANZ,Savings
02-08-2025 14:09,ANZE9B281F4BA894686A6FB,012-345-678,11111111,APPLE ANZ,80.97,0,41031.21,DR,REF861128,ANZ,Savings
02-08-2025 14:31,ANZ5540AA9B5CD3401E9708,012-345-678,11111111,APPLE ANZ,21.51,0,41009.7,DR,REF940971,ANZ,Savings
02-08-2025 14:33,INTA6632994546A464C8613,012-345-678,11111111,TRANSFER FROM NAB 44444444,0,1462.75,42472.45,CR,INT-52083,ANZ,Savings
02-08-2025 14:45,ANZ50EAC2930A8341E8B9BD,012-345-678,11111111,BANK FEE ANZ,36.26,0,42436.19,DR,REF813712,ANZ,Savings
02-08-2025 15:04,ANZD65EFF2B86EB4235B6CD,012-345-678,11111111,MCDONALDS ANZ,34.96,0,42401.23,DR,REF792779,ANZ,Savings
02-08-2025 16:12,ANZF31C344E12A44CAFBC7C,012-345-678,11111111,JB HI-FI ANZ,58.6,0,42342.63,DR,REF509559,ANZ,Savings
02-08-2025 16:14,ANZE8E057D88BAA4470A329,012-345-678,11111111,RAILWAY STATION ANZ,2.14,0,42340.49,DR,REF184592,ANZ,Savings
02-08-2025 16:30,ANZ27072A2F78FE46208A4A,012-345-678,11111111,WAGES CREDIT ANZ,0,6893.76,49234.25,CR,REF358271,ANZ,Savings
02-08-2025 16:50,ANZ430CDEEF7AE649ED89A4,012-345-678,11111111,BANK FEE ANZ,20.91,0,49213.34,DR,REF297555,ANZ,Savings
02-08-2025 17:00,ANZB483C841DA94452DA2A4,012-345-678,11111111,TAFE BOOKSHOP ANZ,27.58,0,49185.76,DR,REF182987,ANZ,Savings
02-08-2025 17:17,ANZ6411ED49B1E343F99C8B,012-345-678,11111111,BANK FEE ANZ,22.53,0,49163.23,DR,REF777772,ANZ,Savings
02-08-2025 17:37,ANZ928543619F9B4C208AAE,012-345-678,11111111,LIQUORLAND ANZ,133.61,0,49029.62,DR,REF820112,ANZ,Savings
02-08-2025 17:41,ANZ226B7F0E554E4912B922,012-345-678,11111111,7-ELEVEN ANZ,24.53,0,49005.09,DR,REF583190,ANZ,Savings
02-08-2025 17:51,INT559C0545709A484AB82B,012-345-678,11111111,TRANSFER FROM CBA 33333333,0,891.48,49896.57,CR,INT-58757,ANZ,Savings
02-08-2025 17:56,ANZ749D9E8A7BD04D43AB40,012-345-678,11111111,FLIXBUS ANZ,46.09,0,49850.48,DR,REF781084,ANZ,Savings
02-08-2025 18:56,ANZ12A251D3371D4B8B9F82,012-345-678,11111111,7-ELEVEN ANZ,2.59,0,49847.89,DR,REF318875,ANZ,Savings
02-08-2025 19:11,ANZ410DF09AC73B447A8C61,012-345-678,11111111,SHELL ANZ,93.29,0,49754.6,DR,REF298004,ANZ,Savings
02-08-2025 19:18,ANZ877243E22C544CAA998C,012-345-678,11111111,AMAZON AU ANZ,6.76,0,49747.84,DR,REF101775,ANZ,Savings
02-08-2025 19:27,ANZD842EA417D6F4B6492B9,012-345-678,11111111,LIQUORLAND ANZ,9.01,0,49738.83,DR,REF380433,ANZ,Savings
02-08-2025 19:51,ANZ3E2AC5E40E82442A81C9,012-345-678,11111111,PAYPAL *NETFLIX ANZ,93.65,0,49645.18,DR,REF273521,ANZ,Savings
02-08-2025 19:59,ANZ657B1DD0B7654B7FB02F,012-345-678,11111111,BIGW ANZ,43.78,0,49601.4,DR,REF539674,ANZ,Savings
02-08-2025 20:51,ANZA627A537647A473093A2,012-345-678,11111111,PAYPAL *NETFLIX ANZ,41.84,0,49559.56,DR,REF736386,ANZ,Savings
02-08-2025 21:02,ANZ5CD37D2E28C64396BC46,012-345-678,11111111,SHELL ANZ,59.95,0,49499.61,DR,REF156443,ANZ,Savings
02-08-2025 21:27,ANZ6C9E219B8950470EA19B,012-345-678,11111111,ALDI ANZ,61.19,0,49438.42,DR,REF241650,ANZ,Savings
02-08-2025 21:54,ANZ6D36E0BB1C1A449AA7ED,012-345-678,11111111,SPOTIFY ANZ,21.15,0,49417.27,DR,REF259681,ANZ,Savings
02-08-2025 22:25,ANZ6FB75A3E21CD4E9C8C89,012-345-678,11111111,MCDONALDS ANZ,107.82,0,49309.45,DR,REF281284,ANZ,Savings
02-08-2025 22:28,ANZ4E88A6F8AE5F45D0BC6F,012-345-678,11111111,UBER EATS ANZ,71.34,0,49238.11,DR,REF356232,ANZ,Savings
02-08-2025 22:37,ANZ15F4890766A247A5A48D,012-345-678,11111111,SPOTIFY ANZ,24.03,0,49214.08,DR,REF589775,ANZ,Savings
02-08-2025 23:03,ANZAC87AC2BE88F42598A10,012-345-678,11111111,PAY - SALARY ANZ,0,7048.88,56262.96,CR,REF892302,ANZ,Savings
02-08-2025 23:04,ANZ8A85783726674E45876B,012-345-678,11111111,BIGW ANZ,148.34,0,56114.62,DR,REF712206,ANZ,Savings
02-08-2025 23:45,ANZ6A58647C8F9D46FA89FE,012-345-678,11111111,COLES ANZ,49.65,0,56064.97,DR,REF493730,ANZ,Savings
02-08-2025 23:47,ANZ706FF809F63646DFBCFE,012-345-678,11111111,KFC ANZ,8.73,0,56056.24,DR,REF431693,ANZ,Savings
02-08-2025 23:56,ANZFE3D09E5696C432DB550,012-345-678,11111111,STARBUCKS ANZ,77.7,0,55978.54,DR,REF459088,ANZ,Savings
03-08-2025 00:19,ANZD549C904ED864F85A7B5,012-345-678,11111111,UBER EATS ANZ,67.01,0,55911.53,DR,REF905338,ANZ,Savings
03-08-2025 00:21,ANZCBDFEC547385470D8970,012-345-678,11111111,DOMINO'S PIZZA ANZ,13.35,0,55898.18,DR,REF666681,ANZ,Savings
03-08-2025 00:52,ANZCCA40137A1FB4BE384BF,012-345-678,11111111,AMAZON AU ANZ,40.69,0,55857.49,DR,REF411365,ANZ,Savings
03-08-2025 02:42,ANZ04FA84ED1F2E46D2853A,012-345-678,11111111,MENULOG ANZ,108.39,0,55749.1,DR,REF352709,ANZ,Savings
03-08-2025 03:40,ANZA7818C8148644C3C829E,012-345-678,11111111,BIGW ANZ,19.89,0,55729.21,DR,REF777017,ANZ,Savings
03-08-2025 03:58,ANZ4C996C78453F41A0AF35,012-345-678,11111111,AMAZON AU ANZ,130.27,0,55598.94,DR,REF587151,ANZ,Savings
03-08-2025 04:46,ANZEBF5EFFA5C034CCB88CE,012-345-678,11111111,BIGW ANZ,16.42,0,55582.52,DR,REF519272,ANZ,Savings
03-08-2025 05:05,ANZ4853221A02594E839EB9,012-345-678,11111111,RAILWAY STATION ANZ,31.59,0,55550.93,DR,REF131471,ANZ,Savings
03-08-2025 06:57,INTD8BA3FD4632742B284B9,012-345-678,11111111,TRANSFER FROM CBA 33333333,0,507.52,56058.45,CR,INT-64134,ANZ,Savings
03-08-2025 07:25,ANZD0EC28CDA3814A528F1F,012-345-678,11111111,TAFE BOOKSHOP ANZ,111.97,0,55946.48,DR,REF628413,ANZ,Savings
03-08-2025 07:36,ANZ3F200F571E91495FA177,012-345-678,11111111,BP ANZ,12.56,0,55933.92,DR,REF894163,ANZ,Savings
03-08-2025 07:47,ANZ4B4B9627221745D18AB6,012-345-678,11111111,WAGES CREDIT ANZ,0,5330.2,61264.12,CR,REF684440,ANZ,Savings
03-08-2025 07:58,ANZ486B33CCB59B4B9E9C55,012-345-678,11111111,UBER EATS ANZ,6.42,0,61257.7,DR,REF405864,ANZ,Savings
03-08-2025 08:11,ANZ3E07749BB06949B3804E,012-345-678,11111111,DOMINO'S PIZZA ANZ,173.54,0,61084.16,DR,REF912855,ANZ,Savings
03-08-2025 08:27,ANZF9631F71467A4EFCBE36,012-345-678,11111111,UBER EATS ANZ,7.53,0,61076.63,DR,REF501013,ANZ,Savings
03-08-2025 08:41,ANZEF26D141E2624BDEABAA,012-345-678,11111111,SALARY PAYMENT ANZ,0,154.94,61231.57,CR,REF315532,ANZ,Savings
03-08-2025 08:58,ANZ839DA8E1D6CF4768A16F,012-345-678,11111111,BANK FEE ANZ,31.39,0,61200.18,DR,REF832771,ANZ,Savings
03-08-2025 09:51,ANZA4A9B44089164AC38215,012-345-678,11111111,SHELL ANZ,31.17,0,61169.01,DR,REF217739,ANZ,Savings
03-08-2025 10:04,ANZ7E41F90781CE408D85FF,012-345-678,11111111,AMAZON AU ANZ,57.14,0,61111.87,DR,REF823612,ANZ,Savings
03-08-2025 10:23,INTFE5E739A2C2C4FC6BF98,012-345-678,11111111,TRANSFER TO CBA 33333333,1112.08,0,59999.79,DR,INT-92971,ANZ,Savings
03-08-2025 10:25,ANZA9FA048AA42E48A999DF,012-345-678,11111111,TAFE BOOKSHOP ANZ,12.29,0,59987.5,DR,REF889800,ANZ,Savings
03-08-2025 10:30,ANZB38CF0FC7A3C43C5B7C1,012-345-678,11111111,COMPANY PAYROLL ANZ,0,7464.97,67452.47,CR,REF513162,ANZ,Savings
03-08-2025 10:32,ANZD1D452CA8F4D4A14A47E,012-345-678,11111111,AMAZON AU ANZ,20.7,0,67431.77,DR,REF375420,ANZ,Savings
03-08-2025 11:35,ANZF38A7701C2F649F88793,012-345-678,11111111,RAILWAY STATION ANZ,52.78,0,67378.99,DR,REF367069,ANZ,Savings
03-08-2025 11:35,ANZ79E6927496D446379994,012-345-678,11111111,COLES ANZ,87.8,0,67291.19,DR,REF653535,ANZ,Savings
03-08-2025 11:46,ANZ4A6888CCF880414595AD,012-345-678,11111111,RAILWAY STATION ANZ,27.6,0,67263.59,DR,REF230830,ANZ,Savings
03-08-2025 12:00,ANZ4FE0E7118AF441C88A6C,012-345-678,11111111,MCDONALDS ANZ,10.63,0,67252.96,DR,REF494628,ANZ,Savings
03-08-2025 12:05,ANZB14234D62C7E4BBD98D4,012-345-678,11111111,COMPANY PAYROLL ANZ,0,2783.78,70036.74,CR,REF638281,ANZ,Savings
03-08-2025 12:07,ANZ38358834B23C42B28023,012-345-678,11111111,SPOTIFY ANZ,121.96,0,69914.78,DR,REF303877,ANZ,Savings
03-08-2025 12:21,ANZ50AD0759B0374C2B877C,012-345-678,11111111,PAYMENT GATEWAY ANZ,31.5,0,69883.28,DR,REF793319,ANZ,Savings
03-08-2025 12:32,ANZ17922506F0924122A0F9,012-345-678,11111111,HARVEY NORMAN ANZ,43.19,0,69840.09,DR,REF110614,ANZ,Savings
03-08-2025 12:50,ANZ1CD3D6FEC8514775A1F6,012-345-678,11111111,CITYLINK ANZ,224.56,0,69615.53,DR,REF834393,ANZ,Savings
03-08-2025 13:08,ANZF32F942ED6304586A0AF,012-345-678,11111111,PAY - SALARY ANZ,0,4063.42,73678.95,CR,REF234642,ANZ,Savings
03-08-2025 13:55,ANZC5D5B29732AC4DD5862F,012-345-678,11111111,7-ELEVEN ANZ,97.84,0,73581.11,DR,REF846170,ANZ,Savings
03-08-2025 13:58,ANZ0ECE36AB591C478AB6CE,012-345-678,11111111,SHELL ANZ,19.32,0,73561.79,DR,REF961369,ANZ,Savings
03-08-2025 14:09,ANZ9677AE0467F44746A7B9,012-345-678,11111111,PAYPAL *NETFLIX ANZ,19.46,0,73542.33,DR,REF113542,ANZ,Savings
03-08-2025 14:10,ANZBC16895EAE1B474ABF7D,012-345-678,11111111,INTERNET TRANSFER ANZ,27.54,0,73514.79,DR,REF446609,ANZ,Savings
03-08-2025 14:14,ANZC71C1B41C5D24966B987,012-345-678,11111111,BANK FEE ANZ,30.44,0,73484.35,DR,REF982757,ANZ,Savings
03-08-2025 14:55,ANZF3FB6D936BC5470791C6,012-345-678,11111111,DOMINO'S PIZZA ANZ,19.03,0,73465.32,DR,REF333487,ANZ,Savings
03-08-2025 15:39,ANZ655D20AD1D074C59AFF4,012-345-678,11111111,STARBUCKS ANZ,4.59,0,73460.73,DR,REF692900,ANZ,Savings
03-08-2025 15:41,ANZ8B1DD20E9FDC4DFE9FFD,012-345-678,11111111,SPOTIFY ANZ,23.31,0,73437.42,DR,REF720127,ANZ,Savings
03-08-2025 17:07,ANZ6C2D773407A241B9B501,012-345-678,11111111,PAY - SALARY ANZ,0,2917.21,76354.63,CR,REF371295,ANZ,Savings
03-08-2025 17:08,ANZE25AF01A33634021B4CF,012-345-678,11111111,ZOOM ANZ,28.5,0,76326.13,DR,REF517304,ANZ,Savings
03-08-2025 17:16,ANZEB4F957E63814BB399FB,012-345-678,11111111,ALDI ANZ,5.33,0,76320.8,DR,REF389973,ANZ,Savings
03-08-2025 17:30,ANZ862C2DCE2446438B9F3A,012-345-678,11111111,BWS ANZ,113.55,0,76207.25,DR,REF446308,ANZ,Savings
03-08-2025 17:54,ANZ0ACA257F60C247BFB447,012-345-678,11111111,CITYLINK ANZ,23.52,0,76183.73,DR,REF159435,ANZ,Savings
03-08-2025 18:02,ANZ22D256B4362148DC8A7F,012-345-678,11111111,BANK FEE ANZ,11.08,0,76172.65,DR,REF143011,ANZ,Savings
03-08-2025 18:03,ANZA85AF8C0171B4BC19F84,012-345-678,11111111,CITYLINK ANZ,67.56,0,76105.09,DR,REF854536,ANZ,Savings
03-08-2025 18:47,ANZ96945CF836B249CF8F8D,012-345-678,11111111,COMPANY PAYROLL ANZ,0,749.51,76854.6,CR,REF118538,ANZ,Savings
03-08-2025 18:48,ANZ02DB011605814A4CA8A5,012-345-678,11111111,KFC ANZ,11.34,0,76843.26,DR,REF393223,ANZ,Savings
03-08-2025 19:07,INTB19F016DBD7549B19E67,012-345-678,11111111,TRANSFER TO CBA 22222222,725.61,0,76117.65,DR,INT-28104,ANZ,Savings
03-08-2025 19:32,ANZE5BA5E39E093482699B8,012-345-678,11111111,BANK FEE ANZ,9.13,0,76108.52,DR,REF376720,ANZ,Savings
03-08-2025 19:33,ANZ0C1FE55F87BA4F34B7B9,012-345-678,11111111,BANK FEE ANZ,2.24,0,76106.28,DR,REF948122,ANZ,Savings
03-08-2025 20:03,ANZF612DBB84ACB456DB39C,012-345-678,11111111,SHELL ANZ,77.25,0,76029.03,DR,REF753750,ANZ,Savings
03-08-2025 20:18,ANZ527E6A0235C2466E9DEB,012-345-678,11111111,MENULOG ANZ,152.87,0,75876.16,DR,REF757419,ANZ,Savings
03-08-2025 20:47,ANZEC9321797053498D88CC,012-345-678,11111111,KFC ANZ,20.56,0,75855.6,DR,REF924184,ANZ,Savings
03-08-2025 21:02,ANZ5FCA192C9EF84577A3BF,012-345-678,11111111,PAYMENT GATEWAY ANZ,45.03,0,75810.57,DR,REF250979,ANZ,Savings
03-08-2025 21:10,ANZ619CC37821184AF288FF,012-345-678,11111111,TAFE BOOKSHOP ANZ,28.21,0,75782.36,DR,REF297530,ANZ,Savings
03-08-2025 21:16,ANZC7ECA1BDD7E1453198CA,012-345-678,11111111,RAILWAY STATION ANZ,100.97,0,75681.39,DR,REF471613,ANZ,Savings
03-08-2025 21:46,INTE1F762EB672B4DCA9DBB,012-345-678,11111111,TRANSFER TO NAB 44444444,467.99,0,75213.4,DR,INT-53574,ANZ,Savings
03-08-2025 22:28,ANZ56DF1489F1D341C9A598,012-345-678,11111111,COLES ANZ,40.48,0,75172.92,DR,REF626449,ANZ,Savings
03-08-2025 22:38,ANZE3040A57199B4170ACC1,012-345-678,11111111,BWS ANZ,44.68,0,75128.24,DR,REF611441,ANZ,Savings
03-08-2025 22:52,ANZ5C9A15E60C804E5BBFE4,012-345-678,11111111,BIGW ANZ,67.43,0,75060.81,DR,REF340753,ANZ,Savings
03-08-2025 22:58,ANZB37315C322FC4469B70C,012-345-678,11111111,DOMINO'S PIZZA ANZ,74.32,0,74986.49,DR,REF573161,ANZ,Savings
03-08-2025 23:05,ANZE74D99D2C9BA4F4FA00B,012-345-678,11111111,TAFE BOOKSHOP ANZ,13.69,0,74972.8,DR,REF667561,ANZ,Savings
03-08-2025 23:15,ANZ5B2E5B6615B44B7B921E,012-345-678,11111111,APPLE ANZ,61.26,0,74911.54,DR,REF949391,ANZ,Savings
03-08-2025 23:44,ANZ8138C59AD996474C86AE,012-345-678,11111111,ALDI ANZ,4.21,0,74907.33,DR,REF798270,ANZ,Savings
03-08-2025 23:48,ANZ4DEBD36A1A694406AC7A,012-345-678,11111111,INTERNET TRANSFER ANZ,359.32,0,74548.01,DR,REF867555,ANZ,Savings
04-08-2025 00:11,ANZ2A463903EF134C07A7C9,012-345-678,11111111,SHELL ANZ,15.1,0,74532.91,DR,REF205799,ANZ,Savings
04-08-2025 01:57,ANZC36BD09FA6EE4D6E998F,012-345-678,11111111,7-ELEVEN ANZ,56.29,0,74476.62,DR,REF831826,ANZ,Savings
04-08-2025 02:06,ANZC81857071C00488B9E3E,012-345-678,11111111,7-ELEVEN ANZ,9.73,0,74466.89,DR,REF402061,ANZ,Savings
04-08-2025 02:10,INT161A44C84D21432EA4E1,012-345-678,11111111,TRANSFER TO CBA 22222222,249.84,0,74217.05,DR,INT-36945,ANZ,Savings
04-08-2025 02:13,ANZE97E49F946D847C8980C,012-345-678,11111111,JB HI-FI ANZ,93.34,0,74123.71,DR,REF417994,ANZ,Savings
04-08-2025 02:14,ANZB967E9DC37CD477D9CF7,012-345-678,11111111,PAYMENT GATEWAY ANZ,117.59,0,74006.12,DR,REF629908,ANZ,Savings
04-08-2025 02:32,ANZ7922E6BAC47148C1B31C,012-345-678,11111111,LIQUORLAND ANZ,64.58,0,73941.54,DR,REF873814,ANZ,Savings
04-08-2025 02:34,ANZ5831FC1589E647BA966B,012-345-678,11111111,BP ANZ,13.9,0,73927.64,DR,REF792073,ANZ,Savings
04-08-2025 03:28,ANZ7DDEC4C9B297476AB795,012-345-678,11111111,SHELL ANZ,13.52,0,73914.12,DR,REF654051,ANZ,Savings
04-08-2025 03:40,ANZ4CB54C229C80469C914A,012-345-678,11111111,HARVEY NORMAN ANZ,105.64,0,73808.48,DR,REF721469,ANZ,Savings
04-08-2025 03:44,ANZ55E9C58C6C7743F8BC0B,012-345-678,11111111,ALDI ANZ,7.8,0,73800.68,DR,REF762736,ANZ,Savings
04-08-2025 03:49,ANZ8471BA75943D4DF5BEA1,012-345-678,11111111,COLES ANZ,58.12,0,73742.56,DR,REF351788,ANZ,Savings
04-08-2025 04:32,ANZ7DF00491663644AD9868,012-345-678,11111111,ALDI ANZ,151.13,0,73591.43,DR,REF998679,ANZ,Savings
04-08-2025 04:59,ANZ9883C30D4C3F4D0BBEF0,012-345-678,11111111,FLIXBUS ANZ,18.98,0,73572.45,DR,REF475731,ANZ,Savings
04-08-2025 05:00,INT43544C0636BC4B4F9DFA,012-345-678,11111111,TRANSFER FROM NAB 44444444,0,879.62,74452.07,CR,INT-22138,ANZ,Savings
04-08-2025 05:10,ANZ68FE45E6686E45E29A92,012-345-678,11111111,WOOLWORTHS ANZ,106.69,0,74345.38,DR,REF484698,ANZ,Savings
04-08-2025 05:12,ANZB616F7F5F35A4CED96E3,012-345-678,11111111,BP ANZ,36.59,0,74308.79,DR,REF717561,ANZ,Savings
04-08-2025 05:30,INTFBBF7DD1CB7F47E991BF,012-345-678,11111111,TRANSFER FROM CBA 22222222,0,1584.95,75893.74,CR,INT-69923,ANZ,Savings
04-08-2025 05:32,ANZ80E3B22D492646479D47,012-345-678,11111111,STARBUCKS ANZ,12.25,0,75881.49,DR,REF791535,ANZ,Savings
04-08-2025 05:36,ANZE0EB5DC712E8401DB3A6,012-345-678,11111111,SALARY PAYMENT ANZ,0,6243.58,82125.07,CR,REF238198,ANZ,Savings
04-08-2025 05:38,ANZ8EC66EE4A0CA4C9DA4C0,012-345-678,11111111,PAYPAL *NETFLIX ANZ,13.92,0,82111.15,DR,REF946145,ANZ,Savings
04-08-2025 05:41,ANZA6DFD051E5FF49E49597,012-345-678,11111111,PAYMENT GATEWAY ANZ,114.52,0,81996.63,DR,REF802087,ANZ,Savings
04-08-2025 05:42,ANZ9093BBAECD8E42CB96FA,012-345-678,11111111,ALDI ANZ,47.56,0,81949.07,DR,REF283332,ANZ,Savings
04-08-2025 05:53,ANZA14AD35AA9164F7A9D1F,012-345-678,11111111,HARVEY NORMAN ANZ,26.05,0,81923.02,DR,REF426465,ANZ,Savings
04-08-2025 06:56,ANZ7BC459DB88074B1E847D,012-345-678,11111111,BIGW ANZ,43.38,0,81879.64,DR,REF959497,ANZ,Savings
04-08-2025 07:10,ANZECF04A8007FE40CCA5EC,012-345-678,11111111,COMPANY PAYROLL ANZ,0,6462.62,88342.26,CR,REF270844,ANZ,Savings
04-08-2025 07:23,ANZ58B2D547F3AF48C09689,012-345-678,11111111,PAYMENT GATEWAY ANZ,13.77,0,88328.49,DR,REF614907,ANZ,Savings
04-08-2025 07:27,ANZC618C2E1F27C491888AB,012-345-678,11111111,APPLE ANZ,96.57,0,88231.92,DR,REF623518,ANZ,Savings
04-08-2025 07:30,ANZAE16FA5E61BA4BDEA1B7,012-345-678,11111111,TAFE BOOKSHOP ANZ,31.17,0,88200.75,DR,REF265776,ANZ,Savings
04-08-2025 07:31,ANZE7AE74EDE1D2457CB72E,012-345-678,11111111,JB HI-FI ANZ,21.37,0,88179.38,DR,REF182166,ANZ,Savings
04-08-2025 07:48,ANZ51984074C7C14A15A487,012-345-678,11111111,COLES ANZ,33.69,0,88145.69,DR,REF669586,ANZ,Savings
04-08-2025 07:48,ANZA9041E9857114070BF87,012-345-678,11111111,UBER EATS ANZ,77.33,0,88068.36,DR,REF155893,ANZ,Savings
04-08-2025 08:19,ANZF73A0C530B1646B5B252,012-345-678,11111111,MCDONALDS ANZ,41.82,0,88026.54,DR,REF417245,ANZ,Savings
04-08-2025 08:28,ANZ590BDDE2ED1745C4BA30,012-345-678,11111111,PAYROLL CREDIT ANZ,0,714.35,88740.89,CR,REF861691,ANZ,Savings
04-08-2025 08:38,ANZ3574E9314CD84584BA35,012-345-678,11111111,PAY - SALARY ANZ,0,2684.96,91425.85,CR,REF907208,ANZ,Savings
04-08-2025 09:09,ANZ6D891CEB03564DF99DA1,012-345-678,11111111,SPOTIFY ANZ,84.97,0,91340.88,DR,REF369542,ANZ,Savings
04-08-2025 09:38,ANZB70BDA1672114D6E9462,012-345-678,11111111,BIGW ANZ,139.79,0,91201.09,DR,REF894004,ANZ,Savings
04-08-2025 09:51,ANZA56C7E1948B24AECA607,012-345-678,11111111,CITYLINK ANZ,6.03,0,91195.06,DR,REF341059,ANZ,Savings
04-08-2025 10:03,ANZBCC71FB156E842DFAB4B,012-345-678,11111111,KFC ANZ,18.59,0,91176.47,DR,REF240649,ANZ,Savings
04-08-2025 10:19,ANZ5A2B10B5FD1243A0972A,012-345-678,11111111,BANK FEE ANZ,29.35,0,91147.12,DR,REF117543,ANZ,Savings
04-08-2025 10:22,ANZ97BB37AB17014013B469,012-345-678,11111111,RAILWAY STATION ANZ,148.88,0,90998.24,DR,REF982157,ANZ,Savings
04-08-2025 10:43,ANZ45C8A63E37304485BB26,012-345-678,11111111,PAYMENT GATEWAY ANZ,6.41,0,90991.83,DR,REF350427,ANZ,Savings
04-08-2025 11:11,ANZCCA6533629C64D59A3A1,012-345-678,11111111,7-ELEVEN ANZ,27.81,0,90964.02,DR,REF976333,ANZ,Savings
04-08-2025 11:15,ANZBF54BCDE2FD94A6BA317,012-345-678,11111111,CITYLINK ANZ,133.03,0,90830.99,DR,REF569077,ANZ,Savings
04-08-2025 11:29,ANZA3021676249C4ABDA84D,012-345-678,11111111,CITYLINK ANZ,72.46,0,90758.53,DR,REF461675,ANZ,Savings
04-08-2025 11:31,ANZ76B8A0CE43FD40268F9F,012-345-678,11111111,BIGW ANZ,8.1,0,90750.43,DR,REF686341,ANZ,Savings
04-08-2025 11:42,ANZ06757BE21220410C85CA,012-345-678,11111111,JB HI-FI ANZ,47.63,0,90702.8,DR,REF948060,ANZ,Savings
04-08-2025 12:41,ANZCFE05EE653B64CCC9171,012-345-678,11111111,HARVEY NORMAN ANZ,28.31,0,90674.49,DR,REF232690,ANZ,Savings
04-08-2025 12:48,ANZ2DCE85C9E496469C8460,012-345-678,11111111,ZOOM ANZ,54.2,0,90620.29,DR,REF684939,ANZ,Savings
04-08-2025 12:58,ANZ95FF61926DF74CE3A149,012-345-678,11111111,BP ANZ,29.24,0,90591.05,DR,REF570089,ANZ,Savings
04-08-2025 13:12,ANZ13CC4BBDBF20419DA8F2,012-345-678,11111111,BIGW ANZ,50.47,0,90540.58,DR,REF581333,ANZ,Savings
04-08-2025 14:14,ANZ9BA62E66DA704700A99E,012-345-678,11111111,DOMINO'S PIZZA ANZ,90.89,0,90449.69,DR,REF385543,ANZ,Savings
04-08-2025 14:20,ANZ6B510B4F9D97427898FA,012-345-678,11111111,PAY - SALARY ANZ,0,4682.3,95131.99,CR,REF618411,ANZ,Savings
04-08-2025 14:59,ANZ58BA0ECA1D9046CCAE3D,012-345-678,11111111,BANK FEE ANZ,16.67,0,95115.32,DR,REF503006,ANZ,Savings
04-08-2025 15:03,ANZ29FFEFD12F9447AB8CD8,012-345-678,11111111,KFC ANZ,57.13,0,95058.19,DR,REF891287,ANZ,Savings
04-08-2025 15:05,ANZ4D22F0AC4F4644BFA7DC,012-345-678,11111111,HARVEY NORMAN ANZ,32.1,0,95026.09,DR,REF283373,ANZ,Savings
04-08-2025 15:10,ANZD75E08F1AE674EEFBBC7,012-345-678,11111111,SALARY PAYMENT ANZ,0,2384.47,97410.56,CR,REF834082,ANZ,Savings
04-08-2025 15:19,ANZ5997491A46DC48908A8A,012-345-678,11111111,WAGES CREDIT ANZ,0,476.93,97887.49,CR,REF701853,ANZ,Savings
04-08-2025 15:36,ANZ8382D54A86E04A1BBDEE,012-345-678,11111111,SALARY PAYMENT ANZ,0,3142.3,101029.79,CR,REF329526,ANZ,Savings
04-08-2025 16:13,ANZ1EE19E1D35CB4481AD65,012-345-678,11111111,SALARY PAYMENT ANZ,0,550.78,101580.57,CR,REF436334,ANZ,Savings
04-08-2025 16:29,ANZ0AEA75016CA8431DA772,012-345-678,11111111,JB HI-FI ANZ,68.19,0,101512.38,DR,REF395519,ANZ,Savings
04-08-2025 17:04,ANZCA7821D56C91438FAB8F,012-345-678,11111111,PAYROLL CREDIT ANZ,0,30.11,101542.49,CR,REF221322,ANZ,Savings
04-08-2025 17:13,ANZ3DB9AFAF563D4FB189A4,012-345-678,11111111,BIGW ANZ,40.21,0,101502.28,DR,REF166237,ANZ,Savings
04-08-2025 17:16,ANZCE27EF4AB96B4E779C16,012-345-678,11111111,RAILWAY STATION ANZ,5.81,0,101496.47,DR,REF147172,ANZ,Savings
04-08-2025 17:18,ANZ27DA2F2F8ED749009EEB,012-345-678,11111111,BP ANZ,36.92,0,101459.55,DR,REF515206,ANZ,Savings
04-08-2025 17:21,ANZ39B81F2C7F1F406B9F0A,012-345-678,11111111,PAYPAL *NETFLIX ANZ,165.66,0,101293.89,DR,REF337548,ANZ,Savings
04-08-2025 17:32,ANZ799554E6CE2F43E38B69,012-345-678,11111111,APPLE ANZ,11.81,0,101282.08,DR,REF937243,ANZ,Savings
04-08-2025 17:45,ANZFACB5D642BF64525AA48,012-345-678,11111111,TAFE BOOKSHOP ANZ,93.51,0,101188.57,DR,REF927631,ANZ,Savings
04-08-2025 17:49,ANZA0C0344C9DA847AEA603,012-345-678,11111111,AMAZON AU ANZ,34.09,0,101154.48,DR,REF402638,ANZ,Savings
04-08-2025 18:10,ANZCEDA4DCABFDA45F3B7ED,012-345-678,11111111,HARVEY NORMAN ANZ,7.46,0,101147.02,DR,REF436661,ANZ,Savings
04-08-2025 18:13,ANZE2D13A96EAD246F3BAED,012-345-678,11111111,ALDI ANZ,35.25,0,101111.77,DR,REF216685,ANZ,Savings
04-08-2025 18:46,ANZ93783297F3E24170A755,012-345-678,11111111,BP ANZ,11.86,0,101099.91,DR,REF142488,ANZ,Savings
04-08-2025 18:54,ANZB4D83B6B2F694F1481E5,012-345-678,11111111,SALARY PAYMENT ANZ,0,4386.49,105486.4,CR,REF993825,ANZ,Savings
04-08-2025 18:56,ANZ81437CA6F4B045ECA4AB,012-345-678,11111111,BP ANZ,86.41,0,105399.99,DR,REF792271,ANZ,Savings
04-08-2025 19:18,ANZ9D0329E7C9744248AD69,012-345-678,11111111,PAYPAL *NETFLIX ANZ,45.63,0,105354.36,DR,REF461460,ANZ,Savings
04-08-2025 19:51,ANZ2AB2BD04193C453D857A,012-345-678,11111111,BWS ANZ,63.02,0,105291.34,DR,REF566480,ANZ,Savings
04-08-2025 20:14,ANZ342FF8AEFE134B0F91B0,012-345-678,11111111,ALDI ANZ,62.72,0,105228.62,DR,REF719765,ANZ,Savings
04-08-2025 20:22,ANZ0441E9C1E29F4749959C,012-345-678,11111111,PAYPAL *NETFLIX ANZ,84.98,0,105143.64,DR,REF357957,ANZ,Savings
04-08-2025 20:29,ANZ37F7C119AABE46AC9FD1,012-345-678,11111111,INTERNET TRANSFER ANZ,108.96,0,105034.68,DR,REF248952,ANZ,Savings
04-08-2025 20:36,ANZ780B61BD6A2A461D8F38,012-345-678,11111111,INTERNET TRANSFER ANZ,53.31,0,104981.37,DR,REF243766,ANZ,Savings
04-08-2025 20:37,ANZ1DB8D069F4154DD492D0,012-345-678,11111111,CITYLINK ANZ,125.67,0,104855.7,DR,REF344800,ANZ,Savings
04-08-2025 20:51,ANZ50A7808C2E1B40C09B6E,012-345-678,11111111,AMAZON AU ANZ,52.77,0,104802.93,DR,REF551967,ANZ,Savings
04-08-2025 20:52,ANZ07E676793CEE44A7B0C3,012-345-678,11111111,STARBUCKS ANZ,23.34,0,104779.59,DR,REF183480,ANZ,Savings
04-08-2025 20:53,INT1D42BEF6F0DA4773B38E,012-345-678,11111111,TRANSFER FROM NAB 44444444,0,1967.79,106747.38,CR,INT-59650,ANZ,Savings
04-08-2025 20:56,ANZ1B5C0D9392B349F3BE9F,012-345-678,11111111,BWS ANZ,139.19,0,106608.19,DR,REF307490,ANZ,Savings
04-08-2025 21:09,ANZD4B0C8E61A8E49A398A4,012-345-678,11111111,MENULOG ANZ,7.16,0,106601.03,DR,REF222011,ANZ,Savings
04-08-2025 21:13,ANZA253A2175AC747648916,012-345-678,11111111,LIQUORLAND ANZ,82.84,0,106518.19,DR,REF310785,ANZ,Savings
04-08-2025 21:20,ANZF658D83F359841C491FD,012-345-678,11111111,7-ELEVEN ANZ,37.7,0,106480.49,DR,REF902784,ANZ,Savings
04-08-2025 21:43,ANZ162312CEB27C411DA311,012-345-678,11111111,COLES ANZ,10.45,0,106470.04,DR,REF303519,ANZ,Savings
05-08-2025 00:18,INTB4F9AC03EDC145C38AF8,012-345-678,11111111,TRANSFER FROM CBA 22222222,0,1278.6,107748.64,CR,INT-72216,ANZ,Savings
05-08-2025 00:37,ANZE95F4806647F457EA78D,012-345-678,11111111,PAYMENT GATEWAY ANZ,37.2,0,107711.44,DR,REF470671,ANZ,Savings
05-08-2025 00:55,INT85A0229BB0DF415883BA,012-345-678,11111111,TRANSFER TO CBA 33333333,1609.54,0,106101.9,DR,INT-63803,ANZ,Savings
05-08-2025 01:03,ANZ901876EBE81D425397FA,012-345-678,11111111,PAY - SALARY ANZ,0,4483.68,110585.58,CR,REF394665,ANZ,Savings
05-08-2025 01:13,ANZB54F2E662FC94488ADDF,012-345-678,11111111,TAFE BOOKSHOP ANZ,25.99,0,110559.59,DR,REF483808,ANZ,Savings
05-08-2025 01:41,ANZ3ECA192DA30D486583CD,012-345-678,11111111,PAYMENT GATEWAY ANZ,12.06,0,110547.53,DR,REF406520,ANZ,Savings
05-08-2025 01:54,ANZ00F25932AD4B4F15A9B8,012-345-678,11111111,SHELL ANZ,21.88,0,110525.65,DR,REF528681,ANZ,Savings
05-08-2025 01:57,ANZAAF4E5B45AAF4B978858,012-345-678,11111111,UBER EATS ANZ,79.12,0,110446.53,DR,REF654842,ANZ,Savings
05-08-2025 02:30,ANZ1E4B6FB1246C41ECAEB3,012-345-678,11111111,MENULOG ANZ,95.06,0,110351.47,DR,REF808209,ANZ,Savings
05-08-2025 02:45,ANZB3C7109388C34A71AE27,012-345-678,11111111,RAILWAY STATION ANZ,120.44,0,110231.03,DR,REF454435,ANZ,Savings
05-08-2025 02:45,ANZ0148C28596CD4377BA94,012-345-678,11111111,BIGW ANZ,62.42,0,110168.61,DR,REF322165,ANZ,Savings
05-08-2025 03:01,ANZ3D35AD29DF964CB59E1B,012-345-678,11111111,SHELL ANZ,2.42,0,110166.19,DR,REF976827,ANZ,Savings
05-08-2025 03:35,ANZ6D96AADC87114E9099BE,012-345-678,11111111,CITYLINK ANZ,17.67,0,110148.52,DR,REF783121,ANZ,Savings
05-08-2025 03:36,ANZ2A80CA1BD8654D4DB999,012-345-678,11111111,WOOLWORTHS ANZ,11.9,0,110136.62,DR,REF886939,ANZ,Savings
05-08-2025 03:39,ANZ6669942DCF5E4662BAB1,012-345-678,11111111,INTERNET TRANSFER ANZ,85.28,0,110051.34,DR,REF160626,ANZ,Savings
05-08-2025 03:52,ANZF9973E27A0C047DA846F,012-345-678,11111111,JB HI-FI ANZ,108.92,0,109942.42,DR,REF777168,ANZ,Savings
05-08-2025 04:10,ANZAF662B37E7DC47BCBEA3,012-345-678,11111111,ZOOM ANZ,11.13,0,109931.29,DR,REF723510,ANZ,Savings
05-08-2025 05:56,ANZ46A834DC61854840BFE7,012-345-678,11111111,BANK FEE ANZ,62.68,0,109868.61,DR,REF591323,ANZ,Savings
05-08-2025 05:57,ANZ5F17201CF57C430985AC,012-345-678,11111111,JB HI-FI ANZ,34.45,0,109834.16,DR,REF300601,ANZ,Savings
05-08-2025 06:24,INTE9BB64F0210144DFB4B8,012-345-678,11111111,TRANSFER TO NAB 44444444,1433.78,0,108400.38,DR,INT-87567,ANZ,Savings
05-08-2025 06:25,INTE28882C389D2467B9F62,012-345-678,11111111,TRANSFER FROM CBA 22222222,0,103.58,108503.96,CR,INT-45724,ANZ,Savings
05-08-2025 06:54,ANZ3F8994D612AD42E8991D,012-345-678,11111111,WOOLWORTHS ANZ,49.82,0,108454.14,DR,REF799633,ANZ,Savings
05-08-2025 06:59,ANZD4C39F0EEC1F4C0DB7F4,012-345-678,11111111,BP ANZ,249.59,0,108204.55,DR,REF365704,ANZ,Savings
05-08-2025 07:02,ANZ3B9716268911489AAFF2,012-345-678,11111111,INTERNET TRANSFER ANZ,15.51,0,108189.04,DR,REF952419,ANZ,Savings
05-08-2025 07:17,INT29E5C04C915E4D768685,012-345-678,11111111,TRANSFER FROM CBA 33333333,0,954.42,109143.46,CR,INT-94386,ANZ,Savings
05-08-2025 07:28,ANZC1E7769D0B034E77957C,012-345-678,11111111,STARBUCKS ANZ,1.52,0,109141.94,DR,REF397228,ANZ,Savings
05-08-2025 08:00,ANZ5FFA216F44E34B738125,012-345-678,11111111,HARVEY NORMAN ANZ,226.43,0,108915.51,DR,REF646474,ANZ,Savings
05-08-2025 08:15,ANZ474C71C481284D0FBA8B,012-345-678,11111111,HARVEY NORMAN ANZ,56.79,0,108858.72,DR,REF311033,ANZ,Savings
05-08-2025 08:19,INT1EB5B70B94FC495C8EB5,012-345-678,11111111,TRANSFER TO CBA 33333333,77.73,0,108780.99,DR,INT-39085,ANZ,Savings
05-08-2025 08:23,ANZ1FAEEA755C04448F9121,012-345-678,11111111,PAYPAL *NETFLIX ANZ,4.85,0,108776.14,DR,REF826353,ANZ,Savings
05-08-2025 08:45,ANZF513BD990EED47049E61,012-345-678,11111111,COMPANY PAYROLL ANZ,0,1073.42,109849.56,CR,REF124812,ANZ,Savings
05-08-2025 08:55,INT974939A18E3A433BB213,012-345-678,11111111,TRANSFER TO NAB 44444444,1440.17,0,108409.39,DR,INT-15101,ANZ,Savings
05-08-2025 08:56,ANZ3BFDBC0E123F43E99DF2,012-345-678,11111111,PAYMENT GATEWAY ANZ,94.11,0,108315.28,DR,REF968153,ANZ,Savings
05-08-2025 08:58,ANZ26C77BB2B1E049869017,012-345-678,11111111,PAYROLL CREDIT ANZ,0,49.14,108364.42,CR,REF189816,ANZ,Savings
05-08-2025 09:05,ANZ28677981B59443268305,012-345-678,11111111,TAFE BOOKSHOP ANZ,23.29,0,108341.13,DR,REF504561,ANZ,Savings
05-08-2025 09:43,ANZF955EB1194424D2DBF1A,012-345-678,11111111,SHELL ANZ,9.44,0,108331.69,DR,REF305855,ANZ,Savings
05-08-2025 09:58,ANZ186AE99DD9304A6FA216,012-345-678,11111111,7-ELEVEN ANZ,14.94,0,108316.75,DR,REF617817,ANZ,Savings
05-08-2025 09:58,ANZ2B466D3534F1476C8F41,012-345-678,11111111,PAYMENT GATEWAY ANZ,5.68,0,108311.07,DR,REF445995,ANZ,Savings
05-08-2025 10:47,INTB5BBAB00639C4D3681F3,012-345-678,11111111,TRANSFER TO CBA 22222222,220.47,0,108090.6,DR,INT-71457,ANZ,Savings
05-08-2025 11:11,ANZAC6D739D97EC411A95EC,012-345-678,11111111,RAILWAY STATION ANZ,5.69,0,108084.91,DR,REF119960,ANZ,Savings
05-08-2025 11:39,ANZ2D508174B58D4EB79D4F,012-345-678,11111111,JB HI-FI ANZ,134.01,0,107950.9,DR,REF817423,ANZ,Savings
05-08-2025 12:08,ANZ991DD8E8AD05427287F0,012-345-678,11111111,BIGW ANZ,61.81,0,107889.09,DR,REF260467,ANZ,Savings
05-08-2025 12:12,ANZ3023BEC8B58144DBA604,012-345-678,11111111,ALDI ANZ,3.13,0,107885.96,DR,REF478949,ANZ,Savings
05-08-2025 12:17,ANZC3EAE06E40F545939CEB,012-345-678,11111111,HARVEY NORMAN ANZ,19.75,0,107866.21,DR,REF984985,ANZ,Savings
05-08-2025 12:30,ANZ08C59B2D49764971B4AA,012-345-678,11111111,TAFE BOOKSHOP ANZ,179.57,0,107686.64,DR,REF324742,ANZ,Savings
05-08-2025 12:44,ANZ92C6F295935F467E956A,012-345-678,11111111,PAYROLL CREDIT ANZ,0,3401.24,111087.88,CR,REF921311,ANZ,Savings
05-08-2025 13:10,ANZDA2CA42874504CDDBFF2,012-345-678,11111111,BWS ANZ,202.74,0,110885.14,DR,REF285849,ANZ,Savings
05-08-2025 13:19,INT89CB481ADA7145508153,012-345-678,11111111,TRANSFER TO NAB 44444444,1364.04,0,109521.1,DR,INT-61207,ANZ,Savings
05-08-2025 13:30,ANZ9D0376750254477BBBE8,012-345-678,11111111,BWS ANZ,51.02,0,109470.08,DR,REF623056,ANZ,Savings
05-08-2025 13:33,ANZ36D5F70B2E744C98A28C,012-345-678,11111111,SPOTIFY ANZ,2.78,0,109467.3,DR,REF238194,ANZ,Savings
05-08-2025 14:12,ANZ776C7B21FD3C4A638200,012-345-678,11111111,HARVEY NORMAN ANZ,22.28,0,109445.02,DR,REF124193,ANZ,Savings
05-08-2025 14:15,ANZ1A19D1B30D62466A806A,012-345-678,11111111,WAGES CREDIT ANZ,0,2795.81,112240.83,CR,REF333695,ANZ,Savings
05-08-2025 14:27,ANZ2FF13A92A4D5412BB8B1,012-345-678,11111111,PAYPAL *NETFLIX ANZ,90.73,0,112150.1,DR,REF512002,ANZ,Savings
05-08-2025 14:56,ANZ62E9F3F4364D4809B268,012-345-678,11111111,BP ANZ,60.45,0,112089.65,DR,REF942482,ANZ,Savings
05-08-2025 15:10,ANZ94E122F482864E85A0FC,012-345-678,11111111,INTERNET TRANSFER ANZ,126.55,0,111963.1,DR,REF873217,ANZ,Savings
05-08-2025 15:35,ANZ59914AECC22C47F0846B,012-345-678,11111111,STARBUCKS ANZ,163.43,0,111799.67,DR,REF471382,ANZ,Savings
05-08-2025 15:39,ANZ757429B4C21448F3B841,012-345-678,11111111,COLES ANZ,52.4,0,111747.27,DR,REF746125,ANZ,Savings
05-08-2025 15:40,ANZ02DC82CBA61541FDB473,012-345-678,11111111,MENULOG ANZ,27.14,0,111720.13,DR,REF869123,ANZ,Savings
05-08-2025 15:41,ANZ03AE8304A4924AB5AE50,012-345-678,11111111,SPOTIFY ANZ,64.21,0,111655.92,DR,REF648841,ANZ,Savings
05-08-2025 16:20,ANZ7F9EFAEADF1149928702,012-345-678,11111111,AMAZON AU ANZ,61.44,0,111594.48,DR,REF853234,ANZ,Savings
05-08-2025 17:03,ANZ7EE5335EA42742029FDF,012-345-678,11111111,RAILWAY STATION ANZ,29.43,0,111565.05,DR,REF240660,ANZ,Savings
05-08-2025 17:26,ANZ293E0B2380F447FB9094,012-345-678,11111111,ALDI ANZ,36.15,0,111528.9,DR,REF848696,ANZ,Savings
05-08-2025 17:44,ANZ61514D1D934E426A97B3,012-345-678,11111111,BIGW ANZ,19.05,0,111509.85,DR,REF290254,ANZ,Savings
05-08-2025 18:18,ANZ15B3214A4A504B51A54B,012-345-678,11111111,AMAZON AU ANZ,56.86,0,111452.99,DR,REF945177,ANZ,Savings
05-08-2025 18:35,ANZ0F6A5DB3B59141939E3D,012-345-678,11111111,STARBUCKS ANZ,101.24,0,111351.75,DR,REF620666,ANZ,Savings
05-08-2025 18:36,ANZ3383915D8ED54AF48BB5,012-345-678,11111111,COLES ANZ,83.9,0,111267.85,DR,REF602680,ANZ,Savings
05-08-2025 18:43,ANZ8CA934E1B19447B0B7A4,012-345-678,11111111,PAYMENT GATEWAY ANZ,8.12,0,111259.73,DR,REF491828,ANZ,Savings
05-08-2025 19:12,ANZ4B4B5EF9FCA7466D9E36,012-345-678,11111111,APPLE ANZ,11.19,0,111248.54,DR,REF754005,ANZ,Savings
05-08-2025 19:32,ANZBB3A051DA4124BDEB161,012-345-678,11111111,COMPANY PAYROLL ANZ,0,5965.49,117214.03,CR,REF986086,ANZ,Savings
05-08-2025 19:40,ANZAF4C0CE90EE44FE8AA39,012-345-678,11111111,SALARY PAYMENT ANZ,0,1088.8,118302.83,CR,REF667345,ANZ,Savings
05-08-2025 20:05,ANZE49F745881C04D458EF9,012-345-678,11111111,WOOLWORTHS ANZ,51.78,0,118251.05,DR,REF676921,ANZ,Savings
05-08-2025 20:11,INT7DA5D356BC6346B293AC,012-345-678,11111111,TRANSFER TO CBA 22222222,1447.18,0,116803.87,DR,INT-68168,ANZ,Savings
05-08-2025 21:13,INT4D56183983584DA8B042,012-345-678,11111111,TRANSFER FROM CBA 22222222,0,784.88,117588.75,CR,INT-93020,ANZ,Savings
05-08-2025 21:31,INTBC70B3CF73664C05AB57,012-345-678,11111111,TRANSFER TO NAB 44444444,1985.48,0,115603.27,DR,INT-35806,ANZ,Savings
05-08-2025 21:33,ANZ0D674DFD47364B1CBFFB,012-345-678,11111111,COLES ANZ,24.14,0,115579.13,DR,REF824009,ANZ,Savings
05-08-2025 22:24,ANZ4A06FC21093C4C43A0F8,012-345-678,11111111,HARVEY NORMAN ANZ,10.39,0,115568.74,DR,REF201388,ANZ,Savings
05-08-2025 22:26,ANZ06524C1E3B754FF98AE8,012-345-678,11111111,COMPANY PAYROLL ANZ,0,5741.15,121309.89,CR,REF300130,ANZ,Savings
05-08-2025 23:06,ANZEBE69DCF05864E919ABD,012-345-678,11111111,SALARY PAYMENT ANZ,0,1950,123259.89,CR,REF738462,ANZ,Savings
05-08-2025 23:19,ANZ239B90AB62574ACA89F0,012-345-678,11111111,CITYLINK ANZ,40.29,0,123219.6,DR,REF894015,ANZ,Savings
05-08-2025 23:21,ANZ67D9C617830D406EBB6A,012-345-678,11111111,BANK FEE ANZ,34.45,0,123185.15,DR,REF955092,ANZ,Savings
05-08-2025 23:57,ANZF4EAA70AB777426DB52B,012-345-678,11111111,PAY - SALARY ANZ,0,6307.39,129492.54,CR,REF498474,ANZ,Savings
06-08-2025 00:03,ANZ63C1F516A279408C91C3,012-345-678,11111111,STARBUCKS ANZ,123.89,0,129368.65,DR,REF518504,ANZ,Savings
06-08-2025 00:09,ANZ793A34D613574FB4B373,012-345-678,11111111,ZOOM ANZ,59.52,0,129309.13,DR,REF437588,ANZ,Savings
06-08-2025 00:09,ANZE341D9D0AE8947CF9A6F,012-345-678,11111111,SPOTIFY ANZ,5.65,0,129303.48,DR,REF975813,ANZ,Savings
06-08-2025 00:15,ANZ052FF6E8573D4B138EEB,012-345-678,11111111,SPOTIFY ANZ,20.53,0,129282.95,DR,REF514162,ANZ,Savings
06-08-2025 00:23,ANZ4DDAE2A989FA49DBA536,012-345-678,11111111,BANK FEE ANZ,36.28,0,129246.67,DR,REF951650,ANZ,Savings
06-08-2025 00:27,ANZ73EC2D02420D4964962A,012-345-678,11111111,TAFE BOOKSHOP ANZ,8.42,0,129238.25,DR,REF470169,ANZ,Savings
06-08-2025 00:31,ANZ2D00138393BE415C8EF5,012-345-678,11111111,SPOTIFY ANZ,38.12,0,129200.13,DR,REF891886,ANZ,Savings
06-08-2025 00:37,ANZC9B974709DAD4471B3EA,012-345-678,11111111,INTERNET TRANSFER ANZ,7.23,0,129192.9,DR,REF408584,ANZ,Savings
06-08-2025 00:48,ANZ15AE124824DA49AAAE26,012-345-678,11111111,KFC ANZ,55.03,0,129137.87,DR,REF414196,ANZ,Savings
06-08-2025 00:58,ANZ76E9B9B2E7D748CA9E26,012-345-678,11111111,CITYLINK ANZ,83.85,0,129054.02,DR,REF425568,ANZ,Savings
06-08-2025 01:03,ANZ85FB518D015E413780A2,012-345-678,11111111,PAYPAL *NETFLIX ANZ,4.08,0,129049.94,DR,REF175965,ANZ,Savings
06-08-2025 01:17,ANZ366BDFBEF8914FA09166,012-345-678,11111111,AMAZON AU ANZ,17.64,0,129032.3,DR,REF165307,ANZ,Savings
06-08-2025 01:25,ANZ66BE579BC59A40DEBBC0,012-345-678,11111111,TAFE BOOKSHOP ANZ,30.95,0,129001.35,DR,REF542660,ANZ,Savings
06-08-2025 01:40,ANZ231F15D27E1747DCAD56,012-345-678,11111111,HARVEY NORMAN ANZ,27.9,0,128973.45,DR,REF525363,ANZ,Savings
06-08-2025 01:41,ANZ4B6617A83C594A52A67C,012-345-678,11111111,JB HI-FI ANZ,84.79,0,128888.66,DR,REF880788,ANZ,Savings
06-08-2025 01:49,ANZE63BD99639864C729046,012-345-678,11111111,STARBUCKS ANZ,43.51,0,128845.15,DR,REF403719,ANZ,Savings
06-08-2025 02:23,ANZDC754EEA0CF742F5A867,012-345-678,11111111,PAY - SALARY ANZ,0,4234.06,133079.21,CR,REF798657,ANZ,Savings
06-08-2025 02:56,ANZBBB07208CF6149FE8669,012-345-678,11111111,SALARY PAYMENT ANZ,0,2723.07,135802.28,CR,REF106833,ANZ,Savings
06-08-2025 03:13,ANZ140454DFFF25447BA7F2,012-345-678,11111111,COMPANY PAYROLL ANZ,0,633.34,136435.62,CR,REF901792,ANZ,Savings
06-08-2025 03:36,ANZCAD7E8760B914DE5ACF1,012-345-678,11111111,INTERNET TRANSFER ANZ,13.68,0,136421.94,DR,REF395225,ANZ,Savings
06-08-2025 04:33,ANZD772E9FEB8504E5A93B1,012-345-678,11111111,APPLE ANZ,35.23,0,136386.71,DR,REF758709,ANZ,Savings
06-08-2025 04:39,ANZ27B5FD4B31394B2386CB,012-345-678,11111111,PAYROLL CREDIT ANZ,0,2691.05,139077.76,CR,REF154969,ANZ,Savings
06-08-2025 04:50,ANZDF410D511D84436EA13B,012-345-678,11111111,TAFE BOOKSHOP ANZ,41.22,0,139036.54,DR,REF628087,ANZ,Savings
06-08-2025 05:30,ANZF2A44DA97B084BCF80C2,012-345-678,11111111,UBER EATS ANZ,65.1,0,138971.44,DR,REF612744,ANZ,Savings
06-08-2025 05:34,ANZ6918A10BBB674C038309,012-345-678,11111111,JB HI-FI ANZ,27.46,0,138943.98,DR,REF618743,ANZ,Savings
06-08-2025 05:44,ANZF906631C768B421DB980,012-345-678,11111111,CITYLINK ANZ,33.1,0,138910.88,DR,REF861898,ANZ,Savings
06-08-2025 05:58,ANZ0AFBAA875F9D459DBD8D,012-345-678,11111111,APPLE ANZ,33.26,0,138877.62,DR,REF662021,ANZ,Savings
06-08-2025 06:12,ANZ148E603F3119445E8C5D,012-345-678,11111111,FLIXBUS ANZ,10.01,0,138867.61,DR,REF654401,ANZ,Savings
06-08-2025 06:22,ANZAAD8317418C54A7198EC,012-345-678,11111111,BWS ANZ,32.58,0,138835.03,DR,REF720615,ANZ,Savings
06-08-2025 06:54,ANZ642C95C5E61D4B4DB7CA,012-345-678,11111111,UBER EATS ANZ,7.45,0,138827.58,DR,REF445626,ANZ,Savings
06-08-2025 07:44,ANZ7CC2A5BB97C04A09AC67,012-345-678,11111111,BIGW ANZ,54.6,0,138772.98,DR,REF487672,ANZ,Savings
06-08-2025 07:45,ANZ68038B60B984468E8C93,012-345-678,11111111,LIQUORLAND ANZ,165.37,0,138607.61,DR,REF687598,ANZ,Savings
06-08-2025 07:49,ANZE040BCE14FA3476C8B55,012-345-678,11111111,LIQUORLAND ANZ,43.87,0,138563.74,DR,REF779495,ANZ,Savings
06-08-2025 08:18,ANZ2D77C20AB48B4263B88F,012-345-678,11111111,SPOTIFY ANZ,75.25,0,138488.49,DR,REF854647,ANZ,Savings
06-08-2025 08:26,ANZF77275E30AD14DC38EB7,012-345-678,11111111,BWS ANZ,24.25,0,138464.24,DR,REF428552,ANZ,Savings
06-08-2025 08:56,ANZDBD6F625A6E34C9E9326,012-345-678,11111111,BP ANZ,11.65,0,138452.59,DR,REF487138,ANZ,Savings
06-08-2025 09:25,ANZ31D1944C15934722A554,012-345-678,11111111,COLES ANZ,16.34,0,138436.25,DR,REF763311,ANZ,Savings
06-08-2025 09:41,ANZ077CB78BCE474D49B6B2,012-345-678,11111111,UBER EATS ANZ,25.44,0,138410.81,DR,REF577231,ANZ,Savings
06-08-2025 10:03,ANZF24DFD4A8E86455DA2E8,012-345-678,11111111,COLES ANZ,28.6,0,138382.21,DR,REF554125,ANZ,Savings
06-08-2025 10:12,INT1D1952E6B7214EA1B30A,012-345-678,11111111,TRANSFER TO CBA 22222222,1727.71,0,136654.5,DR,INT-87904,ANZ,Savings
06-08-2025 10:24,ANZ0EB3F4E07FB544199000,012-345-678,11111111,BIGW ANZ,8.62,0,136645.88,DR,REF156951,ANZ,Savings
06-08-2025 10:25,ANZAABDCDC3645945A8B787,012-345-678,11111111,MENULOG ANZ,21.27,0,136624.61,DR,REF877401,ANZ,Savings
06-08-2025 10:31,ANZC739AEF293FA4E93A593,012-345-678,11111111,TAFE BOOKSHOP ANZ,36.06,0,136588.55,DR,REF367490,ANZ,Savings
06-08-2025 10:46,ANZ4C17C132605449D2963F,012-345-678,11111111,PAYPAL *NETFLIX ANZ,52.86,0,136535.69,DR,REF665464,ANZ,Savings
06-08-2025 10:54,ANZC677750DBEA7494D8DDE,012-345-678,11111111,RAILWAY STATION ANZ,44.74,0,136490.95,DR,REF588238,ANZ,Savings
06-08-2025 11:00,ANZ52BB1F1A6EAE47308A2E,012-345-678,11111111,INTERNET TRANSFER ANZ,6.82,0,136484.13,DR,REF247684,ANZ,Savings
06-08-2025 11:23,ANZD594BC152DDB46238F03,012-345-678,11111111,COLES ANZ,39.43,0,136444.7,DR,REF959473,ANZ,Savings
06-08-2025 11:25,ANZECDB356984D441099F51,012-345-678,11111111,FLIXBUS ANZ,26.17,0,136418.53,DR,REF202782,ANZ,Savings
06-08-2025 11:42,ANZ1E40C9BB784348099A91,012-345-678,11111111,UBER EATS ANZ,155.92,0,136262.61,DR,REF351480,ANZ,Savings
06-08-2025 12:13,ANZB5316EB6050B491D90EF,012-345-678,11111111,PAY - SALARY ANZ,0,2473.47,138736.08,CR,REF163494,ANZ,Savings
06-08-2025 12:59,ANZ4A37BC443F9345C3B18D,012-345-678,11111111,MCDONALDS ANZ,22.36,0,138713.72,DR,REF645736,ANZ,Savings
06-08-2025 13:09,ANZ43D59FE4CAE44D6E871F,012-345-678,11111111,WOOLWORTHS ANZ,11.63,0,138702.09,DR,REF332935,ANZ,Savings
06-08-2025 13:42,ANZ79FB10E63A7441B2BFB0,012-345-678,11111111,WOOLWORTHS ANZ,34.38,0,138667.71,DR,REF809588,ANZ,Savings
06-08-2025 13:46,ANZ135B826DAAC8497E9DE4,012-345-678,11111111,BWS ANZ,89.05,0,138578.66,DR,REF922190,ANZ,Savings
06-08-2025 13:54,ANZ62F8CB4BE4484605B74C,012-345-678,11111111,MCDONALDS ANZ,40.87,0,138537.79,DR,REF802435,ANZ,Savings
06-08-2025 14:19,INTF431CFFA736C4D119454,012-345-678,11111111,TRANSFER TO NAB 44444444,1541.87,0,136995.92,DR,INT-94759,ANZ,Savings
06-08-2025 14:35,INT235576910BF84BDFBCE8,012-345-678,11111111,TRANSFER FROM NAB 44444444,0,837.61,137833.53,CR,INT-75113,ANZ,Savings
06-08-2025 14:49,ANZE268CC84549B4C939FD7,012-345-678,11111111,INTERNET TRANSFER ANZ,64.22,0,137769.31,DR,REF140007,ANZ,Savings
06-08-2025 15:12,ANZ395189E90D6D481D8DBF,012-345-678,11111111,WOOLWORTHS ANZ,15.98,0,137753.33,DR,REF816654,ANZ,Savings
06-08-2025 15:52,ANZ944FCBD4E4C34F618028,012-345-678,11111111,WAGES CREDIT ANZ,0,3085.64,140838.97,CR,REF173957,ANZ,Savings
06-08-2025 16:15,ANZ2B53EF245C1D4766B9AF,012-345-678,11111111,MENULOG ANZ,42.24,0,140796.73,DR,REF266704,ANZ,Savings
06-08-2025 16:46,ANZ6DBC6C84512A4FC1BEDD,012-345-678,11111111,ZOOM ANZ,12.23,0,140784.5,DR,REF500084,ANZ,Savings
06-08-2025 17:12,ANZA40DEC762AA141518309,012-345-678,11111111,UBER EATS ANZ,44.6,0,140739.9,DR,REF652182,ANZ,Savings
06-08-2025 17:33,ANZ6B7E315650824C239565,012-345-678,11111111,DOMINO'S PIZZA ANZ,9.03,0,140730.87,DR,REF527538,ANZ,Savings
06-08-2025 17:40,ANZ066FBE4831F34B4AB3BD,012-345-678,11111111,SPOTIFY ANZ,3.8,0,140727.07,DR,REF347665,ANZ,Savings
06-08-2025 18:31,ANZ0ABD3B5814DE4A409CFD,012-345-678,11111111,PAY - SALARY ANZ,0,343.53,141070.6,CR,REF430452,ANZ,Savings
06-08-2025 18:43,ANZCABCE1E1FD7846FCA1D6,012-345-678,11111111,RAILWAY STATION ANZ,75.24,0,140995.36,DR,REF990670,ANZ,Savings
06-08-2025 18:53,ANZ065A5E2AC8DC41CEB1CC,012-345-678,11111111,WOOLWORTHS ANZ,152.57,0,140842.79,DR,REF489488,ANZ,Savings
06-08-2025 19:06,INTD3E5ABD865B749F0BD2B,012-345-678,11111111,TRANSFER FROM NAB 44444444,0,657.32,141500.11,CR,INT-83781,ANZ,Savings
06-08-2025 19:09,ANZ454F70735B1548FD9869,012-345-678,11111111,PAY - SALARY ANZ,0,7244.48,148744.59,CR,REF531879,ANZ,Savings
06-08-2025 19:18,ANZBC13DBB76D704945B222,012-345-678,11111111,INTERNET TRANSFER ANZ,17.04,0,148727.55,DR,REF528139,ANZ,Savings
06-08-2025 19:36,ANZAEDFE64FFD2B45059267,012-345-678,11111111,COMPANY PAYROLL ANZ,0,710.81,149438.36,CR,REF719971,ANZ,Savings
06-08-2025 19:39,ANZ382D15EE3B3945AE9F19,012-345-678,11111111,ZOOM ANZ,17.68,0,149420.68,DR,REF182195,ANZ,Savings
06-08-2025 19:42,ANZ0C6F4D589DAB4F3883A0,012-345-678,11111111,7-ELEVEN ANZ,5.25,0,149415.43,DR,REF345171,ANZ,Savings
06-08-2025 19:58,ANZ14C72CAD948948469CE0,012-345-678,11111111,PAY - SALARY ANZ,0,6170.44,155585.87,CR,REF231125,ANZ,Savings
06-08-2025 20:33,ANZ71D7C00521564A1CBEC1,012-345-678,11111111,COMPANY PAYROLL ANZ,0,707.3,156293.17,CR,REF460356,ANZ,Savings
06-08-2025 20:34,ANZEABD301B80C14D5BAD73,012-345-678,11111111,MCDONALDS ANZ,56.7,0,156236.47,DR,REF702222,ANZ,Savings
06-08-2025 20:36,ANZ9125E6532ED040F6ABE4,012-345-678,11111111,AMAZON AU ANZ,16.35,0,156220.12,DR,REF894005,ANZ,Savings
06-08-2025 20:52,ANZ1BDFBCCBECFF442A80C0,012-345-678,11111111,UBER EATS ANZ,165.02,0,156055.1,DR,REF968478,ANZ,Savings
06-08-2025 21:10,ANZ915C645F4BD1454C8804,012-345-678,11111111,COMPANY PAYROLL ANZ,0,5708.17,161763.27,CR,REF158360,ANZ,Savings
06-08-2025 21:13,ANZE046174343F549299FE6,012-345-678,11111111,WAGES CREDIT ANZ,0,816.57,162579.84,CR,REF484859,ANZ,Savings
06-08-2025 21:14,ANZ7DF041585F3F4307ABE1,012-345-678,11111111,ALDI ANZ,32.42,0,162547.42,DR,REF827940,ANZ,Savings
06-08-2025 21:17,ANZ15A6CD1286AC4DB0ACC4,012-345-678,11111111,SHELL ANZ,26.36,0,162521.06,DR,REF123540,ANZ,Savings
06-08-2025 21:25,ANZ790067A332634D949FF7,012-345-678,11111111,PAY - SALARY ANZ,0,1104.55,163625.61,CR,REF630401,ANZ,Savings
06-08-2025 22:19,ANZ58296547B5E04C818D4F,012-345-678,11111111,HARVEY NORMAN ANZ,95.92,0,163529.69,DR,REF396590,ANZ,Savings
06-08-2025 22:22,ANZ8B95C54674B946EFB18F,012-345-678,11111111,SPOTIFY ANZ,76.26,0,163453.43,DR,REF414946,ANZ,Savings
06-08-2025 22:31,ANZ63123E2D17F94688956C,012-345-678,11111111,RAILWAY STATION ANZ,18.97,0,163434.46,DR,REF875710,ANZ,Savings
06-08-2025 23:31,ANZ3B74931E3A8746D29555,012-345-678,11111111,DOMINO'S PIZZA ANZ,55.68,0,163378.78,DR,REF746538,ANZ,Savings
06-08-2025 23:58,ANZ0B0C3B329CCD4CB9AA1F,012-345-678,11111111,CITYLINK ANZ,43.78,0,163335,DR,REF463604,ANZ,Savings
07-08-2025 00:04,ANZ422C128B7AEF40A7AA50,012-345-678,11111111,MENULOG ANZ,20.95,0,163314.05,DR,REF490576,ANZ,Savings
07-08-2025 00:54,ANZA2DC5C18CB17463180E1,012-345-678,11111111,BIGW ANZ,4.24,0,163309.81,DR,REF765805,ANZ,Savings
07-08-2025 01:15,ANZ2309324193B24DB9A0CD,012-345-678,11111111,SHELL ANZ,13.93,0,163295.88,DR,REF162461,ANZ,Savings
07-08-2025 01:23,ANZ2F0DCD05195146A7A856,012-345-678,11111111,MCDONALDS ANZ,2.58,0,163293.3,DR,REF605606,ANZ,Savings
07-08-2025 01:23,ANZA84CF949A21641168B0E,012-345-678,11111111,WOOLWORTHS ANZ,7.67,0,163285.63,DR,REF508823,ANZ,Savings
07-08-2025 01:41,ANZEFDE4669F7C24040BF59,012-345-678,11111111,BWS ANZ,18.21,0,163267.42,DR,REF399356,ANZ,Savings
07-08-2025 02:13,ANZ760F00AD044E45248DC9,012-345-678,11111111,ZOOM ANZ,146.39,0,163121.03,DR,REF929447,ANZ,Savings
07-08-2025 02:27,ANZB801FCDBFB9F45C0ADE7,012-345-678,11111111,SPOTIFY ANZ,20.32,0,163100.71,DR,REF487371,ANZ,Savings
07-08-2025 02:56,ANZF157C860CBFA4D18B090,012-345-678,11111111,AMAZON AU ANZ,6.65,0,163094.06,DR,REF543810,ANZ,Savings
07-08-2025 03:09,ANZ31B44B3FE9B14F8B9AC6,012-345-678,11111111,DOMINO'S PIZZA ANZ,122.75,0,162971.31,DR,REF406441,ANZ,Savings
07-08-2025 03:52,ANZAD6BEE54A1754503B1E2,012-345-678,11111111,BP ANZ,30.76,0,162940.55,DR,REF832545,ANZ,Savings
07-08-2025 03:55,ANZ3B054762AC344AF19CB5,012-345-678,11111111,7-ELEVEN ANZ,110.94,0,162829.61,DR,REF900123,ANZ,Savings
07-08-2025 04:02,ANZA6FE16B64C0948488BCD,012-345-678,11111111,PAYMENT GATEWAY ANZ,37.73,0,162791.88,DR,REF519601,ANZ,Savings
07-08-2025 04:33,ANZ2B431CB8BB024597911F,012-345-678,11111111,CITYLINK ANZ,223.04,0,162568.84,DR,REF388210,ANZ,Savings
07-08-2025 04:57,ANZ5A56311AA51845E3A5C3,012-345-678,11111111,BIGW ANZ,60.28,0,162508.56,DR,REF227145,ANZ,Savings
07-08-2025 04:58,ANZF50313ECCB16411F9158,012-345-678,11111111,RAILWAY STATION ANZ,8.2,0,162500.36,DR,REF909798,ANZ,Savings
07-08-2025 05:19,ANZ131D45DA37BD4A6484C2,012-345-678,11111111,FLIXBUS ANZ,51.73,0,162448.63,DR,REF819702,ANZ,Savings
07-08-2025 05:19,ANZ702236ED6AAE441088DF,012-345-678,11111111,SPOTIFY ANZ,76.88,0,162371.75,DR,REF793429,ANZ,Savings
07-08-2025 05:37,ANZCD4FF771366B480590BA,012-345-678,11111111,SHELL ANZ,11.16,0,162360.59,DR,REF195786,ANZ,Savings
07-08-2025 05:45,ANZDD0ED2B1350A42748D92,012-345-678,11111111,HARVEY NORMAN ANZ,37.32,0,162323.27,DR,REF771981,ANZ,Savings
07-08-2025 06:13,ANZ5BBE56EC12514727BF9F,012-345-678,11111111,COLES ANZ,29.51,0,162293.76,DR,REF736546,ANZ,Savings
07-08-2025 06:23,ANZD244920B24A0435ABCA9,012-345-678,11111111,ZOOM ANZ,5.45,0,162288.31,DR,REF193975,ANZ,Savings
07-08-2025 06:59,INT92781EB710444993A50F,012-345-678,11111111,TRANSFER TO CBA 33333333,212.39,0,162075.92,DR,INT-32848,ANZ,Savings
07-08-2025 07:06,INTD3C1637B0B3E4A9D8E34,012-345-678,11111111,TRANSFER TO NAB 44444444,1416.49,0,160659.43,DR,INT-93035,ANZ,Savings
07-08-2025 07:27,ANZC21138A3908C402DAFD4,012-345-678,11111111,7-ELEVEN ANZ,54.73,0,160604.7,DR,REF763170,ANZ,Savings
07-08-2025 07:29,ANZBC789CA016FC42D78E41,012-345-678,11111111,COLES ANZ,42.07,0,160562.63,DR,REF683767,ANZ,Savings
07-08-2025 07:33,ANZFB3A490B3CAF4C3FA36E,012-345-678,11111111,STARBUCKS ANZ,116.44,0,160446.19,DR,REF717696,ANZ,Savings
07-08-2025 07:46,ANZ89726E2FFECD48C78394,012-345-678,11111111,UBER EATS ANZ,19.91,0,160426.28,DR,REF274896,ANZ,Savings
07-08-2025 07:52,ANZBE13D7F5AB8E40A5BA60,012-345-678,11111111,PAYPAL *NETFLIX ANZ,77.34,0,160348.94,DR,REF616784,ANZ,Savings
07-08-2025 07:52,ANZ68D50A92ECF54500BDE4,012-345-678,11111111,UBER EATS ANZ,40.4,0,160308.54,DR,REF508522,ANZ,Savings
07-08-2025 08:03,ANZD0F91C2F581E40CDBE55,012-345-678,11111111,WOOLWORTHS ANZ,51.82,0,160256.72,DR,REF280014,ANZ,Savings
07-08-2025 08:09,ANZ993DB23F6B1843188B3F,012-345-678,11111111,COMPANY PAYROLL ANZ,0,5830.39,166087.11,CR,REF949588,ANZ,Savings
07-08-2025 08:16,ANZ6552137A4024425E9873,012-345-678,11111111,INTERNET TRANSFER ANZ,20.43,0,166066.68,DR,REF305438,ANZ,Savings
07-08-2025 08:17,ANZ4658AC25D98B4C928B62,012-345-678,11111111,TAFE BOOKSHOP ANZ,10.09,0,166056.59,DR,REF592645,ANZ,Savings
07-08-2025 08:29,ANZ74831E84C80E4931B8CD,012-345-678,11111111,HARVEY NORMAN ANZ,25.44,0,166031.15,DR,REF912570,ANZ,Savings
07-08-2025 08:54,ANZ5220BE84D00E4B84883C,012-345-678,11111111,MENULOG ANZ,93.38,0,165937.77,DR,REF716615,ANZ,Savings
07-08-2025 09:33,ANZ7B0F3A2C0B97454DB868,012-345-678,11111111,DOMINO'S PIZZA ANZ,21.35,0,165916.42,DR,REF581946,ANZ,Savings
07-08-2025 09:42,ANZA2912359644B4A829F52,012-345-678,11111111,SALARY PAYMENT ANZ,0,4433.18,170349.6,CR,REF597073,ANZ,Savings
07-08-2025 10:42,ANZ407D1D87BE9A46879B6F,012-345-678,11111111,UBER EATS ANZ,44.38,0,170305.22,DR,REF220256,ANZ,Savings
07-08-2025 10:45,ANZ3F331DECAB4945239227,012-345-678,11111111,AMAZON AU ANZ,189.32,0,170115.9,DR,REF351922,ANZ,Savings
07-08-2025 10:53,ANZ431169BA00B84E508C8B,012-345-678,11111111,PAYPAL *NETFLIX ANZ,17.4,0,170098.5,DR,REF985156,ANZ,Savings
07-08-2025 11:02,ANZ6418D5517CF140729033,012-345-678,11111111,STARBUCKS ANZ,5.09,0,170093.41,DR,REF933877,ANZ,Savings
07-08-2025 11:08,ANZA1811B499B6E483F9EAF,012-345-678,11111111,STARBUCKS ANZ,56.72,0,170036.69,DR,REF131467,ANZ,Savings
07-08-2025 11:37,ANZD8ED20B880DF4F598315,012-345-678,11111111,WAGES CREDIT ANZ,0,7509.14,177545.83,CR,REF329721,ANZ,Savings
07-08-2025 11:43,ANZD8BDF100CFA74538B012,012-345-678,11111111,BIGW ANZ,39.29,0,177506.54,DR,REF870115,ANZ,Savings
07-08-2025 11:44,INT809D2B77139C41AF8561,012-345-678,11111111,TRANSFER TO CBA 22222222,434.2,0,177072.34,DR,INT-68592,ANZ,Savings
07-08-2025 11:45,ANZE95B13A0407C4010BFA2,012-345-678,11111111,APPLE ANZ,57.14,0,177015.2,DR,REF975403,ANZ,Savings
07-08-2025 11:52,ANZ2921BDC3BD8A4174905F,012-345-678,11111111,UBER EATS ANZ,98.01,0,176917.19,DR,REF680730,ANZ,Savings
07-08-2025 12:15,ANZCF681B04CE084C2AA698,012-345-678,11111111,STARBUCKS ANZ,117.78,0,176799.41,DR,REF453421,ANZ,Savings
07-08-2025 12:19,ANZ6B218BC843F640E09957,012-345-678,11111111,DOMINO'S PIZZA ANZ,10.75,0,176788.66,DR,REF401658,ANZ,Savings
07-08-2025 12:29,ANZ93ED1E6D394A427CB21D,012-345-678,11111111,MENULOG ANZ,38.45,0,176750.21,DR,REF715251,ANZ,Savings
07-08-2025 12:41,ANZ346E787EF1EE4BC796B6,012-345-678,11111111,PAYROLL CREDIT ANZ,0,116.57,176866.78,CR,REF782797,ANZ,Savings
07-08-2025 12:46,INT2A7B88B1D54343468B9A,012-345-678,11111111,TRANSFER TO CBA 33333333,1812.46,0,175054.32,DR,INT-61577,ANZ,Savings
07-08-2025 12:51,ANZ709B274A65FE46CFA67B,012-345-678,11111111,CITYLINK ANZ,79.4,0,174974.92,DR,REF855155,ANZ,Savings
07-08-2025 13:14,ANZFEE896934BEA4E1AB4F0,012-345-678,11111111,UBER EATS ANZ,13.47,0,174961.45,DR,REF885951,ANZ,Savings
07-08-2025 13:29,ANZ5C1268723F994ED798FC,012-345-678,11111111,COLES ANZ,34.29,0,174927.16,DR,REF170037,ANZ,Savings
07-08-2025 13:55,ANZ1BFACCC01A234626AEF5,012-345-678,11111111,WAGES CREDIT ANZ,0,7224.91,182152.07,CR,REF947787,ANZ,Savings
07-08-2025 14:29,ANZCFBD16D7ED574AFE808F,012-345-678,11111111,COMPANY PAYROLL ANZ,0,2798.43,184950.5,CR,REF865722,ANZ,Savings
07-08-2025 14:30,ANZ3859B0383E074B749731,012-345-678,11111111,APPLE ANZ,41.96,0,184908.54,DR,REF619064,ANZ,Savings
07-08-2025 15:05,ANZAFA909E4F6E542E8AD3F,012-345-678,11111111,APPLE ANZ,34.26,0,184874.28,DR,REF279124,ANZ,Savings
07-08-2025 15:07,ANZ9B0C5F1368FB4F0795BA,012-345-678,11111111,ALDI ANZ,35.19,0,184839.09,DR,REF335216,ANZ,Savings
07-08-2025 15:15,ANZ1B9B356E6A254B2CBE1E,012-345-678,11111111,JB HI-FI ANZ,76.92,0,184762.17,DR,REF714543,ANZ,Savings
07-08-2025 15:16,ANZ12994354FD5F4051B1E7,012-345-678,11111111,AMAZON AU ANZ,57.4,0,184704.77,DR,REF852632,ANZ,Savings
07-08-2025 15:30,ANZB0DEA74B808541059C83,012-345-678,11111111,INTERNET TRANSFER ANZ,55.94,0,184648.83,DR,REF685693,ANZ,Savings
07-08-2025 15:55,ANZ2B76B904F14B4B89B352,012-345-678,11111111,BP ANZ,29.3,0,184619.53,DR,REF269941,ANZ,Savings
07-08-2025 15:59,ANZF448474E93EE440BA39E,012-345-678,11111111,BIGW ANZ,19.23,0,184600.3,DR,REF421404,ANZ,Savings
07-08-2025 16:13,ANZ1BDE4E3BA1C4496AA035,012-345-678,11111111,HARVEY NORMAN ANZ,45.15,0,184555.15,DR,REF661365,ANZ,Savings
07-08-2025 17:00,ANZ3C56AD94420D4294B888,012-345-678,11111111,CITYLINK ANZ,53.87,0,184501.28,DR,REF743825,ANZ,Savings
07-08-2025 17:12,ANZE86CE56B6C5D47088B5C,012-345-678,11111111,PAYPAL *NETFLIX ANZ,7.36,0,184493.92,DR,REF817777,ANZ,Savings
07-08-2025 17:20,ANZAFE0BB6B518E475CB030,012-345-678,11111111,BWS ANZ,69.93,0,184423.99,DR,REF687143,ANZ,Savings
07-08-2025 18:34,ANZB84BCD7D2D844672BF11,012-345-678,11111111,RAILWAY STATION ANZ,18.96,0,184405.03,DR,REF450047,ANZ,Savings
07-08-2025 18:51,ANZ8921AC62B2B4471FAC96,012-345-678,11111111,BWS ANZ,34.13,0,184370.9,DR,REF967911,ANZ,Savings
07-08-2025 19:08,ANZ152DF4937D394EBD99D7,012-345-678,11111111,BP ANZ,39.83,0,184331.07,DR,REF253019,ANZ,Savings
07-08-2025 19:34,ANZAC26868AD3624AD29A30,012-345-678,11111111,ZOOM ANZ,44.33,0,184286.74,DR,REF854307,ANZ,Savings
07-08-2025 20:10,ANZ2BF2B3F1D83346F8AFEA,012-345-678,11111111,BWS ANZ,50.29,0,184236.45,DR,REF506671,ANZ,Savings
07-08-2025 20:23,INTA372CF048F01486A9259,012-345-678,11111111,TRANSFER FROM CBA 33333333,0,254.58,184491.03,CR,INT-78509,ANZ,Savings
07-08-2025 20:28,ANZB6DBE66230B9493EA4C7,012-345-678,11111111,BP ANZ,76.35,0,184414.68,DR,REF797585,ANZ,Savings
07-08-2025 20:30,ANZ4AF32ED3F5644B26AE09,012-345-678,11111111,WAGES CREDIT ANZ,0,182.87,184597.55,CR,REF277864,ANZ,Savings
07-08-2025 20:33,ANZ73942FC164E74FDB93ED,012-345-678,11111111,ALDI ANZ,6.65,0,184590.9,DR,REF562087,ANZ,Savings
07-08-2025 20:58,ANZ52EC4CC0B60C4CC3BE8B,012-345-678,11111111,DOMINO'S PIZZA ANZ,25.34,0,184565.56,DR,REF216232,ANZ,Savings
07-08-2025 21:01,ANZA837A4DE77444E4FB2B9,012-345-678,11111111,PAYMENT GATEWAY ANZ,188.38,0,184377.18,DR,REF301815,ANZ,Savings
07-08-2025 21:10,ANZ087152C64E264825AFEE,012-345-678,11111111,HARVEY NORMAN ANZ,94.21,0,184282.97,DR,REF973585,ANZ,Savings
07-08-2025 21:23,ANZCF74635BD4904C8283C9,012-345-678,11111111,BP ANZ,35.21,0,184247.76,DR,REF273890,ANZ,Savings
07-08-2025 21:23,ANZ909601ED8FB54FB08E4D,012-345-678,11111111,PAYMENT GATEWAY ANZ,29.7,0,184218.06,DR,REF385614,ANZ,Savings
07-08-2025 21:26,ANZCE001A411A1C4D978E9B,012-345-678,11111111,SPOTIFY ANZ,14.43,0,184203.63,DR,REF110829,ANZ,Savings
07-08-2025 21:44,ANZ01064836A5BC46F6B688,012-345-678,11111111,UBER EATS ANZ,28.26,0,184175.37,DR,REF834263,ANZ,Savings
07-08-2025 22:27,ANZA91BB970C0D143BC8FDC,012-345-678,11111111,COLES ANZ,29.34,0,184146.03,DR,REF121686,ANZ,Savings
07-08-2025 22:48,ANZ88E61BFFA2024D748B17,012-345-678,11111111,ZOOM ANZ,19.35,0,184126.68,DR,REF940165,ANZ,Savings
07-08-2025 22:51,ANZ002CDA82DEE74682B8C1,012-345-678,11111111,HARVEY NORMAN ANZ,125.33,0,184001.35,DR,REF535357,ANZ,Savings
07-08-2025 23:14,ANZ3B060CCDDDE44F52A3F3,012-345-678,11111111,WAGES CREDIT ANZ,0,343.29,184344.64,CR,REF846873,ANZ,Savings
07-08-2025 23:30,ANZD13EF20D4CC84096B007,012-345-678,11111111,SHELL ANZ,71.74,0,184272.9,DR,REF661562,ANZ,Savings
07-08-2025 23:31,ANZ16D86D7528154B748F8C,012-345-678,11111111,CITYLINK ANZ,36.81,0,184236.09,DR,REF553134,ANZ,Savings
07-08-2025 23:35,ANZ69A9F1FB733D43AAA59B,012-345-678,11111111,COMPANY PAYROLL ANZ,0,2199.89,186435.98,CR,REF445568,ANZ,Savings
08-08-2025 00:15,ANZ92EBDAA0D6F345D6B84A,012-345-678,11111111,ALDI ANZ,37.13,0,186398.85,DR,REF372326,ANZ,Savings
08-08-2025 00:58,ANZ9A520BEE8CAC4895BEB9,012-345-678,11111111,TAFE BOOKSHOP ANZ,84.53,0,186314.32,DR,REF965315,ANZ,Savings
08-08-2025 01:07,ANZDCE633974BE643B08EDA,012-345-678,11111111,SPOTIFY ANZ,113.84,0,186200.48,DR,REF749262,ANZ,Savings
08-08-2025 01:20,ANZ7942451DA9D4489BAB2A,012-345-678,11111111,ALDI ANZ,153.4,0,186047.08,DR,REF976569,ANZ,Savings
08-08-2025 02:00,ANZ24BBF5550F054480897F,012-345-678,11111111,AMAZON AU ANZ,91.45,0,185955.63,DR,REF861469,ANZ,Savings
08-08-2025 02:33,INT0668FBFBBA044FD19ACD,012-345-678,11111111,TRANSFER TO CBA 33333333,999.09,0,184956.54,DR,INT-37816,ANZ,Savings
08-08-2025 02:57,ANZE63A945E2B904E18A88D,012-345-678,11111111,HARVEY NORMAN ANZ,82.42,0,184874.12,DR,REF326395,ANZ,Savings
08-08-2025 03:12,INT740D5658861946DFA063,012-345-678,11111111,TRANSFER FROM CBA 33333333,0,1973.38,186847.5,CR,INT-30984,ANZ,Savings
08-08-2025 03:26,ANZ7D93EDB91D2C41FABC4D,012-345-678,11111111,SHELL ANZ,12.88,0,186834.62,DR,REF623079,ANZ,Savings
08-08-2025 04:18,ANZA47AF84076BF4020B055,012-345-678,11111111,WOOLWORTHS ANZ,48.97,0,186785.65,DR,REF978083,ANZ,Savings
08-08-2025 04:34,ANZ9D9521F82AAB45FCA0DA,012-345-678,11111111,WOOLWORTHS ANZ,95.38,0,186690.27,DR,REF199929,ANZ,Savings
08-08-2025 05:34,ANZ47693804CAD64C9EA5E0,012-345-678,11111111,FLIXBUS ANZ,21.71,0,186668.56,DR,REF808469,ANZ,Savings
08-08-2025 05:36,ANZD8C050DE94664C348D77,012-345-678,11111111,7-ELEVEN ANZ,149.99,0,186518.57,DR,REF236140,ANZ,Savings
08-08-2025 06:22,ANZC1B33A65E2754C98B55C,012-345-678,11111111,SHELL ANZ,98.67,0,186419.9,DR,REF533126,ANZ,Savings
08-08-2025 07:02,ANZ8A8E61FF83D34443BCAA,012-345-678,11111111,COMPANY PAYROLL ANZ,0,975.6,187395.5,CR,REF268616,ANZ,Savings
08-08-2025 07:05,ANZFAE4E07C1FEE47A3B0D5,012-345-678,11111111,WOOLWORTHS ANZ,26.36,0,187369.14,DR,REF187675,ANZ,Savings
08-08-2025 08:13,ANZ5859A1F43E08439983A1,012-345-678,11111111,STARBUCKS ANZ,4.09,0,187365.05,DR,REF179337,ANZ,Savings
08-08-2025 08:25,ANZ1BDB1657A22B4BFAB07D,012-345-678,11111111,SHELL ANZ,37.78,0,187327.27,DR,REF908286,ANZ,Savings
08-08-2025 08:27,ANZ574E76D7845C4FF697B7,012-345-678,11111111,DOMINO'S PIZZA ANZ,12.13,0,187315.14,DR,REF618116,ANZ,Savings
08-08-2025 08:30,ANZ146AA436105B44D68ED3,012-345-678,11111111,UBER EATS ANZ,100.34,0,187214.8,DR,REF148329,ANZ,Savings
08-08-2025 08:48,ANZ6B6B0BC32515441F9B15,012-345-678,11111111,WAGES CREDIT ANZ,0,6924.63,194139.43,CR,REF914057,ANZ,Savings
08-08-2025 08:57,ANZC06046E32E5C45C5A79C,012-345-678,11111111,LIQUORLAND ANZ,2.9,0,194136.53,DR,REF311743,ANZ,Savings
08-08-2025 09:44,ANZFEDA544A4B6C469585E5,012-345-678,11111111,DOMINO'S PIZZA ANZ,178.2,0,193958.33,DR,REF330602,ANZ,Savings
08-08-2025 09:56,ANZ76694A6E68D14244A4CA,012-345-678,11111111,TAFE BOOKSHOP ANZ,11.81,0,193946.52,DR,REF205411,ANZ,Savings
08-08-2025 10:01,ANZ74FDA23FB50D4F84A769,012-345-678,11111111,INTERNET TRANSFER ANZ,62.88,0,193883.64,DR,REF402269,ANZ,Savings
08-08-2025 10:14,ANZ42BAB503DA1F49218E95,012-345-678,11111111,WAGES CREDIT ANZ,0,6626.78,200510.42,CR,REF832836,ANZ,Savings
08-08-2025 10:20,INT9305427B8AE84994B3B2,012-345-678,11111111,TRANSFER FROM NAB 44444444,0,1417.2,201927.62,CR,INT-68202,ANZ,Savings
08-08-2025 10:28,ANZAFD149DCA3584E4C8996,012-345-678,11111111,APPLE ANZ,14.11,0,201913.51,DR,REF618034,ANZ,Savings
08-08-2025 10:39,ANZ8FA5C3B172EB4C9FA3D6,012-345-678,11111111,MCDONALDS ANZ,169.04,0,201744.47,DR,REF435021,ANZ,Savings
08-08-2025 10:41,ANZ65B5AA9D90694AEAB663,012-345-678,11111111,KFC ANZ,177.12,0,201567.35,DR,REF636141,ANZ,Savings
08-08-2025 10:51,ANZ8AFAE99B292E43A39676,012-345-678,11111111,AMAZON AU ANZ,28.99,0,201538.36,DR,REF316991,ANZ,Savings
08-08-2025 11:11,ANZ9202E4E161624892886C,012-345-678,11111111,MCDONALDS ANZ,72.55,0,201465.81,DR,REF262605,ANZ,Savings
08-08-2025 11:14,ANZD1C79A4D24894ADD90A6,012-345-678,11111111,BWS ANZ,18.24,0,201447.57,DR,REF253426,ANZ,Savings
08-08-2025 11:48,ANZ8BB1E447375441D59588,012-345-678,11111111,ALDI ANZ,30,0,201417.57,DR,REF531333,ANZ,Savings
08-08-2025 11:50,ANZ43BA7849995C45AFAFDB,012-345-678,11111111,PAY - SALARY ANZ,0,3374.58,204792.15,CR,REF512284,ANZ,Savings
08-08-2025 12:38,ANZ44EDEC87E348408AAADE,012-345-678,11111111,7-ELEVEN ANZ,45.33,0,204746.82,DR,REF853680,ANZ,Savings
08-08-2025 12:38,ANZ6FA23D2A254048E5B23C,012-345-678,11111111,MCDONALDS ANZ,49.07,0,204697.75,DR,REF444086,ANZ,Savings
08-08-2025 13:22,ANZA98AED665E054ED2A0E0,012-345-678,11111111,BP ANZ,22.65,0,204675.1,DR,REF835463,ANZ,Savings
08-08-2025 13:27,ANZA9EDADF1A8CE4FBEB0E5,012-345-678,11111111,UBER EATS ANZ,91.43,0,204583.67,DR,REF587812,ANZ,Savings
08-08-2025 14:07,ANZ33E5FA6E49A7473B8EDE,012-345-678,11111111,BP ANZ,163.27,0,204420.4,DR,REF276202,ANZ,Savings
08-08-2025 14:09,ANZ7FD3C78E72B1474BB3EE,012-345-678,11111111,APPLE ANZ,19.91,0,204400.49,DR,REF836431,ANZ,Savings
08-08-2025 14:13,ANZDF772FE64C644465BEAA,012-345-678,11111111,BWS ANZ,42.09,0,204358.4,DR,REF176792,ANZ,Savings
08-08-2025 14:13,ANZ62BFC3D215DD40F2B81C,012-345-678,11111111,BIGW ANZ,72.49,0,204285.91,DR,REF317810,ANZ,Savings
08-08-2025 14:37,ANZ8D86F1DB8CC44711ACA2,012-345-678,11111111,WAGES CREDIT ANZ,0,6283.06,210568.97,CR,REF410485,ANZ,Savings
08-08-2025 14:37,ANZF07D3BD993464CEA8713,012-345-678,11111111,COMPANY PAYROLL ANZ,0,4870.8,215439.77,CR,REF736649,ANZ,Savings
08-08-2025 14:42,ANZC2B749A87D4F46C3AAD9,012-345-678,11111111,PAY - SALARY ANZ,0,4786.12,220225.89,CR,REF256697,ANZ,Savings
08-08-2025 14:52,ANZCF0E301792FE4C17B697,012-345-678,11111111,HARVEY NORMAN ANZ,3.71,0,220222.18,DR,REF396862,ANZ,Savings
08-08-2025 15:03,ANZ8E9DEE6D8D414F4185B4,012-345-678,11111111,PAYMENT GATEWAY ANZ,47.27,0,220174.91,DR,REF960395,ANZ,Savings
08-08-2025 15:44,INT90D1286B4ED1459193B4,012-345-678,11111111,TRANSFER FROM CBA 33333333,0,1771,221945.91,CR,INT-67996,ANZ,Savings
08-08-2025 15:56,ANZ93DF2FF474F84351BC7A,012-345-678,11111111,ZOOM ANZ,32.46,0,221913.45,DR,REF948104,ANZ,Savings
08-08-2025 16:14,ANZ457CAC9CFD2D4D6A9C0B,012-345-678,11111111,UBER EATS ANZ,72.06,0,221841.39,DR,REF430252,ANZ,Savings
08-08-2025 16:34,ANZC07FFC3367C04BF98A6A,012-345-678,11111111,BIGW ANZ,28.34,0,221813.05,DR,REF875317,ANZ,Savings
08-08-2025 16:55,ANZ8E642C1956B543FAB9D7,012-345-678,11111111,AMAZON AU ANZ,49.88,0,221763.17,DR,REF723879,ANZ,Savings
08-08-2025 17:04,ANZDAB65BB7B34E49CB8EED,012-345-678,11111111,HARVEY NORMAN ANZ,16.15,0,221747.02,DR,REF341232,ANZ,Savings
08-08-2025 17:25,ANZ629256E7DAF74BE4A0CF,012-345-678,11111111,ZOOM ANZ,20.89,0,221726.13,DR,REF598914,ANZ,Savings
08-08-2025 17:42,ANZF7A12FC1A45B4089928C,012-345-678,11111111,CITYLINK ANZ,53.29,0,221672.84,DR,REF759461,ANZ,Savings
08-08-2025 17:53,ANZ849222D8334549F3AC8A,012-345-678,11111111,BWS ANZ,92.89,0,221579.95,DR,REF416677,ANZ,Savings
08-08-2025 19:07,ANZA4C61B2C179A4856A652,012-345-678,11111111,PAYROLL CREDIT ANZ,0,6264.96,227844.91,CR,REF909868,ANZ,Savings
08-08-2025 19:29,ANZ46C72634BD8F4719907C,012-345-678,11111111,RAILWAY STATION ANZ,49.57,0,227795.34,DR,REF862502,ANZ,Savings
08-08-2025 20:10,ANZ3DD18985F9FB43EB8BEA,012-345-678,11111111,BWS ANZ,39.28,0,227756.06,DR,REF693055,ANZ,Savings
08-08-2025 20:31,ANZ551E224B3E3A47B48CE3,012-345-678,11111111,PAYPAL *NETFLIX ANZ,173.07,0,227582.99,DR,REF217474,ANZ,Savings
08-08-2025 20:56,ANZ8C03EE8F267B422792CE,012-345-678,11111111,INTERNET TRANSFER ANZ,33.82,0,227549.17,DR,REF865557,ANZ,Savings
08-08-2025 20:58,ANZ541B5CDD5C8149FD9389,012-345-678,11111111,TAFE BOOKSHOP ANZ,23.92,0,227525.25,DR,REF718475,ANZ,Savings
08-08-2025 21:32,ANZ3B41C041DF6C41738943,012-345-678,11111111,WOOLWORTHS ANZ,112.12,0,227413.13,DR,REF834818,ANZ,Savings
08-08-2025 21:38,ANZ1AE6B7C2D73D400482A0,012-345-678,11111111,PAYPAL *NETFLIX ANZ,38.14,0,227374.99,DR,REF745403,ANZ,Savings
08-08-2025 22:32,ANZ1BBD90CAF78D463088E0,012-345-678,11111111,COMPANY PAYROLL ANZ,0,982.05,228357.04,CR,REF476196,ANZ,Savings
08-08-2025 22:54,ANZD88698B3B4E146519890,012-345-678,11111111,SALARY PAYMENT ANZ,0,6850.19,235207.23,CR,REF107312,ANZ,Savings
09-08-2025 00:11,ANZ0F954FACF1554E3482E4,012-345-678,11111111,FLIXBUS ANZ,5.69,0,235201.54,DR,REF133859,ANZ,Savings
09-08-2025 00:17,ANZAF0D57DAFC834D0187F4,012-345-678,11111111,INTERNET TRANSFER ANZ,42.11,0,235159.43,DR,REF859689,ANZ,Savings
09-08-2025 00:32,ANZ450301C601CF41749BA7,012-345-678,11111111,HARVEY NORMAN ANZ,12.82,0,235146.61,DR,REF796204,ANZ,Savings
09-08-2025 00:40,ANZ4428BE333C8A46699F83,012-345-678,11111111,AMAZON AU ANZ,136.93,0,235009.68,DR,REF185190,ANZ,Savings
09-08-2025 00:45,ANZ21E439B98DF4451BBACA,012-345-678,11111111,AMAZON AU ANZ,60.62,0,234949.06,DR,REF457246,ANZ,Savings
09-08-2025 00:50,ANZE5BD9659B56B457EA5F7,012-345-678,11111111,STARBUCKS ANZ,29.81,0,234919.25,DR,REF863033,ANZ,Savings
09-08-2025 00:51,ANZ8173F203CD554751A7DB,012-345-678,11111111,WOOLWORTHS ANZ,2.84,0,234916.41,DR,REF786037,ANZ,Savings
09-08-2025 01:21,ANZ4A5DFD416D3A44148FCE,012-345-678,11111111,BWS ANZ,32.88,0,234883.53,DR,REF594488,ANZ,Savings
09-08-2025 01:28,ANZD97A279BD13D401AA09A,012-345-678,11111111,RAILWAY STATION ANZ,5.02,0,234878.51,DR,REF393532,ANZ,Savings
09-08-2025 02:18,ANZBE48B93CAE574F488BEE,012-345-678,11111111,BP ANZ,99.57,0,234778.94,DR,REF313894,ANZ,Savings
09-08-2025 02:19,ANZ50307A97851E4B76B4C9,012-345-678,11111111,JB HI-FI ANZ,106.93,0,234672.01,DR,REF895756,ANZ,Savings
09-08-2025 02:35,ANZBB2813C65F1D490ABCED,012-345-678,11111111,UBER EATS ANZ,38.1,0,234633.91,DR,REF360991,ANZ,Savings
09-08-2025 02:44,ANZ7094F9295B5940E4B7B6,012-345-678,11111111,WAGES CREDIT ANZ,0,3892.72,238526.63,CR,REF177258,ANZ,Savings
09-08-2025 03:04,ANZCEE55789010B4FA1A66C,012-345-678,11111111,BANK FEE ANZ,98.67,0,238427.96,DR,REF580789,ANZ,Savings
09-08-2025 03:41,ANZ64923FF65CCC41A9B65B,012-345-678,11111111,RAILWAY STATION ANZ,86.01,0,238341.95,DR,REF460432,ANZ,Savings
09-08-2025 04:15,ANZ830E87FD94B04DD4AB91,012-345-678,11111111,RAILWAY STATION ANZ,10.94,0,238331.01,DR,REF821605,ANZ,Savings
09-08-2025 04:26,ANZ0D8712DAE6A446BCB62F,012-345-678,11111111,PAYMENT GATEWAY ANZ,51.44,0,238279.57,DR,REF744464,ANZ,Savings
09-08-2025 04:29,ANZ0DE881AD7836469E9832,012-345-678,11111111,WOOLWORTHS ANZ,23.16,0,238256.41,DR,REF674972,ANZ,Savings
09-08-2025 04:31,ANZF3818E9C81744B24BD7D,012-345-678,11111111,PAYMENT GATEWAY ANZ,108.4,0,238148.01,DR,REF839051,ANZ,Savings
09-08-2025 04:40,ANZ41C48905E7664788BFFC,012-345-678,11111111,STARBUCKS ANZ,10.91,0,238137.1,DR,REF173050,ANZ,Savings
09-08-2025 05:21,ANZ3B76E9312FE74FC9ABBE,012-345-678,11111111,SHELL ANZ,92.08,0,238045.02,DR,REF518813,ANZ,Savings
09-08-2025 05:28,ANZF6F7DC135D6441B5B976,012-345-678,11111111,AMAZON AU ANZ,12.78,0,238032.24,DR,REF812366,ANZ,Savings
09-08-2025 05:47,ANZD66F0465D3AF4E4CB2F8,012-345-678,11111111,RAILWAY STATION ANZ,6.58,0,238025.66,DR,REF503682,ANZ,Savings
09-08-2025 06:05,INT4C76FB9E6BCF489981E2,012-345-678,11111111,TRANSFER FROM CBA 22222222,0,912.15,238937.81,CR,INT-56045,ANZ,Savings
09-08-2025 06:06,INT4E79B37247334C93B668,012-345-678,11111111,TRANSFER FROM NAB 44444444,0,284.47,239222.28,CR,INT-47041,ANZ,Savings
09-08-2025 06:12,ANZA3C0C98027DD433DB2A9,012-345-678,11111111,JB HI-FI ANZ,95.32,0,239126.96,DR,REF975961,ANZ,Savings
09-08-2025 06:26,ANZ3B22E7CCF6004A93B01C,012-345-678,11111111,FLIXBUS ANZ,5.47,0,239121.49,DR,REF601285,ANZ,Savings
09-08-2025 06:42,ANZ059C42C9F42D463DA5CB,012-345-678,11111111,APPLE ANZ,101.36,0,239020.13,DR,REF908087,ANZ,Savings
09-08-2025 06:57,ANZD4FAD6E1B1E048B8868A,012-345-678,11111111,INTERNET TRANSFER ANZ,19.44,0,239000.69,DR,REF312510,ANZ,Savings
09-08-2025 07:55,ANZ06489133FD604B0C9127,012-345-678,11111111,AMAZON AU ANZ,60.66,0,238940.03,DR,REF593717,ANZ,Savings
09-08-2025 08:00,ANZDF495976B0654EB3A1CD,012-345-678,11111111,ALDI ANZ,36.55,0,238903.48,DR,REF563386,ANZ,Savings
09-08-2025 08:27,ANZ8BDBB01798F8468B81EB,012-345-678,11111111,BWS ANZ,13.94,0,238889.54,DR,REF173685,ANZ,Savings
09-08-2025 08:35,ANZ35F7F2CEEC3B44A78B2F,012-345-678,11111111,ZOOM ANZ,30.23,0,238859.31,DR,REF127895,ANZ,Savings
09-08-2025 08:45,ANZ80C8B04A3AAD4AF791CD,012-345-678,11111111,UBER EATS ANZ,56.52,0,238802.79,DR,REF937371,ANZ,Savings
09-08-2025 08:50,ANZ22A3A807CCC64B05ACF3,012-345-678,11111111,PAYPAL *NETFLIX ANZ,87.51,0,238715.28,DR,REF686746,ANZ,Savings
09-08-2025 09:00,ANZB556257E8B0D4C70ABB5,012-345-678,11111111,MENULOG ANZ,10.98,0,238704.3,DR,REF482487,ANZ,Savings
09-08-2025 09:43,ANZ900AC1F743B24EF58D92,012-345-678,11111111,COMPANY PAYROLL ANZ,0,7457.79,246162.09,CR,REF349683,ANZ,Savings
09-08-2025 09:44,ANZ228A3AAD0DE149838D7C,012-345-678,11111111,MCDONALDS ANZ,136.88,0,246025.21,DR,REF584169,ANZ,Savings
09-08-2025 09:58,INTA0ACA1909FC0404E8189,012-345-678,11111111,TRANSFER FROM CBA 33333333,0,1554.36,247579.57,CR,INT-92615,ANZ,Savings
09-08-2025 10:04,ANZ7D233B6D9D98442C9BCC,012-345-678,11111111,BP ANZ,45.94,0,247533.63,DR,REF558506,ANZ,Savings
09-08-2025 10:16,ANZ161FDF1F345A44F8A852,012-345-678,11111111,BWS ANZ,3.54,0,247530.09,DR,REF547050,ANZ,Savings
09-08-2025 10:24,ANZ25361E399DC3479B9556,012-345-678,11111111,SPOTIFY ANZ,32.92,0,247497.17,DR,REF634226,ANZ,Savings
09-08-2025 11:03,ANZ3C613E42174C449E93A8,012-345-678,11111111,PAYROLL CREDIT ANZ,0,3282.62,250779.79,CR,REF832830,ANZ,Savings
09-08-2025 11:04,ANZC31EB5EACB8C478C9F66,012-345-678,11111111,SHELL ANZ,7.72,0,250772.07,DR,REF746815,ANZ,Savings
09-08-2025 11:08,ANZFAB86672499F4E619256,012-345-678,11111111,BIGW ANZ,2.33,0,250769.74,DR,REF339693,ANZ,Savings
09-08-2025 11:26,ANZA285EAC15C1241FF9A92,012-345-678,11111111,KFC ANZ,59.64,0,250710.1,DR,REF842578,ANZ,Savings
09-08-2025 11:45,ANZC27E27302E4C487B90F6,012-345-678,11111111,DOMINO'S PIZZA ANZ,117.17,0,250592.93,DR,REF356908,ANZ,Savings
09-08-2025 12:16,ANZ682C126F2C7C44DD8FE4,012-345-678,11111111,ZOOM ANZ,14.84,0,250578.09,DR,REF101751,ANZ,Savings
09-08-2025 12:52,INT8FEB409A213B4BAC836E,012-345-678,11111111,TRANSFER FROM CBA 33333333,0,1046.68,251624.77,CR,INT-39710,ANZ,Savings
09-08-2025 12:53,ANZ3F7559BFFCC048C2822E,012-345-678,11111111,COMPANY PAYROLL ANZ,0,562.38,252187.15,CR,REF384940,ANZ,Savings
09-08-2025 13:04,ANZ193095CEB6A24C41BEC2,012-345-678,11111111,FLIXBUS ANZ,33.46,0,252153.69,DR,REF431649,ANZ,Savings
09-08-2025 13:26,ANZ750633B923E94312AFE7,012-345-678,11111111,LIQUORLAND ANZ,17.52,0,252136.17,DR,REF877694,ANZ,Savings
09-08-2025 13:31,ANZE175C784E48445298EBE,012-345-678,11111111,PAYROLL CREDIT ANZ,0,716.95,252853.12,CR,REF551979,ANZ,Savings
09-08-2025 13:48,ANZ6072E40532C848F5A779,012-345-678,11111111,PAYROLL CREDIT ANZ,0,5565.85,258418.97,CR,REF177093,ANZ,Savings
09-08-2025 14:18,ANZ2C3410D55BD343458395,012-345-678,11111111,INTERNET TRANSFER ANZ,16.54,0,258402.43,DR,REF298136,ANZ,Savings
09-08-2025 14:30,ANZA23DD1C221DA41DC99D6,012-345-678,11111111,FLIXBUS ANZ,22.7,0,258379.73,DR,REF106943,ANZ,Savings
09-08-2025 14:33,ANZ6BE878E75F474046BB96,012-345-678,11111111,HARVEY NORMAN ANZ,52.15,0,258327.58,DR,REF785913,ANZ,Savings
09-08-2025 15:21,ANZFDCE84C1A6CE4FA28523,012-345-678,11111111,SALARY PAYMENT ANZ,0,7324.51,265652.09,CR,REF840985,ANZ,Savings
09-08-2025 15:33,ANZ8338ABEF276646099EF4,012-345-678,11111111,BWS ANZ,7.19,0,265644.9,DR,REF274096,ANZ,Savings
09-08-2025 15:56,ANZ69212E37A13747E1BC58,012-345-678,11111111,RAILWAY STATION ANZ,16.53,0,265628.37,DR,REF278568,ANZ,Savings
09-08-2025 15:59,ANZ6CCDB90FA16D4ADF8417,012-345-678,11111111,JB HI-FI ANZ,59.29,0,265569.08,DR,REF411471,ANZ,Savings
09-08-2025 16:30,ANZ3384C9813FF74EF4BA05,012-345-678,11111111,INTERNET TRANSFER ANZ,12.18,0,265556.9,DR,REF473949,ANZ,Savings
09-08-2025 16:44,ANZDF99D4FC2F564DB5BA94,012-345-678,11111111,JB HI-FI ANZ,7.78,0,265549.12,DR,REF625822,ANZ,Savings
09-08-2025 16:52,ANZ14792F82CB964071B8FA,012-345-678,11111111,PAYPAL *NETFLIX ANZ,62.49,0,265486.63,DR,REF424201,ANZ,Savings
09-08-2025 17:12,ANZ3584CE23E49F4416801B,012-345-678,11111111,LIQUORLAND ANZ,32.87,0,265453.76,DR,REF904647,ANZ,Savings
09-08-2025 17:20,ANZ1992F3E18C3B4FE38D8C,012-345-678,11111111,ZOOM ANZ,35.39,0,265418.37,DR,REF633416,ANZ,Savings
09-08-2025 17:42,ANZC4D3AB5E2FCA486B8848,012-345-678,11111111,RAILWAY STATION ANZ,17.06,0,265401.31,DR,REF102798,ANZ,Savings
09-08-2025 18:23,INT91B2B0FF9C88401FADF2,012-345-678,11111111,TRANSFER FROM NAB 44444444,0,1519.94,266921.25,CR,INT-20661,ANZ,Savings
09-08-2025 18:52,ANZ34123F86BFA34EF09915,012-345-678,11111111,BWS ANZ,16.16,0,266905.09,DR,REF476341,ANZ,Savings
09-08-2025 20:38,ANZ21B8F69D8124431D8812,012-345-678,11111111,BWS ANZ,15.14,0,266889.95,DR,REF754440,ANZ,Savings
09-08-2025 20:51,ANZ3141F98C422A4CEC9DAB,012-345-678,11111111,RAILWAY STATION ANZ,20.63,0,266869.32,DR,REF249182,ANZ,Savings
09-08-2025 21:03,ANZ5897CFD836B445689986,012-345-678,11111111,PAY - SALARY ANZ,0,7073.13,273942.45,CR,REF398949,ANZ,Savings
09-08-2025 21:29,ANZDB632648894840F6BEFE,012-345-678,11111111,FLIXBUS ANZ,25.62,0,273916.83,DR,REF977039,ANZ,Savings
09-08-2025 21:55,ANZ2078D304B5184A7D8ED3,012-345-678,11111111,WAGES CREDIT ANZ,0,6926.9,280843.73,CR,REF482272,ANZ,Savings
09-08-2025 22:03,ANZ8C1C7EBEA02341EA9711,012-345-678,11111111,SPOTIFY ANZ,27.74,0,280815.99,DR,REF479402,ANZ,Savings
09-08-2025 22:06,ANZ4BD4F5A6DF49403A902E,012-345-678,11111111,ALDI ANZ,3,0,280812.99,DR,REF386677,ANZ,Savings
09-08-2025 22:33,ANZ1FD221A8A02A436CB2D7,012-345-678,11111111,FLIXBUS ANZ,27.44,0,280785.55,DR,REF804755,ANZ,Savings
09-08-2025 22:35,ANZF44367360E554B6F86FE,012-345-678,11111111,PAYMENT GATEWAY ANZ,17.59,0,280767.96,DR,REF915771,ANZ,Savings
09-08-2025 22:37,ANZ24EFD050303D4343A107,012-345-678,11111111,BIGW ANZ,82.05,0,280685.91,DR,REF659126,ANZ,Savings
09-08-2025 23:36,ANZ79951E226CB247B1B540,012-345-678,11111111,PAY - SALARY ANZ,0,2588.88,283274.79,CR,REF703436,ANZ,Savings
09-08-2025 23:45,ANZ166A56BF62CA4B39B15F,012-345-678,11111111,LIQUORLAND ANZ,38.97,0,283235.82,DR,REF642321,ANZ,Savings
10-08-2025 00:06,ANZ6728CEE9EF5D455A9115,012-345-678,11111111,LIQUORLAND ANZ,42.49,0,283193.33,DR,REF161172,ANZ,Savings
10-08-2025 00:12,ANZF278C0A237AE4F3FA2FA,012-345-678,11111111,PAYROLL CREDIT ANZ,0,3301.83,286495.16,CR,REF921115,ANZ,Savings
10-08-2025 00:23,ANZ881E042F58D14AD2AC6C,012-345-678,11111111,LIQUORLAND ANZ,10.91,0,286484.25,DR,REF292154,ANZ,Savings
10-08-2025 00:32,ANZBDD83FA0D47A41069B91,012-345-678,11111111,TAFE BOOKSHOP ANZ,6.9,0,286477.35,DR,REF694633,ANZ,Savings
10-08-2025 01:31,ANZD26319EC1A594CA0B1BE,012-345-678,11111111,APPLE ANZ,33.18,0,286444.17,DR,REF139273,ANZ,Savings
10-08-2025 01:48,ANZ3734701EDEB84DABA388,012-345-678,11111111,CITYLINK ANZ,90.84,0,286353.33,DR,REF586038,ANZ,Savings
10-08-2025 01:48,ANZA4E6F7E050D24496A1F2,012-345-678,11111111,JB HI-FI ANZ,13.86,0,286339.47,DR,REF787503,ANZ,Savings
10-08-2025 01:53,ANZBFF8FC58712140F2BE02,012-345-678,11111111,PAY - SALARY ANZ,0,1098.02,287437.49,CR,REF447124,ANZ,Savings
10-08-2025 01:54,ANZ387F28CC3329432EA2D2,012-345-678,11111111,SPOTIFY ANZ,33.7,0,287403.79,DR,REF587732,ANZ,Savings
10-08-2025 02:16,ANZECEA70E973CB4AAEA654,012-345-678,11111111,COLES ANZ,59.17,0,287344.62,DR,REF574350,ANZ,Savings
10-08-2025 02:33,ANZFBD3EB244D74419DBDFC,012-345-678,11111111,7-ELEVEN ANZ,75.52,0,287269.1,DR,REF661894,ANZ,Savings
10-08-2025 02:33,ANZ5CD889A084A74A0EA14F,012-345-678,11111111,PAYPAL *NETFLIX ANZ,152.79,0,287116.31,DR,REF700947,ANZ,Savings
10-08-2025 03:11,ANZAD9C54073DCF45D0988E,012-345-678,11111111,MENULOG ANZ,50.56,0,287065.75,DR,REF963075,ANZ,Savings
10-08-2025 03:29,INTD168ED051CCA4C828BD2,012-345-678,11111111,TRANSFER FROM CBA 33333333,0,1272.41,288338.16,CR,INT-76632,ANZ,Savings
10-08-2025 03:39,ANZ87B30A5489D04DBCAE82,012-345-678,11111111,ZOOM ANZ,152.31,0,288185.85,DR,REF238814,ANZ,Savings
10-08-2025 03:59,ANZ4262932F67104CAFA654,012-345-678,11111111,TAFE BOOKSHOP ANZ,12.21,0,288173.64,DR,REF264030,ANZ,Savings
10-08-2025 04:05,ANZ43D4C6B5CD68408E9020,012-345-678,11111111,BWS ANZ,36.16,0,288137.48,DR,REF783358,ANZ,Savings
10-08-2025 04:06,ANZ80F6E64CF13A4BD18EB8,012-345-678,11111111,HARVEY NORMAN ANZ,80.55,0,288056.93,DR,REF426173,ANZ,Savings
10-08-2025 05:07,ANZ098F7C9B31D446EFAFF6,012-345-678,11111111,STARBUCKS ANZ,60.95,0,287995.98,DR,REF293480,ANZ,Savings
10-08-2025 05:41,ANZADB448F84E254D7887CE,012-345-678,11111111,WAGES CREDIT ANZ,0,5332.81,293328.79,CR,REF364490,ANZ,Savings
10-08-2025 05:45,ANZ4842E548582B4756AD43,012-345-678,11111111,BWS ANZ,123.79,0,293205,DR,REF175736,ANZ,Savings
10-08-2025 05:52,ANZ25CBE510A67541F6A7D3,012-345-678,11111111,FLIXBUS ANZ,116.03,0,293088.97,DR,REF613018,ANZ,Savings
10-08-2025 05:56,ANZB79F664B8955436F80DA,012-345-678,11111111,TAFE BOOKSHOP ANZ,21.13,0,293067.84,DR,REF274560,ANZ,Savings
10-08-2025 06:25,ANZDE053D67C7A94310967A,012-345-678,11111111,SHELL ANZ,66.98,0,293000.86,DR,REF469820,ANZ,Savings
10-08-2025 06:29,ANZ4A52EA45740140EBB956,012-345-678,11111111,KFC ANZ,63.29,0,292937.57,DR,REF317041,ANZ,Savings
10-08-2025 06:32,ANZ2E673AAB995E42EDBBAC,012-345-678,11111111,MENULOG ANZ,265.45,0,292672.12,DR,REF626291,ANZ,Savings
10-08-2025 07:06,ANZ43AA9318E7DE4DF487DB,012-345-678,11111111,UBER EATS ANZ,28.16,0,292643.96,DR,REF583648,ANZ,Savings
10-08-2025 07:39,ANZ6EF035BF322C4CEBBE2C,012-345-678,11111111,AMAZON AU ANZ,51.52,0,292592.44,DR,REF787296,ANZ,Savings
10-08-2025 08:34,ANZ7D6C7517EB6645F0987A,012-345-678,11111111,ZOOM ANZ,144.4,0,292448.04,DR,REF300025,ANZ,Savings
10-08-2025 08:49,ANZ7A3F039411684E8C8C72,012-345-678,11111111,APPLE ANZ,67.84,0,292380.2,DR,REF502737,ANZ,Savings
10-08-2025 09:03,ANZ41704E281D184B03AAF3,012-345-678,11111111,MENULOG ANZ,22.68,0,292357.52,DR,REF871954,ANZ,Savings
10-08-2025 09:15,ANZ239D479E19D64FA1A9D0,012-345-678,11111111,COMPANY PAYROLL ANZ,0,1031.49,293389.01,CR,REF676950,ANZ,Savings
10-08-2025 09:23,ANZ636BD17C2B7A4CEE98D8,012-345-678,11111111,FLIXBUS ANZ,41.67,0,293347.34,DR,REF101461,ANZ,Savings
10-08-2025 09:31,ANZ3A0357CBD34F4D2A9A7F,012-345-678,11111111,JB HI-FI ANZ,32.94,0,293314.4,DR,REF230658,ANZ,Savings
10-08-2025 09:39,ANZ2BBC7902905D45F78978,012-345-678,11111111,MCDONALDS ANZ,58.91,0,293255.49,DR,REF867590,ANZ,Savings
10-08-2025 10:02,ANZ978781A67C064D26A5D1,012-345-678,11111111,ALDI ANZ,28.52,0,293226.97,DR,REF625331,ANZ,Savings
10-08-2025 10:04,ANZE686E7D0197D43D89438,012-345-678,11111111,CITYLINK ANZ,106.7,0,293120.27,DR,REF358050,ANZ,Savings
10-08-2025 10:14,ANZ30ECAC676D2B41C4A0A4,012-345-678,11111111,UBER EATS ANZ,112.37,0,293007.9,DR,REF659862,ANZ,Savings
10-08-2025 10:15,ANZAA16191808214F9EACBF,012-345-678,11111111,LIQUORLAND ANZ,6.7,0,293001.2,DR,REF162411,ANZ,Savings
10-08-2025 10:33,ANZ109B8A88E48F40D39672,012-345-678,11111111,SPOTIFY ANZ,126.43,0,292874.77,DR,REF724017,ANZ,Savings
10-08-2025 10:55,ANZC3CFFE35221341A6AFA5,012-345-678,11111111,INTERNET TRANSFER ANZ,62.42,0,292812.35,DR,REF513995,ANZ,Savings
10-08-2025 11:29,ANZ20D25AE49F4C4F318239,012-345-678,11111111,LIQUORLAND ANZ,58.89,0,292753.46,DR,REF372636,ANZ,Savings
10-08-2025 11:55,ANZ756C3AE0BE3F460A9729,012-345-678,11111111,UBER EATS ANZ,75.14,0,292678.32,DR,REF238768,ANZ,Savings
10-08-2025 12:12,ANZE46AA6CCDED3428E8483,012-345-678,11111111,UBER EATS ANZ,4.35,0,292673.97,DR,REF368557,ANZ,Savings
10-08-2025 12:16,ANZ40E9C688F65D48C680B5,012-345-678,11111111,7-ELEVEN ANZ,29.95,0,292644.02,DR,REF375727,ANZ,Savings
10-08-2025 13:18,ANZA4A76D1A9D7B43738615,012-345-678,11111111,7-ELEVEN ANZ,71.48,0,292572.54,DR,REF922176,ANZ,Savings
10-08-2025 13:46,ANZBA4EE64E7B7D4BDDA9A8,012-345-678,11111111,MCDONALDS ANZ,20.89,0,292551.65,DR,REF793484,ANZ,Savings
10-08-2025 13:54,ANZ32CBB24E792248A080B9,012-345-678,11111111,PAYMENT GATEWAY ANZ,167.1,0,292384.55,DR,REF688074,ANZ,Savings
10-08-2025 14:03,ANZ6CDC8DF746034144AA35,012-345-678,11111111,APPLE ANZ,10.58,0,292373.97,DR,REF311615,ANZ,Savings
10-08-2025 14:08,ANZ70E77A1167664CA1BFF0,012-345-678,11111111,BWS ANZ,93.43,0,292280.54,DR,REF269808,ANZ,Savings
10-08-2025 14:51,ANZ85E57D3344354527B689,012-345-678,11111111,7-ELEVEN ANZ,55.28,0,292225.26,DR,REF270955,ANZ,Savings
10-08-2025 14:53,ANZ98FD410F47384C54B500,012-345-678,11111111,PAYMENT GATEWAY ANZ,33.94,0,292191.32,DR,REF739586,ANZ,Savings
10-08-2025 15:15,ANZ3F18FDAA6B29454C89F3,012-345-678,11111111,STARBUCKS ANZ,44.55,0,292146.77,DR,REF517772,ANZ,Savings
10-08-2025 15:24,ANZ563CA2241CAB4D1C844F,012-345-678,11111111,BIGW ANZ,3.35,0,292143.42,DR,REF589566,ANZ,Savings
10-08-2025 15:27,ANZ66A715AA5C2B44B883EA,012-345-678,11111111,PAY - SALARY ANZ,0,6392.33,298535.75,CR,REF249307,ANZ,Savings
10-08-2025 15:45,ANZEFF8F876860445119A69,012-345-678,11111111,INTERNET TRANSFER ANZ,36.27,0,298499.48,DR,REF844597,ANZ,Savings
10-08-2025 16:11,ANZ8CE3FF127EDB424780D7,012-345-678,11111111,COLES ANZ,17.14,0,298482.34,DR,REF208717,ANZ,Savings
10-08-2025 16:24,ANZA68081C867A34E5882E1,012-345-678,11111111,COMPANY PAYROLL ANZ,0,7326.95,305809.29,CR,REF533234,ANZ,Savings
10-08-2025 17:38,ANZ842219D4C8384665A3CA,012-345-678,11111111,ZOOM ANZ,178.82,0,305630.47,DR,REF845986,ANZ,Savings
10-08-2025 18:47,ANZAACB859B7A1749FD93BD,012-345-678,11111111,COMPANY PAYROLL ANZ,0,3652.88,309283.35,CR,REF934800,ANZ,Savings
10-08-2025 18:58,ANZ19B2C4E1F75A49E3B054,012-345-678,11111111,BANK FEE ANZ,10.54,0,309272.81,DR,REF417963,ANZ,Savings
10-08-2025 19:11,ANZ9B6BD3137813435B8DB6,012-345-678,11111111,TAFE BOOKSHOP ANZ,8.64,0,309264.17,DR,REF631561,ANZ,Savings
10-08-2025 19:18,ANZ936F30D1C2A94394889D,012-345-678,11111111,STARBUCKS ANZ,25.48,0,309238.69,DR,REF226965,ANZ,Savings
10-08-2025 19:45,INT1D48BD89ADA545738191,012-345-678,11111111,TRANSFER TO CBA 33333333,1613.73,0,307624.96,DR,INT-83117,ANZ,Savings
10-08-2025 19:48,ANZ0FD6274E44D0489B88F1,012-345-678,11111111,PAY - SALARY ANZ,0,7328.13,314953.09,CR,REF981246,ANZ,Savings
10-08-2025 20:13,ANZ368F7F4DBB5B425DBDC1,012-345-678,11111111,KFC ANZ,42.66,0,314910.43,DR,REF342472,ANZ,Savings
10-08-2025 20:21,ANZ18FB39E0E4594093B4E4,012-345-678,11111111,WOOLWORTHS ANZ,53.4,0,314857.03,DR,REF399241,ANZ,Savings
10-08-2025 20:43,ANZ710D62DC672441CC9E57,012-345-678,11111111,PAYPAL *NETFLIX ANZ,9.01,0,314848.02,DR,REF764178,ANZ,Savings
10-08-2025 21:00,ANZA934BD1EEE5E489E9016,012-345-678,11111111,COLES ANZ,273.05,0,314574.97,DR,REF559456,ANZ,Savings
10-08-2025 21:17,ANZB07C5F50341D454CA449,012-345-678,11111111,UBER EATS ANZ,196.65,0,314378.32,DR,REF272304,ANZ,Savings
10-08-2025 21:35,ANZ7D0478F902BE425492AF,012-345-678,11111111,BP ANZ,25.19,0,314353.13,DR,REF455276,ANZ,Savings
10-08-2025 21:47,ANZFFDE62658C174BA285ED,012-345-678,11111111,SHELL ANZ,13.14,0,314339.99,DR,REF842492,ANZ,Savings
10-08-2025 21:48,ANZ9F1E2EBD0A5A4B71B7C1,012-345-678,11111111,FLIXBUS ANZ,8.29,0,314331.7,DR,REF435881,ANZ,Savings
10-08-2025 22:29,ANZE6DB0D2A6544494791BB,012-345-678,11111111,LIQUORLAND ANZ,30.19,0,314301.51,DR,REF347602,ANZ,Savings
10-08-2025 22:39,ANZF5AAFB4988CF4DCAA9B5,012-345-678,11111111,PAY - SALARY ANZ,0,4450.53,318752.04,CR,REF393794,ANZ,Savings
10-08-2025 22:50,ANZ59C3ECCD1E1D42F4AE30,012-345-678,11111111,WAGES CREDIT ANZ,0,4297.37,323049.41,CR,REF335716,ANZ,Savings
10-08-2025 22:51,ANZB7A4DCDB70FC4E61A2F5,012-345-678,11111111,ZOOM ANZ,10.13,0,323039.28,DR,REF720027,ANZ,Savings
10-08-2025 23:17,ANZF42F68667229481D8891,012-345-678,11111111,COLES ANZ,86.16,0,322953.12,DR,REF512485,ANZ,Savings
10-08-2025 23:35,ANZ6F087AA1AEF54D589343,012-345-678,11111111,COLES ANZ,84.98,0,322868.14,DR,REF787599,ANZ,Savings
10-08-2025 23:39,ANZF2EDBCA3D50A4AF48C4A,012-345-678,11111111,BANK FEE ANZ,3.42,0,322864.72,DR,REF542666,ANZ,Savings
11-08-2025 00:04,ANZD7BBE3D363684D71A865,012-345-678,11111111,PAYROLL CREDIT ANZ,0,4722.91,327587.63,CR,REF880518,ANZ,Savings
11-08-2025 00:17,ANZ15A8CF9B0EF54F8CB94F,012-345-678,11111111,BIGW ANZ,5.82,0,327581.81,DR,REF850975,ANZ,Savings
11-08-2025 00:33,ANZ516DB30315D7478DA70F,012-345-678,11111111,PAYMENT GATEWAY ANZ,16.03,0,327565.78,DR,REF963368,ANZ,Savings
11-08-2025 00:42,ANZC47480EE70284EF0A3CD,012-345-678,11111111,SHELL ANZ,50.51,0,327515.27,DR,REF567357,ANZ,Savings
11-08-2025 00:49,ANZ760457CF04854DA2BDD3,012-345-678,11111111,WAGES CREDIT ANZ,0,298.03,327813.3,CR,REF252332,ANZ,Savings
11-08-2025 00:50,ANZ0461D1AE8A81434BB474,012-345-678,11111111,KFC ANZ,15.24,0,327798.06,DR,REF314243,ANZ,Savings
11-08-2025 01:28,ANZ8B5B9D1695B946F0A20E,012-345-678,11111111,ZOOM ANZ,9.19,0,327788.87,DR,REF793437,ANZ,Savings
11-08-2025 01:41,ANZ2D872848A6D147E3A0A1,012-345-678,11111111,JB HI-FI ANZ,69.16,0,327719.71,DR,REF341381,ANZ,Savings
11-08-2025 01:55,ANZC4AC5A1649FE4F01BDAA,012-345-678,11111111,JB HI-FI ANZ,52.86,0,327666.85,DR,REF224151,ANZ,Savings
11-08-2025 02:04,ANZ43AE2F4C3E594D0F9D50,012-345-678,11111111,BWS ANZ,65.25,0,327601.6,DR,REF125109,ANZ,Savings
11-08-2025 02:08,ANZF47C858FB6D14A6C83E6,012-345-678,11111111,APPLE ANZ,4.47,0,327597.13,DR,REF486256,ANZ,Savings
11-08-2025 02:14,ANZCA0678E99CF246F2A9E0,012-345-678,11111111,BP ANZ,53.81,0,327543.32,DR,REF610305,ANZ,Savings
11-08-2025 02:36,ANZ407235F18ADA46F9A8B7,012-345-678,11111111,PAYROLL CREDIT ANZ,0,17.23,327560.55,CR,REF661415,ANZ,Savings
11-08-2025 02:38,ANZ9BDA99E9C0914B69B2E8,012-345-678,11111111,TAFE BOOKSHOP ANZ,19.21,0,327541.34,DR,REF499528,ANZ,Savings
11-08-2025 02:45,ANZF2AC7D441E384B54A92E,012-345-678,11111111,AMAZON AU ANZ,118.34,0,327423,DR,REF689566,ANZ,Savings
11-08-2025 02:55,ANZ27C46EC0BF2F4F78A109,012-345-678,11111111,HARVEY NORMAN ANZ,4.78,0,327418.22,DR,REF345845,ANZ,Savings
11-08-2025 03:28,ANZD06BA9B36B59497DA683,012-345-678,11111111,KFC ANZ,3.25,0,327414.97,DR,REF367921,ANZ,Savings
11-08-2025 04:12,ANZ17CB179366AB44488D12,012-345-678,11111111,SPOTIFY ANZ,53.6,0,327361.37,DR,REF968351,ANZ,Savings
11-08-2025 04:37,INT62626635F72143248D6C,012-345-678,11111111,TRANSFER FROM NAB 44444444,0,84.49,327445.86,CR,INT-30504,ANZ,Savings
11-08-2025 04:50,ANZB9BE1582042B41C48429,012-345-678,11111111,BIGW ANZ,241.24,0,327204.62,DR,REF240406,ANZ,Savings
11-08-2025 05:08,ANZ3D6CAA341EAC4FE8A4C1,012-345-678,11111111,MENULOG ANZ,10.87,0,327193.75,DR,REF283463,ANZ,Savings
11-08-2025 05:10,ANZ740EBB33F3C149BD9924,012-345-678,11111111,APPLE ANZ,23.9,0,327169.85,DR,REF914124,ANZ,Savings
11-08-2025 05:11,ANZ61F6F000A1FE4AA1A2C3,012-345-678,11111111,CITYLINK ANZ,16.61,0,327153.24,DR,REF328825,ANZ,Savings
11-08-2025 05:13,ANZ4AA584627ED2444F8952,012-345-678,11111111,SPOTIFY ANZ,17.95,0,327135.29,DR,REF385319,ANZ,Savings
11-08-2025 05:27,ANZC855CDE8656E4A0381D7,012-345-678,11111111,COLES ANZ,57.08,0,327078.21,DR,REF125096,ANZ,Savings
11-08-2025 05:58,ANZEE247A2ECAE249DB93A3,012-345-678,11111111,CITYLINK ANZ,56.35,0,327021.86,DR,REF423019,ANZ,Savings
11-08-2025 06:00,ANZ80E25FBA39314791B9BF,012-345-678,11111111,BP ANZ,149.32,0,326872.54,DR,REF821614,ANZ,Savings
11-08-2025 06:10,ANZ40A376439F6843B89E7C,012-345-678,11111111,MCDONALDS ANZ,7.02,0,326865.52,DR,REF951954,ANZ,Savings
11-08-2025 06:43,ANZBDC77763AD7B4B499C31,012-345-678,11111111,DOMINO'S PIZZA ANZ,6.65,0,326858.87,DR,REF615546,ANZ,Savings
11-08-2025 06:58,ANZA615811886F94B9195C0,012-345-678,11111111,MCDONALDS ANZ,12.32,0,326846.55,DR,REF878841,ANZ,Savings
11-08-2025 07:01,ANZ8450505E2B5B48E98125,012-345-678,11111111,KFC ANZ,49.98,0,326796.57,DR,REF493084,ANZ,Savings
11-08-2025 07:27,INTF0CB1D5F0C1A442CBEDF,012-345-678,11111111,TRANSFER TO NAB 44444444,1036.22,0,325760.35,DR,INT-41446,ANZ,Savings
11-08-2025 07:47,ANZ1576D8E61BB64AE58F66,012-345-678,11111111,TAFE BOOKSHOP ANZ,58.84,0,325701.51,DR,REF105639,ANZ,Savings
11-08-2025 08:02,ANZ82E21C4CBD364FC1BC17,012-345-678,11111111,WAGES CREDIT ANZ,0,2877.54,328579.05,CR,REF456655,ANZ,Savings
11-08-2025 08:09,ANZ94BC64702A3E4FD39521,012-345-678,11111111,PAYPAL *NETFLIX ANZ,68.59,0,328510.46,DR,REF272678,ANZ,Savings
11-08-2025 08:11,ANZEAC99FACCB3F47F5AD0A,012-345-678,11111111,SPOTIFY ANZ,3.23,0,328507.23,DR,REF670065,ANZ,Savings
11-08-2025 08:15,ANZ24BCBA175B724EB1B86D,012-345-678,11111111,FLIXBUS ANZ,88.66,0,328418.57,DR,REF341603,ANZ,Savings
11-08-2025 09:40,ANZ80D98F675D3140A9B73D,012-345-678,11111111,STARBUCKS ANZ,11.96,0,328406.61,DR,REF520502,ANZ,Savings
11-08-2025 09:51,ANZC9737D30992E4F4DBDEB,012-345-678,11111111,WAGES CREDIT ANZ,0,1157.01,329563.62,CR,REF333562,ANZ,Savings
11-08-2025 09:58,ANZFE9ABF518AE14DC481E3,012-345-678,11111111,PAYROLL CREDIT ANZ,0,7841.08,337404.7,CR,REF951910,ANZ,Savings
11-08-2025 10:32,ANZ9E972349189F4EC1BFC7,012-345-678,11111111,TAFE BOOKSHOP ANZ,101.97,0,337302.73,DR,REF314812,ANZ,Savings
11-08-2025 11:13,ANZ88304FED00A64981B0D8,012-345-678,11111111,TAFE BOOKSHOP ANZ,65.78,0,337236.95,DR,REF996415,ANZ,Savings
11-08-2025 11:37,ANZ1DACC4275DA441DBAF81,012-345-678,11111111,BP ANZ,137.22,0,337099.73,DR,REF622569,ANZ,Savings
11-08-2025 11:43,ANZE9201CFD579343478F06,012-345-678,11111111,7-ELEVEN ANZ,70.25,0,337029.48,DR,REF936148,ANZ,Savings
11-08-2025 11:51,ANZ51FDB6E6E80A492A9B40,012-345-678,11111111,SALARY PAYMENT ANZ,0,2043.2,339072.68,CR,REF584265,ANZ,Savings
11-08-2025 12:01,ANZ768E8FBDE8664F668E1D,012-345-678,11111111,STARBUCKS ANZ,31.2,0,339041.48,DR,REF721245,ANZ,Savings
11-08-2025 12:18,ANZ4C56D91D3E6F424386A1,012-345-678,11111111,KFC ANZ,52.41,0,338989.07,DR,REF299472,ANZ,Savings
11-08-2025 12:33,ANZ52D094A432944492A1C6,012-345-678,11111111,INTERNET TRANSFER ANZ,58.83,0,338930.24,DR,REF202859,ANZ,Savings
11-08-2025 12:36,ANZA8EA3742BEB6422DBCE6,012-345-678,11111111,BANK FEE ANZ,24.32,0,338905.92,DR,REF617438,ANZ,Savings
11-08-2025 12:53,ANZECCB7B717C144DD487DA,012-345-678,11111111,BWS ANZ,42.33,0,338863.59,DR,REF736758,ANZ,Savings
11-08-2025 13:15,ANZD203CA1E7B58495CA176,012-345-678,11111111,WOOLWORTHS ANZ,161.44,0,338702.15,DR,REF486033,ANZ,Savings
11-08-2025 13:16,ANZ167F61C16CE04E3EBD65,012-345-678,11111111,LIQUORLAND ANZ,19.53,0,338682.62,DR,REF562142,ANZ,Savings
11-08-2025 13:42,ANZ09DFB45C7A2E4B56BF0E,012-345-678,11111111,PAYROLL CREDIT ANZ,0,431.74,339114.36,CR,REF227354,ANZ,Savings
11-08-2025 13:42,ANZB80BB391FFAC45B5842C,012-345-678,11111111,CITYLINK ANZ,4.39,0,339109.97,DR,REF743146,ANZ,Savings
11-08-2025 14:05,ANZA19D59972A054331AFEB,012-345-678,11111111,AMAZON AU ANZ,100.77,0,339009.2,DR,REF665413,ANZ,Savings
11-08-2025 14:08,ANZDE8AE63E23874931B2A7,012-345-678,11111111,WOOLWORTHS ANZ,6.97,0,339002.23,DR,REF934304,ANZ,Savings
11-08-2025 14:34,ANZ59CACE4AAB284ECC916E,012-345-678,11111111,SHELL ANZ,126.32,0,338875.91,DR,REF479613,ANZ,Savings
11-08-2025 14:49,ANZ46FBADC887964B2B8779,012-345-678,11111111,WAGES CREDIT ANZ,0,1012.4,339888.31,CR,REF324096,ANZ,Savings
11-08-2025 14:49,INTA2CD5662FFDA4F84BDD9,012-345-678,11111111,TRANSFER TO CBA 22222222,1237.19,0,338651.12,DR,INT-86308,ANZ,Savings
11-08-2025 15:15,ANZ7A8613AF12774104BCC7,012-345-678,11111111,RAILWAY STATION ANZ,63.86,0,338587.26,DR,REF493603,ANZ,Savings
11-08-2025 16:04,INT7EE2E0CA83AE41DE8038,012-345-678,11111111,TRANSFER TO NAB 44444444,1379.07,0,337208.19,DR,INT-45757,ANZ,Savings
11-08-2025 16:35,ANZ8419B4B2E31845D1A012,012-345-678,11111111,INTERNET TRANSFER ANZ,15.09,0,337193.1,DR,REF420573,ANZ,Savings
11-08-2025 16:50,ANZ23758BF22E6D4D379154,012-345-678,11111111,ALDI ANZ,2.28,0,337190.82,DR,REF976752,ANZ,Savings
11-08-2025 16:59,ANZA05F083D190A4CC4A9D0,012-345-678,11111111,KFC ANZ,3.04,0,337187.78,DR,REF922697,ANZ,Savings
11-08-2025 17:15,ANZE2B27ADE177E4E24B66A,012-345-678,11111111,SHELL ANZ,45.03,0,337142.75,DR,REF412813,ANZ,Savings
11-08-2025 17:44,ANZ08CCD8402F2A4DBBB53E,012-345-678,11111111,7-ELEVEN ANZ,18.94,0,337123.81,DR,REF751760,ANZ,Savings
11-08-2025 17:53,ANZ05EE4C16665A47D9A254,012-345-678,11111111,ZOOM ANZ,155.89,0,336967.92,DR,REF273455,ANZ,Savings
11-08-2025 19:20,ANZ39213A07891643D49142,012-345-678,11111111,JB HI-FI ANZ,9.43,0,336958.49,DR,REF590095,ANZ,Savings
11-08-2025 19:20,ANZD9FD93C543AC404DA61A,012-345-678,11111111,TAFE BOOKSHOP ANZ,52.38,0,336906.11,DR,REF927938,ANZ,Savings
11-08-2025 20:11,ANZ49207D08702341FB88F2,012-345-678,11111111,PAYPAL *NETFLIX ANZ,6.06,0,336900.05,DR,REF882839,ANZ,Savings
11-08-2025 20:31,ANZ0F517A842B684BD6AD6E,012-345-678,11111111,BANK FEE ANZ,5.1,0,336894.95,DR,REF109065,ANZ,Savings
11-08-2025 21:02,ANZF2EB9CBAE4C3485F8A56,012-345-678,11111111,RAILWAY STATION ANZ,31.39,0,336863.56,DR,REF872139,ANZ,Savings
11-08-2025 21:21,ANZ4753116828084A2583E6,012-345-678,11111111,BP ANZ,11.47,0,336852.09,DR,REF726092,ANZ,Savings
11-08-2025 22:08,ANZADF1A6D71F7043928CAE,012-345-678,11111111,SALARY PAYMENT ANZ,0,5704.06,342556.15,CR,REF283774,ANZ,Savings
11-08-2025 22:11,ANZF1FA0954D85A409AB251,012-345-678,11111111,WOOLWORTHS ANZ,66.61,0,342489.54,DR,REF233967,ANZ,Savings
11-08-2025 22:34,ANZ67080EC72C3146A08C93,012-345-678,11111111,JB HI-FI ANZ,47.89,0,342441.65,DR,REF336402,ANZ,Savings
11-08-2025 22:41,ANZE430036DFF58412C86F2,012-345-678,11111111,KFC ANZ,57.9,0,342383.75,DR,REF996557,ANZ,Savings
11-08-2025 22:49,ANZ699F31E59FA34E119DFA,012-345-678,11111111,FLIXBUS ANZ,9.25,0,342374.5,DR,REF124347,ANZ,Savings
11-08-2025 23:01,ANZ989DCFD9B04A4EDBBDF1,012-345-678,11111111,LIQUORLAND ANZ,20.38,0,342354.12,DR,REF975958,ANZ,Savings
12-08-2025 00:31,ANZ48D888C727C04FE597BF,012-345-678,11111111,SHELL ANZ,31.02,0,342323.1,DR,REF179706,ANZ,Savings
12-08-2025 00:53,ANZ6804876AD15143788650,012-345-678,11111111,MENULOG ANZ,136.41,0,342186.69,DR,REF954017,ANZ,Savings
12-08-2025 01:41,ANZE6FCC7AF082C45FE8D58,012-345-678,11111111,LIQUORLAND ANZ,39.61,0,342147.08,DR,REF270935,ANZ,Savings
12-08-2025 02:02,ANZDE642D11AD364A83AFA9,012-345-678,11111111,BP ANZ,43.32,0,342103.76,DR,REF158554,ANZ,Savings
12-08-2025 02:18,ANZC0786AABA18243A0B0EB,012-345-678,11111111,COMPANY PAYROLL ANZ,0,780.8,342884.56,CR,REF528413,ANZ,Savings
12-08-2025 02:20,ANZ1846ECB68E754B8FB708,012-345-678,11111111,PAYPAL *NETFLIX ANZ,157.7,0,342726.86,DR,REF696834,ANZ,Savings
12-08-2025 02:24,ANZ6E76C5CD24994E1C8DA4,012-345-678,11111111,AMAZON AU ANZ,87.31,0,342639.55,DR,REF571771,ANZ,Savings
12-08-2025 02:52,ANZ7063BE7870674EA08F52,012-345-678,11111111,UBER EATS ANZ,55.84,0,342583.71,DR,REF943066,ANZ,Savings
12-08-2025 02:53,ANZB0AFC59B007B45B59AAB,012-345-678,11111111,COLES ANZ,5.97,0,342577.74,DR,REF126797,ANZ,Savings
12-08-2025 03:41,ANZ5691D67A65834E46B1B9,012-345-678,11111111,HARVEY NORMAN ANZ,3.44,0,342574.3,DR,REF829716,ANZ,Savings
12-08-2025 03:45,ANZE0BBAC9B4FD342ED9A99,012-345-678,11111111,CITYLINK ANZ,28.2,0,342546.1,DR,REF156040,ANZ,Savings
12-08-2025 03:51,ANZDA611DFC653E4EB6A319,012-345-678,11111111,COLES ANZ,193.41,0,342352.69,DR,REF777495,ANZ,Savings
12-08-2025 04:06,ANZB014D926312F489280C0,012-345-678,11111111,FLIXBUS ANZ,41.53,0,342311.16,DR,REF936016,ANZ,Savings
12-08-2025 04:17,ANZ7CA833E3054D46F2B81D,012-345-678,11111111,STARBUCKS ANZ,140.76,0,342170.4,DR,REF595110,ANZ,Savings
12-08-2025 04:40,ANZDA74A1363F004235BA19,012-345-678,11111111,SPOTIFY ANZ,16.03,0,342154.37,DR,REF396949,ANZ,Savings
12-08-2025 04:40,ANZF271414BDD6C4C7A86F3,012-345-678,11111111,APPLE ANZ,74.16,0,342080.21,DR,REF923967,ANZ,Savings
12-08-2025 04:42,ANZBE9AC7807DE9489ABD3C,012-345-678,11111111,APPLE ANZ,104.71,0,341975.5,DR,REF595061,ANZ,Savings
12-08-2025 04:50,ANZC8C1D6617C5440ACAB63,012-345-678,11111111,RAILWAY STATION ANZ,109.9,0,341865.6,DR,REF686744,ANZ,Savings
12-08-2025 05:24,ANZAB543E3947C44001886E,012-345-678,11111111,HARVEY NORMAN ANZ,16.76,0,341848.84,DR,REF976433,ANZ,Savings
12-08-2025 05:35,ANZ1AF6EFCB8F994BAA8E61,012-345-678,11111111,AMAZON AU ANZ,21.97,0,341826.87,DR,REF754559,ANZ,Savings
12-08-2025 06:12,ANZ5ADD74134E09489191B3,012-345-678,11111111,SHELL ANZ,92.71,0,341734.16,DR,REF659606,ANZ,Savings
12-08-2025 06:31,ANZFB92824EE825429B9B81,012-345-678,11111111,7-ELEVEN ANZ,92.43,0,341641.73,DR,REF956946,ANZ,Savings
12-08-2025 06:32,ANZ67F82027077144D6B732,012-345-678,11111111,MCDONALDS ANZ,22.09,0,341619.64,DR,REF333114,ANZ,Savings
12-08-2025 07:07,ANZF93B5B0AA8BA41CFBE02,012-345-678,11111111,STARBUCKS ANZ,8.27,0,341611.37,DR,REF714146,ANZ,Savings
12-08-2025 07:17,ANZD0A38008AC1C42229C21,012-345-678,11111111,BIGW ANZ,89.9,0,341521.47,DR,REF597633,ANZ,Savings
12-08-2025 07:44,INT20CE3B076B1C46AA815F,012-345-678,11111111,TRANSFER FROM CBA 33333333,0,1776.49,343297.96,CR,INT-84203,ANZ,Savings
12-08-2025 08:29,ANZ8BE7CACC18FB42F48E9D,012-345-678,11111111,KFC ANZ,21.88,0,343276.08,DR,REF390154,ANZ,Savings
12-08-2025 08:32,ANZ9F1AF97812DB4EBB9B18,012-345-678,11111111,SPOTIFY ANZ,66.79,0,343209.29,DR,REF742418,ANZ,Savings
12-08-2025 09:47,ANZ3D5FB05C51A846038A5B,012-345-678,11111111,COLES ANZ,7.58,0,343201.71,DR,REF575539,ANZ,Savings
12-08-2025 09:51,INTBB14BC58040B48DE9EE8,012-345-678,11111111,TRANSFER TO CBA 22222222,1523.01,0,341678.7,DR,INT-42529,ANZ,Savings
12-08-2025 10:01,ANZ129683D6C25F4D1783F7,012-345-678,11111111,AMAZON AU ANZ,7.95,0,341670.75,DR,REF744313,ANZ,Savings
12-08-2025 10:03,ANZ36E94B4717A643DEADC1,012-345-678,11111111,BANK FEE ANZ,40.02,0,341630.73,DR,REF961696,ANZ,Savings
12-08-2025 10:14,ANZ89681C2CAE8E4A66B681,012-345-678,11111111,APPLE ANZ,118.53,0,341512.2,DR,REF758929,ANZ,Savings
12-08-2025 11:27,ANZ4D2DA43C23F2423489E1,012-345-678,11111111,PAYPAL *NETFLIX ANZ,49.18,0,341463.02,DR,REF488291,ANZ,Savings
12-08-2025 11:36,ANZ4F5B0DAA1B5B43679A26,012-345-678,11111111,APPLE ANZ,170.48,0,341292.54,DR,REF901821,ANZ,Savings
12-08-2025 11:51,ANZ65AC3CB12C9B4DD0A9FD,012-345-678,11111111,RAILWAY STATION ANZ,28.15,0,341264.39,DR,REF712154,ANZ,Savings
12-08-2025 12:00,ANZ17F65BCE91D14E0F936B,012-345-678,11111111,SHELL ANZ,20.52,0,341243.87,DR,REF665012,ANZ,Savings
12-08-2025 12:10,ANZA0472FF900AF42D4BA19,012-345-678,11111111,DOMINO'S PIZZA ANZ,54.17,0,341189.7,DR,REF143336,ANZ,Savings
12-08-2025 12:23,ANZFD628545703645AD8B23,012-345-678,11111111,HARVEY NORMAN ANZ,45.81,0,341143.89,DR,REF212023,ANZ,Savings
12-08-2025 12:26,ANZ4D7047A86FF443028DBE,012-345-678,11111111,BANK FEE ANZ,5.91,0,341137.98,DR,REF500503,ANZ,Savings
12-08-2025 12:32,ANZE1276D604FB74F4E8675,012-345-678,11111111,HARVEY NORMAN ANZ,4.02,0,341133.96,DR,REF748464,ANZ,Savings
12-08-2025 12:37,ANZC139A996BCCE4394B18E,012-345-678,11111111,AMAZON AU ANZ,54.91,0,341079.05,DR,REF156668,ANZ,Savings
12-08-2025 13:22,ANZC5E41BF42CF74506B9F6,012-345-678,11111111,COLES ANZ,28.47,0,341050.58,DR,REF255472,ANZ,Savings
12-08-2025 13:26,ANZ8C0DAF0D700B4E568AAE,012-345-678,11111111,HARVEY NORMAN ANZ,20.36,0,341030.22,DR,REF365448,ANZ,Savings
12-08-2025 13:41,ANZ330328AE978640A9AC9D,012-345-678,11111111,CITYLINK ANZ,91.22,0,340939,DR,REF345909,ANZ,Savings
12-08-2025 13:56,ANZ828221FF9A6C40EAA788,012-345-678,11111111,COMPANY PAYROLL ANZ,0,7341.84,348280.84,CR,REF847605,ANZ,Savings
12-08-2025 14:18,ANZ69FF9E25931F41C998D8,012-345-678,11111111,CITYLINK ANZ,50.8,0,348230.04,DR,REF475734,ANZ,Savings
12-08-2025 14:42,ANZFF28D5C1AF0D464F9463,012-345-678,11111111,PAYROLL CREDIT ANZ,0,4467.4,352697.44,CR,REF512406,ANZ,Savings
12-08-2025 15:40,ANZ0CFFC1023973483DB5C3,012-345-678,11111111,LIQUORLAND ANZ,155.66,0,352541.78,DR,REF802096,ANZ,Savings
12-08-2025 16:00,ANZAA5442CED27B44568A21,012-345-678,11111111,SHELL ANZ,16.37,0,352525.41,DR,REF865008,ANZ,Savings
12-08-2025 16:14,INT6180AB727D2A4A3289F6,012-345-678,11111111,TRANSFER FROM CBA 22222222,0,1413.2,353938.61,CR,INT-66319,ANZ,Savings
12-08-2025 16:25,ANZ8D8F992797E54520A2B3,012-345-678,11111111,APPLE ANZ,78.47,0,353860.14,DR,REF111700,ANZ,Savings
12-08-2025 16:45,ANZ3C7C1A4F4702422FA360,012-345-678,11111111,PAYPAL *NETFLIX ANZ,111.02,0,353749.12,DR,REF449857,ANZ,Savings
12-08-2025 17:18,ANZC2C12764C7AC4507BF4A,012-345-678,11111111,MENULOG ANZ,19.23,0,353729.89,DR,REF595900,ANZ,Savings
12-08-2025 17:41,ANZD71F45F37D744696A29A,012-345-678,11111111,WOOLWORTHS ANZ,43.07,0,353686.82,DR,REF390131,ANZ,Savings
12-08-2025 17:45,ANZ53D7EF1458BF4921ACDC,012-345-678,11111111,TAFE BOOKSHOP ANZ,27.84,0,353658.98,DR,REF133415,ANZ,Savings
12-08-2025 17:56,ANZB0EBAA4D5CFA42DE9F75,012-345-678,11111111,PAYMENT GATEWAY ANZ,15.2,0,353643.78,DR,REF303000,ANZ,Savings
12-08-2025 18:15,ANZ004D611E50EA449CA667,012-345-678,11111111,DOMINO'S PIZZA ANZ,91.03,0,353552.75,DR,REF653875,ANZ,Savings
12-08-2025 19:02,ANZ2070F245A71B49D4A369,012-345-678,11111111,BIGW ANZ,9.5,0,353543.25,DR,REF707106,ANZ,Savings
12-08-2025 20:19,ANZ3620785524224236BF85,012-345-678,11111111,TAFE BOOKSHOP ANZ,159.96,0,353383.29,DR,REF666612,ANZ,Savings
12-08-2025 20:50,ANZ1E8E4071090D49D2822B,012-345-678,11111111,MCDONALDS ANZ,7.44,0,353375.85,DR,REF888427,ANZ,Savings
12-08-2025 21:15,ANZ2ED14906D13D4E22A422,012-345-678,11111111,WOOLWORTHS ANZ,26.88,0,353348.97,DR,REF511846,ANZ,Savings
12-08-2025 21:45,ANZB5E61F799C76453D8880,012-345-678,11111111,MCDONALDS ANZ,31.39,0,353317.58,DR,REF581490,ANZ,Savings
12-08-2025 22:00,ANZEB769FA3ABF640618040,012-345-678,11111111,FLIXBUS ANZ,30.68,0,353286.9,DR,REF804543,ANZ,Savings
12-08-2025 22:27,ANZ9D31C638C2E74EF8A9C5,012-345-678,11111111,JB HI-FI ANZ,109.09,0,353177.81,DR,REF836994,ANZ,Savings
12-08-2025 22:28,ANZB3752934951D460F8670,012-345-678,11111111,SHELL ANZ,67.38,0,353110.43,DR,REF740191,ANZ,Savings
12-08-2025 23:05,ANZ2EC47EA781294D3BAF71,012-345-678,11111111,DOMINO'S PIZZA ANZ,173.63,0,352936.8,DR,REF861618,ANZ,Savings
12-08-2025 23:09,ANZ722390DF1747440AB748,012-345-678,11111111,UBER EATS ANZ,3,0,352933.8,DR,REF212929,ANZ,Savings
12-08-2025 23:25,ANZFC72ED6B080141FF9629,012-345-678,11111111,BP ANZ,100.23,0,352833.57,DR,REF130768,ANZ,Savings
12-08-2025 23:57,ANZB8026DB524C444D7B0CF,012-345-678,11111111,ALDI ANZ,19.66,0,352813.91,DR,REF800599,ANZ,Savings
13-08-2025 00:00,ANZ8D0B98395B7F4ABEAA58,012-345-678,11111111,WOOLWORTHS ANZ,3.42,0,352810.49,DR,REF484501,ANZ,Savings
13-08-2025 00:07,ANZ40390C7F018745B6B591,012-345-678,11111111,UBER EATS ANZ,88.95,0,352721.54,DR,REF166472,ANZ,Savings
13-08-2025 00:11,ANZD7D0338CCE2E4F6E81C1,012-345-678,11111111,WAGES CREDIT ANZ,0,729.22,353450.76,CR,REF338035,ANZ,Savings
13-08-2025 00:18,INTDC39292781DD4F0FBC14,012-345-678,11111111,TRANSFER FROM CBA 33333333,0,630.67,354081.43,CR,INT-58249,ANZ,Savings
13-08-2025 00:36,ANZA88D138C3AFA4C0D8C2F,012-345-678,11111111,7-ELEVEN ANZ,1.5,0,354079.93,DR,REF655201,ANZ,Savings
13-08-2025 00:46,INT2B233CAB2676450FAF4B,012-345-678,11111111,TRANSFER TO CBA 22222222,385.16,0,353694.77,DR,INT-34228,ANZ,Savings
13-08-2025 00:57,ANZ821F0DA9096044989ECB,012-345-678,11111111,ZOOM ANZ,50.11,0,353644.66,DR,REF167030,ANZ,Savings
13-08-2025 01:09,ANZ83486148D64D47DBA1EB,012-345-678,11111111,ALDI ANZ,74,0,353570.66,DR,REF236219,ANZ,Savings
13-08-2025 01:15,ANZA7A3B14A59504B5092B9,012-345-678,11111111,SPOTIFY ANZ,12.34,0,353558.32,DR,REF110922,ANZ,Savings
13-08-2025 01:21,ANZBC1AC71B0EA5489298D4,012-345-678,11111111,APPLE ANZ,7.93,0,353550.39,DR,REF533060,ANZ,Savings
13-08-2025 01:23,ANZ3BB8E87F268A4BAEB713,012-345-678,11111111,TAFE BOOKSHOP ANZ,94.22,0,353456.17,DR,REF704749,ANZ,Savings
13-08-2025 01:23,ANZD40404A6D0394A179E7D,012-345-678,11111111,BWS ANZ,91.73,0,353364.44,DR,REF600537,ANZ,Savings
13-08-2025 01:38,ANZ4E0C664C8AF642C6A387,012-345-678,11111111,DOMINO'S PIZZA ANZ,3.24,0,353361.2,DR,REF877366,ANZ,Savings
13-08-2025 01:43,ANZEAB1D9B3D1DA47BEAF0B,012-345-678,11111111,JB HI-FI ANZ,110.6,0,353250.6,DR,REF181743,ANZ,Savings
13-08-2025 02:14,ANZ8705961A46A94EEEB6A1,012-345-678,11111111,COLES ANZ,121.1,0,353129.5,DR,REF250832,ANZ,Savings
13-08-2025 02:42,ANZ5BA0DEC3524F43238CDC,012-345-678,11111111,PAY - SALARY ANZ,0,6746.29,359875.79,CR,REF889315,ANZ,Savings
13-08-2025 02:44,ANZD7164458DCCC489DA176,012-345-678,11111111,UBER EATS ANZ,27.85,0,359847.94,DR,REF935828,ANZ,Savings
13-08-2025 03:14,INTD299FF144B554C1AA885,012-345-678,11111111,TRANSFER FROM CBA 33333333,0,1360.31,361208.25,CR,INT-27645,ANZ,Savings
13-08-2025 03:45,ANZFF06BA09BAB9414B8DD1,012-345-678,11111111,CITYLINK ANZ,37.28,0,361170.97,DR,REF817289,ANZ,Savings
13-08-2025 03:57,ANZ961220BCB17C4DCCA5CE,012-345-678,11111111,INTERNET TRANSFER ANZ,21.65,0,361149.32,DR,REF152562,ANZ,Savings
13-08-2025 04:00,ANZB97A1BC7D5C846E6AB40,012-345-678,11111111,BWS ANZ,86.8,0,361062.52,DR,REF896956,ANZ,Savings
13-08-2025 04:07,ANZ68B2E030F1F0423E8750,012-345-678,11111111,JB HI-FI ANZ,176.04,0,360886.48,DR,REF779624,ANZ,Savings
13-08-2025 04:14,ANZ0018FC5B39E24E97B747,012-345-678,11111111,PAY - SALARY ANZ,0,2495.41,363381.89,CR,REF384319,ANZ,Savings
13-08-2025 05:15,ANZ23E47492065143B8A3E7,012-345-678,11111111,JB HI-FI ANZ,74.82,0,363307.07,DR,REF677058,ANZ,Savings
13-08-2025 05:15,ANZDF0E381CE31C4650ABF2,012-345-678,11111111,PAY - SALARY ANZ,0,3848.4,367155.47,CR,REF352410,ANZ,Savings
13-08-2025 05:28,ANZA294B4D423BD4691BE66,012-345-678,11111111,FLIXBUS ANZ,21.8,0,367133.67,DR,REF443612,ANZ,Savings
13-08-2025 05:47,ANZC742B4A4AD154FA4853D,012-345-678,11111111,APPLE ANZ,94.39,0,367039.28,DR,REF881039,ANZ,Savings
13-08-2025 06:09,ANZB889D42A6A1C45769ECA,012-345-678,11111111,WAGES CREDIT ANZ,0,6714.47,373753.75,CR,REF891002,ANZ,Savings
13-08-2025 06:37,ANZDC735BC4A4E74476A838,012-345-678,11111111,PAYROLL CREDIT ANZ,0,3022.29,376776.04,CR,REF746151,ANZ,Savings
13-08-2025 06:38,ANZC6A2274828634CCFBD77,012-345-678,11111111,KFC ANZ,13.84,0,376762.2,DR,REF507337,ANZ,Savings
13-08-2025 06:54,ANZ39485AC8775A440C9F97,012-345-678,11111111,INTERNET TRANSFER ANZ,18.98,0,376743.22,DR,REF274230,ANZ,Savings
13-08-2025 07:38,ANZ227192FD959F4BE3ABA3,012-345-678,11111111,7-ELEVEN ANZ,45.69,0,376697.53,DR,REF790377,ANZ,Savings
13-08-2025 07:49,ANZDA3462D2B5A04BA7BAB5,012-345-678,11111111,MCDONALDS ANZ,105.2,0,376592.33,DR,REF357844,ANZ,Savings
13-08-2025 08:22,ANZ52FB474A587547F8A616,012-345-678,11111111,KFC ANZ,45.17,0,376547.16,DR,REF502105,ANZ,Savings
13-08-2025 08:41,ANZ6F9AED5343B8491F82DE,012-345-678,11111111,ZOOM ANZ,5.76,0,376541.4,DR,REF764825,ANZ,Savings
13-08-2025 08:49,ANZF16A4CDE69E145F88B35,012-345-678,11111111,BANK FEE ANZ,91.84,0,376449.56,DR,REF180516,ANZ,Savings
13-08-2025 08:52,ANZ84F6C0F0F2E8433C9345,012-345-678,11111111,APPLE ANZ,38.06,0,376411.5,DR,REF560420,ANZ,Savings
13-08-2025 09:40,ANZA43627D9B7324A7498AF,012-345-678,11111111,LIQUORLAND ANZ,140.31,0,376271.19,DR,REF364142,ANZ,Savings
13-08-2025 10:36,ANZF368EEA54434450A8706,012-345-678,11111111,PAYPAL *NETFLIX ANZ,7.27,0,376263.92,DR,REF856712,ANZ,Savings
13-08-2025 11:02,ANZF71FB9560B334D98ADCE,012-345-678,11111111,7-ELEVEN ANZ,8.04,0,376255.88,DR,REF136649,ANZ,Savings
13-08-2025 11:25,ANZC6A28572180246D7BEAF,012-345-678,11111111,SALARY PAYMENT ANZ,0,5850.06,382105.94,CR,REF451194,ANZ,Savings
13-08-2025 12:12,ANZ843988165F83451DA021,012-345-678,11111111,STARBUCKS ANZ,84.02,0,382021.92,DR,REF996687,ANZ,Savings
13-08-2025 12:40,ANZ2E9D2CFF5B594F27BCCA,012-345-678,11111111,STARBUCKS ANZ,36.33,0,381985.59,DR,REF963802,ANZ,Savings
13-08-2025 13:12,ANZ492FF89939B34A54B9AF,012-345-678,11111111,WAGES CREDIT ANZ,0,2854.69,384840.28,CR,REF278931,ANZ,Savings
13-08-2025 13:31,ANZ30BD7E9AA0AB44E1BA5D,012-345-678,11111111,7-ELEVEN ANZ,54.73,0,384785.55,DR,REF187302,ANZ,Savings
13-08-2025 13:33,ANZ520A22B032EA4027BC5C,012-345-678,11111111,APPLE ANZ,8.47,0,384777.08,DR,REF712289,ANZ,Savings
13-08-2025 13:44,ANZ1104BC003C674C41A66D,012-345-678,11111111,SPOTIFY ANZ,5.14,0,384771.94,DR,REF214048,ANZ,Savings
13-08-2025 13:53,ANZ78633B08962841A294F8,012-345-678,11111111,STARBUCKS ANZ,51.3,0,384720.64,DR,REF883871,ANZ,Savings
13-08-2025 13:57,ANZ777BD11965754254B3B9,012-345-678,11111111,ZOOM ANZ,190.37,0,384530.27,DR,REF946601,ANZ,Savings
13-08-2025 14:59,ANZF895976204CE439AA04A,012-345-678,11111111,SHELL ANZ,66.5,0,384463.77,DR,REF378266,ANZ,Savings
13-08-2025 15:25,ANZAEFA77CFFB884EC3BE44,012-345-678,11111111,TAFE BOOKSHOP ANZ,33.37,0,384430.4,DR,REF245689,ANZ,Savings
13-08-2025 15:32,INTA2C437E4C6E448B0B421,012-345-678,11111111,TRANSFER TO CBA 33333333,1875.67,0,382554.73,DR,INT-91209,ANZ,Savings
13-08-2025 16:15,ANZ97B7C17FBB5F4C1FAD17,012-345-678,11111111,MCDONALDS ANZ,5.95,0,382548.78,DR,REF425908,ANZ,Savings
13-08-2025 16:35,ANZB8A611DEC17340469D93,012-345-678,11111111,BANK FEE ANZ,6.33,0,382542.45,DR,REF974664,ANZ,Savings
13-08-2025 16:54,ANZ5F5DDED3DDAC4801B3C5,012-345-678,11111111,ZOOM ANZ,170.95,0,382371.5,DR,REF201970,ANZ,Savings
13-08-2025 17:03,ANZ0D8C05A60E4042C3ADC7,012-345-678,11111111,KFC ANZ,13.6,0,382357.9,DR,REF718497,ANZ,Savings
13-08-2025 17:18,INTCFB72CDE66754270A20F,012-345-678,11111111,TRANSFER FROM NAB 44444444,0,1081.66,383439.56,CR,INT-72601,ANZ,Savings
13-08-2025 17:23,INT0A2FE18BE5DC4DE689CF,012-345-678,11111111,TRANSFER FROM NAB 44444444,0,1911.04,385350.6,CR,INT-32163,ANZ,Savings
13-08-2025 17:46,ANZD88D59E326844E22BE4D,012-345-678,11111111,FLIXBUS ANZ,49.78,0,385300.82,DR,REF996269,ANZ,Savings
13-08-2025 17:46,ANZF477DDEED1CE41EBB141,012-345-678,11111111,CITYLINK ANZ,6.34,0,385294.48,DR,REF904056,ANZ,Savings
13-08-2025 17:55,ANZC481DEE798AB4FA2B7FC,012-345-678,11111111,FLIXBUS ANZ,149.58,0,385144.9,DR,REF657574,ANZ,Savings
13-08-2025 18:28,ANZ835DD3ADA06E4350977F,012-345-678,11111111,UBER EATS ANZ,144.66,0,385000.24,DR,REF712531,ANZ,Savings
13-08-2025 19:06,ANZ3F0D74881FA94914B72D,012-345-678,11111111,MCDONALDS ANZ,75.81,0,384924.43,DR,REF747368,ANZ,Savings
13-08-2025 19:25,ANZ52011C7735D94727A8F2,012-345-678,11111111,DOMINO'S PIZZA ANZ,17.32,0,384907.11,DR,REF494353,ANZ,Savings
13-08-2025 23:20,ANZ574A6C7B143C45519202,012-345-678,11111111,BANK FEE ANZ,54.89,0,384852.22,DR,REF733499,ANZ,Savings
13-08-2025 23:25,ANZEA8E1F01E19E456A8C49,012-345-678,11111111,BWS ANZ,106.37,0,384745.85,DR,REF383213,ANZ,Savings
13-08-2025 23:45,ANZ7D9BD3CCAEF94A52BF18,012-345-678,11111111,WAGES CREDIT ANZ,0,5364.22,390110.07,CR,REF551698,ANZ,Savings
14-08-2025 00:07,ANZ494AAD63448A4C3A80E6,012-345-678,11111111,7-ELEVEN ANZ,9.93,0,390100.14,DR,REF970899,ANZ,Savings
14-08-2025 00:30,ANZ3E913B30A8FB4EBBA172,012-345-678,11111111,COLES ANZ,32.15,0,390067.99,DR,REF997460,ANZ,Savings
14-08-2025 00:34,INT9ED91672EB704AF78B45,012-345-678,11111111,TRANSFER FROM CBA 33333333,0,441.45,390509.44,CR,INT-95748,ANZ,Savings
14-08-2025 00:45,ANZ89645B49C6B64302AF54,012-345-678,11111111,7-ELEVEN ANZ,4.69,0,390504.75,DR,REF984119,ANZ,Savings
14-08-2025 00:56,ANZFAB2E24C21E244E6B516,012-345-678,11111111,BWS ANZ,75.92,0,390428.83,DR,REF715465,ANZ,Savings
14-08-2025 01:02,ANZ3BE7538D7142400681BF,012-345-678,11111111,DOMINO'S PIZZA ANZ,88.48,0,390340.35,DR,REF811481,ANZ,Savings
14-08-2025 01:34,ANZ6247FEE9C8B94B348562,012-345-678,11111111,BANK FEE ANZ,15.58,0,390324.77,DR,REF632763,ANZ,Savings
14-08-2025 02:01,ANZ6E72ABBF1EB646988886,012-345-678,11111111,WOOLWORTHS ANZ,17.71,0,390307.06,DR,REF267362,ANZ,Savings
14-08-2025 02:27,ANZA4F77101BC104E95A349,012-345-678,11111111,TAFE BOOKSHOP ANZ,34.29,0,390272.77,DR,REF114875,ANZ,Savings
14-08-2025 02:33,ANZB546294200914896969A,012-345-678,11111111,PAY - SALARY ANZ,0,4050.52,394323.29,CR,REF396488,ANZ,Savings
14-08-2025 02:47,ANZB6B0DE1665B5406F8549,012-345-678,11111111,PAYROLL CREDIT ANZ,0,7872.45,402195.74,CR,REF895444,ANZ,Savings
14-08-2025 03:01,ANZ8702C5C9E3194CE2915E,012-345-678,11111111,APPLE ANZ,5.89,0,402189.85,DR,REF526073,ANZ,Savings
14-08-2025 03:28,INT7F08F0445C8340B2B568,012-345-678,11111111,TRANSFER TO NAB 44444444,360.79,0,401829.06,DR,INT-49217,ANZ,Savings
14-08-2025 03:33,ANZ2C0544AF600645B5A04A,012-345-678,11111111,RAILWAY STATION ANZ,60.16,0,401768.9,DR,REF683690,ANZ,Savings
14-08-2025 03:53,ANZ4F5E5C93075D45BC8236,012-345-678,11111111,COMPANY PAYROLL ANZ,0,5012.26,406781.16,CR,REF698025,ANZ,Savings
14-08-2025 04:00,ANZFF23A95EAAC9467BA7BC,012-345-678,11111111,WOOLWORTHS ANZ,27.01,0,406754.15,DR,REF891445,ANZ,Savings
14-08-2025 04:58,ANZ5CC5FB5E7C234B3A86FB,012-345-678,11111111,INTERNET TRANSFER ANZ,30.54,0,406723.61,DR,REF666314,ANZ,Savings
14-08-2025 05:38,ANZA921C66896B04F3997FF,012-345-678,11111111,PAYMENT GATEWAY ANZ,7.44,0,406716.17,DR,REF381679,ANZ,Savings
14-08-2025 05:59,ANZ46B444DD60B54F0C9A07,012-345-678,11111111,PAY - SALARY ANZ,0,7451.83,414168,CR,REF983408,ANZ,Savings
14-08-2025 06:10,ANZ52C3C05A957D41F0BD20,012-345-678,11111111,ZOOM ANZ,64.13,0,414103.87,DR,REF973697,ANZ,Savings
14-08-2025 06:10,ANZ23AD5205E53C45DCA32A,012-345-678,11111111,PAY - SALARY ANZ,0,6577.17,420681.04,CR,REF244330,ANZ,Savings
14-08-2025 06:13,ANZ72589530086A46F5A2AF,012-345-678,11111111,SALARY PAYMENT ANZ,0,801.34,421482.38,CR,REF204287,ANZ,Savings
14-08-2025 06:32,ANZ4F4D277776074E4DBE44,012-345-678,11111111,PAYMENT GATEWAY ANZ,117.13,0,421365.25,DR,REF199707,ANZ,Savings
14-08-2025 06:34,ANZ76257AAC4BAD469793EA,012-345-678,11111111,BANK FEE ANZ,10.1,0,421355.15,DR,REF459133,ANZ,Savings
14-08-2025 07:34,ANZ390955DCCA67453D871D,012-345-678,11111111,HARVEY NORMAN ANZ,214.14,0,421141.01,DR,REF991964,ANZ,Savings
14-08-2025 08:17,ANZ5C5000C5E4384AC4A864,012-345-678,11111111,PAYPAL *NETFLIX ANZ,23.04,0,421117.97,DR,REF771219,ANZ,Savings
14-08-2025 08:33,ANZ8E45DA50F48C45948522,012-345-678,11111111,SALARY PAYMENT ANZ,0,214.8,421332.77,CR,REF235467,ANZ,Savings
14-08-2025 08:44,ANZAE32AD2DEA1C451E9421,012-345-678,11111111,FLIXBUS ANZ,4.9,0,421327.87,DR,REF941945,ANZ,Savings
14-08-2025 09:48,ANZ2D6702283E37413193DB,012-345-678,11111111,COMPANY PAYROLL ANZ,0,791.64,422119.51,CR,REF676708,ANZ,Savings
14-08-2025 10:06,ANZ334961C80FBF4A7BAA61,012-345-678,11111111,WOOLWORTHS ANZ,74.68,0,422044.83,DR,REF845281,ANZ,Savings
14-08-2025 10:26,ANZ01BF4C85368247EC8ECA,012-345-678,11111111,JB HI-FI ANZ,26.68,0,422018.15,DR,REF734356,ANZ,Savings
14-08-2025 11:21,ANZ0A85292522EB4CC0A892,012-345-678,11111111,MENULOG ANZ,24.86,0,421993.29,DR,REF729578,ANZ,Savings
14-08-2025 11:21,ANZ2C09A33A561A42918CCB,012-345-678,11111111,BWS ANZ,125.56,0,421867.73,DR,REF723637,ANZ,Savings
14-08-2025 11:29,ANZF86B16930F184F578211,012-345-678,11111111,ALDI ANZ,119.55,0,421748.18,DR,REF602894,ANZ,Savings
14-08-2025 11:38,ANZC32379879FC9414F99EC,012-345-678,11111111,WAGES CREDIT ANZ,0,4272.38,426020.56,CR,REF330235,ANZ,Savings
14-08-2025 12:02,INT33C40859E3404E56B38F,012-345-678,11111111,TRANSFER TO CBA 33333333,1360.86,0,424659.7,DR,INT-49946,ANZ,Savings
14-08-2025 12:09,ANZ64E34671325A423B8776,012-345-678,11111111,FLIXBUS ANZ,25.5,0,424634.2,DR,REF631657,ANZ,Savings
14-08-2025 13:02,ANZ1D8C74A8DACD4DBFA5BB,012-345-678,11111111,STARBUCKS ANZ,10.44,0,424623.76,DR,REF679679,ANZ,Savings
14-08-2025 13:13,ANZ45D990F0D1194A208653,012-345-678,11111111,ZOOM ANZ,4.2,0,424619.56,DR,REF451445,ANZ,Savings
14-08-2025 13:55,ANZF81A0FA1E1A44E6A8BD8,012-345-678,11111111,MENULOG ANZ,30.84,0,424588.72,DR,REF713018,ANZ,Savings
14-08-2025 14:00,ANZF8E88081B0D349669715,012-345-678,11111111,CITYLINK ANZ,67.84,0,424520.88,DR,REF246978,ANZ,Savings
14-08-2025 14:15,ANZ87174D48F09442F48BB1,012-345-678,11111111,ALDI ANZ,14.69,0,424506.19,DR,REF426080,ANZ,Savings
14-08-2025 14:24,ANZF363BBCFBA3D4E808C7A,012-345-678,11111111,WAGES CREDIT ANZ,0,1624.98,426131.17,CR,REF759146,ANZ,Savings
14-08-2025 14:29,ANZB360B14E5D3C4F5F92E9,012-345-678,11111111,LIQUORLAND ANZ,47.4,0,426083.77,DR,REF712412,ANZ,Savings
14-08-2025 14:43,ANZ0D9923A51C2C4AEEAE9E,012-345-678,11111111,MCDONALDS ANZ,16.09,0,426067.68,DR,REF675210,ANZ,Savings
14-08-2025 14:45,ANZ3BDE2B242426431CA53F,012-345-678,11111111,7-ELEVEN ANZ,15.4,0,426052.28,DR,REF917099,ANZ,Savings
14-08-2025 15:38,ANZ35C440E1B7194EA7A3E6,012-345-678,11111111,ALDI ANZ,154.78,0,425897.5,DR,REF755854,ANZ,Savings
14-08-2025 16:14,ANZF0CAD2703FE74E298BD1,012-345-678,11111111,BP ANZ,36.49,0,425861.01,DR,REF271789,ANZ,Savings
14-08-2025 17:00,ANZE1A30D81379D44F4B1AE,012-345-678,11111111,COLES ANZ,8.79,0,425852.22,DR,REF296639,ANZ,Savings
14-08-2025 17:15,ANZCA680D5489224C61BE5C,012-345-678,11111111,PAYPAL *NETFLIX ANZ,21.11,0,425831.11,DR,REF206424,ANZ,Savings
14-08-2025 17:20,ANZA66C3009A10845F0B3F9,012-345-678,11111111,7-ELEVEN ANZ,1.66,0,425829.45,DR,REF752486,ANZ,Savings
14-08-2025 17:21,ANZ2045B08A91F5410C876E,012-345-678,11111111,RAILWAY STATION ANZ,78.39,0,425751.06,DR,REF586441,ANZ,Savings
14-08-2025 17:31,ANZ88ECC1AEC7924CF88391,012-345-678,11111111,CITYLINK ANZ,89.88,0,425661.18,DR,REF128922,ANZ,Savings
14-08-2025 17:40,ANZ0CB15A8F9BF047B981CF,012-345-678,11111111,LIQUORLAND ANZ,107.9,0,425553.28,DR,REF943410,ANZ,Savings
14-08-2025 18:05,ANZF3F8ED8DD03C4288A8E6,012-345-678,11111111,BANK FEE ANZ,30.74,0,425522.54,DR,REF143644,ANZ,Savings
14-08-2025 18:12,ANZ4E5718B9F4794BDB8D7F,012-345-678,11111111,DOMINO'S PIZZA ANZ,58.89,0,425463.65,DR,REF103384,ANZ,Savings
14-08-2025 18:22,ANZ6CAFFB9A963841DE9C10,012-345-678,11111111,WOOLWORTHS ANZ,24.83,0,425438.82,DR,REF254512,ANZ,Savings
14-08-2025 18:36,ANZ38FEBEA1C2A94175A17A,012-345-678,11111111,UBER EATS ANZ,5.25,0,425433.57,DR,REF111911,ANZ,Savings
14-08-2025 18:50,ANZB766814744BE48319340,012-345-678,11111111,PAYROLL CREDIT ANZ,0,3120.46,428554.03,CR,REF241733,ANZ,Savings
14-08-2025 19:00,ANZ8C8BA2B9E5A74357ADCC,012-345-678,11111111,BWS ANZ,21.72,0,428532.31,DR,REF606995,ANZ,Savings
14-08-2025 19:02,ANZ5B2BCF4FE8354C98808F,012-345-678,11111111,COLES ANZ,20.09,0,428512.22,DR,REF104423,ANZ,Savings
14-08-2025 19:43,ANZ5BDBC842963C4FF4A36B,012-345-678,11111111,APPLE ANZ,95.62,0,428416.6,DR,REF592956,ANZ,Savings
14-08-2025 19:52,ANZC4C5EFB141704DBA9E0C,012-345-678,11111111,FLIXBUS ANZ,64.68,0,428351.92,DR,REF650940,ANZ,Savings
14-08-2025 19:58,ANZ403A5EB3C8A14949AC6E,012-345-678,11111111,INTERNET TRANSFER ANZ,118.02,0,428233.9,DR,REF600533,ANZ,Savings
14-08-2025 20:01,ANZ34F71021DBDF4790AFFA,012-345-678,11111111,TAFE BOOKSHOP ANZ,9.21,0,428224.69,DR,REF586786,ANZ,Savings
14-08-2025 21:03,ANZF2D37FE7A4774A84BBEC,012-345-678,11111111,PAYMENT GATEWAY ANZ,37.49,0,428187.2,DR,REF802146,ANZ,Savings
14-08-2025 21:07,INTC19965D74E094E7A9D76,012-345-678,11111111,TRANSFER TO CBA 33333333,96.22,0,428090.98,DR,INT-28409,ANZ,Savings
14-08-2025 21:21,ANZ2148F001A63B42388959,012-345-678,11111111,BIGW ANZ,5.53,0,428085.45,DR,REF418273,ANZ,Savings
14-08-2025 22:25,ANZDB5A953DE5634CFCA5F2,012-345-678,11111111,FLIXBUS ANZ,123.39,0,427962.06,DR,REF853744,ANZ,Savings
14-08-2025 22:25,ANZ98924C22574D456CAEC6,012-345-678,11111111,CITYLINK ANZ,102.93,0,427859.13,DR,REF852910,ANZ,Savings
14-08-2025 22:36,ANZ7B46EE6D7CD14487A28C,012-345-678,11111111,STARBUCKS ANZ,27.33,0,427831.8,DR,REF874296,ANZ,Savings
14-08-2025 22:53,ANZ1475520C943F47C6B9BF,012-345-678,11111111,KFC ANZ,36.88,0,427794.92,DR,REF906449,ANZ,Savings
14-08-2025 23:10,ANZA1A1F9A2AE3E4081B5E8,012-345-678,11111111,BWS ANZ,28.76,0,427766.16,DR,REF885233,ANZ,Savings
14-08-2025 23:35,ANZA4C33F56AD6642AEBA51,012-345-678,11111111,MCDONALDS ANZ,17.79,0,427748.37,DR,REF618101,ANZ,Savings
14-08-2025 23:51,ANZ703DB14EEF374B4EA7D1,012-345-678,11111111,ALDI ANZ,49.84,0,427698.53,DR,REF442579,ANZ,Savings
15-08-2025 00:00,ANZF3311D71F8324F60BC91,012-345-678,11111111,MENULOG ANZ,20.99,0,427677.54,DR,REF249331,ANZ,Savings
15-08-2025 00:10,INT03DDBE3B84444C3783F8,012-345-678,11111111,TRANSFER TO CBA 22222222,131.74,0,427545.8,DR,INT-65690,ANZ,Savings
15-08-2025 00:18,ANZ85D0405B7AB44B158179,012-345-678,11111111,INTERNET TRANSFER ANZ,59.53,0,427486.27,DR,REF451022,ANZ,Savings
15-08-2025 00:30,ANZ2B9905AD1F41420CA12D,012-345-678,11111111,BWS ANZ,25.03,0,427461.24,DR,REF139117,ANZ,Savings
15-08-2025 00:34,INT9F1C0D14176D431A8873,012-345-678,11111111,TRANSFER FROM CBA 33333333,0,1017.99,428479.23,CR,INT-26376,ANZ,Savings
15-08-2025 00:39,ANZF3E3783D44E54DD1A374,012-345-678,11111111,TAFE BOOKSHOP ANZ,81.99,0,428397.24,DR,REF137543,ANZ,Savings
15-08-2025 01:14,ANZF4F11B91CB15427FA4F0,012-345-678,11111111,SHELL ANZ,19.23,0,428378.01,DR,REF140246,ANZ,Savings
15-08-2025 01:24,ANZ1F4011D25B9C466599E4,012-345-678,11111111,COLES ANZ,106.36,0,428271.65,DR,REF946920,ANZ,Savings
15-08-2025 01:29,ANZ91A49FA84E5E445497D2,012-345-678,11111111,COLES ANZ,65.56,0,428206.09,DR,REF124053,ANZ,Savings
15-08-2025 02:02,ANZ9869B0CA64F34950AE3F,012-345-678,11111111,PAYMENT GATEWAY ANZ,110.05,0,428096.04,DR,REF546171,ANZ,Savings
15-08-2025 02:05,ANZA951AE14DAE74C61B7E7,012-345-678,11111111,SPOTIFY ANZ,8.29,0,428087.75,DR,REF565720,ANZ,Savings
15-08-2025 02:08,ANZC02CF6BB714F450B8673,012-345-678,11111111,MCDONALDS ANZ,32.74,0,428055.01,DR,REF368620,ANZ,Savings
15-08-2025 02:08,ANZ69079514D49B47E9AF99,012-345-678,11111111,PAYMENT GATEWAY ANZ,46.19,0,428008.82,DR,REF257156,ANZ,Savings
15-08-2025 02:22,ANZ7C387822704C47D6BE1C,012-345-678,11111111,SALARY PAYMENT ANZ,0,2546.48,430555.3,CR,REF764369,ANZ,Savings
15-08-2025 02:49,ANZ9ADF13DF6DBF40D2A89F,012-345-678,11111111,MENULOG ANZ,40.85,0,430514.45,DR,REF674670,ANZ,Savings
15-08-2025 02:57,ANZDF0E98FC4E494CCC89D1,012-345-678,11111111,7-ELEVEN ANZ,87.23,0,430427.22,DR,REF923148,ANZ,Savings
15-08-2025 03:14,ANZ2B909D1EE4034B0781D6,012-345-678,11111111,PAYPAL *NETFLIX ANZ,9.06,0,430418.16,DR,REF470609,ANZ,Savings
15-08-2025 03:37,ANZ23F2B121AFCB450CA82F,012-345-678,11111111,CITYLINK ANZ,98.46,0,430319.7,DR,REF187991,ANZ,Savings
15-08-2025 03:42,ANZC5EC814D713C486DA1A7,012-345-678,11111111,MENULOG ANZ,109.41,0,430210.29,DR,REF513059,ANZ,Savings
15-08-2025 03:45,ANZF845254B5C344B46B290,012-345-678,11111111,WAGES CREDIT ANZ,0,7875.29,438085.58,CR,REF265310,ANZ,Savings
15-08-2025 04:12,ANZ29FBC5AB8C814A988FDC,012-345-678,11111111,COMPANY PAYROLL ANZ,0,531.26,438616.84,CR,REF955238,ANZ,Savings
15-08-2025 04:31,ANZ51E579780C7C49A8AD1A,012-345-678,11111111,PAYMENT GATEWAY ANZ,14.05,0,438602.79,DR,REF713750,ANZ,Savings
15-08-2025 04:44,ANZ40A8214FF1364E4E8274,012-345-678,11111111,APPLE ANZ,33.8,0,438568.99,DR,REF951165,ANZ,Savings
15-08-2025 05:18,ANZ20EEA1BBF7104159B779,012-345-678,11111111,TAFE BOOKSHOP ANZ,7.23,0,438561.76,DR,REF533418,ANZ,Savings
15-08-2025 05:19,ANZ7DA0BFF092834B5288E5,012-345-678,11111111,COMPANY PAYROLL ANZ,0,4663.92,443225.68,CR,REF898868,ANZ,Savings
15-08-2025 05:27,ANZD97BDD7EB2DA49008F81,012-345-678,11111111,JB HI-FI ANZ,34.13,0,443191.55,DR,REF834916,ANZ,Savings
15-08-2025 05:28,ANZ19E1B165EB574C0AA79B,012-345-678,11111111,COLES ANZ,91.46,0,443100.09,DR,REF478698,ANZ,Savings
15-08-2025 05:37,ANZ3D9DD0544D194C9E9E62,012-345-678,11111111,BWS ANZ,40.06,0,443060.03,DR,REF862961,ANZ,Savings
15-08-2025 05:52,ANZ209B6EDDA2D9425394E3,012-345-678,11111111,FLIXBUS ANZ,103.74,0,442956.29,DR,REF525800,ANZ,Savings
15-08-2025 06:17,ANZ657810321B1342C49FFA,012-345-678,11111111,RAILWAY STATION ANZ,16.66,0,442939.63,DR,REF858475,ANZ,Savings
15-08-2025 06:31,ANZ303BC69611DA4742BE5D,012-345-678,11111111,BIGW ANZ,32.94,0,442906.69,DR,REF188272,ANZ,Savings
15-08-2025 06:32,ANZB3F0E912EF7E44A8973D,012-345-678,11111111,APPLE ANZ,68.55,0,442838.14,DR,REF735475,ANZ,Savings
15-08-2025 06:47,ANZ16D7806371A64102BD38,012-345-678,11111111,PAYROLL CREDIT ANZ,0,454.7,443292.84,CR,REF108864,ANZ,Savings
15-08-2025 07:37,ANZ35621CAF718C47DAB52A,012-345-678,11111111,SHELL ANZ,184.49,0,443108.35,DR,REF570124,ANZ,Savings
15-08-2025 07:37,ANZD448046577C143E4824C,012-345-678,11111111,PAYPAL *NETFLIX ANZ,109.26,0,442999.09,DR,REF594628,ANZ,Savings
15-08-2025 07:52,ANZ299FB81BDC004F039241,012-345-678,11111111,WAGES CREDIT ANZ,0,6602.12,449601.21,CR,REF471151,ANZ,Savings
15-08-2025 08:08,ANZ2EC8B233D2B444E2957C,012-345-678,11111111,ALDI ANZ,69.61,0,449531.6,DR,REF743177,ANZ,Savings
15-08-2025 08:27,ANZAA99E68ED6724F309BD1,012-345-678,11111111,ALDI ANZ,46.98,0,449484.62,DR,REF485419,ANZ,Savings
15-08-2025 08:28,ANZDC40B6EB2AF64CB99A21,012-345-678,11111111,WOOLWORTHS ANZ,88.03,0,449396.59,DR,REF215682,ANZ,Savings
15-08-2025 08:32,ANZ4EA65383FFF941FB909A,012-345-678,11111111,COMPANY PAYROLL ANZ,0,652.12,450048.71,CR,REF754362,ANZ,Savings
15-08-2025 08:40,ANZ5ECB694B34F44769A800,012-345-678,11111111,PAYMENT GATEWAY ANZ,91.75,0,449956.96,DR,REF802981,ANZ,Savings
15-08-2025 08:44,ANZEDB9D6FADD6D4835A185,012-345-678,11111111,DOMINO'S PIZZA ANZ,4.9,0,449952.06,DR,REF478462,ANZ,Savings
15-08-2025 08:48,ANZ9F4863FE9F914A6FA6A2,012-345-678,11111111,COLES ANZ,58.88,0,449893.18,DR,REF589041,ANZ,Savings
15-08-2025 09:04,ANZ91935136453E4060BD43,012-345-678,11111111,BWS ANZ,36.94,0,449856.24,DR,REF260949,ANZ,Savings
15-08-2025 09:58,ANZEF9A87A9F9B343449C8A,012-345-678,11111111,APPLE ANZ,8.74,0,449847.5,DR,REF949540,ANZ,Savings
15-08-2025 10:00,ANZ1039105628C64A04AC79,012-345-678,11111111,WAGES CREDIT ANZ,0,1056.36,450903.86,CR,REF931275,ANZ,Savings
15-08-2025 10:14,ANZ974926920DB34E1D8E75,012-345-678,11111111,BIGW ANZ,9.45,0,450894.41,DR,REF356809,ANZ,Savings
15-08-2025 10:17,ANZ6459E0DF2B9F4A1AB076,012-345-678,11111111,7-ELEVEN ANZ,90.3,0,450804.11,DR,REF671433,ANZ,Savings
15-08-2025 10:56,INTA65865C072D7443DA610,012-345-678,11111111,TRANSFER TO CBA 33333333,1918.98,0,448885.13,DR,INT-59117,ANZ,Savings
15-08-2025 11:17,ANZE3F8FF11A449400D889E,012-345-678,11111111,LIQUORLAND ANZ,33.3,0,448851.83,DR,REF698789,ANZ,Savings
15-08-2025 11:21,ANZ9F55DBA9C58047A2BB92,012-345-678,11111111,SHELL ANZ,47.69,0,448804.14,DR,REF605737,ANZ,Savings
15-08-2025 11:35,ANZ8460B476A2EE41B5ABEA,012-345-678,11111111,LIQUORLAND ANZ,28.74,0,448775.4,DR,REF756935,ANZ,Savings
15-08-2025 11:39,ANZE5369B2BF276459AA2A3,012-345-678,11111111,WAGES CREDIT ANZ,0,5825.66,454601.06,CR,REF307299,ANZ,Savings
15-08-2025 11:54,INT9CB2D899F5D7428282A3,012-345-678,11111111,TRANSFER TO CBA 33333333,1910.06,0,452691,DR,INT-70191,ANZ,Savings
15-08-2025 11:58,ANZACC310E27A4443CAA307,012-345-678,11111111,COMPANY PAYROLL ANZ,0,2914.89,455605.89,CR,REF135954,ANZ,Savings
15-08-2025 11:59,INT60E8DC38A2F24D289908,012-345-678,11111111,TRANSFER TO CBA 33333333,1050.6,0,454555.29,DR,INT-54257,ANZ,Savings
15-08-2025 12:47,ANZ015F596B5F0E43B58E05,012-345-678,11111111,TAFE BOOKSHOP ANZ,94.09,0,454461.2,DR,REF649695,ANZ,Savings
15-08-2025 12:48,ANZ0A0E3603FFBF4C7F9AE3,012-345-678,11111111,BANK FEE ANZ,57.94,0,454403.26,DR,REF248092,ANZ,Savings
15-08-2025 12:56,ANZ807112666F554E6FAC9B,012-345-678,11111111,UBER EATS ANZ,16.42,0,454386.84,DR,REF711894,ANZ,Savings
15-08-2025 13:02,ANZ795A842800E442DAAC03,012-345-678,11111111,ZOOM ANZ,111.42,0,454275.42,DR,REF702054,ANZ,Savings
15-08-2025 13:59,ANZ5CCEB13B153C49BFAE90,012-345-678,11111111,WOOLWORTHS ANZ,3.94,0,454271.48,DR,REF796450,ANZ,Savings
15-08-2025 14:07,ANZ99660F1AE2D74A74BEA5,012-345-678,11111111,BWS ANZ,24,0,454247.48,DR,REF235379,ANZ,Savings
15-08-2025 14:08,ANZ60C353B847424A46ACC5,012-345-678,11111111,COLES ANZ,30.92,0,454216.56,DR,REF939803,ANZ,Savings
15-08-2025 14:11,ANZC8A789F643B442608B2D,012-345-678,11111111,BWS ANZ,77.55,0,454139.01,DR,REF892561,ANZ,Savings
15-08-2025 14:32,ANZ13A6DD3C53F54E7B9616,012-345-678,11111111,RAILWAY STATION ANZ,7.71,0,454131.3,DR,REF941009,ANZ,Savings
15-08-2025 14:34,ANZ49E945043FBE445B8730,012-345-678,11111111,CITYLINK ANZ,3.94,0,454127.36,DR,REF231010,ANZ,Savings
15-08-2025 14:46,ANZD3668AAE862F4FA1A4D6,012-345-678,11111111,RAILWAY STATION ANZ,71.27,0,454056.09,DR,REF162627,ANZ,Savings
15-08-2025 15:45,ANZ70F4990F5ABD4932946E,012-345-678,11111111,BIGW ANZ,8.91,0,454047.18,DR,REF181380,ANZ,Savings
15-08-2025 15:50,ANZD3317A4066324BB8A91B,012-345-678,11111111,WAGES CREDIT ANZ,0,1049.15,455096.33,CR,REF569879,ANZ,Savings
15-08-2025 15:52,INT6C28A0365C8E44068745,012-345-678,11111111,TRANSFER TO NAB 44444444,394.31,0,454702.02,DR,INT-48558,ANZ,Savings
15-08-2025 15:54,ANZ980AA78CE237469AB978,012-345-678,11111111,FLIXBUS ANZ,20.09,0,454681.93,DR,REF137079,ANZ,Savings
15-08-2025 15:56,ANZAA88A2045F5D41D78AC0,012-345-678,11111111,INTERNET TRANSFER ANZ,33.33,0,454648.6,DR,REF413957,ANZ,Savings
15-08-2025 16:17,ANZAE70D9CF13D24F72872B,012-345-678,11111111,MENULOG ANZ,4.73,0,454643.87,DR,REF681638,ANZ,Savings
15-08-2025 16:43,ANZBB7AEDD5673148EA9266,012-345-678,11111111,KFC ANZ,28.92,0,454614.95,DR,REF704432,ANZ,Savings
15-08-2025 17:04,INT3C938F0C122C4349A9B4,012-345-678,11111111,TRANSFER FROM NAB 44444444,0,1937.77,456552.72,CR,INT-34004,ANZ,Savings
15-08-2025 18:10,ANZ1D8E54FDB70F476C9276,012-345-678,11111111,BIGW ANZ,101.92,0,456450.8,DR,REF843043,ANZ,Savings
15-08-2025 18:13,ANZ4BFE5E90A5424796A92F,012-345-678,11111111,BP ANZ,19.65,0,456431.15,DR,REF404985,ANZ,Savings
15-08-2025 19:07,ANZ8F4304BF08FD423499F1,012-345-678,11111111,KFC ANZ,9.52,0,456421.63,DR,REF913281,ANZ,Savings
15-08-2025 19:12,ANZB96684BD032B465A876D,012-345-678,11111111,PAYPAL *NETFLIX ANZ,66.43,0,456355.2,DR,REF569559,ANZ,Savings
15-08-2025 19:13,ANZ37774D8EB15E405B804B,012-345-678,11111111,BANK FEE ANZ,39.75,0,456315.45,DR,REF493886,ANZ,Savings
15-08-2025 19:16,ANZ70E374098F804EA68AC3,012-345-678,11111111,SALARY PAYMENT ANZ,0,5232.74,461548.19,CR,REF682602,ANZ,Savings
15-08-2025 19:45,ANZF277CFB67AA949798FC3,012-345-678,11111111,FLIXBUS ANZ,29.08,0,461519.11,DR,REF645393,ANZ,Savings
15-08-2025 20:00,ANZ75A3C64DB32C4D33AAC5,012-345-678,11111111,CITYLINK ANZ,4.7,0,461514.41,DR,REF832470,ANZ,Savings
15-08-2025 20:21,ANZC6B690F12210478E9217,012-345-678,11111111,DOMINO'S PIZZA ANZ,13.68,0,461500.73,DR,REF959109,ANZ,Savings
15-08-2025 20:27,INT6E728274497848C3A30B,012-345-678,11111111,TRANSFER FROM CBA 33333333,0,659.74,462160.47,CR,INT-96122,ANZ,Savings
15-08-2025 20:38,ANZ2BB20AFCA6BB4AB4A5F1,012-345-678,11111111,PAYROLL CREDIT ANZ,0,3957.82,466118.29,CR,REF303393,ANZ,Savings
15-08-2025 21:06,ANZDDCA2F77CC0C473E8A2A,012-345-678,11111111,ZOOM ANZ,13.9,0,466104.39,DR,REF919127,ANZ,Savings
15-08-2025 21:46,ANZ07D9CADF2440487C92B0,012-345-678,11111111,WAGES CREDIT ANZ,0,658.64,466763.03,CR,REF520159,ANZ,Savings
15-08-2025 21:49,ANZD674687ADEBA4E8D985A,012-345-678,11111111,STARBUCKS ANZ,150.29,0,466612.74,DR,REF904647,ANZ,Savings
15-08-2025 22:17,ANZ392BC57CB07C45799206,012-345-678,11111111,CITYLINK ANZ,19.27,0,466593.47,DR,REF714600,ANZ,Savings
15-08-2025 22:19,ANZD98FB258FFB94A639308,012-345-678,11111111,JB HI-FI ANZ,19.38,0,466574.09,DR,REF722942,ANZ,Savings
15-08-2025 22:57,ANZ9AFD38B68B814FA6A9BA,012-345-678,11111111,HARVEY NORMAN ANZ,188.06,0,466386.03,DR,REF139181,ANZ,Savings
15-08-2025 23:12,INT5FD9F4A73C9D4F66A820,012-345-678,11111111,TRANSFER FROM CBA 33333333,0,1458.43,467844.46,CR,INT-37354,ANZ,Savings
15-08-2025 23:23,ANZ241B0883A63C4C1CA06B,012-345-678,11111111,PAYPAL *NETFLIX ANZ,28.5,0,467815.96,DR,REF422221,ANZ,Savings
15-08-2025 23:50,ANZ51E6674E150842498927,012-345-678,11111111,MCDONALDS ANZ,9.55,0,467806.41,DR,REF148360,ANZ,Savings
16-08-2025 00:17,ANZ9B27E5851BB442B1809C,012-345-678,11111111,BANK FEE ANZ,42.22,0,467764.19,DR,REF495014,ANZ,Savings
16-08-2025 00:38,INT58FA13210DAD41AA8729,012-345-678,11111111,TRANSFER FROM CBA 22222222,0,1887.94,469652.13,CR,INT-13675,ANZ,Savings
16-08-2025 00:51,ANZFA1663F88DEA4F6ABD04,012-345-678,11111111,PAYPAL *NETFLIX ANZ,18.27,0,469633.86,DR,REF343653,ANZ,Savings
16-08-2025 01:28,ANZDD50DBE0B1BC43FAB8D0,012-345-678,11111111,BP ANZ,43.08,0,469590.78,DR,REF188586,ANZ,Savings
16-08-2025 01:47,ANZ785DA08A250F4BFCB261,012-345-678,11111111,SHELL ANZ,12.59,0,469578.19,DR,REF341099,ANZ,Savings
16-08-2025 02:26,ANZ0EE710B944F84BC2A8BF,012-345-678,11111111,ALDI ANZ,45.02,0,469533.17,DR,REF980568,ANZ,Savings
16-08-2025 02:27,ANZCEA0C3D541E544FF8457,012-345-678,11111111,ZOOM ANZ,41.27,0,469491.9,DR,REF698047,ANZ,Savings
16-08-2025 03:26,ANZ3E7E0768264D4A3892C8,012-345-678,11111111,CITYLINK ANZ,8.13,0,469483.77,DR,REF542610,ANZ,Savings
16-08-2025 03:30,ANZ2725C7014E654C8AB39F,012-345-678,11111111,PAY - SALARY ANZ,0,1147.23,470631,CR,REF200677,ANZ,Savings
16-08-2025 03:35,ANZD84E66106A2E4A75BE30,012-345-678,11111111,WAGES CREDIT ANZ,0,372.85,471003.85,CR,REF330494,ANZ,Savings
16-08-2025 04:11,ANZ0BBCCB791A2A4D91B895,012-345-678,11111111,MCDONALDS ANZ,33.27,0,470970.58,DR,REF878506,ANZ,Savings
16-08-2025 04:13,ANZ520291A18E324D36A97B,012-345-678,11111111,PAYPAL *NETFLIX ANZ,46.98,0,470923.6,DR,REF602309,ANZ,Savings
16-08-2025 04:33,ANZ60850ABF2BBC478E8A1D,012-345-678,11111111,WOOLWORTHS ANZ,112.42,0,470811.18,DR,REF734067,ANZ,Savings
16-08-2025 04:59,ANZF5D664136A6A4513A2D2,012-345-678,11111111,ZOOM ANZ,122.35,0,470688.83,DR,REF277013,ANZ,Savings
16-08-2025 05:49,ANZB7E40FB946BA4640A224,012-345-678,11111111,BWS ANZ,119.44,0,470569.39,DR,REF150956,ANZ,Savings
16-08-2025 06:35,INT009A453A38BF452EBC81,012-345-678,11111111,TRANSFER TO CBA 22222222,1812.31,0,468757.08,DR,INT-89865,ANZ,Savings
16-08-2025 06:54,ANZEF0436B184014074802B,012-345-678,11111111,MCDONALDS ANZ,51.61,0,468705.47,DR,REF173412,ANZ,Savings
16-08-2025 07:22,ANZ8F4F909480E5421B91C2,012-345-678,11111111,AMAZON AU ANZ,65.9,0,468639.57,DR,REF457918,ANZ,Savings
16-08-2025 07:28,ANZ03C557ABD7E947988AC3,012-345-678,11111111,BIGW ANZ,21.82,0,468617.75,DR,REF935009,ANZ,Savings
16-08-2025 07:28,ANZA0F3E7DCFBAD40649CAE,012-345-678,11111111,COLES ANZ,136.1,0,468481.65,DR,REF945888,ANZ,Savings
16-08-2025 07:34,ANZBA6185CB536B4CE99DE4,012-345-678,11111111,SALARY PAYMENT ANZ,0,3592.48,472074.13,CR,REF131404,ANZ,Savings
16-08-2025 07:40,ANZ3A6F352E794246EDBFAE,012-345-678,11111111,WOOLWORTHS ANZ,25.09,0,472049.04,DR,REF971605,ANZ,Savings
16-08-2025 07:55,ANZ4026724AF6A648738502,012-345-678,11111111,KFC ANZ,205.16,0,471843.88,DR,REF666114,ANZ,Savings
16-08-2025 08:28,ANZD9B1420D25FE43B28BC4,012-345-678,11111111,MENULOG ANZ,48.25,0,471795.63,DR,REF456373,ANZ,Savings
16-08-2025 10:11,ANZEC952DE13E70479EA898,012-345-678,11111111,PAYROLL CREDIT ANZ,0,4218.6,476014.23,CR,REF529904,ANZ,Savings
16-08-2025 11:04,ANZ79930E256E80431F9771,012-345-678,11111111,SPOTIFY ANZ,21.19,0,475993.04,DR,REF450753,ANZ,Savings
16-08-2025 11:11,ANZ67B6A6FA466F4FC59567,012-345-678,11111111,DOMINO'S PIZZA ANZ,13.08,0,475979.96,DR,REF758062,ANZ,Savings
16-08-2025 11:38,INT9991284807B4434E95DA,012-345-678,11111111,TRANSFER TO NAB 44444444,392.19,0,475587.77,DR,INT-22237,ANZ,Savings
16-08-2025 12:19,ANZF30C9E902D624F68881A,012-345-678,11111111,BIGW ANZ,15.18,0,475572.59,DR,REF468860,ANZ,Savings
16-08-2025 12:56,ANZB17CA69BC69440F4A283,012-345-678,11111111,AMAZON AU ANZ,2.98,0,475569.61,DR,REF594327,ANZ,Savings
16-08-2025 13:08,ANZ4E770629EED14CCCAA0E,012-345-678,11111111,BANK FEE ANZ,35.62,0,475533.99,DR,REF628057,ANZ,Savings
16-08-2025 13:24,ANZF322CB758C3B40A1972B,012-345-678,11111111,PAYMENT GATEWAY ANZ,14.6,0,475519.39,DR,REF362357,ANZ,Savings
16-08-2025 13:46,ANZ7DEE26C82239474381A8,012-345-678,11111111,JB HI-FI ANZ,3.44,0,475515.95,DR,REF458079,ANZ,Savings
16-08-2025 14:00,ANZCA6C9571A08747E3A240,012-345-678,11111111,STARBUCKS ANZ,17.07,0,475498.88,DR,REF463927,ANZ,Savings
16-08-2025 14:04,ANZ07CE072F439741359664,012-345-678,11111111,FLIXBUS ANZ,62.11,0,475436.77,DR,REF262190,ANZ,Savings
16-08-2025 15:00,ANZF4D6E36C9D544BCC9CC9,012-345-678,11111111,JB HI-FI ANZ,19.76,0,475417.01,DR,REF865004,ANZ,Savings
16-08-2025 15:03,ANZ48283E41D72C46CD92A1,012-345-678,11111111,PAY - SALARY ANZ,0,765.54,476182.55,CR,REF344898,ANZ,Savings
16-08-2025 15:16,ANZ3CE16A1F852640999D16,012-345-678,11111111,CITYLINK ANZ,8.7,0,476173.85,DR,REF428177,ANZ,Savings
16-08-2025 15:18,ANZDCD88AD3C9844150A396,012-345-678,11111111,BANK FEE ANZ,27.02,0,476146.83,DR,REF224252,ANZ,Savings
16-08-2025 15:35,ANZD413A66FEA94472C975A,012-345-678,11111111,SHELL ANZ,30.87,0,476115.96,DR,REF700874,ANZ,Savings
16-08-2025 15:38,ANZA64D01BB77E64C52A70E,012-345-678,11111111,PAYROLL CREDIT ANZ,0,971.82,477087.78,CR,REF991685,ANZ,Savings
16-08-2025 15:42,ANZDDAB4641DF6945BAA332,012-345-678,11111111,BP ANZ,12.16,0,477075.62,DR,REF110004,ANZ,Savings
16-08-2025 16:08,ANZC9BEA1DDE9EB48B7AECF,012-345-678,11111111,7-ELEVEN ANZ,99.25,0,476976.37,DR,REF560512,ANZ,Savings
16-08-2025 16:10,ANZF6236CDB5AF44134859D,012-345-678,11111111,BP ANZ,64.08,0,476912.29,DR,REF811738,ANZ,Savings
16-08-2025 16:18,ANZBB825D8ECE9748BE9F0E,012-345-678,11111111,SHELL ANZ,382.49,0,476529.8,DR,REF219434,ANZ,Savings
16-08-2025 16:20,ANZ40C8D3B71AD541A28C0F,012-345-678,11111111,CITYLINK ANZ,28.45,0,476501.35,DR,REF862915,ANZ,Savings
16-08-2025 16:32,ANZ02282819259147869142,012-345-678,11111111,WOOLWORTHS ANZ,7.18,0,476494.17,DR,REF433693,ANZ,Savings
16-08-2025 17:50,INT5AC1E9C6046440C78802,012-345-678,11111111,TRANSFER FROM NAB 44444444,0,799.72,477293.89,CR,INT-79990,ANZ,Savings
16-08-2025 18:09,ANZ66129020872F4A94BED5,012-345-678,11111111,WAGES CREDIT ANZ,0,1148.76,478442.65,CR,REF345121,ANZ,Savings
16-08-2025 18:13,ANZC843C88A5BD44792A8F6,012-345-678,11111111,ZOOM ANZ,69.82,0,478372.83,DR,REF656265,ANZ,Savings
16-08-2025 18:21,ANZ01C1EACFCF1B4B468D06,012-345-678,11111111,MENULOG ANZ,17.19,0,478355.64,DR,REF265819,ANZ,Savings
16-08-2025 18:22,ANZF4AEA1CC400C4E7488D3,012-345-678,11111111,MENULOG ANZ,56.77,0,478298.87,DR,REF745428,ANZ,Savings
16-08-2025 18:43,ANZB1DA5F47FD9640F0A2F2,012-345-678,11111111,WOOLWORTHS ANZ,281.38,0,478017.49,DR,REF836441,ANZ,Savings
16-08-2025 19:41,ANZA9D5396928794F86888E,012-345-678,11111111,SALARY PAYMENT ANZ,0,1678.51,479696,CR,REF539413,ANZ,Savings
16-08-2025 19:44,ANZFB1A28B0E5D84D28B6E4,012-345-678,11111111,LIQUORLAND ANZ,31.43,0,479664.57,DR,REF726442,ANZ,Savings
16-08-2025 19:49,ANZ7BD2713F912B4BFA90DC,012-345-678,11111111,PAYMENT GATEWAY ANZ,9.78,0,479654.79,DR,REF182556,ANZ,Savings
16-08-2025 19:55,ANZ080758D6961E474A8373,012-345-678,11111111,STARBUCKS ANZ,56.38,0,479598.41,DR,REF405097,ANZ,Savings
16-08-2025 20:33,ANZ274E828760604B9AB487,012-345-678,11111111,JB HI-FI ANZ,38.7,0,479559.71,DR,REF290330,ANZ,Savings
16-08-2025 20:38,ANZD480C36B27234D6C9680,012-345-678,11111111,BANK FEE ANZ,228.75,0,479330.96,DR,REF488972,ANZ,Savings
16-08-2025 20:54,ANZEC75055378F14A71ACA8,012-345-678,11111111,SALARY PAYMENT ANZ,0,3744.45,483075.41,CR,REF860480,ANZ,Savings
16-08-2025 21:07,ANZFDE7B9BF26DD453584BB,012-345-678,11111111,TAFE BOOKSHOP ANZ,146.04,0,482929.37,DR,REF530114,ANZ,Savings
16-08-2025 21:16,ANZB2985C7A9BD948F095CF,012-345-678,11111111,SPOTIFY ANZ,23.06,0,482906.31,DR,REF809219,ANZ,Savings
16-08-2025 21:19,ANZ4E44795ECD2740FA802F,012-345-678,11111111,TAFE BOOKSHOP ANZ,65.68,0,482840.63,DR,REF671512,ANZ,Savings
16-08-2025 22:08,ANZ7ECB9F95E885468ABEFD,012-345-678,11111111,SHELL ANZ,139.04,0,482701.59,DR,REF266706,ANZ,Savings
16-08-2025 22:49,ANZFE9B26733DA0487E9EDF,012-345-678,11111111,BWS ANZ,9.93,0,482691.66,DR,REF489717,ANZ,Savings
16-08-2025 22:52,ANZ0CA4E17882804A9CB686,012-345-678,11111111,FLIXBUS ANZ,98.38,0,482593.28,DR,REF375497,ANZ,Savings
16-08-2025 23:24,ANZ8FD436F24B464FF3AEB3,012-345-678,11111111,MENULOG ANZ,129.71,0,482463.57,DR,REF692591,ANZ,Savings
16-08-2025 23:38,ANZAC139E25018045EBB488,012-345-678,11111111,MENULOG ANZ,12.52,0,482451.05,DR,REF329460,ANZ,Savings
17-08-2025 00:14,INTEA21CCDED07E4319BF39,012-345-678,11111111,TRANSFER FROM NAB 44444444,0,933.91,483384.96,CR,INT-47660,ANZ,Savings
17-08-2025 01:19,ANZD92B38A927F14228A3EF,012-345-678,11111111,LIQUORLAND ANZ,75.27,0,483309.69,DR,REF926080,ANZ,Savings
17-08-2025 01:32,ANZ099CCA7C13DB4DEDA248,012-345-678,11111111,UBER EATS ANZ,142.66,0,483167.03,DR,REF148155,ANZ,Savings
17-08-2025 01:35,ANZ536BA7528C8B4ED396F2,012-345-678,11111111,PAY - SALARY ANZ,0,6506.76,489673.79,CR,REF325079,ANZ,Savings
17-08-2025 01:49,ANZB6405BFDE8F24C26A689,012-345-678,11111111,INTERNET TRANSFER ANZ,1.25,0,489672.54,DR,REF336466,ANZ,Savings
17-08-2025 02:17,ANZ0D50D0F0F46042F78734,012-345-678,11111111,PAYMENT GATEWAY ANZ,5.3,0,489667.24,DR,REF194327,ANZ,Savings
17-08-2025 02:24,ANZ5AB9A4A1664D4B5CB565,012-345-678,11111111,SHELL ANZ,40.7,0,489626.54,DR,REF197332,ANZ,Savings
17-08-2025 02:29,ANZ7DF463E4B0F8433B8313,012-345-678,11111111,SHELL ANZ,45.97,0,489580.57,DR,REF123259,ANZ,Savings
17-08-2025 02:38,ANZ1EF176923D5C4354B46D,012-345-678,11111111,PAY - SALARY ANZ,0,5139.87,494720.44,CR,REF469756,ANZ,Savings
17-08-2025 03:15,ANZ4BB174BD585B40318789,012-345-678,11111111,MENULOG ANZ,38.4,0,494682.04,DR,REF186405,ANZ,Savings
17-08-2025 03:41,ANZD1F92A21384049B98D81,012-345-678,11111111,INTERNET TRANSFER ANZ,92.06,0,494589.98,DR,REF136269,ANZ,Savings
17-08-2025 04:19,ANZBCB1D19605A240718FB0,012-345-678,11111111,STARBUCKS ANZ,7.77,0,494582.21,DR,REF490923,ANZ,Savings
17-08-2025 04:24,ANZAFDD30EE73F94B33B1E0,012-345-678,11111111,KFC ANZ,10.04,0,494572.17,DR,REF683323,ANZ,Savings
17-08-2025 04:35,ANZE45AB1C2F85E4A7284A1,012-345-678,11111111,HARVEY NORMAN ANZ,28.95,0,494543.22,DR,REF766927,ANZ,Savings
17-08-2025 05:21,ANZF9ACFAFCFAF746FBB533,012-345-678,11111111,STARBUCKS ANZ,81.94,0,494461.28,DR,REF205096,ANZ,Savings
17-08-2025 06:13,ANZ79CC0AC2F6084DC9ABE0,012-345-678,11111111,PAY - SALARY ANZ,0,5187.81,499649.09,CR,REF855351,ANZ,Savings
17-08-2025 06:49,ANZ574C4694A84C43219173,012-345-678,11111111,BP ANZ,88.31,0,499560.78,DR,REF487651,ANZ,Savings
17-08-2025 06:58,ANZB9334E0846524F3CA262,012-345-678,11111111,SPOTIFY ANZ,54.58,0,499506.2,DR,REF354269,ANZ,Savings
17-08-2025 07:02,ANZDDD3D4B1DE7C47738AFF,012-345-678,11111111,MCDONALDS ANZ,13.27,0,499492.93,DR,REF926746,ANZ,Savings
17-08-2025 07:34,ANZ7480634105C9425B8588,012-345-678,11111111,LIQUORLAND ANZ,3.5,0,499489.43,DR,REF191058,ANZ,Savings
17-08-2025 08:21,ANZF21F5A3DF8B448B98213,012-345-678,11111111,BWS ANZ,70.91,0,499418.52,DR,REF515801,ANZ,Savings
17-08-2025 08:27,ANZA7182887D02140DB8C25,012-345-678,11111111,WOOLWORTHS ANZ,158.09,0,499260.43,DR,REF586091,ANZ,Savings
17-08-2025 08:27,ANZ7A363F566272413CA972,012-345-678,11111111,MCDONALDS ANZ,8.2,0,499252.23,DR,REF319571,ANZ,Savings
17-08-2025 08:36,ANZ05B9C5CC351E44088490,012-345-678,11111111,MCDONALDS ANZ,21.17,0,499231.06,DR,REF417194,ANZ,Savings
17-08-2025 09:14,ANZ5CAF5DF35BA740FABB52,012-345-678,11111111,DOMINO'S PIZZA ANZ,141.81,0,499089.25,DR,REF789677,ANZ,Savings
17-08-2025 09:54,ANZ570B2E0F48C540BDA6CD,012-345-678,11111111,CITYLINK ANZ,13.42,0,499075.83,DR,REF933595,ANZ,Savings
17-08-2025 10:06,ANZ0A21B7372B094CBF9877,012-345-678,11111111,PAYROLL CREDIT ANZ,0,7870.05,506945.88,CR,REF275727,ANZ,Savings
17-08-2025 10:30,ANZ55CE808072524C458429,012-345-678,11111111,PAYROLL CREDIT ANZ,0,1532.12,508478,CR,REF500786,ANZ,Savings
17-08-2025 10:42,ANZB014A5877FF54B2F82C7,012-345-678,11111111,BP ANZ,224.46,0,508253.54,DR,REF642902,ANZ,Savings
17-08-2025 11:25,ANZ195D9A3670B448B69248,012-345-678,11111111,WOOLWORTHS ANZ,14.51,0,508239.03,DR,REF864684,ANZ,Savings
17-08-2025 11:48,ANZ5A113AAB8AE3404ABBE5,012-345-678,11111111,SHELL ANZ,177.55,0,508061.48,DR,REF222131,ANZ,Savings
17-08-2025 11:50,ANZ737B8D02F1634BF8891A,012-345-678,11111111,ALDI ANZ,133.19,0,507928.29,DR,REF906341,ANZ,Savings
17-08-2025 11:51,ANZ086D17A271EF4F538BB7,012-345-678,11111111,DOMINO'S PIZZA ANZ,21.86,0,507906.43,DR,REF735150,ANZ,Savings
17-08-2025 12:36,ANZ7A792B12E2614F49A3E8,012-345-678,11111111,TAFE BOOKSHOP ANZ,15.01,0,507891.42,DR,REF306990,ANZ,Savings
17-08-2025 12:49,ANZ04DBDD777EA5408E84FB,012-345-678,11111111,MCDONALDS ANZ,39.69,0,507851.73,DR,REF657804,ANZ,Savings
17-08-2025 13:46,ANZ9D4DE98D24B64EE288FB,012-345-678,11111111,DOMINO'S PIZZA ANZ,126.15,0,507725.58,DR,REF967315,ANZ,Savings
17-08-2025 13:46,ANZ68D65488761C43D1ACF0,012-345-678,11111111,FLIXBUS ANZ,68.13,0,507657.45,DR,REF339676,ANZ,Savings
17-08-2025 13:57,ANZA3BD4F04A5B4470AA222,012-345-678,11111111,ZOOM ANZ,14.21,0,507643.24,DR,REF395452,ANZ,Savings
17-08-2025 14:26,ANZ0F62E384377946EF9B34,012-345-678,11111111,TAFE BOOKSHOP ANZ,66.49,0,507576.75,DR,REF357898,ANZ,Savings
17-08-2025 14:29,ANZB745EACF00AD4C889241,012-345-678,11111111,SALARY PAYMENT ANZ,0,608.63,508185.38,CR,REF894941,ANZ,Savings
17-08-2025 14:35,ANZ01AD1BCF96D14739A1F2,012-345-678,11111111,SHELL ANZ,29.43,0,508155.95,DR,REF629780,ANZ,Savings
17-08-2025 14:38,ANZ25002952F1B049059D00,012-345-678,11111111,PAYROLL CREDIT ANZ,0,4956.33,513112.28,CR,REF662478,ANZ,Savings
17-08-2025 15:15,ANZ0AE19A73499D455CB49E,012-345-678,11111111,PAYPAL *NETFLIX ANZ,65.37,0,513046.91,DR,REF635378,ANZ,Savings
17-08-2025 15:19,ANZD210041A4B844B498F8E,012-345-678,11111111,UBER EATS ANZ,91.91,0,512955,DR,REF913576,ANZ,Savings
17-08-2025 15:23,ANZ1B15A3EA253E4C139388,012-345-678,11111111,CITYLINK ANZ,65.5,0,512889.5,DR,REF865505,ANZ,Savings
17-08-2025 15:40,ANZ6F24E38E886B47DCAC67,012-345-678,11111111,JB HI-FI ANZ,89.25,0,512800.25,DR,REF484659,ANZ,Savings
17-08-2025 15:47,ANZEA6C342D7E9442F3A765,012-345-678,11111111,DOMINO'S PIZZA ANZ,49.65,0,512750.6,DR,REF935875,ANZ,Savings
17-08-2025 17:07,ANZ0A64FEF3F617454DA577,012-345-678,11111111,CITYLINK ANZ,103.95,0,512646.65,DR,REF937979,ANZ,Savings
17-08-2025 17:19,ANZ4223ADA62872437F9C8D,012-345-678,11111111,RAILWAY STATION ANZ,38.48,0,512608.17,DR,REF247446,ANZ,Savings
17-08-2025 17:35,ANZ1E0E3ACE83D14331B4F7,012-345-678,11111111,COLES ANZ,10.96,0,512597.21,DR,REF155035,ANZ,Savings
17-08-2025 17:40,ANZ5BC4F788E4354829A620,012-345-678,11111111,JB HI-FI ANZ,64.32,0,512532.89,DR,REF557769,ANZ,Savings
17-08-2025 18:06,INT00796ADAF40F4ABE9069,012-345-678,11111111,TRANSFER FROM CBA 22222222,0,1107.23,513640.12,CR,INT-25088,ANZ,Savings
17-08-2025 18:26,ANZD774E93303DA48A9A118,012-345-678,11111111,STARBUCKS ANZ,4.56,0,513635.56,DR,REF139781,ANZ,Savings
17-08-2025 18:29,ANZB4DBA6350BE84FDC97D3,012-345-678,11111111,RAILWAY STATION ANZ,120.76,0,513514.8,DR,REF992783,ANZ,Savings
17-08-2025 18:36,ANZEB69E11D1C3E4855B6C6,012-345-678,11111111,MCDONALDS ANZ,94.8,0,513420,DR,REF941508,ANZ,Savings
17-08-2025 19:02,ANZ7DC4B125BECC4CA58C60,012-345-678,11111111,WAGES CREDIT ANZ,0,906.83,514326.83,CR,REF597025,ANZ,Savings
17-08-2025 19:31,ANZA9CFF79ACD14464E878B,012-345-678,11111111,INTERNET TRANSFER ANZ,90.79,0,514236.04,DR,REF799208,ANZ,Savings
17-08-2025 19:44,ANZ36DE119D8B6147DB8A5C,012-345-678,11111111,STARBUCKS ANZ,23.36,0,514212.68,DR,REF824982,ANZ,Savings
17-08-2025 19:47,ANZ14D93C092898484BA403,012-345-678,11111111,FLIXBUS ANZ,4,0,514208.68,DR,REF162597,ANZ,Savings
17-08-2025 19:52,ANZ0A3A82CABCC64F39B743,012-345-678,11111111,ALDI ANZ,36.17,0,514172.51,DR,REF488683,ANZ,Savings
17-08-2025 20:25,ANZ26646C09A85149319CD4,012-345-678,11111111,DOMINO'S PIZZA ANZ,62.54,0,514109.97,DR,REF210044,ANZ,Savings
17-08-2025 21:08,ANZDA0CF0E9656A4F32B9D6,012-345-678,11111111,SPOTIFY ANZ,101.54,0,514008.43,DR,REF993949,ANZ,Savings
17-08-2025 21:38,ANZ37ED96498765401C971E,012-345-678,11111111,PAYMENT GATEWAY ANZ,32.45,0,513975.98,DR,REF528689,ANZ,Savings
17-08-2025 21:54,ANZ44B651CA1EA3456E9E17,012-345-678,11111111,JB HI-FI ANZ,65.2,0,513910.78,DR,REF829355,ANZ,Savings
17-08-2025 21:55,ANZ27021E4D118C4951AC5F,012-345-678,11111111,BIGW ANZ,78.38,0,513832.4,DR,REF953694,ANZ,Savings
17-08-2025 22:23,ANZEA3C8DC09D5946A3BD9F,012-345-678,11111111,KFC ANZ,12.68,0,513819.72,DR,REF315000,ANZ,Savings
17-08-2025 22:37,ANZ11B53ED490F94D89A51C,012-345-678,11111111,DOMINO'S PIZZA ANZ,17.04,0,513802.68,DR,REF869987,ANZ,Savings
17-08-2025 23:00,ANZ6B5D567DAA8647FE886F,012-345-678,11111111,BANK FEE ANZ,234.61,0,513568.07,DR,REF838133,ANZ,Savings
17-08-2025 23:02,ANZ1805CFF2AC0A430EBE64,012-345-678,11111111,UBER EATS ANZ,24.03,0,513544.04,DR,REF898421,ANZ,Savings
17-08-2025 23:34,ANZ16189B1E44054AD9A4E4,012-345-678,11111111,PAYROLL CREDIT ANZ,0,5323.98,518868.02,CR,REF931063,ANZ,Savings
17-08-2025 23:47,ANZAD771881820C4C61B1BF,012-345-678,11111111,7-ELEVEN ANZ,64.71,0,518803.31,DR,REF553252,ANZ,Savings
18-08-2025 00:06,ANZC93800C2D28843DAAFCB,012-345-678,11111111,FLIXBUS ANZ,66.8,0,518736.51,DR,REF230527,ANZ,Savings
18-08-2025 00:37,ANZAB9440A8E5BC42D5904D,012-345-678,11111111,PAYROLL CREDIT ANZ,0,7766.04,526502.55,CR,REF552624,ANZ,Savings
18-08-2025 00:38,ANZD1E524AAF8484B9DA49A,012-345-678,11111111,APPLE ANZ,79.2,0,526423.35,DR,REF660833,ANZ,Savings
18-08-2025 00:40,ANZ2689D8339C2F49179631,012-345-678,11111111,COLES ANZ,45.41,0,526377.94,DR,REF396208,ANZ,Savings
18-08-2025 00:46,ANZ1B79F64504A648358AF6,012-345-678,11111111,STARBUCKS ANZ,63.82,0,526314.12,DR,REF397313,ANZ,Savings
18-08-2025 01:05,ANZ83B09D17DEA747D3A71C,012-345-678,11111111,SPOTIFY ANZ,99.08,0,526215.04,DR,REF636275,ANZ,Savings
18-08-2025 02:53,ANZE92D07FFD2824C258F85,012-345-678,11111111,HARVEY NORMAN ANZ,126.3,0,526088.74,DR,REF427019,ANZ,Savings
18-08-2025 03:04,INTB5A43526D4D541E0BA36,012-345-678,11111111,TRANSFER TO NAB 44444444,329.77,0,525758.97,DR,INT-19055,ANZ,Savings
18-08-2025 03:14,ANZ8ED0CF947DBC47CCBC35,012-345-678,11111111,BIGW ANZ,15.51,0,525743.46,DR,REF653007,ANZ,Savings
18-08-2025 03:18,ANZE0055F43176D419C88BE,012-345-678,11111111,PAYROLL CREDIT ANZ,0,1044.94,526788.4,CR,REF746152,ANZ,Savings
18-08-2025 03:21,ANZ633C0B1E1EC547F0B16A,012-345-678,11111111,HARVEY NORMAN ANZ,35.04,0,526753.36,DR,REF505094,ANZ,Savings
18-08-2025 03:29,ANZ2154523A32DC494AB532,012-345-678,11111111,UBER EATS ANZ,14.53,0,526738.83,DR,REF163253,ANZ,Savings
18-08-2025 04:21,ANZB86D7D0D247244E7B91E,012-345-678,11111111,RAILWAY STATION ANZ,19.83,0,526719,DR,REF499847,ANZ,Savings
18-08-2025 04:35,ANZ860A0326A3B646F6AEB5,012-345-678,11111111,ALDI ANZ,41.58,0,526677.42,DR,REF383060,ANZ,Savings
18-08-2025 04:43,ANZD210689728B64CF689A2,012-345-678,11111111,KFC ANZ,30.6,0,526646.82,DR,REF257558,ANZ,Savings
18-08-2025 04:49,ANZ561600C16C854523B2F6,012-345-678,11111111,TAFE BOOKSHOP ANZ,12.66,0,526634.16,DR,REF465455,ANZ,Savings
18-08-2025 05:03,ANZCDA3316085C1493B81A7,012-345-678,11111111,UBER EATS ANZ,3.18,0,526630.98,DR,REF858348,ANZ,Savings
18-08-2025 05:06,ANZAE9DC8338C8C480C88E2,012-345-678,11111111,PAYMENT GATEWAY ANZ,15.48,0,526615.5,DR,REF706631,ANZ,Savings
18-08-2025 05:15,ANZ2FB8D5848E9E47E88344,012-345-678,11111111,BANK FEE ANZ,22.21,0,526593.29,DR,REF352405,ANZ,Savings
18-08-2025 05:20,ANZB759EA96A2A34E98AA3A,012-345-678,11111111,WOOLWORTHS ANZ,137.88,0,526455.41,DR,REF915248,ANZ,Savings
18-08-2025 05:27,ANZB5DEF9ED23784802916B,012-345-678,11111111,CITYLINK ANZ,151.35,0,526304.06,DR,REF834206,ANZ,Savings
18-08-2025 05:30,ANZ2E2B13AEF33F458CB3E3,012-345-678,11111111,AMAZON AU ANZ,17.54,0,526286.52,DR,REF195416,ANZ,Savings
18-08-2025 05:32,INT5C0A771CDEDC49F09E15,012-345-678,11111111,TRANSFER TO CBA 22222222,1712.82,0,524573.7,DR,INT-17116,ANZ,Savings
18-08-2025 06:00,ANZ0369A49A5DFC46E29142,012-345-678,11111111,MCDONALDS ANZ,4.84,0,524568.86,DR,REF447965,ANZ,Savings
18-08-2025 06:23,ANZC7F6AED818A6468A9A94,012-345-678,11111111,ZOOM ANZ,18.29,0,524550.57,DR,REF887383,ANZ,Savings
18-08-2025 06:28,ANZ2139DF45A77B489792DD,012-345-678,11111111,SALARY PAYMENT ANZ,0,7708.88,532259.45,CR,REF478485,ANZ,Savings
18-08-2025 06:42,ANZ96D6EB6A80374AFDB777,012-345-678,11111111,BWS ANZ,12.07,0,532247.38,DR,REF601281,ANZ,Savings
18-08-2025 07:31,ANZ2DB207DBC00742A2B2B0,012-345-678,11111111,SALARY PAYMENT ANZ,0,3739.14,535986.52,CR,REF353494,ANZ,Savings
18-08-2025 08:12,ANZ3459F41C7C834D6D9A0C,012-345-678,11111111,MCDONALDS ANZ,18.54,0,535967.98,DR,REF453527,ANZ,Savings
18-08-2025 08:24,ANZ2D826B84D9F047BB9FFE,012-345-678,11111111,MENULOG ANZ,80.84,0,535887.14,DR,REF453028,ANZ,Savings
18-08-2025 08:27,ANZAE1485D0F5554B23A207,012-345-678,11111111,PAYMENT GATEWAY ANZ,16.65,0,535870.49,DR,REF404708,ANZ,Savings
18-08-2025 09:49,ANZ5D9730A619CF4ED19A3C,012-345-678,11111111,BIGW ANZ,58.86,0,535811.63,DR,REF721351,ANZ,Savings
18-08-2025 11:12,INTF7B2B54673834252821B,012-345-678,11111111,TRANSFER TO CBA 33333333,997.48,0,534814.15,DR,INT-25872,ANZ,Savings
18-08-2025 11:26,ANZ8DEA753826CB4B9CA841,012-345-678,11111111,BANK FEE ANZ,4.52,0,534809.63,DR,REF830400,ANZ,Savings
18-08-2025 11:48,ANZ12FBB97FFB9E402C90F4,012-345-678,11111111,RAILWAY STATION ANZ,40.06,0,534769.57,DR,REF638745,ANZ,Savings
18-08-2025 12:24,ANZ7119C2C33E5A4C6483C1,012-345-678,11111111,RAILWAY STATION ANZ,7.78,0,534761.79,DR,REF307808,ANZ,Savings
18-08-2025 12:24,ANZ66F780CB57FD4B13B8F7,012-345-678,11111111,PAYPAL *NETFLIX ANZ,114.45,0,534647.34,DR,REF615089,ANZ,Savings
18-08-2025 12:45,ANZE94D92F3FFB34BADA416,012-345-678,11111111,APPLE ANZ,23.28,0,534624.06,DR,REF725377,ANZ,Savings
18-08-2025 12:58,ANZCAAD102C719141919ED9,012-345-678,11111111,DOMINO'S PIZZA ANZ,18.59,0,534605.47,DR,REF315825,ANZ,Savings
18-08-2025 13:29,ANZ9BC51632D2F74DC08D3A,012-345-678,11111111,KFC ANZ,26.76,0,534578.71,DR,REF605045,ANZ,Savings
18-08-2025 13:41,ANZE36AB29BC95C4C9F942B,012-345-678,11111111,MCDONALDS ANZ,185.22,0,534393.49,DR,REF783328,ANZ,Savings
18-08-2025 13:50,ANZE7819E995C4A410DBE22,012-345-678,11111111,WOOLWORTHS ANZ,49.13,0,534344.36,DR,REF586216,ANZ,Savings
18-08-2025 14:23,ANZ0BC091241B554084B2FC,012-345-678,11111111,ZOOM ANZ,42.15,0,534302.21,DR,REF281834,ANZ,Savings
18-08-2025 14:30,ANZA8C3EBFAB598471EB015,012-345-678,11111111,MENULOG ANZ,37.18,0,534265.03,DR,REF475475,ANZ,Savings
18-08-2025 14:37,ANZ2C192DF11F374594B07B,012-345-678,11111111,7-ELEVEN ANZ,9.63,0,534255.4,DR,REF946451,ANZ,Savings
18-08-2025 14:41,INTEA485475154449C5AE74,012-345-678,11111111,TRANSFER TO CBA 33333333,116.9,0,534138.5,DR,INT-32326,ANZ,Savings
18-08-2025 14:51,ANZD7B9B23A984C4397BCDE,012-345-678,11111111,COLES ANZ,57.22,0,534081.28,DR,REF190858,ANZ,Savings
18-08-2025 15:14,ANZ263569A62B0C4A3385CB,012-345-678,11111111,STARBUCKS ANZ,13.51,0,534067.77,DR,REF746763,ANZ,Savings
18-08-2025 15:16,ANZ23E5CC5DAA744564BCF7,012-345-678,11111111,JB HI-FI ANZ,81.76,0,533986.01,DR,REF130855,ANZ,Savings
18-08-2025 15:22,ANZB33D9BDAD6DF4C85A9D3,012-345-678,11111111,7-ELEVEN ANZ,4.44,0,533981.57,DR,REF221106,ANZ,Savings
18-08-2025 16:10,ANZ7BBD638FCC91489EA740,012-345-678,11111111,INTERNET TRANSFER ANZ,15.28,0,533966.29,DR,REF720164,ANZ,Savings
18-08-2025 16:18,ANZ0C5530F127CC457DAC28,012-345-678,11111111,PAYMENT GATEWAY ANZ,56.61,0,533909.68,DR,REF805840,ANZ,Savings
18-08-2025 16:25,ANZC39089CF73BF40E28E00,012-345-678,11111111,CITYLINK ANZ,17.27,0,533892.41,DR,REF823288,ANZ,Savings
18-08-2025 17:18,ANZ0E74867BDA5E49E9A3A9,012-345-678,11111111,CITYLINK ANZ,33.48,0,533858.93,DR,REF180191,ANZ,Savings
18-08-2025 17:33,ANZ3F64E9BFBA244B06BE93,012-345-678,11111111,FLIXBUS ANZ,72.64,0,533786.29,DR,REF752025,ANZ,Savings
18-08-2025 17:42,ANZ26A81A048A30479CA259,012-345-678,11111111,DOMINO'S PIZZA ANZ,64.53,0,533721.76,DR,REF124983,ANZ,Savings
18-08-2025 18:12,ANZ8BBE5A26855B44D2993C,012-345-678,11111111,SHELL ANZ,12.01,0,533709.75,DR,REF925631,ANZ,Savings
18-08-2025 18:15,ANZ493517792FA24EA1999D,012-345-678,11111111,TAFE BOOKSHOP ANZ,99.2,0,533610.55,DR,REF478760,ANZ,Savings
18-08-2025 18:15,ANZ663E0E9CCABB4BBD8A13,012-345-678,11111111,COMPANY PAYROLL ANZ,0,2321.11,535931.66,CR,REF801489,ANZ,Savings
18-08-2025 18:15,ANZ18BC86BF773D4C3B9C12,012-345-678,11111111,APPLE ANZ,219.89,0,535711.77,DR,REF970416,ANZ,Savings
18-08-2025 18:39,ANZFF421E17FFE9415C8120,012-345-678,11111111,PAYMENT GATEWAY ANZ,78.5,0,535633.27,DR,REF173516,ANZ,Savings
18-08-2025 18:40,ANZ1303226ECB0D4A5E9CCB,012-345-678,11111111,BANK FEE ANZ,20.84,0,535612.43,DR,REF756993,ANZ,Savings
18-08-2025 18:51,ANZ1E2EB417CFAE47B0BF8E,012-345-678,11111111,COMPANY PAYROLL ANZ,0,2805.84,538418.27,CR,REF940562,ANZ,Savings
18-08-2025 19:22,ANZA8518F11840E4AAFA6C9,012-345-678,11111111,MENULOG ANZ,12.4,0,538405.87,DR,REF761740,ANZ,Savings
18-08-2025 20:05,ANZ7A09B9083A7E42B0846B,012-345-678,11111111,HARVEY NORMAN ANZ,19.15,0,538386.72,DR,REF492676,ANZ,Savings
18-08-2025 20:56,ANZC6D6671097AD4E118B7C,012-345-678,11111111,ALDI ANZ,26.39,0,538360.33,DR,REF720187,ANZ,Savings
18-08-2025 21:02,ANZCE62BA1FDDDA4E7E96A0,012-345-678,11111111,ALDI ANZ,58.5,0,538301.83,DR,REF118182,ANZ,Savings
18-08-2025 21:37,ANZ9CF08D1A13F0455E8307,012-345-678,11111111,LIQUORLAND ANZ,35.85,0,538265.98,DR,REF116862,ANZ,Savings
18-08-2025 22:22,ANZ6756CEA1042645C398C1,012-345-678,11111111,SALARY PAYMENT ANZ,0,6710.66,544976.64,CR,REF473656,ANZ,Savings
18-08-2025 22:23,INT9D366F28BE3041E99721,012-345-678,11111111,TRANSFER FROM CBA 22222222,0,881.08,545857.72,CR,INT-25157,ANZ,Savings
18-08-2025 22:39,ANZE42E31B607C34956BFA7,012-345-678,11111111,UBER EATS ANZ,100.97,0,545756.75,DR,REF914041,ANZ,Savings
18-08-2025 23:07,ANZ12516CFE19E7453AB3FD,012-345-678,11111111,HARVEY NORMAN ANZ,67.37,0,545689.38,DR,REF801782,ANZ,Savings
18-08-2025 23:21,ANZ30D732302E584A5C9397,012-345-678,11111111,BANK FEE ANZ,183.19,0,545506.19,DR,REF605367,ANZ,Savings
18-08-2025 23:26,ANZ208BC6D530C749C0BCC0,012-345-678,11111111,INTERNET TRANSFER ANZ,45.24,0,545460.95,DR,REF452025,ANZ,Savings
18-08-2025 23:52,ANZ89A984956BC348B5B8B0,012-345-678,11111111,BWS ANZ,156.07,0,545304.88,DR,REF647840,ANZ,Savings
18-08-2025 23:59,ANZD64AD242BE4740DE80CD,012-345-678,11111111,ALDI ANZ,5.49,0,545299.39,DR,REF820182,ANZ,Savings
19-08-2025 00:19,ANZC9E9393CACD14D2B8DCA,012-345-678,11111111,APPLE ANZ,81.43,0,545217.96,DR,REF687682,ANZ,Savings
19-08-2025 01:01,ANZ5A7143A1F8A7451FB0FC,012-345-678,11111111,BIGW ANZ,26.17,0,545191.79,DR,REF941929,ANZ,Savings
19-08-2025 01:15,ANZCDAA89DDCDED4B5FB4B8,012-345-678,11111111,BP ANZ,109.81,0,545081.98,DR,REF666252,ANZ,Savings
19-08-2025 02:43,ANZBA8171E88B0C434FAB92,012-345-678,11111111,PAYMENT GATEWAY ANZ,12.71,0,545069.27,DR,REF493631,ANZ,Savings
19-08-2025 02:52,ANZDA0B7C2B5D914C91BEA2,012-345-678,11111111,MCDONALDS ANZ,18.58,0,545050.69,DR,REF148424,ANZ,Savings
19-08-2025 04:06,ANZ5177FF80DE7A4A249D9A,012-345-678,11111111,TAFE BOOKSHOP ANZ,15.1,0,545035.59,DR,REF751850,ANZ,Savings
19-08-2025 04:37,ANZC5EDB9090CB840C0A298,012-345-678,11111111,TAFE BOOKSHOP ANZ,9.28,0,545026.31,DR,REF928454,ANZ,Savings
19-08-2025 04:58,ANZD6C92BDEDB8A4DACA718,012-345-678,11111111,TAFE BOOKSHOP ANZ,25.34,0,545000.97,DR,REF414129,ANZ,Savings
19-08-2025 05:17,ANZE58AF890FCF549A19110,012-345-678,11111111,ALDI ANZ,16.28,0,544984.69,DR,REF242674,ANZ,Savings
19-08-2025 05:25,ANZF3F5F54DD3EA4C968409,012-345-678,11111111,INTERNET TRANSFER ANZ,17.08,0,544967.61,DR,REF408877,ANZ,Savings
19-08-2025 06:07,ANZ5951129E5AAC4C5FA637,012-345-678,11111111,MENULOG ANZ,39.34,0,544928.27,DR,REF736547,ANZ,Savings
19-08-2025 06:10,ANZF1B11FA513C240E8940C,012-345-678,11111111,PAYMENT GATEWAY ANZ,97.05,0,544831.22,DR,REF153894,ANZ,Savings
19-08-2025 06:10,ANZ4ECE547C5E054FEA82DC,012-345-678,11111111,BWS ANZ,46.94,0,544784.28,DR,REF192249,ANZ,Savings
19-08-2025 06:16,ANZ4A4D9451A8CC44F990E6,012-345-678,11111111,RAILWAY STATION ANZ,63.56,0,544720.72,DR,REF213555,ANZ,Savings
19-08-2025 06:36,INT22BD45F9CCF64DD9AAE0,012-345-678,11111111,TRANSFER FROM CBA 22222222,0,276.64,544997.36,CR,INT-57610,ANZ,Savings
19-08-2025 06:46,ANZ125070684D7F42D09DEC,012-345-678,11111111,JB HI-FI ANZ,60.86,0,544936.5,DR,REF961716,ANZ,Savings
19-08-2025 06:47,ANZ2100B4727BF444638725,012-345-678,11111111,DOMINO'S PIZZA ANZ,46.44,0,544890.06,DR,REF457875,ANZ,Savings
19-08-2025 06:51,ANZ3B12151CB89B45CBAF3C,012-345-678,11111111,SALARY PAYMENT ANZ,0,3633.13,548523.19,CR,REF284738,ANZ,Savings
19-08-2025 07:41,ANZ82F4572117EA438D8601,012-345-678,11111111,PAYROLL CREDIT ANZ,0,2048.5,550571.69,CR,REF618630,ANZ,Savings
19-08-2025 07:48,ANZ26F00E197A0441FABF13,012-345-678,11111111,BP ANZ,49.55,0,550522.14,DR,REF641795,ANZ,Savings
19-08-2025 07:57,ANZ621124FB5F844EB99057,012-345-678,11111111,APPLE ANZ,4.01,0,550518.13,DR,REF356559,ANZ,Savings
19-08-2025 07:59,ANZB6AC56EC5AF14508AC56,012-345-678,11111111,MCDONALDS ANZ,25.07,0,550493.06,DR,REF591363,ANZ,Savings
19-08-2025 08:13,ANZ446ABF3E4E994E889174,012-345-678,11111111,BP ANZ,129.31,0,550363.75,DR,REF203149,ANZ,Savings
19-08-2025 08:39,ANZ5B4ABC119F2F4FB6872E,012-345-678,11111111,APPLE ANZ,39.95,0,550323.8,DR,REF326301,ANZ,Savings
19-08-2025 08:52,ANZ041A1031E6D54E559179,012-345-678,11111111,CITYLINK ANZ,108.74,0,550215.06,DR,REF259019,ANZ,Savings
19-08-2025 09:15,ANZ02ADFAFB99784DA8893A,012-345-678,11111111,INTERNET TRANSFER ANZ,21.72,0,550193.34,DR,REF594991,ANZ,Savings
19-08-2025 09:29,ANZE180D2D5DC754DA7A353,012-345-678,11111111,PAY - SALARY ANZ,0,642.38,550835.72,CR,REF380139,ANZ,Savings
19-08-2025 09:39,ANZ3D68A11F3DAD4BEDAB1D,012-345-678,11111111,CITYLINK ANZ,78.14,0,550757.58,DR,REF941909,ANZ,Savings
19-08-2025 09:40,ANZ3EBB56E8271544A2B4EF,012-345-678,11111111,COLES ANZ,12.65,0,550744.93,DR,REF151345,ANZ,Savings
19-08-2025 09:46,ANZFCE6796EF9CB4B4FAF47,012-345-678,11111111,BIGW ANZ,58.38,0,550686.55,DR,REF854252,ANZ,Savings
19-08-2025 10:09,ANZ66634C2EF87143458FBE,012-345-678,11111111,BP ANZ,52.2,0,550634.35,DR,REF751891,ANZ,Savings
19-08-2025 11:19,ANZB2EE888642204051B1FA,012-345-678,11111111,COMPANY PAYROLL ANZ,0,5364.37,555998.72,CR,REF973628,ANZ,Savings
19-08-2025 11:21,ANZ01F19C066DC340709E78,012-345-678,11111111,TAFE BOOKSHOP ANZ,44.67,0,555954.05,DR,REF493716,ANZ,Savings
19-08-2025 11:55,ANZ03C620FD52E64EDFB8C1,012-345-678,11111111,MENULOG ANZ,46.63,0,555907.42,DR,REF954224,ANZ,Savings
19-08-2025 12:10,ANZA97F7914ADE54D5A84D7,012-345-678,11111111,MENULOG ANZ,40.23,0,555867.19,DR,REF376907,ANZ,Savings
19-08-2025 13:16,ANZA860BEC8E6014130AE84,012-345-678,11111111,MCDONALDS ANZ,54.11,0,555813.08,DR,REF902965,ANZ,Savings
19-08-2025 13:19,ANZ45AAB27DC78C4244BCB0,012-345-678,11111111,BWS ANZ,7.66,0,555805.42,DR,REF914666,ANZ,Savings
19-08-2025 13:51,ANZ2F86719069344AF88B1C,012-345-678,11111111,WOOLWORTHS ANZ,9.36,0,555796.06,DR,REF824876,ANZ,Savings
19-08-2025 14:29,ANZ8148D4EDB7074AEA96CC,012-345-678,11111111,INTERNET TRANSFER ANZ,13.61,0,555782.45,DR,REF489463,ANZ,Savings
19-08-2025 14:30,ANZ7FD8DD48886A450A9037,012-345-678,11111111,CITYLINK ANZ,15.02,0,555767.43,DR,REF986300,ANZ,Savings
19-08-2025 14:36,ANZFED739CA50C44829AB06,012-345-678,11111111,SPOTIFY ANZ,24.87,0,555742.56,DR,REF346594,ANZ,Savings
19-08-2025 14:57,ANZ0926C944FB4A49C69140,012-345-678,11111111,BWS ANZ,58.04,0,555684.52,DR,REF792917,ANZ,Savings
19-08-2025 15:20,ANZ68ADD9FEC95F4403975D,012-345-678,11111111,AMAZON AU ANZ,3.86,0,555680.66,DR,REF561455,ANZ,Savings
19-08-2025 15:57,ANZA4F5CF5E674B4B2A945E,012-345-678,11111111,COMPANY PAYROLL ANZ,0,1909.76,557590.42,CR,REF247504,ANZ,Savings
19-08-2025 16:00,ANZEC498909B25144E98046,012-345-678,11111111,PAYPAL *NETFLIX ANZ,9.18,0,557581.24,DR,REF452837,ANZ,Savings
19-08-2025 16:38,ANZ9E60AF6D26084BA3B4AD,012-345-678,11111111,7-ELEVEN ANZ,182.61,0,557398.63,DR,REF767746,ANZ,Savings
19-08-2025 16:53,ANZA6CD82BE45F549A18092,012-345-678,11111111,7-ELEVEN ANZ,35.9,0,557362.73,DR,REF676475,ANZ,Savings
19-08-2025 16:56,ANZAB5896725E96484DAF8E,012-345-678,11111111,RAILWAY STATION ANZ,21.57,0,557341.16,DR,REF664663,ANZ,Savings
19-08-2025 17:10,ANZD08CD9B6F84A48F1AFA3,012-345-678,11111111,ZOOM ANZ,45.76,0,557295.4,DR,REF208636,ANZ,Savings
19-08-2025 17:47,ANZEFBF81FD08A447A38FCE,012-345-678,11111111,HARVEY NORMAN ANZ,58.26,0,557237.14,DR,REF662728,ANZ,Savings
19-08-2025 18:31,ANZFF54F97CEF234C9D88D7,012-345-678,11111111,7-ELEVEN ANZ,73.4,0,557163.74,DR,REF356400,ANZ,Savings
19-08-2025 18:46,ANZ4A148919673F42468826,012-345-678,11111111,HARVEY NORMAN ANZ,198.28,0,556965.46,DR,REF217395,ANZ,Savings
19-08-2025 19:16,ANZF483D4E367E147D98E55,012-345-678,11111111,APPLE ANZ,62.45,0,556903.01,DR,REF943645,ANZ,Savings
19-08-2025 19:26,ANZDDE3F568180945E08385,012-345-678,11111111,TAFE BOOKSHOP ANZ,63.13,0,556839.88,DR,REF313922,ANZ,Savings
19-08-2025 19:38,ANZB2754D64FAD64BA0B42C,012-345-678,11111111,JB HI-FI ANZ,16.69,0,556823.19,DR,REF768333,ANZ,Savings
19-08-2025 19:40,ANZ930258CCAA7F421FA9D5,012-345-678,11111111,BWS ANZ,27.96,0,556795.23,DR,REF335668,ANZ,Savings
19-08-2025 19:48,ANZ70CE4DCF8B3C45A9A84F,012-345-678,11111111,DOMINO'S PIZZA ANZ,19.43,0,556775.8,DR,REF809152,ANZ,Savings
19-08-2025 20:06,INTC07A13E57AA4430F801B,012-345-678,11111111,TRANSFER TO NAB 44444444,1722.43,0,555053.37,DR,INT-63805,ANZ,Savings
19-08-2025 21:03,ANZF9D7003CA50441669D8D,012-345-678,11111111,COMPANY PAYROLL ANZ,0,3833.41,558886.78,CR,REF943275,ANZ,Savings
19-08-2025 21:08,ANZEDE2B1F876F447C3997F,012-345-678,11111111,SHELL ANZ,32.02,0,558854.76,DR,REF759821,ANZ,Savings
19-08-2025 21:17,ANZF29E12C46C3E4F428374,012-345-678,11111111,PAYMENT GATEWAY ANZ,83.26,0,558771.5,DR,REF611914,ANZ,Savings
19-08-2025 23:07,ANZ6C0B19D39E124E13B3B1,012-345-678,11111111,INTERNET TRANSFER ANZ,49.32,0,558722.18,DR,REF876028,ANZ,Savings
19-08-2025 23:08,ANZ0D93C400AA1941689227,012-345-678,11111111,MENULOG ANZ,75.59,0,558646.59,DR,REF780872,ANZ,Savings
19-08-2025 23:09,ANZE3DF34E1276A4F24BEF8,012-345-678,11111111,COLES ANZ,4.41,0,558642.18,DR,REF900944,ANZ,Savings
19-08-2025 23:14,ANZD6B5089A3D094964AFD6,012-345-678,11111111,UBER EATS ANZ,90.36,0,558551.82,DR,REF944945,ANZ,Savings
19-08-2025 23:48,ANZ02721C5C57A14C8FAE86,012-345-678,11111111,WOOLWORTHS ANZ,51.65,0,558500.17,DR,REF890811,ANZ,Savings
19-08-2025 23:51,ANZ734B771CDDF84A389186,012-345-678,11111111,ZOOM ANZ,43.09,0,558457.08,DR,REF272359,ANZ,Savings
20-08-2025 00:13,ANZD425CC801069489BB8BD,012-345-678,11111111,AMAZON AU ANZ,120.32,0,558336.76,DR,REF243716,ANZ,Savings
20-08-2025 00:32,ANZ0FAE6E31F6FB43A0A62A,012-345-678,11111111,DOMINO'S PIZZA ANZ,27.99,0,558308.77,DR,REF755642,ANZ,Savings
20-08-2025 00:34,ANZ1238F000DC164F6996D8,012-345-678,11111111,WAGES CREDIT ANZ,0,6773.47,565082.24,CR,REF406679,ANZ,Savings
20-08-2025 00:44,ANZ222B5C9043034E17A18B,012-345-678,11111111,JB HI-FI ANZ,250.2,0,564832.04,DR,REF841190,ANZ,Savings
20-08-2025 00:54,ANZEEFDBD8A8DFF490C8905,012-345-678,11111111,UBER EATS ANZ,187.92,0,564644.12,DR,REF440864,ANZ,Savings
20-08-2025 01:04,ANZ4DE9006971CB4F24B0D5,012-345-678,11111111,JB HI-FI ANZ,17.74,0,564626.38,DR,REF265716,ANZ,Savings
20-08-2025 01:44,ANZ80042C362BF94DD4971D,012-345-678,11111111,MENULOG ANZ,88.88,0,564537.5,DR,REF869297,ANZ,Savings
20-08-2025 02:09,ANZD2F102DB566C4DF789BA,012-345-678,11111111,SPOTIFY ANZ,11.06,0,564526.44,DR,REF384159,ANZ,Savings
20-08-2025 02:13,ANZC71A19019030422EAE9E,012-345-678,11111111,PAYROLL CREDIT ANZ,0,89.86,564616.3,CR,REF136101,ANZ,Savings
20-08-2025 02:27,INT0E76D7F8C2A7499490DE,012-345-678,11111111,TRANSFER FROM CBA 33333333,0,638.3,565254.6,CR,INT-36503,ANZ,Savings
20-08-2025 02:52,ANZE2EBE3FCB8614818B598,012-345-678,11111111,APPLE ANZ,83.58,0,565171.02,DR,REF895755,ANZ,Savings
20-08-2025 04:08,ANZC0520D96A68342AEA3B7,012-345-678,11111111,CITYLINK ANZ,81.03,0,565089.99,DR,REF955809,ANZ,Savings
20-08-2025 04:16,ANZECF90542D3CE4EDDAB59,012-345-678,11111111,HARVEY NORMAN ANZ,94.99,0,564995,DR,REF437537,ANZ,Savings
20-08-2025 04:22,ANZ261FD3F89AD9438581D1,012-345-678,11111111,PAYMENT GATEWAY ANZ,11.23,0,564983.77,DR,REF863230,ANZ,Savings
20-08-2025 04:25,ANZ615BD15215DB459F95EF,012-345-678,11111111,BANK FEE ANZ,76.87,0,564906.9,DR,REF128237,ANZ,Savings
20-08-2025 04:37,ANZC64510705F9449A79C11,012-345-678,11111111,SALARY PAYMENT ANZ,0,1040.49,565947.39,CR,REF566232,ANZ,Savings
20-08-2025 05:14,ANZ93765C12A0B841BC80E6,012-345-678,11111111,PAY - SALARY ANZ,0,961.56,566908.95,CR,REF901225,ANZ,Savings
20-08-2025 05:30,INT59DC73985DD147B2A7DA,012-345-678,11111111,TRANSFER FROM NAB 44444444,0,739.53,567648.48,CR,INT-39381,ANZ,Savings
20-08-2025 05:50,ANZA81DD8BFF7634BF1A31F,012-345-678,11111111,JB HI-FI ANZ,137.08,0,567511.4,DR,REF727741,ANZ,Savings
20-08-2025 05:55,INT501EBB495FAD4BEBAF0C,012-345-678,11111111,TRANSFER TO CBA 22222222,1848.84,0,565662.56,DR,INT-17167,ANZ,Savings
20-08-2025 05:57,ANZ0853302C32FE45CBBA39,012-345-678,11111111,COLES ANZ,44.93,0,565617.63,DR,REF967855,ANZ,Savings
20-08-2025 06:49,ANZB3EF637C5A8F4E2A8300,012-345-678,11111111,AMAZON AU ANZ,19.64,0,565597.99,DR,REF665252,ANZ,Savings
20-08-2025 06:53,ANZ6728BA1B707B40B1A76F,012-345-678,11111111,BWS ANZ,104.59,0,565493.4,DR,REF605642,ANZ,Savings
20-08-2025 07:15,ANZ2DD5575142384F96B3F9,012-345-678,11111111,PAYPAL *NETFLIX ANZ,53.84,0,565439.56,DR,REF705969,ANZ,Savings
20-08-2025 07:22,ANZ16C38B548ED74B8C9C9F,012-345-678,11111111,JB HI-FI ANZ,15.93,0,565423.63,DR,REF711859,ANZ,Savings
20-08-2025 07:24,ANZE887BBBB75794F098F7C,012-345-678,11111111,KFC ANZ,55.28,0,565368.35,DR,REF208999,ANZ,Savings
20-08-2025 09:12,ANZ4D45BCE5C10D4BF5B693,012-345-678,11111111,LIQUORLAND ANZ,84.21,0,565284.14,DR,REF629795,ANZ,Savings
20-08-2025 09:27,ANZ989C72B95FBB4EBA9585,012-345-678,11111111,MCDONALDS ANZ,22.82,0,565261.32,DR,REF176259,ANZ,Savings
20-08-2025 10:08,ANZ157C3DB6BAFA4FE8B75B,012-345-678,11111111,7-ELEVEN ANZ,14.93,0,565246.39,DR,REF589225,ANZ,Savings
20-08-2025 10:08,ANZB36FA0E9A35246CEA0F2,012-345-678,11111111,7-ELEVEN ANZ,77.91,0,565168.48,DR,REF921811,ANZ,Savings
20-08-2025 10:49,ANZC8D7EF7D58A347AFAE4C,012-345-678,11111111,SPOTIFY ANZ,70.46,0,565098.02,DR,REF130837,ANZ,Savings
20-08-2025 10:50,ANZF3313D37D2C3451593C4,012-345-678,11111111,KFC ANZ,7.99,0,565090.03,DR,REF591307,ANZ,Savings
20-08-2025 10:52,ANZ96C50D3E9B7A4B52A799,012-345-678,11111111,KFC ANZ,102.43,0,564987.6,DR,REF205624,ANZ,Savings
20-08-2025 11:04,INT73FC342E13914F4D99B1,012-345-678,11111111,TRANSFER FROM CBA 33333333,0,887.17,565874.77,CR,INT-20576,ANZ,Savings
20-08-2025 11:08,ANZ833F97BE5EE44FC4A10F,012-345-678,11111111,COLES ANZ,10.51,0,565864.26,DR,REF633664,ANZ,Savings
20-08-2025 11:22,ANZ083A4515EA194073B844,012-345-678,11111111,KFC ANZ,23.42,0,565840.84,DR,REF104936,ANZ,Savings
20-08-2025 11:26,ANZEE89D3932CCF4C1C8453,012-345-678,11111111,7-ELEVEN ANZ,11.37,0,565829.47,DR,REF908820,ANZ,Savings
20-08-2025 11:33,ANZ2E74AEB51A434B0C95B9,012-345-678,11111111,PAY - SALARY ANZ,0,2557.69,568387.16,CR,REF110350,ANZ,Savings
20-08-2025 12:34,ANZA82E535D88D2468EB45F,012-345-678,11111111,SPOTIFY ANZ,49.35,0,568337.81,DR,REF373749,ANZ,Savings
20-08-2025 12:35,ANZFD04A9984913486B95E5,012-345-678,11111111,ZOOM ANZ,158.96,0,568178.85,DR,REF403669,ANZ,Savings
20-08-2025 12:39,ANZ873D65F279764B77A577,012-345-678,11111111,PAY - SALARY ANZ,0,4837.27,573016.12,CR,REF469008,ANZ,Savings
20-08-2025 12:59,ANZ54DFCCF3262544AEAD95,012-345-678,11111111,BP ANZ,66.7,0,572949.42,DR,REF875772,ANZ,Savings
20-08-2025 13:38,ANZ66535216C1B547F4A105,012-345-678,11111111,TAFE BOOKSHOP ANZ,39.29,0,572910.13,DR,REF485896,ANZ,Savings
20-08-2025 14:05,ANZ570BC7E8F2C446C28AB1,012-345-678,11111111,TAFE BOOKSHOP ANZ,71.67,0,572838.46,DR,REF719332,ANZ,Savings
20-08-2025 14:38,ANZ685D4856F96242CCBEBC,012-345-678,11111111,INTERNET TRANSFER ANZ,20.66,0,572817.8,DR,REF880453,ANZ,Savings
20-08-2025 14:44,ANZD860A7F89DCD499DAFFE,012-345-678,11111111,MENULOG ANZ,9.01,0,572808.79,DR,REF984163,ANZ,Savings
20-08-2025 14:57,ANZ38FCB86409C44D5BAFC0,012-345-678,11111111,ZOOM ANZ,55.26,0,572753.53,DR,REF378483,ANZ,Savings
20-08-2025 15:09,ANZ84BC2157E84C4118B94D,012-345-678,11111111,COMPANY PAYROLL ANZ,0,626.35,573379.88,CR,REF115016,ANZ,Savings
20-08-2025 15:17,ANZBE6E5F9EFADB4A32AC60,012-345-678,11111111,APPLE ANZ,69.94,0,573309.94,DR,REF212565,ANZ,Savings
20-08-2025 15:39,ANZ97EDB0BC98514B11B4F4,012-345-678,11111111,INTERNET TRANSFER ANZ,29.11,0,573280.83,DR,REF939691,ANZ,Savings
20-08-2025 16:34,ANZBED6FC37005845CB9D33,012-345-678,11111111,COMPANY PAYROLL ANZ,0,4725.3,578006.13,CR,REF744892,ANZ,Savings
20-08-2025 17:28,ANZAA75A1BDB4F84CEFA03E,012-345-678,11111111,COMPANY PAYROLL ANZ,0,498.62,578504.75,CR,REF929955,ANZ,Savings
20-08-2025 18:09,ANZ4293A7CF15ED4B8885A3,012-345-678,11111111,BIGW ANZ,28.36,0,578476.39,DR,REF241282,ANZ,Savings
20-08-2025 18:20,ANZFEF9D404D0B54A7D8897,012-345-678,11111111,RAILWAY STATION ANZ,5.04,0,578471.35,DR,REF452635,ANZ,Savings
20-08-2025 18:32,INT1F99879EF11B40F49674,012-345-678,11111111,TRANSFER FROM NAB 44444444,0,1018.81,579490.16,CR,INT-61417,ANZ,Savings
20-08-2025 20:15,INT68E47592FBB540D584E8,012-345-678,11111111,TRANSFER FROM NAB 44444444,0,150.82,579640.98,CR,INT-58306,ANZ,Savings
20-08-2025 21:42,ANZ8EC4D4AB96AA4E09BEF2,012-345-678,11111111,CITYLINK ANZ,48.95,0,579592.03,DR,REF904921,ANZ,Savings
20-08-2025 21:49,ANZC69683148D9543CFB73A,012-345-678,11111111,MENULOG ANZ,57.96,0,579534.07,DR,REF269177,ANZ,Savings
20-08-2025 22:29,ANZC131A3C7985843219807,012-345-678,11111111,TAFE BOOKSHOP ANZ,11.77,0,579522.3,DR,REF685086,ANZ,Savings
20-08-2025 22:33,ANZ5DDC6840641649D5B443,012-345-678,11111111,PAY - SALARY ANZ,0,3007.69,582529.99,CR,REF180020,ANZ,Savings
20-08-2025 23:16,ANZE2C5F17D9A29403EBC79,012-345-678,11111111,RAILWAY STATION ANZ,19.17,0,582510.82,DR,REF883059,ANZ,Savings
20-08-2025 23:29,ANZC6503EC7F9C442578746,012-345-678,11111111,AMAZON AU ANZ,10.42,0,582500.4,DR,REF269906,ANZ,Savings
21-08-2025 00:00,ANZ732498E382B94A8B9CEB,012-345-678,11111111,SHELL ANZ,96.27,0,582404.13,DR,REF269483,ANZ,Savings
21-08-2025 00:04,ANZ0F27031AC63A4ADDBA06,012-345-678,11111111,KFC ANZ,8.85,0,582395.28,DR,REF304172,ANZ,Savings
21-08-2025 00:58,ANZ431F1E11BDF84F9BAF70,012-345-678,11111111,7-ELEVEN ANZ,5.21,0,582390.07,DR,REF949518,ANZ,Savings
21-08-2025 01:06,ANZD1245C786E6D4695822B,012-345-678,11111111,BP ANZ,88.19,0,582301.88,DR,REF597463,ANZ,Savings
21-08-2025 01:09,ANZ7CE826FB93C4487FBBC8,012-345-678,11111111,SALARY PAYMENT ANZ,0,3452.98,585754.86,CR,REF431381,ANZ,Savings
21-08-2025 01:29,ANZ22557439BF744BDAA48C,012-345-678,11111111,ALDI ANZ,104.08,0,585650.78,DR,REF552014,ANZ,Savings
21-08-2025 02:09,ANZ0CFC3F3224F74681B57C,012-345-678,11111111,UBER EATS ANZ,109.44,0,585541.34,DR,REF521197,ANZ,Savings
21-08-2025 03:02,ANZ4AD9EFBB39D440D39B48,012-345-678,11111111,BWS ANZ,51.38,0,585489.96,DR,REF948318,ANZ,Savings
21-08-2025 03:08,ANZ141D4E0079D84A659F13,012-345-678,11111111,DOMINO'S PIZZA ANZ,71.17,0,585418.79,DR,REF682488,ANZ,Savings
21-08-2025 03:20,ANZ62D280AEDC0044D2AA9C,012-345-678,11111111,PAY - SALARY ANZ,0,594.04,586012.83,CR,REF565580,ANZ,Savings
21-08-2025 03:33,ANZEB5E2D3B782346358C07,012-345-678,11111111,FLIXBUS ANZ,150.98,0,585861.85,DR,REF386870,ANZ,Savings
21-08-2025 03:47,ANZ8D2E9A56BC2C45B2B189,012-345-678,11111111,WAGES CREDIT ANZ,0,447.5,586309.35,CR,REF223005,ANZ,Savings
21-08-2025 04:00,ANZF33F11BA63964D98AAA7,012-345-678,11111111,MENULOG ANZ,141.53,0,586167.82,DR,REF281997,ANZ,Savings
21-08-2025 04:10,ANZ1E4A5BD726CF472C8BF0,012-345-678,11111111,WOOLWORTHS ANZ,20.4,0,586147.42,DR,REF568814,ANZ,Savings
21-08-2025 04:11,ANZC393039611FD4DDC8247,012-345-678,11111111,RAILWAY STATION ANZ,72.3,0,586075.12,DR,REF137647,ANZ,Savings
21-08-2025 04:56,ANZ98ED51172417476D84CD,012-345-678,11111111,INTERNET TRANSFER ANZ,69.03,0,586006.09,DR,REF555723,ANZ,Savings
21-08-2025 05:05,ANZ46BC56C5236D443EB6F4,012-345-678,11111111,ALDI ANZ,36.84,0,585969.25,DR,REF340205,ANZ,Savings
21-08-2025 06:36,ANZ1B2B559AC0514D699749,012-345-678,11111111,7-ELEVEN ANZ,97.15,0,585872.1,DR,REF129719,ANZ,Savings
21-08-2025 06:40,ANZ2064961A02D040B08482,012-345-678,11111111,STARBUCKS ANZ,67.21,0,585804.89,DR,REF869387,ANZ,Savings
21-08-2025 06:42,ANZ7C526C056B0441C0930B,012-345-678,11111111,KFC ANZ,107.37,0,585697.52,DR,REF790698,ANZ,Savings
21-08-2025 06:45,ANZD94AD87E4A9F4C89BE97,012-345-678,11111111,APPLE ANZ,25.98,0,585671.54,DR,REF775129,ANZ,Savings
21-08-2025 06:48,ANZ9163F8DA6CF545A1B4BA,012-345-678,11111111,CITYLINK ANZ,51.39,0,585620.15,DR,REF806420,ANZ,Savings
21-08-2025 07:43,ANZC7A59BECABD74013A6EE,012-345-678,11111111,RAILWAY STATION ANZ,106.6,0,585513.55,DR,REF260300,ANZ,Savings
21-08-2025 07:50,ANZ9A71C1679975474BB714,012-345-678,11111111,KFC ANZ,65.06,0,585448.49,DR,REF832752,ANZ,Savings
21-08-2025 07:54,ANZ48625EC183E84D7099FD,012-345-678,11111111,KFC ANZ,26.49,0,585422,DR,REF702058,ANZ,Savings
21-08-2025 08:15,ANZ292320CEFDDE48F4A49B,012-345-678,11111111,BANK FEE ANZ,24.34,0,585397.66,DR,REF539598,ANZ,Savings
21-08-2025 08:40,ANZBEA71895041D462893DC,012-345-678,11111111,PAYROLL CREDIT ANZ,0,2047.67,587445.33,CR,REF811501,ANZ,Savings
21-08-2025 09:04,ANZ88E12710D6F149C0B1D6,012-345-678,11111111,HARVEY NORMAN ANZ,8.3,0,587437.03,DR,REF292021,ANZ,Savings
21-08-2025 09:11,ANZD97ABE026E5445458F11,012-345-678,11111111,KFC ANZ,76.77,0,587360.26,DR,REF782816,ANZ,Savings
21-08-2025 09:12,ANZ19445F3C69EC444AA151,012-345-678,11111111,BANK FEE ANZ,135.78,0,587224.48,DR,REF549941,ANZ,Savings
21-08-2025 09:29,ANZE9DD0838373B4B9AA3BD,012-345-678,11111111,7-ELEVEN ANZ,16.93,0,587207.55,DR,REF609040,ANZ,Savings
21-08-2025 09:30,ANZ6ACF52D2B0464DEC841C,012-345-678,11111111,SPOTIFY ANZ,2.4,0,587205.15,DR,REF562093,ANZ,Savings
21-08-2025 09:40,ANZBA35508F95624C5B84F8,012-345-678,11111111,WOOLWORTHS ANZ,9.48,0,587195.67,DR,REF855072,ANZ,Savings
21-08-2025 09:54,INTE04353C04A7E45BA939E,012-345-678,11111111,TRANSFER TO CBA 22222222,753.4,0,586442.27,DR,INT-72056,ANZ,Savings
21-08-2025 10:48,ANZ97B9A3BCA4B74A77BB53,012-345-678,11111111,RAILWAY STATION ANZ,3.91,0,586438.36,DR,REF642088,ANZ,Savings
21-08-2025 11:04,ANZE2F3C2E3DA164B79836E,012-345-678,11111111,WAGES CREDIT ANZ,0,7514.97,593953.33,CR,REF625501,ANZ,Savings
21-08-2025 11:25,ANZ8C93C806151F43C991C2,012-345-678,11111111,LIQUORLAND ANZ,59.02,0,593894.31,DR,REF512700,ANZ,Savings
21-08-2025 12:40,ANZ6B6B1FCADDAA4C809EC4,012-345-678,11111111,BANK FEE ANZ,71.7,0,593822.61,DR,REF977209,ANZ,Savings
21-08-2025 12:42,ANZ1BBA8DAC368E47B98961,012-345-678,11111111,PAY - SALARY ANZ,0,1760.17,595582.78,CR,REF588133,ANZ,Savings
21-08-2025 13:07,ANZFF781BE7CCDA42B48F3A,012-345-678,11111111,ALDI ANZ,5.61,0,595577.17,DR,REF283967,ANZ,Savings
21-08-2025 13:15,ANZBCBA7AC8D3134647A32C,012-345-678,11111111,BP ANZ,39.99,0,595537.18,DR,REF395872,ANZ,Savings
21-08-2025 13:29,ANZ5A01A5209BFC4F66BA78,012-345-678,11111111,AMAZON AU ANZ,46.81,0,595490.37,DR,REF930478,ANZ,Savings
21-08-2025 13:30,ANZDD9BE00491CB4FEE822A,012-345-678,11111111,BIGW ANZ,6.59,0,595483.78,DR,REF454860,ANZ,Savings
21-08-2025 13:46,ANZEBC3BAD0E3D742BC9663,012-345-678,11111111,INTERNET TRANSFER ANZ,18.33,0,595465.45,DR,REF249859,ANZ,Savings
21-08-2025 13:50,ANZD899ECD6E46841DBBB62,012-345-678,11111111,SHELL ANZ,6.13,0,595459.32,DR,REF881060,ANZ,Savings
21-08-2025 14:04,ANZCE951C3F596E4F4E8C04,012-345-678,11111111,ZOOM ANZ,18.22,0,595441.1,DR,REF933733,ANZ,Savings
21-08-2025 14:09,ANZC2FB9D7B28A842D7B4A8,012-345-678,11111111,COMPANY PAYROLL ANZ,0,1164.69,596605.79,CR,REF757655,ANZ,Savings
21-08-2025 14:39,ANZCACDCD33CF844639B05C,012-345-678,11111111,APPLE ANZ,103.86,0,596501.93,DR,REF305139,ANZ,Savings
21-08-2025 15:01,INT808AFCEFC726481592E0,012-345-678,11111111,TRANSFER FROM CBA 22222222,0,1818.23,598320.16,CR,INT-95644,ANZ,Savings
21-08-2025 15:19,ANZ1366B108080F453C97AA,012-345-678,11111111,FLIXBUS ANZ,70.64,0,598249.52,DR,REF794258,ANZ,Savings
21-08-2025 15:32,ANZ253427ACABE640ACBDF8,012-345-678,11111111,BWS ANZ,36.66,0,598212.86,DR,REF782469,ANZ,Savings
21-08-2025 15:59,ANZF814460582C840D59BE0,012-345-678,11111111,BANK FEE ANZ,73.35,0,598139.51,DR,REF719242,ANZ,Savings
21-08-2025 16:11,ANZCAB61D876C014CB186DA,012-345-678,11111111,JB HI-FI ANZ,15.21,0,598124.3,DR,REF177224,ANZ,Savings
21-08-2025 16:43,ANZBCC0D28952D3413F8E75,012-345-678,11111111,STARBUCKS ANZ,62.93,0,598061.37,DR,REF547887,ANZ,Savings
21-08-2025 17:00,ANZ05EF049C8D484D7F8189,012-345-678,11111111,BWS ANZ,81.17,0,597980.2,DR,REF800547,ANZ,Savings
21-08-2025 17:33,ANZFBFC87A79B374D7190D8,012-345-678,11111111,STARBUCKS ANZ,33.71,0,597946.49,DR,REF698159,ANZ,Savings
21-08-2025 17:59,ANZ646662A3987B42FD8553,012-345-678,11111111,KFC ANZ,9.49,0,597937,DR,REF393999,ANZ,Savings
21-08-2025 18:22,ANZFE6E972AE4A74C9ABCEF,012-345-678,11111111,PAY - SALARY ANZ,0,4430.78,602367.78,CR,REF125585,ANZ,Savings
21-08-2025 18:53,ANZB18B342C6C8A4DDCA3ED,012-345-678,11111111,BP ANZ,110.01,0,602257.77,DR,REF937690,ANZ,Savings
21-08-2025 18:54,ANZ5F6C042AF3EF4C3781A0,012-345-678,11111111,BIGW ANZ,33.57,0,602224.2,DR,REF448742,ANZ,Savings
21-08-2025 18:54,ANZ5EFE76A488314EDDA714,012-345-678,11111111,7-ELEVEN ANZ,3.69,0,602220.51,DR,REF336981,ANZ,Savings
21-08-2025 19:30,ANZB51DF76A82CE4A1F9B90,012-345-678,11111111,CITYLINK ANZ,59.23,0,602161.28,DR,REF647008,ANZ,Savings
21-08-2025 19:51,ANZ23863B76B4CB423DA32A,012-345-678,11111111,APPLE ANZ,74.4,0,602086.88,DR,REF202475,ANZ,Savings
21-08-2025 20:26,ANZF9022FB5396E4B9EACA9,012-345-678,11111111,UBER EATS ANZ,26.7,0,602060.18,DR,REF946322,ANZ,Savings
21-08-2025 20:37,ANZA7F7A617E1FD439BA486,012-345-678,11111111,TAFE BOOKSHOP ANZ,78.61,0,601981.57,DR,REF302263,ANZ,Savings
21-08-2025 20:43,ANZ890F74161CD041388F98,012-345-678,11111111,PAYROLL CREDIT ANZ,0,4949.66,606931.23,CR,REF192485,ANZ,Savings
21-08-2025 21:40,ANZ0D3498B8BE3544EEAAC7,012-345-678,11111111,PAYMENT GATEWAY ANZ,14.3,0,606916.93,DR,REF937572,ANZ,Savings
21-08-2025 21:43,ANZ1A479A2A50FA4F34B4BB,012-345-678,11111111,KFC ANZ,188.21,0,606728.72,DR,REF897010,ANZ,Savings
21-08-2025 21:59,ANZ6DFBDDE5F0E04026963E,012-345-678,11111111,SHELL ANZ,91.07,0,606637.65,DR,REF907058,ANZ,Savings
21-08-2025 22:12,ANZ058A73C0D33D4485904B,012-345-678,11111111,ALDI ANZ,27.85,0,606609.8,DR,REF196506,ANZ,Savings
21-08-2025 22:22,ANZ87FFC71A4E2248C6BA91,012-345-678,11111111,7-ELEVEN ANZ,36.61,0,606573.19,DR,REF231833,ANZ,Savings
21-08-2025 22:36,INTFC771606F327489286D2,012-345-678,11111111,TRANSFER TO CBA 22222222,1742.74,0,604830.45,DR,INT-22178,ANZ,Savings
21-08-2025 22:42,ANZB5019ED3FB714C0AA420,012-345-678,11111111,HARVEY NORMAN ANZ,11.34,0,604819.11,DR,REF339349,ANZ,Savings
21-08-2025 22:50,ANZ6F9CAF19FFC045B2BE5F,012-345-678,11111111,APPLE ANZ,50.41,0,604768.7,DR,REF140936,ANZ,Savings
21-08-2025 23:25,ANZBC80784B91AE44ACA5AC,012-345-678,11111111,SHELL ANZ,40.99,0,604727.71,DR,REF848278,ANZ,Savings
22-08-2025 00:33,ANZ1E8086EDECB947CC8533,012-345-678,11111111,STARBUCKS ANZ,18.29,0,604709.42,DR,REF121172,ANZ,Savings
22-08-2025 00:43,ANZ649A04F15907422CAC78,012-345-678,11111111,CITYLINK ANZ,32.96,0,604676.46,DR,REF615646,ANZ,Savings
22-08-2025 00:46,ANZ98FC9B38B32147C5A8C7,012-345-678,11111111,BANK FEE ANZ,31.48,0,604644.98,DR,REF940110,ANZ,Savings
22-08-2025 00:48,ANZB51D970B2F5542BB8BB9,012-345-678,11111111,CITYLINK ANZ,87.85,0,604557.13,DR,REF608226,ANZ,Savings
22-08-2025 01:02,ANZ9D1FD7E2293B4A63BD9C,012-345-678,11111111,CITYLINK ANZ,9.27,0,604547.86,DR,REF821114,ANZ,Savings
22-08-2025 01:15,ANZB06F3821A8654FFB95C6,012-345-678,11111111,7-ELEVEN ANZ,53.92,0,604493.94,DR,REF587684,ANZ,Savings
22-08-2025 01:29,ANZ2D8ED848C150492EBD2A,012-345-678,11111111,AMAZON AU ANZ,39.45,0,604454.49,DR,REF704966,ANZ,Savings
22-08-2025 01:35,ANZ02909DA47AC04351B1EA,012-345-678,11111111,DOMINO'S PIZZA ANZ,34.23,0,604420.26,DR,REF110138,ANZ,Savings
22-08-2025 01:39,ANZ5683F32EAB364FA6BC7A,012-345-678,11111111,PAYPAL *NETFLIX ANZ,184.47,0,604235.79,DR,REF864206,ANZ,Savings
22-08-2025 01:44,ANZ64B19B572119431BA664,012-345-678,11111111,APPLE ANZ,16.2,0,604219.59,DR,REF266787,ANZ,Savings
22-08-2025 02:31,ANZ15F2DF92CE4C4E4A8FE8,012-345-678,11111111,SPOTIFY ANZ,76.1,0,604143.49,DR,REF427997,ANZ,Savings
22-08-2025 03:22,ANZ5C8E238F10224DDCAFDE,012-345-678,11111111,TAFE BOOKSHOP ANZ,14.93,0,604128.56,DR,REF437701,ANZ,Savings
22-08-2025 03:36,ANZ39E43C77C4A84E5E9354,012-345-678,11111111,PAYROLL CREDIT ANZ,0,3396.3,607524.86,CR,REF862723,ANZ,Savings
22-08-2025 03:39,ANZ393E2EC7E7554C7D96B3,012-345-678,11111111,STARBUCKS ANZ,13.57,0,607511.29,DR,REF533748,ANZ,Savings
22-08-2025 03:50,ANZ1E2909B910C64327B237,012-345-678,11111111,ALDI ANZ,22.86,0,607488.43,DR,REF735707,ANZ,Savings
22-08-2025 04:04,ANZ8651D50482684DEE9DEB,012-345-678,11111111,APPLE ANZ,45.05,0,607443.38,DR,REF964066,ANZ,Savings
22-08-2025 04:44,ANZ802902BF79C243F28F78,012-345-678,11111111,BIGW ANZ,38.11,0,607405.27,DR,REF613578,ANZ,Savings
22-08-2025 04:46,ANZD78E6BC6F8F64BCBB5CC,012-345-678,11111111,RAILWAY STATION ANZ,49.24,0,607356.03,DR,REF832357,ANZ,Savings
22-08-2025 04:59,ANZF6E0E21E406F4AB5880D,012-345-678,11111111,DOMINO'S PIZZA ANZ,29.75,0,607326.28,DR,REF182830,ANZ,Savings
22-08-2025 05:21,ANZ5D0D2E4EFFDD409AA09B,012-345-678,11111111,COMPANY PAYROLL ANZ,0,954.77,608281.05,CR,REF670259,ANZ,Savings
22-08-2025 05:35,ANZ243B33B7BC2646C0A4BC,012-345-678,11111111,HARVEY NORMAN ANZ,42.07,0,608238.98,DR,REF958625,ANZ,Savings
22-08-2025 05:59,ANZ1B3E9ECE10A94282951B,012-345-678,11111111,WAGES CREDIT ANZ,0,2841.4,611080.38,CR,REF728006,ANZ,Savings
22-08-2025 06:15,ANZ404081C9F4F540D8B200,012-345-678,11111111,CITYLINK ANZ,13.79,0,611066.59,DR,REF811547,ANZ,Savings
22-08-2025 06:16,ANZD0AE65F5A7F7469D8BCA,012-345-678,11111111,AMAZON AU ANZ,5.39,0,611061.2,DR,REF234915,ANZ,Savings
22-08-2025 06:22,ANZ84FEA65E81CF45A8AA0E,012-345-678,11111111,CITYLINK ANZ,29.49,0,611031.71,DR,REF490005,ANZ,Savings
22-08-2025 06:26,ANZA2E1EC4018D34EA5813D,012-345-678,11111111,MCDONALDS ANZ,33.38,0,610998.33,DR,REF716237,ANZ,Savings
22-08-2025 06:28,ANZC2426F5D18294D2DB777,012-345-678,11111111,MENULOG ANZ,93.46,0,610904.87,DR,REF666845,ANZ,Savings
22-08-2025 06:29,ANZ68DEFE617715422FAE2D,012-345-678,11111111,COLES ANZ,100.48,0,610804.39,DR,REF431689,ANZ,Savings
22-08-2025 06:38,ANZC243DD8B48A94047B515,012-345-678,11111111,PAYPAL *NETFLIX ANZ,25.94,0,610778.45,DR,REF790042,ANZ,Savings
22-08-2025 06:49,ANZE4CBB04F149C43A6911E,012-345-678,11111111,AMAZON AU ANZ,109.14,0,610669.31,DR,REF340663,ANZ,Savings
22-08-2025 06:50,ANZCC36A74C2E954234A14C,012-345-678,11111111,MENULOG ANZ,42.23,0,610627.08,DR,REF651689,ANZ,Savings
22-08-2025 07:15,ANZD82F9DDAB8024C808B48,012-345-678,11111111,BANK FEE ANZ,38.13,0,610588.95,DR,REF659042,ANZ,Savings
22-08-2025 07:18,ANZ7F93779F36B748879B1E,012-345-678,11111111,RAILWAY STATION ANZ,34.62,0,610554.33,DR,REF883185,ANZ,Savings
22-08-2025 07:44,ANZB2BF6A7D20D6416483C8,012-345-678,11111111,WAGES CREDIT ANZ,0,7762.03,618316.36,CR,REF617920,ANZ,Savings
22-08-2025 07:59,INT26DB0B5CA53844FFA00B,012-345-678,11111111,TRANSFER TO CBA 22222222,567.36,0,617749,DR,INT-36251,ANZ,Savings
22-08-2025 08:09,ANZA5C15D5AC0A64E1580F6,012-345-678,11111111,BIGW ANZ,43.95,0,617705.05,DR,REF246150,ANZ,Savings
22-08-2025 08:12,ANZ723F52D1E1F1427B9C86,012-345-678,11111111,COLES ANZ,78.82,0,617626.23,DR,REF471275,ANZ,Savings
22-08-2025 08:30,ANZ1F6577D4233846EA93E9,012-345-678,11111111,COMPANY PAYROLL ANZ,0,5901.61,623527.84,CR,REF591673,ANZ,Savings
22-08-2025 08:39,ANZ7116677049C14C43AB14,012-345-678,11111111,UBER EATS ANZ,157.42,0,623370.42,DR,REF955584,ANZ,Savings
22-08-2025 09:10,ANZ164BADF8CB444128815C,012-345-678,11111111,SALARY PAYMENT ANZ,0,6442.56,629812.98,CR,REF189548,ANZ,Savings
22-08-2025 09:12,ANZ84C05E976E9249C796B9,012-345-678,11111111,FLIXBUS ANZ,5.48,0,629807.5,DR,REF614966,ANZ,Savings
22-08-2025 09:45,ANZEBB19C31ED0E4270B396,012-345-678,11111111,UBER EATS ANZ,55.28,0,629752.22,DR,REF781773,ANZ,Savings
22-08-2025 09:55,ANZAAD859C662134824ADC1,012-345-678,11111111,PAYPAL *NETFLIX ANZ,143.84,0,629608.38,DR,REF169525,ANZ,Savings
22-08-2025 10:21,ANZ48F790D8FC9F49ED939F,012-345-678,11111111,COLES ANZ,17.31,0,629591.07,DR,REF240952,ANZ,Savings
22-08-2025 10:31,ANZF5970F3A03DE4921AEAC,012-345-678,11111111,INTERNET TRANSFER ANZ,30.42,0,629560.65,DR,REF142356,ANZ,Savings
22-08-2025 11:17,ANZ20A92B4A1B864210957F,012-345-678,11111111,MENULOG ANZ,9.42,0,629551.23,DR,REF384260,ANZ,Savings
22-08-2025 11:53,ANZ209E01D6523F4F33B733,012-345-678,11111111,PAYROLL CREDIT ANZ,0,5368.76,634919.99,CR,REF872496,ANZ,Savings
22-08-2025 12:02,ANZAE6D49394C7C4246904C,012-345-678,11111111,SALARY PAYMENT ANZ,0,192.97,635112.96,CR,REF587151,ANZ,Savings
22-08-2025 12:02,ANZA0DD8D9B64CE4B3F9FE1,012-345-678,11111111,PAYMENT GATEWAY ANZ,4.2,0,635108.76,DR,REF807045,ANZ,Savings
22-08-2025 13:08,ANZ53D3F030C1F24785A9CA,012-345-678,11111111,UBER EATS ANZ,41.28,0,635067.48,DR,REF871117,ANZ,Savings
22-08-2025 14:13,ANZC03012807EF84C9B8AFF,012-345-678,11111111,INTERNET TRANSFER ANZ,24.37,0,635043.11,DR,REF862521,ANZ,Savings
22-08-2025 14:24,ANZ448E9D55F3EC450AA561,012-345-678,11111111,INTERNET TRANSFER ANZ,31.19,0,635011.92,DR,REF232231,ANZ,Savings
22-08-2025 14:56,ANZC47C4F2947D34C31881A,012-345-678,11111111,SPOTIFY ANZ,14.01,0,634997.91,DR,REF978592,ANZ,Savings
22-08-2025 15:04,ANZEBB212329EE34C208AD5,012-345-678,11111111,KFC ANZ,98.21,0,634899.7,DR,REF271818,ANZ,Savings
22-08-2025 16:05,ANZA68D424A47094FA4A58F,012-345-678,11111111,CITYLINK ANZ,153.12,0,634746.58,DR,REF920467,ANZ,Savings
22-08-2025 16:17,ANZ20A755DACAB14C9087C5,012-345-678,11111111,HARVEY NORMAN ANZ,12.62,0,634733.96,DR,REF885349,ANZ,Savings
22-08-2025 16:20,ANZ63A2A58D35C44A48B827,012-345-678,11111111,BANK FEE ANZ,17.5,0,634716.46,DR,REF620705,ANZ,Savings
22-08-2025 16:27,ANZF54F469A2A9F40AB8FC9,012-345-678,11111111,TAFE BOOKSHOP ANZ,26.83,0,634689.63,DR,REF523928,ANZ,Savings
22-08-2025 16:29,ANZ954984933D6448F8BBC3,012-345-678,11111111,LIQUORLAND ANZ,49.87,0,634639.76,DR,REF574723,ANZ,Savings
22-08-2025 16:46,ANZ674B605CF38841119F7C,012-345-678,11111111,HARVEY NORMAN ANZ,33.46,0,634606.3,DR,REF775840,ANZ,Savings
22-08-2025 16:57,ANZ38407D69C57E45B4A54C,012-345-678,11111111,BWS ANZ,20.01,0,634586.29,DR,REF913396,ANZ,Savings
22-08-2025 17:01,ANZ8EB8161F85574135BA8F,012-345-678,11111111,WAGES CREDIT ANZ,0,45.13,634631.42,CR,REF527153,ANZ,Savings
22-08-2025 17:30,ANZ9617ABDED496407E9890,012-345-678,11111111,7-ELEVEN ANZ,25.78,0,634605.64,DR,REF981465,ANZ,Savings
22-08-2025 17:44,INTF1D62116A7024B4085C0,012-345-678,11111111,TRANSFER TO CBA 33333333,1279.79,0,633325.85,DR,INT-86572,ANZ,Savings
22-08-2025 18:03,ANZ43CCE626FAA442E5AF70,012-345-678,11111111,DOMINO'S PIZZA ANZ,69.88,0,633255.97,DR,REF505688,ANZ,Savings
22-08-2025 18:08,INTABA0FF76DD104896ACD2,012-345-678,11111111,TRANSFER FROM NAB 44444444,0,1465.46,634721.43,CR,INT-29020,ANZ,Savings
22-08-2025 18:40,ANZB9B5746D07144456B3C0,012-345-678,11111111,BANK FEE ANZ,56.29,0,634665.14,DR,REF331828,ANZ,Savings
22-08-2025 18:49,ANZ0F7883D9F44442E3A218,012-345-678,11111111,WAGES CREDIT ANZ,0,1903.36,636568.5,CR,REF242622,ANZ,Savings
22-08-2025 18:59,ANZCFF67650430F477BB615,012-345-678,11111111,AMAZON AU ANZ,62.02,0,636506.48,DR,REF769784,ANZ,Savings
22-08-2025 19:16,ANZ613130C2907D4CDC80F7,012-345-678,11111111,7-ELEVEN ANZ,94.35,0,636412.13,DR,REF945710,ANZ,Savings
22-08-2025 19:50,ANZ4407384E56D546F3B3A8,012-345-678,11111111,PAYPAL *NETFLIX ANZ,3.22,0,636408.91,DR,REF556520,ANZ,Savings
22-08-2025 20:01,ANZ2EB8200FF40A415393C2,012-345-678,11111111,SHELL ANZ,63.24,0,636345.67,DR,REF374864,ANZ,Savings
22-08-2025 20:12,ANZ001D78B9570E41B2B936,012-345-678,11111111,ZOOM ANZ,102.97,0,636242.7,DR,REF172394,ANZ,Savings
22-08-2025 20:14,ANZ7053CF487B8440AA8DE3,012-345-678,11111111,DOMINO'S PIZZA ANZ,63.3,0,636179.4,DR,REF650580,ANZ,Savings
22-08-2025 20:57,ANZ89D3C6F179554819BC68,012-345-678,11111111,BIGW ANZ,45.37,0,636134.03,DR,REF774736,ANZ,Savings
22-08-2025 21:08,ANZ1B5DFB55D3DD48FCB540,012-345-678,11111111,PAYMENT GATEWAY ANZ,20.86,0,636113.17,DR,REF409241,ANZ,Savings
22-08-2025 21:31,ANZ8B0972B446A14BBCB18D,012-345-678,11111111,ZOOM ANZ,25.21,0,636087.96,DR,REF425570,ANZ,Savings
22-08-2025 21:48,ANZ98143C909B2F49FCAF81,012-345-678,11111111,WAGES CREDIT ANZ,0,542.64,636630.6,CR,REF761186,ANZ,Savings
22-08-2025 21:49,ANZ656F90FF9A714925B84C,012-345-678,11111111,BANK FEE ANZ,46.64,0,636583.96,DR,REF994881,ANZ,Savings
22-08-2025 22:57,ANZ98AD4BCE8C674CF3A051,012-345-678,11111111,COMPANY PAYROLL ANZ,0,5752.94,642336.9,CR,REF954607,ANZ,Savings
23-08-2025 00:49,ANZDD4C45C3DE7D41008CC4,012-345-678,11111111,PAYPAL *NETFLIX ANZ,83.42,0,642253.48,DR,REF725628,ANZ,Savings
23-08-2025 00:56,ANZ4D048AFBF4E54B3D90F9,012-345-678,11111111,BIGW ANZ,65.71,0,642187.77,DR,REF716045,ANZ,Savings
23-08-2025 01:07,ANZBD029C0334964DC4AEC2,012-345-678,11111111,AMAZON AU ANZ,5.65,0,642182.12,DR,REF834734,ANZ,Savings
23-08-2025 01:23,ANZDFF34F81F9204294A6DF,012-345-678,11111111,MCDONALDS ANZ,53.31,0,642128.81,DR,REF835470,ANZ,Savings
23-08-2025 01:38,ANZ67C10890D79A489FAF92,012-345-678,11111111,PAY - SALARY ANZ,0,6589.61,648718.42,CR,REF390579,ANZ,Savings
23-08-2025 01:54,ANZEC1F60374E4D4D62B628,012-345-678,11111111,PAYMENT GATEWAY ANZ,13.3,0,648705.12,DR,REF802943,ANZ,Savings
23-08-2025 02:29,ANZ12C0D595F12F43E4A7F5,012-345-678,11111111,PAY - SALARY ANZ,0,2922.56,651627.68,CR,REF828628,ANZ,Savings
23-08-2025 02:37,ANZ9F8E4A0E5ADD40E69F08,012-345-678,11111111,MCDONALDS ANZ,9.83,0,651617.85,DR,REF342199,ANZ,Savings
23-08-2025 03:19,ANZ08454AA877D540A4A113,012-345-678,11111111,COLES ANZ,38.06,0,651579.79,DR,REF549175,ANZ,Savings
23-08-2025 04:00,ANZ4C06B08B8DDD4AC2BE94,012-345-678,11111111,AMAZON AU ANZ,6.27,0,651573.52,DR,REF711466,ANZ,Savings
23-08-2025 04:13,ANZ1E9B4504564F485192D0,012-345-678,11111111,ZOOM ANZ,178.08,0,651395.44,DR,REF443316,ANZ,Savings
23-08-2025 04:24,ANZ68C23C989C504C34B2CA,012-345-678,11111111,WAGES CREDIT ANZ,0,3700.56,655096,CR,REF624382,ANZ,Savings
23-08-2025 05:03,ANZ6B23C932829340528B0A,012-345-678,11111111,BANK FEE ANZ,24.68,0,655071.32,DR,REF693753,ANZ,Savings
23-08-2025 05:08,ANZ59A1A74B7F4C4BA1BFC0,012-345-678,11111111,RAILWAY STATION ANZ,105.57,0,654965.75,DR,REF970612,ANZ,Savings
23-08-2025 05:10,ANZ17C4AC20176F42E4A779,012-345-678,11111111,FLIXBUS ANZ,26.63,0,654939.12,DR,REF629834,ANZ,Savings
23-08-2025 05:15,ANZ245ABB787E1145FAAB00,012-345-678,11111111,KFC ANZ,20.32,0,654918.8,DR,REF171692,ANZ,Savings
23-08-2025 05:49,ANZ93BAC05A0A4841FD8D60,012-345-678,11111111,COLES ANZ,72.3,0,654846.5,DR,REF983262,ANZ,Savings
23-08-2025 05:56,ANZ3BE71D6E22AB42549460,012-345-678,11111111,SPOTIFY ANZ,37.97,0,654808.53,DR,REF478486,ANZ,Savings
23-08-2025 06:09,ANZ5C0291012A52488EA031,012-345-678,11111111,COMPANY PAYROLL ANZ,0,7866.56,662675.09,CR,REF295638,ANZ,Savings
23-08-2025 06:14,ANZF8B31B5CA72F49CF87A2,012-345-678,11111111,ZOOM ANZ,10.5,0,662664.59,DR,REF155133,ANZ,Savings
23-08-2025 06:49,ANZ4DD830F6E3D44529A9DB,012-345-678,11111111,APPLE ANZ,19.61,0,662644.98,DR,REF523519,ANZ,Savings
23-08-2025 07:38,ANZ0A5089CAC143451E957A,012-345-678,11111111,KFC ANZ,24.19,0,662620.79,DR,REF764036,ANZ,Savings
23-08-2025 07:48,INT6C29DE088A7F40E8B4AD,012-345-678,11111111,TRANSFER FROM CBA 22222222,0,1295.65,663916.44,CR,INT-88536,ANZ,Savings
23-08-2025 08:09,ANZD9710B4168D643009621,012-345-678,11111111,CITYLINK ANZ,6.2,0,663910.24,DR,REF225870,ANZ,Savings
23-08-2025 08:28,ANZ4681719D63BC463A940F,012-345-678,11111111,BANK FEE ANZ,247.81,0,663662.43,DR,REF291819,ANZ,Savings
23-08-2025 08:34,ANZE390E36058544E30B7D7,012-345-678,11111111,RAILWAY STATION ANZ,129.55,0,663532.88,DR,REF888794,ANZ,Savings
23-08-2025 08:46,ANZ0C14B0C2674E440D8B21,012-345-678,11111111,JB HI-FI ANZ,95.64,0,663437.24,DR,REF111968,ANZ,Savings
23-08-2025 09:06,ANZAE9106EC37984ADC8458,012-345-678,11111111,PAYMENT GATEWAY ANZ,4.11,0,663433.13,DR,REF837510,ANZ,Savings
23-08-2025 09:08,ANZD531C7AEF255427B9FFA,012-345-678,11111111,BANK FEE ANZ,10.56,0,663422.57,DR,REF315635,ANZ,Savings
23-08-2025 09:16,ANZC3DB7A9B9795425F8428,012-345-678,11111111,WAGES CREDIT ANZ,0,268.23,663690.8,CR,REF872343,ANZ,Savings
23-08-2025 09:34,ANZC63A9AFFFA9340BC91FD,012-345-678,11111111,KFC ANZ,95.2,0,663595.6,DR,REF178988,ANZ,Savings
23-08-2025 10:12,ANZB18EBB0AB16844248B1F,012-345-678,11111111,ALDI ANZ,58.56,0,663537.04,DR,REF548327,ANZ,Savings
23-08-2025 10:13,ANZ2F3C7BDDB307428EBBA6,012-345-678,11111111,WOOLWORTHS ANZ,31.52,0,663505.52,DR,REF979143,ANZ,Savings
23-08-2025 10:31,ANZBA75AB6C209746B2B861,012-345-678,11111111,FLIXBUS ANZ,34.27,0,663471.25,DR,REF565392,ANZ,Savings
23-08-2025 10:54,ANZ0E94C4D44B924CF88897,012-345-678,11111111,LIQUORLAND ANZ,44.49,0,663426.76,DR,REF924053,ANZ,Savings
23-08-2025 11:46,ANZ519E0E6E87B24A01822E,012-345-678,11111111,PAYMENT GATEWAY ANZ,26.57,0,663400.19,DR,REF581074,ANZ,Savings
23-08-2025 12:13,ANZB47299DAD04B449B8F6E,012-345-678,11111111,WOOLWORTHS ANZ,104.5,0,663295.69,DR,REF328413,ANZ,Savings
23-08-2025 12:17,ANZ93CD2B2858C4498C97E0,012-345-678,11111111,LIQUORLAND ANZ,173.46,0,663122.23,DR,REF183757,ANZ,Savings
23-08-2025 12:20,ANZ8D4B2067E0B844CFB3A1,012-345-678,11111111,UBER EATS ANZ,103.58,0,663018.65,DR,REF890308,ANZ,Savings
23-08-2025 13:00,ANZ5325D311AF3746DFAD0A,012-345-678,11111111,APPLE ANZ,16.72,0,663001.93,DR,REF657380,ANZ,Savings
23-08-2025 14:11,ANZ531E510589E548D39F40,012-345-678,11111111,7-ELEVEN ANZ,58.94,0,662942.99,DR,REF596390,ANZ,Savings
23-08-2025 14:32,ANZ43FB0AAEFC874E578D34,012-345-678,11111111,PAYMENT GATEWAY ANZ,143.51,0,662799.48,DR,REF475525,ANZ,Savings
23-08-2025 14:41,ANZAE9AD6906C8A484E9898,012-345-678,11111111,TAFE BOOKSHOP ANZ,267.11,0,662532.37,DR,REF529220,ANZ,Savings
23-08-2025 14:52,ANZ60018E3EB35745738805,012-345-678,11111111,ZOOM ANZ,7.01,0,662525.36,DR,REF669340,ANZ,Savings
23-08-2025 14:56,ANZ21BBA244059746A89B48,012-345-678,11111111,HARVEY NORMAN ANZ,38.2,0,662487.16,DR,REF649742,ANZ,Savings
23-08-2025 15:46,ANZ21C4BEECB19E4C85870C,012-345-678,11111111,CITYLINK ANZ,127.63,0,662359.53,DR,REF131417,ANZ,Savings
23-08-2025 15:48,ANZA1D68245B51B4409B1C6,012-345-678,11111111,COLES ANZ,31.36,0,662328.17,DR,REF375307,ANZ,Savings
23-08-2025 16:00,ANZ15EE829702194D67991D,012-345-678,11111111,INTERNET TRANSFER ANZ,15.79,0,662312.38,DR,REF350758,ANZ,Savings
23-08-2025 16:14,ANZAB7F4704DDFD48EA8F81,012-345-678,11111111,TAFE BOOKSHOP ANZ,92.6,0,662219.78,DR,REF133414,ANZ,Savings
23-08-2025 16:39,ANZ4B12D017F3D6410D9D2C,012-345-678,11111111,ZOOM ANZ,24.92,0,662194.86,DR,REF389800,ANZ,Savings
23-08-2025 16:52,ANZ8FEDBF0D67DE47E59B17,012-345-678,11111111,APPLE ANZ,14.59,0,662180.27,DR,REF389586,ANZ,Savings
23-08-2025 17:12,ANZ0A8068EEA21E46638F04,012-345-678,11111111,WOOLWORTHS ANZ,23.39,0,662156.88,DR,REF984134,ANZ,Savings
23-08-2025 17:28,ANZED66A4EFB0A54ABF985F,012-345-678,11111111,DOMINO'S PIZZA ANZ,55.75,0,662101.13,DR,REF315271,ANZ,Savings
23-08-2025 17:45,ANZA98D906E5CF74EEEB37D,012-345-678,11111111,SALARY PAYMENT ANZ,0,6113.62,668214.75,CR,REF857278,ANZ,Savings
23-08-2025 18:00,ANZ11B666DF315541DD9D31,012-345-678,11111111,BWS ANZ,22.3,0,668192.45,DR,REF336397,ANZ,Savings
23-08-2025 18:08,ANZD38694E91AC3430FA49B,012-345-678,11111111,PAYMENT GATEWAY ANZ,20.08,0,668172.37,DR,REF292642,ANZ,Savings
23-08-2025 18:20,ANZ0EB0A29B19924FA2BB78,012-345-678,11111111,COLES ANZ,11.95,0,668160.42,DR,REF602718,ANZ,Savings
23-08-2025 18:23,ANZ9BE9CF1C958C427683FF,012-345-678,11111111,APPLE ANZ,44.47,0,668115.95,DR,REF882798,ANZ,Savings
23-08-2025 18:26,ANZ0E5D8EA8494347BDBD77,012-345-678,11111111,KFC ANZ,47.3,0,668068.65,DR,REF496909,ANZ,Savings
23-08-2025 18:51,ANZD845E2A3A0C94D2D9AB4,012-345-678,11111111,MENULOG ANZ,63.3,0,668005.35,DR,REF889013,ANZ,Savings
23-08-2025 19:12,ANZ0B87EE2F5F9741749B67,012-345-678,11111111,INTERNET TRANSFER ANZ,9.2,0,667996.15,DR,REF280710,ANZ,Savings
23-08-2025 19:16,ANZ55510E1174A34FE0AA14,012-345-678,11111111,RAILWAY STATION ANZ,56.75,0,667939.4,DR,REF239684,ANZ,Savings
23-08-2025 19:17,ANZ5E67A437E5AE45D5AF07,012-345-678,11111111,7-ELEVEN ANZ,33.1,0,667906.3,DR,REF215840,ANZ,Savings
23-08-2025 19:24,ANZ8A1DC81FC8154279ADC6,012-345-678,11111111,MENULOG ANZ,16.64,0,667889.66,DR,REF599368,ANZ,Savings
23-08-2025 19:27,ANZD290D6A588284680A065,012-345-678,11111111,JB HI-FI ANZ,128.3,0,667761.36,DR,REF395940,ANZ,Savings
23-08-2025 19:55,ANZ49DFA7709BD943899120,012-345-678,11111111,ALDI ANZ,23.27,0,667738.09,DR,REF430461,ANZ,Savings
23-08-2025 19:57,ANZ974866563A304EFB985F,012-345-678,11111111,SHELL ANZ,86.41,0,667651.68,DR,REF930318,ANZ,Savings
23-08-2025 20:14,ANZBA33D80DF835422DB9FD,012-345-678,11111111,JB HI-FI ANZ,23.51,0,667628.17,DR,REF197848,ANZ,Savings
23-08-2025 20:47,ANZB9839BBF0FDE494A8132,012-345-678,11111111,JB HI-FI ANZ,24.63,0,667603.54,DR,REF949569,ANZ,Savings
23-08-2025 21:00,ANZ4DFBA8B8050F40F6B673,012-345-678,11111111,ALDI ANZ,22.94,0,667580.6,DR,REF461297,ANZ,Savings
23-08-2025 21:26,ANZ7F64CB7E11D4424092FC,012-345-678,11111111,KFC ANZ,98.33,0,667482.27,DR,REF247538,ANZ,Savings
23-08-2025 21:39,ANZ5B89C7EC67F74F07B123,012-345-678,11111111,COMPANY PAYROLL ANZ,0,3598.97,671081.24,CR,REF118821,ANZ,Savings
23-08-2025 22:28,ANZ745379C5C9E5495F9368,012-345-678,11111111,INTERNET TRANSFER ANZ,56.01,0,671025.23,DR,REF886546,ANZ,Savings
23-08-2025 22:33,ANZ9E71B3FD581C493EB805,012-345-678,11111111,JB HI-FI ANZ,144.52,0,670880.71,DR,REF746788,ANZ,Savings
23-08-2025 23:22,ANZB6575C5D5C48462DB0ED,012-345-678,11111111,PAYMENT GATEWAY ANZ,17.08,0,670863.63,DR,REF913636,ANZ,Savings
23-08-2025 23:48,ANZ7D65359D2E5146FEAE2B,012-345-678,11111111,BANK FEE ANZ,10.17,0,670853.46,DR,REF763481,ANZ,Savings
24-08-2025 00:01,ANZ0229284EAEB54A87AFC6,012-345-678,11111111,SALARY PAYMENT ANZ,0,4313.22,675166.68,CR,REF649736,ANZ,Savings
24-08-2025 00:20,ANZ8FF222BF2D03411086B5,012-345-678,11111111,DOMINO'S PIZZA ANZ,65.49,0,675101.19,DR,REF508853,ANZ,Savings
24-08-2025 00:54,ANZFDDB726ADCCA493FA2BD,012-345-678,11111111,BP ANZ,224.71,0,674876.48,DR,REF110496,ANZ,Savings
24-08-2025 01:56,ANZF027DD822CD04BFBB368,012-345-678,11111111,AMAZON AU ANZ,21.58,0,674854.9,DR,REF157500,ANZ,Savings
24-08-2025 02:15,ANZ0808D8B8198A4ED1929B,012-345-678,11111111,SHELL ANZ,104.05,0,674750.85,DR,REF221212,ANZ,Savings
24-08-2025 02:21,ANZ7D89CA7CB43A43F6A2BD,012-345-678,11111111,WOOLWORTHS ANZ,101.18,0,674649.67,DR,REF350081,ANZ,Savings
24-08-2025 02:32,ANZ6010819C4B0C49B5811D,012-345-678,11111111,BWS ANZ,229.83,0,674419.84,DR,REF826615,ANZ,Savings
24-08-2025 03:33,ANZCC434FA1A3FB4815B69A,012-345-678,11111111,MENULOG ANZ,37.78,0,674382.06,DR,REF865343,ANZ,Savings
24-08-2025 03:56,ANZ6575E03B61C24C2D9AC3,012-345-678,11111111,BP ANZ,132.03,0,674250.03,DR,REF287780,ANZ,Savings
24-08-2025 04:35,ANZ96D443ADB19342DBBA97,012-345-678,11111111,SALARY PAYMENT ANZ,0,1164.85,675414.88,CR,REF565551,ANZ,Savings
24-08-2025 04:46,ANZB907FE8ACF0C44E09F6E,012-345-678,11111111,APPLE ANZ,5.2,0,675409.68,DR,REF169133,ANZ,Savings
24-08-2025 04:49,ANZD99E1014BAFA44B2AAB4,012-345-678,11111111,AMAZON AU ANZ,58.25,0,675351.43,DR,REF150379,ANZ,Savings
24-08-2025 04:50,ANZ54682DB938C145CD80D4,012-345-678,11111111,HARVEY NORMAN ANZ,36.43,0,675315,DR,REF246057,ANZ,Savings
24-08-2025 05:05,ANZ36EC32E5809942F8AFC6,012-345-678,11111111,RAILWAY STATION ANZ,3.01,0,675311.99,DR,REF725764,ANZ,Savings
24-08-2025 05:09,ANZB33F6C1635BC4CF9B655,012-345-678,11111111,JB HI-FI ANZ,142,0,675169.99,DR,REF965845,ANZ,Savings
24-08-2025 05:13,ANZ9454592B789042839DE8,012-345-678,11111111,KFC ANZ,35.23,0,675134.76,DR,REF292292,ANZ,Savings
24-08-2025 05:33,ANZDA9BFB38A9B04A7B8213,012-345-678,11111111,LIQUORLAND ANZ,14.58,0,675120.18,DR,REF210199,ANZ,Savings
24-08-2025 05:40,ANZ93ADAF1BB4944BC4AE6C,012-345-678,11111111,PAY - SALARY ANZ,0,1104.82,676225,CR,REF980006,ANZ,Savings
24-08-2025 05:45,ANZ02625144A2FC41E5A643,012-345-678,11111111,BANK FEE ANZ,25.81,0,676199.19,DR,REF272421,ANZ,Savings
24-08-2025 05:45,ANZ2D7F079FA10B496E8EC1,012-345-678,11111111,TAFE BOOKSHOP ANZ,32.81,0,676166.38,DR,REF239329,ANZ,Savings
24-08-2025 05:57,ANZB19B87E4EB9F49C8BB65,012-345-678,11111111,COMPANY PAYROLL ANZ,0,88.02,676254.4,CR,REF569665,ANZ,Savings
24-08-2025 06:02,ANZCAA99329BCC342C7B44E,012-345-678,11111111,UBER EATS ANZ,50.66,0,676203.74,DR,REF140467,ANZ,Savings
24-08-2025 06:04,ANZ653815E26277495188B0,012-345-678,11111111,RAILWAY STATION ANZ,45.76,0,676157.98,DR,REF482586,ANZ,Savings
24-08-2025 06:12,ANZ75230FA8E6B7475396A6,012-345-678,11111111,SPOTIFY ANZ,93.82,0,676064.16,DR,REF969782,ANZ,Savings
24-08-2025 06:32,ANZ1F81194528244BAA830F,012-345-678,11111111,ZOOM ANZ,73.41,0,675990.75,DR,REF685567,ANZ,Savings
24-08-2025 06:35,ANZ0B75E902BE694389AB4D,012-345-678,11111111,INTERNET TRANSFER ANZ,12.93,0,675977.82,DR,REF482312,ANZ,Savings
24-08-2025 07:08,ANZ50FA9A33BABE479182C8,012-345-678,11111111,COLES ANZ,181.99,0,675795.83,DR,REF489945,ANZ,Savings
24-08-2025 07:19,ANZA38E1A5C841442F1AB71,012-345-678,11111111,PAY - SALARY ANZ,0,2515.59,678311.42,CR,REF160642,ANZ,Savings
24-08-2025 07:23,ANZA3B2508A012E40B69934,012-345-678,11111111,PAYMENT GATEWAY ANZ,102.3,0,678209.12,DR,REF735173,ANZ,Savings
24-08-2025 07:25,ANZ50DA60D436F34AD6BC2E,012-345-678,11111111,PAY - SALARY ANZ,0,999.25,679208.37,CR,REF427678,ANZ,Savings
24-08-2025 07:26,ANZA342350C7BFE4D24AF91,012-345-678,11111111,BWS ANZ,38,0,679170.37,DR,REF131792,ANZ,Savings
24-08-2025 07:27,ANZ480C859247B94B358BFF,012-345-678,11111111,WOOLWORTHS ANZ,104.08,0,679066.29,DR,REF769285,ANZ,Savings
24-08-2025 07:38,INTB106D587E2AA444194BF,012-345-678,11111111,TRANSFER FROM NAB 44444444,0,410.65,679476.94,CR,INT-91827,ANZ,Savings
24-08-2025 07:56,ANZCBA7470243BC484784FD,012-345-678,11111111,BWS ANZ,43.02,0,679433.92,DR,REF984564,ANZ,Savings
24-08-2025 08:11,ANZ1254A96FE8D74D8FB428,012-345-678,11111111,PAYROLL CREDIT ANZ,0,5941.75,685375.67,CR,REF516703,ANZ,Savings
24-08-2025 08:40,ANZ1064A403485D4A149613,012-345-678,11111111,BP ANZ,6.44,0,685369.23,DR,REF145454,ANZ,Savings
24-08-2025 08:46,ANZC05099EEC70F472C9991,012-345-678,11111111,PAYMENT GATEWAY ANZ,32.11,0,685337.12,DR,REF246146,ANZ,Savings
24-08-2025 08:52,ANZAB0F16EA31AD4195A22B,012-345-678,11111111,PAYPAL *NETFLIX ANZ,122.64,0,685214.48,DR,REF926753,ANZ,Savings
24-08-2025 09:23,ANZB9C5D9DDFC89467BAB3D,012-345-678,11111111,INTERNET TRANSFER ANZ,85.66,0,685128.82,DR,REF922687,ANZ,Savings
24-08-2025 09:32,ANZD3E043743AB34A6AAF95,012-345-678,11111111,DOMINO'S PIZZA ANZ,11.14,0,685117.68,DR,REF867434,ANZ,Savings
24-08-2025 09:38,ANZAAB4F981A2F64034900D,012-345-678,11111111,HARVEY NORMAN ANZ,123.43,0,684994.25,DR,REF530106,ANZ,Savings
24-08-2025 09:43,ANZD3B00FBC51ED40D3B650,012-345-678,11111111,BWS ANZ,59.81,0,684934.44,DR,REF543047,ANZ,Savings
24-08-2025 09:44,ANZ1DB8F4CEEEEE487BA394,012-345-678,11111111,AMAZON AU ANZ,99.58,0,684834.86,DR,REF483548,ANZ,Savings
24-08-2025 10:19,ANZB547CB81456B4A90B08E,012-345-678,11111111,PAYROLL CREDIT ANZ,0,3844.64,688679.5,CR,REF634655,ANZ,Savings
24-08-2025 10:21,ANZA7720834A45F4B10A7BE,012-345-678,11111111,SPOTIFY ANZ,90.1,0,688589.4,DR,REF488196,ANZ,Savings
24-08-2025 10:44,ANZ41C87C1ADAE349E78BBB,012-345-678,11111111,ALDI ANZ,61.12,0,688528.28,DR,REF259514,ANZ,Savings
24-08-2025 10:46,ANZB6C00ADA30C94926B999,012-345-678,11111111,BIGW ANZ,10.8,0,688517.48,DR,REF568008,ANZ,Savings
24-08-2025 11:11,ANZ04212E15923F490F9DF8,012-345-678,11111111,TAFE BOOKSHOP ANZ,7.72,0,688509.76,DR,REF494262,ANZ,Savings
24-08-2025 12:00,ANZ434108A95753411CA498,012-345-678,11111111,PAY - SALARY ANZ,0,251.96,688761.72,CR,REF295071,ANZ,Savings
24-08-2025 12:02,ANZDB141CD008574B228704,012-345-678,11111111,AMAZON AU ANZ,162.55,0,688599.17,DR,REF497327,ANZ,Savings
24-08-2025 12:10,ANZ081E6C1DD700420BAC4E,012-345-678,11111111,PAYMENT GATEWAY ANZ,76.83,0,688522.34,DR,REF682699,ANZ,Savings
24-08-2025 12:14,ANZBFF8AAC7A2B54049BEEB,012-345-678,11111111,COLES ANZ,42.63,0,688479.71,DR,REF770775,ANZ,Savings
24-08-2025 12:51,ANZ3AF4F691569A4F529DC5,012-345-678,11111111,HARVEY NORMAN ANZ,53.71,0,688426,DR,REF981870,ANZ,Savings
24-08-2025 13:53,ANZ790820D6A67D4F60912D,012-345-678,11111111,KFC ANZ,77.57,0,688348.43,DR,REF459418,ANZ,Savings
24-08-2025 13:54,ANZ256AC8ACE1DC42A1AD97,012-345-678,11111111,HARVEY NORMAN ANZ,122.5,0,688225.93,DR,REF214478,ANZ,Savings
24-08-2025 14:09,ANZ2DC12DA615CC4585A627,012-345-678,11111111,JB HI-FI ANZ,74.42,0,688151.51,DR,REF554970,ANZ,Savings
24-08-2025 14:23,ANZ53AB35D1C1B04C4AA6D3,012-345-678,11111111,SPOTIFY ANZ,76.18,0,688075.33,DR,REF105934,ANZ,Savings
24-08-2025 14:35,ANZ7387FFDB65EA460084C1,012-345-678,11111111,LIQUORLAND ANZ,21.63,0,688053.7,DR,REF617152,ANZ,Savings
24-08-2025 15:42,ANZBCB3724EF6F34192A49E,012-345-678,11111111,KFC ANZ,43.08,0,688010.62,DR,REF722787,ANZ,Savings
24-08-2025 15:58,ANZ3CC8F664FA0049A699F2,012-345-678,11111111,SHELL ANZ,49.41,0,687961.21,DR,REF708829,ANZ,Savings
24-08-2025 16:15,ANZ3B3BC1B2089F4519BF96,012-345-678,11111111,COMPANY PAYROLL ANZ,0,5767.55,693728.76,CR,REF543445,ANZ,Savings
24-08-2025 16:28,ANZ251D96DE7D7C48C2A053,012-345-678,11111111,WAGES CREDIT ANZ,0,497.87,694226.63,CR,REF535265,ANZ,Savings
24-08-2025 16:31,ANZ951A7C325F3E43CE83E8,012-345-678,11111111,BP ANZ,73.49,0,694153.14,DR,REF597962,ANZ,Savings
24-08-2025 17:13,ANZ1EBF8A3B9D1E4669A32A,012-345-678,11111111,STARBUCKS ANZ,12.6,0,694140.54,DR,REF948874,ANZ,Savings
24-08-2025 17:23,INTC025D213158340B18230,012-345-678,11111111,TRANSFER TO CBA 22222222,1012.01,0,693128.53,DR,INT-71207,ANZ,Savings
24-08-2025 17:37,ANZB01E3F5FAB6C442C9D05,012-345-678,11111111,PAYMENT GATEWAY ANZ,7.93,0,693120.6,DR,REF512138,ANZ,Savings
24-08-2025 18:10,INT379FC65EF8B74B789E6D,012-345-678,11111111,TRANSFER FROM CBA 33333333,0,1326.81,694447.41,CR,INT-21120,ANZ,Savings
24-08-2025 18:15,ANZC62FE87D5D1940D689BC,012-345-678,11111111,KFC ANZ,110.32,0,694337.09,DR,REF898140,ANZ,Savings
24-08-2025 18:31,ANZFFCAD9E750F5463CA533,012-345-678,11111111,MCDONALDS ANZ,15.3,0,694321.79,DR,REF517122,ANZ,Savings
24-08-2025 18:35,ANZE3BEA4E71CC449A8B037,012-345-678,11111111,RAILWAY STATION ANZ,16.9,0,694304.89,DR,REF432130,ANZ,Savings
24-08-2025 18:45,ANZ809DAC9668B84E56BA89,012-345-678,11111111,BP ANZ,18.75,0,694286.14,DR,REF716671,ANZ,Savings
24-08-2025 19:18,ANZ3FA90CA7707E4DA7A9B5,012-345-678,11111111,STARBUCKS ANZ,17,0,694269.14,DR,REF806183,ANZ,Savings
24-08-2025 19:20,ANZF814F95A95BE4029B21B,012-345-678,11111111,7-ELEVEN ANZ,100.18,0,694168.96,DR,REF751243,ANZ,Savings
24-08-2025 19:27,ANZ1AAF28D2E0A24BACBD3D,012-345-678,11111111,CITYLINK ANZ,14.9,0,694154.06,DR,REF107465,ANZ,Savings
24-08-2025 20:49,ANZE17A703D04B148648F7C,012-345-678,11111111,ZOOM ANZ,76.91,0,694077.15,DR,REF132000,ANZ,Savings
24-08-2025 21:37,ANZ1F6069EAAA79432FA4F2,012-345-678,11111111,STARBUCKS ANZ,22.09,0,694055.06,DR,REF658217,ANZ,Savings
24-08-2025 21:41,ANZ66B75DF55D274BE1BC18,012-345-678,11111111,APPLE ANZ,141.42,0,693913.64,DR,REF283533,ANZ,Savings
24-08-2025 21:47,ANZ61FA2602705A498DA28B,012-345-678,11111111,COLES ANZ,4.95,0,693908.69,DR,REF805691,ANZ,Savings
24-08-2025 21:52,ANZ1D6A7C5A0E4444E78595,012-345-678,11111111,ALDI ANZ,92.04,0,693816.65,DR,REF896117,ANZ,Savings
24-08-2025 22:18,ANZC0A2E62D7DDF43B98DF2,012-345-678,11111111,KFC ANZ,33.94,0,693782.71,DR,REF361287,ANZ,Savings
24-08-2025 22:21,ANZ3E5157669514483E9644,012-345-678,11111111,LIQUORLAND ANZ,28.78,0,693753.93,DR,REF753377,ANZ,Savings
24-08-2025 22:23,ANZDAF7C829C3CE4F42B825,012-345-678,11111111,APPLE ANZ,41.65,0,693712.28,DR,REF242599,ANZ,Savings
24-08-2025 22:28,ANZ8DDEAA2FBB8B4A8199DC,012-345-678,11111111,PAYPAL *NETFLIX ANZ,29.27,0,693683.01,DR,REF349985,ANZ,Savings
24-08-2025 22:28,ANZ18B020692CE3402C8C1A,012-345-678,11111111,KFC ANZ,16.59,0,693666.42,DR,REF307835,ANZ,Savings
24-08-2025 23:09,INT07FA26D0232340CEAD65,012-345-678,11111111,TRANSFER TO CBA 22222222,1643.87,0,692022.55,DR,INT-16979,ANZ,Savings
24-08-2025 23:14,ANZ0B5CACF5D07D4639A92B,012-345-678,11111111,HARVEY NORMAN ANZ,113.45,0,691909.1,DR,REF655497,ANZ,Savings
24-08-2025 23:24,ANZF50416D96FAE4FB5899F,012-345-678,11111111,LIQUORLAND ANZ,30.79,0,691878.31,DR,REF439917,ANZ,Savings
25-08-2025 00:29,ANZ16DA908B64974C98A16B,012-345-678,11111111,PAY - SALARY ANZ,0,10.4,691888.71,CR,REF720631,ANZ,Savings
25-08-2025 00:33,ANZB75D88FC823A4DB09456,012-345-678,11111111,BANK FEE ANZ,29.32,0,691859.39,DR,REF194725,ANZ,Savings
25-08-2025 00:33,ANZ96007460A54C431886BD,012-345-678,11111111,HARVEY NORMAN ANZ,102.54,0,691756.85,DR,REF377780,ANZ,Savings
25-08-2025 00:41,ANZB444B1DCF0AF42928184,012-345-678,11111111,7-ELEVEN ANZ,16.25,0,691740.6,DR,REF618456,ANZ,Savings
25-08-2025 01:06,ANZ14A64E6E58B345A991A4,012-345-678,11111111,PAY - SALARY ANZ,0,2005.39,693745.99,CR,REF879430,ANZ,Savings
25-08-2025 01:12,ANZ3E7EFD32657D453DB56B,012-345-678,11111111,WAGES CREDIT ANZ,0,561.45,694307.44,CR,REF315306,ANZ,Savings
25-08-2025 01:36,ANZ1DCA7C65E0044F6B92D8,012-345-678,11111111,INTERNET TRANSFER ANZ,7.09,0,694300.35,DR,REF979275,ANZ,Savings
25-08-2025 02:25,ANZ140DAC0CAA2646CD96CD,012-345-678,11111111,STARBUCKS ANZ,8.57,0,694291.78,DR,REF843851,ANZ,Savings
25-08-2025 02:40,ANZ648F431CD52A4B3AB985,012-345-678,11111111,WAGES CREDIT ANZ,0,4119.7,698411.48,CR,REF674777,ANZ,Savings
25-08-2025 02:55,ANZAB62EF72405B4ABF8693,012-345-678,11111111,BANK FEE ANZ,105.8,0,698305.68,DR,REF948230,ANZ,Savings
25-08-2025 03:09,ANZ6C85F792F9E644CF926F,012-345-678,11111111,ALDI ANZ,56.15,0,698249.53,DR,REF554031,ANZ,Savings
25-08-2025 03:24,ANZBE2F3FD8CAAC481B8CD5,012-345-678,11111111,HARVEY NORMAN ANZ,27.83,0,698221.7,DR,REF846335,ANZ,Savings
25-08-2025 03:49,ANZD6153467D515468BBD7E,012-345-678,11111111,SHELL ANZ,20.48,0,698201.22,DR,REF806030,ANZ,Savings
25-08-2025 03:56,ANZ89350DB653884810909D,012-345-678,11111111,STARBUCKS ANZ,79.04,0,698122.18,DR,REF326659,ANZ,Savings
25-08-2025 04:13,ANZ39531B36DF204F199FC6,012-345-678,11111111,MENULOG ANZ,35.96,0,698086.22,DR,REF480460,ANZ,Savings
25-08-2025 04:17,ANZ797E2262FFB24005888B,012-345-678,11111111,WOOLWORTHS ANZ,81.12,0,698005.1,DR,REF636837,ANZ,Savings
25-08-2025 04:40,ANZ3B17EDAD9D1B47DDACFF,012-345-678,11111111,KFC ANZ,22.49,0,697982.61,DR,REF891025,ANZ,Savings
25-08-2025 05:15,ANZ6961233104264E67BF0C,012-345-678,11111111,7-ELEVEN ANZ,4.7,0,697977.91,DR,REF712095,ANZ,Savings
25-08-2025 05:33,ANZEB3357296423417BA95C,012-345-678,11111111,CITYLINK ANZ,81.93,0,697895.98,DR,REF197032,ANZ,Savings
25-08-2025 05:43,ANZ3E25DA0CFC914ABEA048,012-345-678,11111111,ALDI ANZ,72.94,0,697823.04,DR,REF635913,ANZ,Savings
25-08-2025 06:32,ANZ1CF50BBF1B5141C4B334,012-345-678,11111111,JB HI-FI ANZ,37.74,0,697785.3,DR,REF283915,ANZ,Savings
25-08-2025 06:40,ANZEFDCDDD4E28441DD9ED0,012-345-678,11111111,BANK FEE ANZ,6.51,0,697778.79,DR,REF154313,ANZ,Savings
25-08-2025 06:55,ANZ5FAC87FFE25B491BBE77,012-345-678,11111111,MENULOG ANZ,50.85,0,697727.94,DR,REF396191,ANZ,Savings
25-08-2025 07:29,ANZC7346AA4FC814139B9C3,012-345-678,11111111,BP ANZ,205.85,0,697522.09,DR,REF126858,ANZ,Savings
25-08-2025 07:44,ANZ61FD6B8EED3F473688FE,012-345-678,11111111,APPLE ANZ,184.79,0,697337.3,DR,REF986680,ANZ,Savings
25-08-2025 07:47,ANZD9A7EDFE0817411095FC,012-345-678,11111111,SPOTIFY ANZ,19.98,0,697317.32,DR,REF597295,ANZ,Savings
25-08-2025 08:11,INTF2E41A968AEF425DBB72,012-345-678,11111111,TRANSFER TO CBA 33333333,455.5,0,696861.82,DR,INT-11938,ANZ,Savings
25-08-2025 08:25,ANZ039B0EA1B08F45118745,012-345-678,11111111,INTERNET TRANSFER ANZ,131.4,0,696730.42,DR,REF790869,ANZ,Savings
25-08-2025 08:50,ANZ7783543062B34F6193D1,012-345-678,11111111,SALARY PAYMENT ANZ,0,662.17,697392.59,CR,REF851359,ANZ,Savings
25-08-2025 09:07,ANZDCDF66C043C343C9A1B8,012-345-678,11111111,BANK FEE ANZ,75.74,0,697316.85,DR,REF605977,ANZ,Savings
25-08-2025 09:07,ANZ1981EB2E28B740F9B358,012-345-678,11111111,APPLE ANZ,53.7,0,697263.15,DR,REF219242,ANZ,Savings
25-08-2025 09:20,ANZ715CDF116B8D4FB3A181,012-345-678,11111111,MCDONALDS ANZ,5.22,0,697257.93,DR,REF909793,ANZ,Savings
25-08-2025 09:27,ANZECB44EA5A6AF43BF9499,012-345-678,11111111,BP ANZ,65.23,0,697192.7,DR,REF199042,ANZ,Savings
25-08-2025 09:42,ANZC14F2F9964114E44973A,012-345-678,11111111,SPOTIFY ANZ,21.33,0,697171.37,DR,REF288533,ANZ,Savings
25-08-2025 09:51,ANZAAF66B0696B144D68428,012-345-678,11111111,ZOOM ANZ,61.73,0,697109.64,DR,REF939301,ANZ,Savings
25-08-2025 10:09,ANZ23C59B04EDA94F16BE64,012-345-678,11111111,RAILWAY STATION ANZ,6.61,0,697103.03,DR,REF125108,ANZ,Savings
25-08-2025 10:09,ANZ024761529B4347E6AAD9,012-345-678,11111111,CITYLINK ANZ,47.29,0,697055.74,DR,REF723285,ANZ,Savings
25-08-2025 10:22,ANZ1C6FCE290808487B9665,012-345-678,11111111,CITYLINK ANZ,130.28,0,696925.46,DR,REF106267,ANZ,Savings
25-08-2025 10:30,ANZ0A0661DDC0474790AC8B,012-345-678,11111111,BANK FEE ANZ,51.48,0,696873.98,DR,REF458427,ANZ,Savings
25-08-2025 10:48,ANZCC658646C8394CB1BC50,012-345-678,11111111,AMAZON AU ANZ,18.12,0,696855.86,DR,REF472372,ANZ,Savings
25-08-2025 11:07,ANZAE3CDEE8538E4B41B41A,012-345-678,11111111,KFC ANZ,12.03,0,696843.83,DR,REF599002,ANZ,Savings
25-08-2025 11:37,ANZ3FB742DA633E4406A5E8,012-345-678,11111111,BIGW ANZ,40.5,0,696803.33,DR,REF626036,ANZ,Savings
25-08-2025 11:50,ANZ9D25CEF67E614714B640,012-345-678,11111111,INTERNET TRANSFER ANZ,6.07,0,696797.26,DR,REF985544,ANZ,Savings
25-08-2025 12:33,ANZEF26ACEF934B4B1FAB92,012-345-678,11111111,COLES ANZ,24.32,0,696772.94,DR,REF348283,ANZ,Savings
25-08-2025 13:06,ANZF3FDBC921A114E888474,012-345-678,11111111,ZOOM ANZ,26.13,0,696746.81,DR,REF696589,ANZ,Savings
25-08-2025 13:23,ANZ0475BAF68FD14EA18380,012-345-678,11111111,SHELL ANZ,23.61,0,696723.2,DR,REF673281,ANZ,Savings
25-08-2025 13:35,ANZ10179D208AFA401C99B3,012-345-678,11111111,UBER EATS ANZ,6.79,0,696716.41,DR,REF457833,ANZ,Savings
25-08-2025 13:51,ANZ17377251AA1F4391A51E,012-345-678,11111111,PAYPAL *NETFLIX ANZ,37.5,0,696678.91,DR,REF778974,ANZ,Savings
25-08-2025 14:25,ANZ4142AF80175E4BCAA545,012-345-678,11111111,FLIXBUS ANZ,18.14,0,696660.77,DR,REF751516,ANZ,Savings
25-08-2025 15:14,ANZ76FA7EF4D5784B568340,012-345-678,11111111,SALARY PAYMENT ANZ,0,811.17,697471.94,CR,REF989120,ANZ,Savings
25-08-2025 15:20,ANZD92BE7F12FF74023A485,012-345-678,11111111,7-ELEVEN ANZ,19.29,0,697452.65,DR,REF246333,ANZ,Savings
25-08-2025 15:27,ANZ113AEAEF2EC54B818B9D,012-345-678,11111111,JB HI-FI ANZ,103.49,0,697349.16,DR,REF122237,ANZ,Savings
25-08-2025 15:59,ANZ2166F5A502484D668710,012-345-678,11111111,RAILWAY STATION ANZ,66.28,0,697282.88,DR,REF898546,ANZ,Savings
25-08-2025 16:47,ANZE2BCF7C78FE4433C860B,012-345-678,11111111,COMPANY PAYROLL ANZ,0,3166.36,700449.24,CR,REF469148,ANZ,Savings
25-08-2025 16:49,ANZBBB0394F7F5B40F2B685,012-345-678,11111111,AMAZON AU ANZ,27.48,0,700421.76,DR,REF377105,ANZ,Savings
25-08-2025 17:52,ANZF96F3F6238F24F2E8BBC,012-345-678,11111111,PAY - SALARY ANZ,0,4525.9,704947.66,CR,REF166192,ANZ,Savings
25-08-2025 18:48,ANZC9D53984CFB54395909E,012-345-678,11111111,KFC ANZ,40.69,0,704906.97,DR,REF479939,ANZ,Savings
25-08-2025 19:31,ANZ1071FFA5C8794CA281EE,012-345-678,11111111,UBER EATS ANZ,21.26,0,704885.71,DR,REF267418,ANZ,Savings
25-08-2025 20:08,ANZ6FE64FFB421D42FAA801,012-345-678,11111111,STARBUCKS ANZ,90.58,0,704795.13,DR,REF643765,ANZ,Savings
25-08-2025 20:14,ANZC22C18DFC67E46CFB2FE,012-345-678,11111111,HARVEY NORMAN ANZ,23.47,0,704771.66,DR,REF765811,ANZ,Savings
25-08-2025 20:24,ANZBDB0DC4CA0664BD890DD,012-345-678,11111111,INTERNET TRANSFER ANZ,49.9,0,704721.76,DR,REF371949,ANZ,Savings
25-08-2025 20:59,INT601B4D78EC924DB4BD36,012-345-678,11111111,TRANSFER TO NAB 44444444,1913.75,0,702808.01,DR,INT-80147,ANZ,Savings
25-08-2025 21:24,ANZ6AA202610FB3480E8D0E,012-345-678,11111111,COMPANY PAYROLL ANZ,0,5651.53,708459.54,CR,REF795738,ANZ,Savings
25-08-2025 21:31,ANZBBE14A48715D4BE1AD9D,012-345-678,11111111,PAYROLL CREDIT ANZ,0,5618.17,714077.71,CR,REF866584,ANZ,Savings
25-08-2025 21:51,ANZ7AD609A32B1F45D3A475,012-345-678,11111111,RAILWAY STATION ANZ,20.99,0,714056.72,DR,REF119862,ANZ,Savings
25-08-2025 23:02,ANZ05321E786A2C4252A3FB,012-345-678,11111111,STARBUCKS ANZ,53.58,0,714003.14,DR,REF599158,ANZ,Savings
25-08-2025 23:05,ANZ1F5C87968F004B2C9CB5,012-345-678,11111111,APPLE ANZ,45.93,0,713957.21,DR,REF214231,ANZ,Savings
25-08-2025 23:12,ANZB3F3657810E54C4E813F,012-345-678,11111111,MCDONALDS ANZ,11.24,0,713945.97,DR,REF322750,ANZ,Savings
25-08-2025 23:14,INT36264F0B20AC4E3AB6AA,012-345-678,11111111,TRANSFER TO CBA 22222222,958.53,0,712987.44,DR,INT-14310,ANZ,Savings
25-08-2025 23:27,ANZB5BD0722A65E4107AB16,012-345-678,11111111,BIGW ANZ,18.79,0,712968.65,DR,REF592065,ANZ,Savings
25-08-2025 23:33,ANZ4870954E62DB4B2D8BE7,012-345-678,11111111,WOOLWORTHS ANZ,15.21,0,712953.44,DR,REF995581,ANZ,Savings
25-08-2025 23:40,ANZ66546A21893E47A7A91F,012-345-678,11111111,STARBUCKS ANZ,7.96,0,712945.48,DR,REF891809,ANZ,Savings
25-08-2025 23:54,ANZ2AD4B164FE464FA9B73E,012-345-678,11111111,HARVEY NORMAN ANZ,85.11,0,712860.37,DR,REF285964,ANZ,Savings
26-08-2025 00:06,ANZAE1664BCA44F4FC2B004,012-345-678,11111111,SPOTIFY ANZ,14.74,0,712845.63,DR,REF719923,ANZ,Savings
26-08-2025 00:24,ANZF52E7847D5E348E7962D,012-345-678,11111111,RAILWAY STATION ANZ,37.76,0,712807.87,DR,REF823225,ANZ,Savings
26-08-2025 00:29,INTC81224E02EF54C2E933C,012-345-678,11111111,TRANSFER TO CBA 22222222,1878.85,0,710929.02,DR,INT-36060,ANZ,Savings
26-08-2025 00:52,ANZB014BBD4B814414CBE83,012-345-678,11111111,SHELL ANZ,128.25,0,710800.77,DR,REF507282,ANZ,Savings
26-08-2025 01:01,ANZAC0B307657694152837A,012-345-678,11111111,INTERNET TRANSFER ANZ,32.74,0,710768.03,DR,REF609733,ANZ,Savings
26-08-2025 01:06,ANZ3DF22F7D90E34D80A621,012-345-678,11111111,DOMINO'S PIZZA ANZ,4.38,0,710763.65,DR,REF322118,ANZ,Savings
26-08-2025 02:10,ANZ920A9892D884447C9C66,012-345-678,11111111,COMPANY PAYROLL ANZ,0,2373.14,713136.79,CR,REF143178,ANZ,Savings
26-08-2025 02:42,ANZ079B5B145B554D6A99E0,012-345-678,11111111,PAYPAL *NETFLIX ANZ,100.01,0,713036.78,DR,REF927211,ANZ,Savings
26-08-2025 03:12,ANZ37B6B9B454D747C88459,012-345-678,11111111,PAYROLL CREDIT ANZ,0,3823.52,716860.3,CR,REF867024,ANZ,Savings
26-08-2025 03:37,ANZ1EB2030C5A2E48EFB392,012-345-678,11111111,RAILWAY STATION ANZ,128.79,0,716731.51,DR,REF988512,ANZ,Savings
26-08-2025 03:41,ANZD7D79003A4CE40039BF6,012-345-678,11111111,FLIXBUS ANZ,49.7,0,716681.81,DR,REF807885,ANZ,Savings
26-08-2025 03:59,ANZ7735FE7FD1F4439086A3,012-345-678,11111111,JB HI-FI ANZ,29.32,0,716652.49,DR,REF928970,ANZ,Savings
26-08-2025 04:03,ANZFD03D5CAE3C54A7589F8,012-345-678,11111111,PAY - SALARY ANZ,0,7467.84,724120.33,CR,REF675316,ANZ,Savings
26-08-2025 04:09,ANZ3F014F5C3A374D84A881,012-345-678,11111111,SHELL ANZ,9.48,0,724110.85,DR,REF979678,ANZ,Savings
26-08-2025 04:14,ANZ6DB5992B0C894A43AD2A,012-345-678,11111111,MENULOG ANZ,9.4,0,724101.45,DR,REF156219,ANZ,Savings
26-08-2025 05:28,INT90F62B810C7142A9AEEA,012-345-678,11111111,TRANSFER TO CBA 22222222,1849.34,0,722252.11,DR,INT-80072,ANZ,Savings
26-08-2025 05:31,ANZ07246B29A59A4F538F74,012-345-678,11111111,UBER EATS ANZ,10.42,0,722241.69,DR,REF181797,ANZ,Savings
26-08-2025 05:51,ANZE3BF7BBC2DA8424A9E8C,012-345-678,11111111,WOOLWORTHS ANZ,17.18,0,722224.51,DR,REF110728,ANZ,Savings
26-08-2025 05:53,ANZ16B119BFB4BA42139370,012-345-678,11111111,7-ELEVEN ANZ,86.38,0,722138.13,DR,REF561131,ANZ,Savings
26-08-2025 06:04,ANZ7B0521EE9CE84465B26A,012-345-678,11111111,KFC ANZ,24.12,0,722114.01,DR,REF128934,ANZ,Savings
26-08-2025 06:49,ANZ5082452BEED345228291,012-345-678,11111111,MENULOG ANZ,82.08,0,722031.93,DR,REF776524,ANZ,Savings
26-08-2025 07:10,ANZC32A9B81D5B94817AA00,012-345-678,11111111,ZOOM ANZ,45.76,0,721986.17,DR,REF870742,ANZ,Savings
26-08-2025 07:19,ANZ58E667CFEAA948DCB878,012-345-678,11111111,DOMINO'S PIZZA ANZ,34.24,0,721951.93,DR,REF858125,ANZ,Savings
26-08-2025 07:32,ANZ1F86AD2FF34A4BDEB760,012-345-678,11111111,TAFE BOOKSHOP ANZ,51.07,0,721900.86,DR,REF384470,ANZ,Savings
26-08-2025 07:38,ANZD24DA958F6FF4030A9A7,012-345-678,11111111,COLES ANZ,115.55,0,721785.31,DR,REF914459,ANZ,Savings
26-08-2025 08:24,ANZ59E10DDB8DD646AD830E,012-345-678,11111111,ALDI ANZ,14.27,0,721771.04,DR,REF369517,ANZ,Savings
26-08-2025 08:46,ANZD454CF0E8A264A51B3DC,012-345-678,11111111,PAY - SALARY ANZ,0,1627.92,723398.96,CR,REF330590,ANZ,Savings
26-08-2025 08:53,ANZ358EC074CF4146D5A4EC,012-345-678,11111111,ZOOM ANZ,32.11,0,723366.85,DR,REF851612,ANZ,Savings
26-08-2025 09:57,ANZ659A86AD0A1D43AE8528,012-345-678,11111111,WAGES CREDIT ANZ,0,6108.06,729474.91,CR,REF589129,ANZ,Savings
26-08-2025 10:16,INT90683BCE2F8143D091E3,012-345-678,11111111,TRANSFER FROM CBA 33333333,0,1262.14,730737.05,CR,INT-67179,ANZ,Savings
26-08-2025 10:19,ANZC2EC67E5D3C04DC1B2DF,012-345-678,11111111,TAFE BOOKSHOP ANZ,25.1,0,730711.95,DR,REF554908,ANZ,Savings
26-08-2025 10:40,ANZ58A6B5A4D14E47F3B1FF,012-345-678,11111111,SPOTIFY ANZ,50.23,0,730661.72,DR,REF645633,ANZ,Savings
26-08-2025 12:01,ANZF4F1D78E00BB454B8E68,012-345-678,11111111,UBER EATS ANZ,71.08,0,730590.64,DR,REF436995,ANZ,Savings
26-08-2025 12:04,INT007FAD8DFB934E5D8F9A,012-345-678,11111111,TRANSFER FROM CBA 33333333,0,1962.61,732553.25,CR,INT-73550,ANZ,Savings
26-08-2025 12:08,ANZ71A7518ABB4B466B88FC,012-345-678,11111111,7-ELEVEN ANZ,16.53,0,732536.72,DR,REF319389,ANZ,Savings
26-08-2025 12:13,ANZ3CDFCC9DF028481E904C,012-345-678,11111111,CITYLINK ANZ,98.28,0,732438.44,DR,REF988228,ANZ,Savings
26-08-2025 12:17,ANZ492982FFF69D4AD39445,012-345-678,11111111,RAILWAY STATION ANZ,27.45,0,732410.99,DR,REF448296,ANZ,Savings
26-08-2025 12:18,ANZED143C69EFF248D58936,012-345-678,11111111,WAGES CREDIT ANZ,0,4135.52,736546.51,CR,REF892217,ANZ,Savings
26-08-2025 12:20,ANZDD113F577CC14138A9B5,012-345-678,11111111,SHELL ANZ,44.84,0,736501.67,DR,REF963539,ANZ,Savings
26-08-2025 12:33,ANZ83FD6C55A4284C5ABF4B,012-345-678,11111111,MENULOG ANZ,37.04,0,736464.63,DR,REF112406,ANZ,Savings
26-08-2025 12:49,ANZ2845323CFC2F454E831B,012-345-678,11111111,WOOLWORTHS ANZ,3.51,0,736461.12,DR,REF777112,ANZ,Savings
26-08-2025 13:01,ANZD8311CDDE8594DD7B8D9,012-345-678,11111111,MENULOG ANZ,121.98,0,736339.14,DR,REF242626,ANZ,Savings
26-08-2025 13:08,ANZ7651065B646248D6953E,012-345-678,11111111,STARBUCKS ANZ,9.95,0,736329.19,DR,REF992144,ANZ,Savings
26-08-2025 13:20,ANZ99A85AD2BACD4EBDBDBD,012-345-678,11111111,RAILWAY STATION ANZ,15.89,0,736313.3,DR,REF954958,ANZ,Savings
26-08-2025 13:26,ANZ2AF1A722D0294830B263,012-345-678,11111111,APPLE ANZ,9.12,0,736304.18,DR,REF707482,ANZ,Savings
26-08-2025 13:28,ANZBDFED05AE3FD40D9A238,012-345-678,11111111,COLES ANZ,61.32,0,736242.86,DR,REF827177,ANZ,Savings
26-08-2025 13:41,ANZ2ACD1B6015CB41B1BFE9,012-345-678,11111111,FLIXBUS ANZ,167.19,0,736075.67,DR,REF480642,ANZ,Savings
26-08-2025 14:02,ANZ8BFA06D0D1704EC79BFB,012-345-678,11111111,BIGW ANZ,8.67,0,736067,DR,REF991553,ANZ,Savings
26-08-2025 14:25,ANZE9E950CC017941BD8A77,012-345-678,11111111,UBER EATS ANZ,46.8,0,736020.2,DR,REF886864,ANZ,Savings
26-08-2025 14:38,ANZ64EDFE1CEF904098B937,012-345-678,11111111,STARBUCKS ANZ,17.96,0,736002.24,DR,REF571338,ANZ,Savings
26-08-2025 14:54,ANZ79578BFA109648FD80E2,012-345-678,11111111,UBER EATS ANZ,67.93,0,735934.31,DR,REF734441,ANZ,Savings
26-08-2025 14:59,ANZ7BA261D0A2BD41A6A130,012-345-678,11111111,LIQUORLAND ANZ,24.43,0,735909.88,DR,REF394713,ANZ,Savings
26-08-2025 15:55,ANZ4C595C46903E49AC84A1,012-345-678,11111111,WOOLWORTHS ANZ,324.88,0,735585,DR,REF681616,ANZ,Savings
26-08-2025 16:28,ANZ39D047F160D24560ADCA,012-345-678,11111111,KFC ANZ,39.39,0,735545.61,DR,REF980998,ANZ,Savings
26-08-2025 16:37,ANZD88711DC19C34A509672,012-345-678,11111111,STARBUCKS ANZ,29.97,0,735515.64,DR,REF333304,ANZ,Savings
26-08-2025 17:01,ANZ1838E09D9EA846FC90A3,012-345-678,11111111,MCDONALDS ANZ,28.33,0,735487.31,DR,REF322279,ANZ,Savings
26-08-2025 17:05,ANZD7BA90668E5C4F2B9570,012-345-678,11111111,SHELL ANZ,9.53,0,735477.78,DR,REF409486,ANZ,Savings
26-08-2025 17:39,ANZB1F8CAEB9DEA467AA99D,012-345-678,11111111,WOOLWORTHS ANZ,61.3,0,735416.48,DR,REF197454,ANZ,Savings
26-08-2025 17:49,ANZ8BF99D66DD6F41C38BB8,012-345-678,11111111,ZOOM ANZ,18.05,0,735398.43,DR,REF810441,ANZ,Savings
26-08-2025 17:49,ANZ93FF515662904D4B94AB,012-345-678,11111111,UBER EATS ANZ,5.75,0,735392.68,DR,REF552985,ANZ,Savings
26-08-2025 18:11,ANZ5D9CDDAF2E214D59AA46,012-345-678,11111111,PAYROLL CREDIT ANZ,0,3639.08,739031.76,CR,REF534843,ANZ,Savings
26-08-2025 18:18,ANZE06314CAC34A4B2C8259,012-345-678,11111111,7-ELEVEN ANZ,111.77,0,738919.99,DR,REF471080,ANZ,Savings
26-08-2025 18:52,ANZE5556D3F957040409BD5,012-345-678,11111111,BP ANZ,52.98,0,738867.01,DR,REF785015,ANZ,Savings
26-08-2025 18:56,ANZ0BB9FD6369DE46E1BF4D,012-345-678,11111111,PAY - SALARY ANZ,0,7876.17,746743.18,CR,REF160038,ANZ,Savings
26-08-2025 19:09,ANZ37F6CCB7B24040BC95B3,012-345-678,11111111,CITYLINK ANZ,97.72,0,746645.46,DR,REF703319,ANZ,Savings
26-08-2025 20:05,ANZD074ABF381264ECC9E60,012-345-678,11111111,PAYPAL *NETFLIX ANZ,17.56,0,746627.9,DR,REF813853,ANZ,Savings
26-08-2025 20:12,ANZ90870F81673048F7B959,012-345-678,11111111,HARVEY NORMAN ANZ,4.67,0,746623.23,DR,REF602445,ANZ,Savings
26-08-2025 20:24,ANZ5F57037BAB824685A5FA,012-345-678,11111111,ALDI ANZ,60.26,0,746562.97,DR,REF621072,ANZ,Savings
26-08-2025 20:45,ANZ07D6A37140534075A6EF,012-345-678,11111111,7-ELEVEN ANZ,34.68,0,746528.29,DR,REF134482,ANZ,Savings
26-08-2025 20:58,ANZE98535266F2A40F8988F,012-345-678,11111111,BIGW ANZ,17.45,0,746510.84,DR,REF248603,ANZ,Savings
26-08-2025 21:04,ANZ1C995A9C7B90490398A1,012-345-678,11111111,ALDI ANZ,50.17,0,746460.67,DR,REF530436,ANZ,Savings
26-08-2025 21:25,ANZ8470A809684F4F8498A7,012-345-678,11111111,AMAZON AU ANZ,10.14,0,746450.53,DR,REF572210,ANZ,Savings
26-08-2025 21:27,ANZAB5DDCE90D054140B7A9,012-345-678,11111111,AMAZON AU ANZ,50.05,0,746400.48,DR,REF560410,ANZ,Savings
26-08-2025 21:41,ANZ77928C2F3AC14C07BA46,012-345-678,11111111,JB HI-FI ANZ,54.42,0,746346.06,DR,REF736107,ANZ,Savings
26-08-2025 21:46,ANZ98487BC1722148A5BABE,012-345-678,11111111,HARVEY NORMAN ANZ,98.59,0,746247.47,DR,REF248436,ANZ,Savings
26-08-2025 22:06,ANZ65891A9FF6DB428DA9B2,012-345-678,11111111,BIGW ANZ,75.27,0,746172.2,DR,REF311478,ANZ,Savings
26-08-2025 22:26,INT3E2289119A214439BF8C,012-345-678,11111111,TRANSFER TO CBA 22222222,1592.83,0,744579.37,DR,INT-41964,ANZ,Savings
26-08-2025 22:34,ANZ522BEFED21D742A5A7C9,012-345-678,11111111,APPLE ANZ,5.83,0,744573.54,DR,REF237984,ANZ,Savings
26-08-2025 22:46,ANZ1A74678BDDD94990A323,012-345-678,11111111,PAYROLL CREDIT ANZ,0,261.4,744834.94,CR,REF803427,ANZ,Savings
26-08-2025 23:42,ANZ7F8114F2BA5F4E5C8FD7,012-345-678,11111111,PAY - SALARY ANZ,0,672.33,745507.27,CR,REF594555,ANZ,Savings
27-08-2025 00:04,ANZDE3E771A31764724B7AC,012-345-678,11111111,SALARY PAYMENT ANZ,0,848.33,746355.6,CR,REF958269,ANZ,Savings
27-08-2025 01:03,ANZ557C04431AAE43B88A57,012-345-678,11111111,INTERNET TRANSFER ANZ,5.73,0,746349.87,DR,REF695293,ANZ,Savings
27-08-2025 01:06,ANZ674B73C4D86F4E1BB70C,012-345-678,11111111,ZOOM ANZ,21.48,0,746328.39,DR,REF362064,ANZ,Savings
27-08-2025 01:09,ANZ6C57C38EDEE04BACBD3E,012-345-678,11111111,STARBUCKS ANZ,5.13,0,746323.26,DR,REF726629,ANZ,Savings
27-08-2025 01:26,ANZBFFE9D65DEF14DE7B9B2,012-345-678,11111111,MENULOG ANZ,97.68,0,746225.58,DR,REF462307,ANZ,Savings
27-08-2025 02:18,ANZDCA524CF21B64A019CF2,012-345-678,11111111,ALDI ANZ,28.79,0,746196.79,DR,REF524905,ANZ,Savings
27-08-2025 02:41,ANZ4C3769CCC32E4AD3B86B,012-345-678,11111111,COLES ANZ,160.67,0,746036.12,DR,REF184578,ANZ,Savings
27-08-2025 02:41,INT90EAF1EC1CEB4F3D9936,012-345-678,11111111,TRANSFER TO CBA 22222222,1795.3,0,744240.82,DR,INT-72594,ANZ,Savings
27-08-2025 03:08,ANZ63DA3041D16246FEBAC3,012-345-678,11111111,HARVEY NORMAN ANZ,132.83,0,744107.99,DR,REF240977,ANZ,Savings
27-08-2025 03:22,ANZ9C244A9A7D0244A1B7D5,012-345-678,11111111,TAFE BOOKSHOP ANZ,28.8,0,744079.19,DR,REF225176,ANZ,Savings
27-08-2025 03:28,ANZ12EA7E68F3704DD79C77,012-345-678,11111111,WAGES CREDIT ANZ,0,5724.8,749803.99,CR,REF895255,ANZ,Savings
27-08-2025 03:32,ANZ1C8A2FC4783A4BAC98FB,012-345-678,11111111,UBER EATS ANZ,41.79,0,749762.2,DR,REF498721,ANZ,Savings
27-08-2025 03:55,ANZ2F9E468D26FF4DB6AC87,012-345-678,11111111,LIQUORLAND ANZ,7.3,0,749754.9,DR,REF731084,ANZ,Savings
27-08-2025 04:11,ANZ431934AAC4384BBC9854,012-345-678,11111111,HARVEY NORMAN ANZ,209.22,0,749545.68,DR,REF435981,ANZ,Savings
27-08-2025 04:17,ANZB7448A41DE434850AC75,012-345-678,11111111,MCDONALDS ANZ,60.23,0,749485.45,DR,REF293177,ANZ,Savings
27-08-2025 04:21,ANZ9385E5293242465C9FEC,012-345-678,11111111,COLES ANZ,24.89,0,749460.56,DR,REF150541,ANZ,Savings
27-08-2025 04:24,ANZA30849DEFF0E4671BE7C,012-345-678,11111111,UBER EATS ANZ,60.93,0,749399.63,DR,REF155236,ANZ,Savings
27-08-2025 04:25,ANZ80AB04285E2440C3A456,012-345-678,11111111,PAYPAL *NETFLIX ANZ,42.94,0,749356.69,DR,REF100432,ANZ,Savings
27-08-2025 04:55,ANZE11BC8873B874033B898,012-345-678,11111111,TAFE BOOKSHOP ANZ,15.41,0,749341.28,DR,REF931449,ANZ,Savings
27-08-2025 05:04,ANZ84FEB53BE37B43BAA07B,012-345-678,11111111,BIGW ANZ,51.32,0,749289.96,DR,REF839431,ANZ,Savings
27-08-2025 05:12,ANZBF27FC981E394A61A57F,012-345-678,11111111,APPLE ANZ,43.1,0,749246.86,DR,REF929655,ANZ,Savings
27-08-2025 06:27,ANZ0EAD0C569F88445ABD2B,012-345-678,11111111,DOMINO'S PIZZA ANZ,97.18,0,749149.68,DR,REF342775,ANZ,Savings
27-08-2025 06:53,ANZEB251678186D4000A8DC,012-345-678,11111111,JB HI-FI ANZ,27.19,0,749122.49,DR,REF109147,ANZ,Savings
27-08-2025 07:13,ANZ0023D0E0C338458FB32B,012-345-678,11111111,TAFE BOOKSHOP ANZ,89.66,0,749032.83,DR,REF329371,ANZ,Savings
27-08-2025 07:20,ANZ7BC0A526AA0E4626A504,012-345-678,11111111,JB HI-FI ANZ,4.82,0,749028.01,DR,REF949019,ANZ,Savings
27-08-2025 07:25,ANZF8A1A6E5E2544D968291,012-345-678,11111111,RAILWAY STATION ANZ,36.74,0,748991.27,DR,REF173132,ANZ,Savings
27-08-2025 07:38,ANZ4456FF84C1D64EDAB2CB,012-345-678,11111111,PAYMENT GATEWAY ANZ,246.73,0,748744.54,DR,REF484382,ANZ,Savings
27-08-2025 08:17,ANZB9FA2B4AF6C2452FBD7D,012-345-678,11111111,PAYROLL CREDIT ANZ,0,511.76,749256.3,CR,REF459033,ANZ,Savings
27-08-2025 08:25,ANZ9A37C2E8550A4961A88E,012-345-678,11111111,ALDI ANZ,83.55,0,749172.75,DR,REF551881,ANZ,Savings
27-08-2025 09:08,ANZB95676F304DC48159587,012-345-678,11111111,PAY - SALARY ANZ,0,4552.2,753724.95,CR,REF971175,ANZ,Savings
27-08-2025 09:13,INT052D0972C0084DA4A8E0,012-345-678,11111111,TRANSFER FROM CBA 22222222,0,1157.46,754882.41,CR,INT-65508,ANZ,Savings
27-08-2025 09:35,ANZD2D2C895BBAD407CA0EA,012-345-678,11111111,KFC ANZ,92.75,0,754789.66,DR,REF455247,ANZ,Savings
27-08-2025 09:44,ANZC9574CB4C1B54E2DAF0B,012-345-678,11111111,WOOLWORTHS ANZ,121.69,0,754667.97,DR,REF618660,ANZ,Savings
27-08-2025 10:06,ANZACA73003749B4DF2B3EF,012-345-678,11111111,MCDONALDS ANZ,45.85,0,754622.12,DR,REF604722,ANZ,Savings
27-08-2025 10:34,ANZF2350011B4F5487291CF,012-345-678,11111111,TAFE BOOKSHOP ANZ,5.18,0,754616.94,DR,REF624738,ANZ,Savings
27-08-2025 11:12,ANZ14FD483C4B1E4E9480FB,012-345-678,11111111,PAY - SALARY ANZ,0,563.69,755180.63,CR,REF266320,ANZ,Savings
27-08-2025 11:15,ANZ4AF490B73FE745B9A63A,012-345-678,11111111,AMAZON AU ANZ,6.77,0,755173.86,DR,REF478071,ANZ,Savings
27-08-2025 11:35,ANZ87DEEC050BA2432D808B,012-345-678,11111111,MCDONALDS ANZ,3.59,0,755170.27,DR,REF781606,ANZ,Savings
27-08-2025 11:53,ANZ679D1ADD1CE24D42AB39,012-345-678,11111111,ALDI ANZ,9.01,0,755161.26,DR,REF426810,ANZ,Savings
27-08-2025 11:54,ANZFB3D5CC41D194A14B8F6,012-345-678,11111111,STARBUCKS ANZ,102.63,0,755058.63,DR,REF834593,ANZ,Savings
27-08-2025 12:22,ANZ76C424DCF7D84FF884D5,012-345-678,11111111,JB HI-FI ANZ,6.02,0,755052.61,DR,REF252685,ANZ,Savings
27-08-2025 12:27,ANZE263686020C94D5880CB,012-345-678,11111111,ZOOM ANZ,153.13,0,754899.48,DR,REF560162,ANZ,Savings
27-08-2025 13:00,ANZ122B623338CA45E6BA69,012-345-678,11111111,ZOOM ANZ,20.96,0,754878.52,DR,REF584515,ANZ,Savings
27-08-2025 13:22,ANZCD46CF0581514A7C9F50,012-345-678,11111111,BANK FEE ANZ,60.51,0,754818.01,DR,REF592864,ANZ,Savings
27-08-2025 13:58,ANZCC7E4F9CD801457F8291,012-345-678,11111111,SALARY PAYMENT ANZ,0,3433.97,758251.98,CR,REF811557,ANZ,Savings
27-08-2025 14:24,ANZ7257A61CD61E4E5E86F7,012-345-678,11111111,MENULOG ANZ,10.11,0,758241.87,DR,REF816540,ANZ,Savings
27-08-2025 14:25,ANZ6DD36344530E4EDDAE7D,012-345-678,11111111,AMAZON AU ANZ,54.87,0,758187,DR,REF818487,ANZ,Savings
27-08-2025 14:46,ANZA85DA452F1A14AA89EAE,012-345-678,11111111,INTERNET TRANSFER ANZ,86.67,0,758100.33,DR,REF165642,ANZ,Savings
27-08-2025 15:09,ANZ6D04A3F8751441E39C04,012-345-678,11111111,SALARY PAYMENT ANZ,0,6222.22,764322.55,CR,REF952541,ANZ,Savings
27-08-2025 15:25,ANZF2A7BBBF5B324BD38347,012-345-678,11111111,TAFE BOOKSHOP ANZ,23.14,0,764299.41,DR,REF964460,ANZ,Savings
27-08-2025 15:36,INT717CC1EE1F904D989265,012-345-678,11111111,TRANSFER FROM CBA 33333333,0,1086.06,765385.47,CR,INT-15555,ANZ,Savings
27-08-2025 15:39,ANZDB8D3103ADA146BEABE0,012-345-678,11111111,BIGW ANZ,43.46,0,765342.01,DR,REF551477,ANZ,Savings
27-08-2025 15:53,ANZ7A0C339672EE48C5837B,012-345-678,11111111,WOOLWORTHS ANZ,156.18,0,765185.83,DR,REF758861,ANZ,Savings
27-08-2025 16:03,ANZAA39A60C918E44A68453,012-345-678,11111111,JB HI-FI ANZ,13.97,0,765171.86,DR,REF627940,ANZ,Savings
27-08-2025 16:14,INT9C4F08519F25403FACAD,012-345-678,11111111,TRANSFER FROM CBA 33333333,0,142.72,765314.58,CR,INT-88126,ANZ,Savings
27-08-2025 16:22,ANZ20C4FF09F05A4027B36C,012-345-678,11111111,INTERNET TRANSFER ANZ,11.06,0,765303.52,DR,REF669610,ANZ,Savings
27-08-2025 16:47,ANZ1512D70CCCEE4ED38701,012-345-678,11111111,COMPANY PAYROLL ANZ,0,739.75,766043.27,CR,REF637403,ANZ,Savings
27-08-2025 17:09,ANZ2AA10EF1E2AE44DE8FB1,012-345-678,11111111,LIQUORLAND ANZ,65.03,0,765978.24,DR,REF775861,ANZ,Savings
27-08-2025 17:11,ANZ86C154FDF3D147468A3C,012-345-678,11111111,BP ANZ,45.57,0,765932.67,DR,REF925323,ANZ,Savings
27-08-2025 17:18,ANZCF1C0722E11B4DBA8C4C,012-345-678,11111111,COMPANY PAYROLL ANZ,0,810.02,766742.69,CR,REF815239,ANZ,Savings
27-08-2025 17:24,ANZF907AF057B4F4364A08A,012-345-678,11111111,BIGW ANZ,70.98,0,766671.71,DR,REF125375,ANZ,Savings
27-08-2025 17:38,ANZA75E90B8B51B43B58871,012-345-678,11111111,ZOOM ANZ,5.14,0,766666.57,DR,REF332985,ANZ,Savings
27-08-2025 17:41,ANZF1AD8853D0C1451CA8BA,012-345-678,11111111,SPOTIFY ANZ,81.56,0,766585.01,DR,REF900520,ANZ,Savings
27-08-2025 17:44,ANZ933BB1B4E8D54EAF9DA8,012-345-678,11111111,LIQUORLAND ANZ,9.66,0,766575.35,DR,REF334843,ANZ,Savings
27-08-2025 17:58,ANZ04A6F8AE23F242C387CE,012-345-678,11111111,SPOTIFY ANZ,36.44,0,766538.91,DR,REF615762,ANZ,Savings
27-08-2025 18:02,ANZFF9F906A89704B6B8675,012-345-678,11111111,ZOOM ANZ,116.35,0,766422.56,DR,REF980124,ANZ,Savings
27-08-2025 18:40,ANZ2EB39B63511C4F78826D,012-345-678,11111111,STARBUCKS ANZ,7.19,0,766415.37,DR,REF587498,ANZ,Savings
27-08-2025 20:22,ANZF7FE628722B94C0485BC,012-345-678,11111111,PAYROLL CREDIT ANZ,0,27.58,766442.95,CR,REF604145,ANZ,Savings
27-08-2025 20:31,INT1648D96FF3664D198EA2,012-345-678,11111111,TRANSFER FROM CBA 33333333,0,81.46,766524.41,CR,INT-32799,ANZ,Savings
27-08-2025 20:39,ANZC20BCCDBE1BD48D5A321,012-345-678,11111111,AMAZON AU ANZ,4.92,0,766519.49,DR,REF830869,ANZ,Savings
27-08-2025 20:52,ANZ57A787B091E5421C9162,012-345-678,11111111,UBER EATS ANZ,79.2,0,766440.29,DR,REF476746,ANZ,Savings
27-08-2025 20:57,ANZCCA0904DD4A445BCAB3B,012-345-678,11111111,ZOOM ANZ,44.84,0,766395.45,DR,REF812189,ANZ,Savings
27-08-2025 21:04,ANZ74AC2CAA843842E9A8A7,012-345-678,11111111,MENULOG ANZ,23.61,0,766371.84,DR,REF633619,ANZ,Savings
27-08-2025 22:32,ANZ559ADF01F21649D8BE80,012-345-678,11111111,JB HI-FI ANZ,66.73,0,766305.11,DR,REF895107,ANZ,Savings
27-08-2025 22:37,ANZCFBB1158B9F443E98B00,012-345-678,11111111,ALDI ANZ,125.22,0,766179.89,DR,REF185198,ANZ,Savings
27-08-2025 22:46,ANZC946B4B8A5124811BED5,012-345-678,11111111,CITYLINK ANZ,117.48,0,766062.41,DR,REF187062,ANZ,Savings
27-08-2025 23:00,ANZ9069266697A84D88904D,012-345-678,11111111,LIQUORLAND ANZ,58.62,0,766003.79,DR,REF483860,ANZ,Savings
27-08-2025 23:32,ANZ4647CF5114FC45D7A7EC,012-345-678,11111111,APPLE ANZ,345.2,0,765658.59,DR,REF717956,ANZ,Savings
28-08-2025 00:04,ANZ2AF5F4D21FFC46B3A2D3,012-345-678,11111111,COMPANY PAYROLL ANZ,0,671.45,766330.04,CR,REF253859,ANZ,Savings
28-08-2025 00:49,ANZ263F952B603046D193A9,012-345-678,11111111,JB HI-FI ANZ,27.14,0,766302.9,DR,REF863800,ANZ,Savings
28-08-2025 00:55,ANZF5B13F3A35084C948C28,012-345-678,11111111,MENULOG ANZ,31.4,0,766271.5,DR,REF213227,ANZ,Savings
28-08-2025 01:02,ANZ5D346575A7FE43ADB695,012-345-678,11111111,STARBUCKS ANZ,67.17,0,766204.33,DR,REF814966,ANZ,Savings
28-08-2025 01:13,ANZ0FB391A6913D4689BBC9,012-345-678,11111111,BWS ANZ,4.99,0,766199.34,DR,REF493899,ANZ,Savings
28-08-2025 02:16,ANZC8B9F873769345C8A88E,012-345-678,11111111,PAYPAL *NETFLIX ANZ,12.44,0,766186.9,DR,REF894753,ANZ,Savings
28-08-2025 02:36,ANZ6621F70167834BFBBC1C,012-345-678,11111111,INTERNET TRANSFER ANZ,10.84,0,766176.06,DR,REF500402,ANZ,Savings
28-08-2025 02:38,ANZ119CAB967B4B42EA9AB5,012-345-678,11111111,BWS ANZ,110.89,0,766065.17,DR,REF859479,ANZ,Savings
28-08-2025 02:42,INT79A8B474EC1E43F7B64D,012-345-678,11111111,TRANSFER FROM CBA 22222222,0,171.6,766236.77,CR,INT-71174,ANZ,Savings
28-08-2025 02:48,ANZ0458A0A5880E40EAB5B4,012-345-678,11111111,BANK FEE ANZ,128.8,0,766107.97,DR,REF783748,ANZ,Savings
28-08-2025 02:58,ANZA3E7D7A5449D447D8B54,012-345-678,11111111,COMPANY PAYROLL ANZ,0,6828.62,772936.59,CR,REF781486,ANZ,Savings
28-08-2025 03:12,ANZ40325AD7F7C549C58239,012-345-678,11111111,APPLE ANZ,7.59,0,772929,DR,REF798495,ANZ,Savings
28-08-2025 03:32,ANZ5472D0F8A1C043FCA6F5,012-345-678,11111111,SPOTIFY ANZ,24.65,0,772904.35,DR,REF283108,ANZ,Savings
28-08-2025 04:03,ANZ037E48C1141241CAAF79,012-345-678,11111111,TAFE BOOKSHOP ANZ,46.02,0,772858.33,DR,REF675499,ANZ,Savings
28-08-2025 04:05,ANZA1A77862BD8E4B7C88B1,012-345-678,11111111,AMAZON AU ANZ,15.35,0,772842.98,DR,REF579384,ANZ,Savings
28-08-2025 04:55,ANZEC1C98980163472DB9FE,012-345-678,11111111,SALARY PAYMENT ANZ,0,2841.37,775684.35,CR,REF563392,ANZ,Savings
28-08-2025 04:58,ANZ571106B154E94FDF96A7,012-345-678,11111111,TAFE BOOKSHOP ANZ,136.89,0,775547.46,DR,REF885036,ANZ,Savings
28-08-2025 05:06,ANZD8076B5A90E7482E9ADC,012-345-678,11111111,PAYROLL CREDIT ANZ,0,6457.75,782005.21,CR,REF673876,ANZ,Savings
28-08-2025 05:21,ANZ4C5BD98265CF4857A7C3,012-345-678,11111111,MCDONALDS ANZ,74.82,0,781930.39,DR,REF462154,ANZ,Savings
28-08-2025 05:27,ANZ4FC048878FE24C54873A,012-345-678,11111111,UBER EATS ANZ,81.63,0,781848.76,DR,REF862864,ANZ,Savings
28-08-2025 05:30,ANZC3441B6A3EC549E6944D,012-345-678,11111111,TAFE BOOKSHOP ANZ,50.45,0,781798.31,DR,REF701382,ANZ,Savings
28-08-2025 05:41,ANZE854D0651EBF4FDFA9DE,012-345-678,11111111,DOMINO'S PIZZA ANZ,238.38,0,781559.93,DR,REF233359,ANZ,Savings
28-08-2025 05:45,ANZD50A0629237A42F5BF2A,012-345-678,11111111,MENULOG ANZ,1.32,0,781558.61,DR,REF850036,ANZ,Savings
28-08-2025 05:48,INT0AE859A927C94468A11B,012-345-678,11111111,TRANSFER TO CBA 22222222,978.23,0,780580.38,DR,INT-85043,ANZ,Savings
28-08-2025 06:01,ANZC6631503B92A4DFB9ECE,012-345-678,11111111,SHELL ANZ,35.07,0,780545.31,DR,REF508139,ANZ,Savings
28-08-2025 06:15,ANZ0DF1E865CAE44FB8B10A,012-345-678,11111111,WAGES CREDIT ANZ,0,5770.96,786316.27,CR,REF786255,ANZ,Savings
28-08-2025 06:21,ANZD0C40C482BC44D098D79,012-345-678,11111111,MENULOG ANZ,26.96,0,786289.31,DR,REF712336,ANZ,Savings
28-08-2025 06:30,ANZ87EF5DDF088B42DD9B59,012-345-678,11111111,APPLE ANZ,62.48,0,786226.83,DR,REF967572,ANZ,Savings
28-08-2025 06:48,ANZA4B090B743C24ADB89C2,012-345-678,11111111,LIQUORLAND ANZ,32.55,0,786194.28,DR,REF279581,ANZ,Savings
28-08-2025 06:58,ANZ979D97A6AE454B55AA23,012-345-678,11111111,SHELL ANZ,16.21,0,786178.07,DR,REF895588,ANZ,Savings
28-08-2025 06:58,ANZ5F7EBAF6B1D1484EB650,012-345-678,11111111,PAY - SALARY ANZ,0,5586.85,791764.92,CR,REF767430,ANZ,Savings
28-08-2025 07:00,ANZEDA6471F3BD44F8C8B23,012-345-678,11111111,CITYLINK ANZ,175.18,0,791589.74,DR,REF576797,ANZ,Savings
28-08-2025 07:55,ANZ690B761A0A624A9495EE,012-345-678,11111111,ALDI ANZ,85.02,0,791504.72,DR,REF660458,ANZ,Savings
28-08-2025 08:12,ANZ999868846F4B47439D6E,012-345-678,11111111,UBER EATS ANZ,25.15,0,791479.57,DR,REF906285,ANZ,Savings
28-08-2025 08:15,ANZFFD0BD3EF9DB4A8C88C9,012-345-678,11111111,LIQUORLAND ANZ,56.67,0,791422.9,DR,REF488429,ANZ,Savings
28-08-2025 09:13,ANZC044B0B954D0470FB1EE,012-345-678,11111111,PAYPAL *NETFLIX ANZ,63.36,0,791359.54,DR,REF256804,ANZ,Savings
28-08-2025 09:33,ANZ61936C21A9EB4D09A8F1,012-345-678,11111111,MENULOG ANZ,33.04,0,791326.5,DR,REF828982,ANZ,Savings
28-08-2025 09:37,INT6F6BB85807DC472689D1,012-345-678,11111111,TRANSFER FROM CBA 22222222,0,1019.81,792346.31,CR,INT-65574,ANZ,Savings
28-08-2025 09:53,ANZ8137BE1E53A24980A92B,012-345-678,11111111,TAFE BOOKSHOP ANZ,90.5,0,792255.81,DR,REF276922,ANZ,Savings
28-08-2025 10:23,ANZ0C08BD31B8D749CEADA5,012-345-678,11111111,STARBUCKS ANZ,193.7,0,792062.11,DR,REF229322,ANZ,Savings
28-08-2025 10:33,ANZD987877A2A9E40C1B8FD,012-345-678,11111111,HARVEY NORMAN ANZ,67.75,0,791994.36,DR,REF588932,ANZ,Savings
28-08-2025 10:39,ANZCF6818D47630401D97EE,012-345-678,11111111,MENULOG ANZ,3.94,0,791990.42,DR,REF322327,ANZ,Savings
28-08-2025 10:41,ANZE6E4B24C95604EA98650,012-345-678,11111111,COMPANY PAYROLL ANZ,0,1088.23,793078.65,CR,REF740283,ANZ,Savings
28-08-2025 11:19,ANZE011CAD78D0D46C8B069,012-345-678,11111111,MCDONALDS ANZ,14.79,0,793063.86,DR,REF277926,ANZ,Savings
28-08-2025 11:31,ANZ8D38C02A2C964CD8AE5F,012-345-678,11111111,BWS ANZ,13.91,0,793049.95,DR,REF139555,ANZ,Savings
28-08-2025 11:43,ANZF8FBE70BC3604FFCBE57,012-345-678,11111111,SHELL ANZ,29.96,0,793019.99,DR,REF810235,ANZ,Savings
28-08-2025 11:52,ANZ2FB4A77FBAE948D0A8B4,012-345-678,11111111,WAGES CREDIT ANZ,0,3985.2,797005.19,CR,REF321067,ANZ,Savings
28-08-2025 11:53,ANZ67085B9970714C45A26D,012-345-678,11111111,FLIXBUS ANZ,31.23,0,796973.96,DR,REF818415,ANZ,Savings
28-08-2025 12:06,ANZBEE859D3ECBD4006B835,012-345-678,11111111,WAGES CREDIT ANZ,0,969.65,797943.61,CR,REF980601,ANZ,Savings
28-08-2025 12:28,ANZ37BBE8E2478E43C0A699,012-345-678,11111111,DOMINO'S PIZZA ANZ,45.04,0,797898.57,DR,REF888301,ANZ,Savings
28-08-2025 12:55,ANZ1D87EC01ADAD45A99605,012-345-678,11111111,7-ELEVEN ANZ,19.68,0,797878.89,DR,REF689317,ANZ,Savings
28-08-2025 12:56,ANZ069354EE1E3640A8A846,012-345-678,11111111,STARBUCKS ANZ,9.99,0,797868.9,DR,REF714809,ANZ,Savings
28-08-2025 14:00,ANZE6D081A05B1B489D9C73,012-345-678,11111111,FLIXBUS ANZ,2.78,0,797866.12,DR,REF876021,ANZ,Savings
28-08-2025 14:12,ANZC37F2FE18DCF42EEA700,012-345-678,11111111,HARVEY NORMAN ANZ,54.65,0,797811.47,DR,REF119565,ANZ,Savings
28-08-2025 15:09,ANZC816D11AE7A34A3E9B3F,012-345-678,11111111,WOOLWORTHS ANZ,57.95,0,797753.52,DR,REF993971,ANZ,Savings
28-08-2025 15:29,ANZCB0CBBBB83CB4634BC68,012-345-678,11111111,RAILWAY STATION ANZ,24.15,0,797729.37,DR,REF495575,ANZ,Savings
28-08-2025 15:46,ANZ2620EF84B74642BBB7BC,012-345-678,11111111,WAGES CREDIT ANZ,0,5869.64,803599.01,CR,REF152771,ANZ,Savings
28-08-2025 16:18,ANZB8F7B31BBAED4DA6988B,012-345-678,11111111,BP ANZ,24.1,0,803574.91,DR,REF830850,ANZ,Savings
28-08-2025 17:03,ANZ50EEF53875FD4235964B,012-345-678,11111111,ZOOM ANZ,15.22,0,803559.69,DR,REF331519,ANZ,Savings
28-08-2025 17:15,ANZ54220EEF4D7249499B98,012-345-678,11111111,TAFE BOOKSHOP ANZ,63.02,0,803496.67,DR,REF431526,ANZ,Savings
28-08-2025 17:40,ANZ2D98E7C557AA4BB0AE31,012-345-678,11111111,SALARY PAYMENT ANZ,0,125.49,803622.16,CR,REF596629,ANZ,Savings
28-08-2025 17:52,ANZ8BE03AC4BFAD44A5A684,012-345-678,11111111,DOMINO'S PIZZA ANZ,9.53,0,803612.63,DR,REF408708,ANZ,Savings
28-08-2025 17:54,ANZA8225264773E484984FE,012-345-678,11111111,TAFE BOOKSHOP ANZ,28.2,0,803584.43,DR,REF817305,ANZ,Savings
28-08-2025 17:57,ANZFA76C61421804094A4C2,012-345-678,11111111,FLIXBUS ANZ,83.36,0,803501.07,DR,REF184258,ANZ,Savings
28-08-2025 18:00,ANZ99B0CD23139D4D588B47,012-345-678,11111111,MCDONALDS ANZ,3.48,0,803497.59,DR,REF272192,ANZ,Savings
28-08-2025 18:04,ANZ123D68F95B224E6AB0B8,012-345-678,11111111,MENULOG ANZ,23.15,0,803474.44,DR,REF471898,ANZ,Savings
28-08-2025 18:04,ANZ593E7AA3A173444C94E8,012-345-678,11111111,STARBUCKS ANZ,29.93,0,803444.51,DR,REF593153,ANZ,Savings
28-08-2025 18:47,ANZ214C7802CB3D4C279A52,012-345-678,11111111,WAGES CREDIT ANZ,0,266.12,803710.63,CR,REF412687,ANZ,Savings
28-08-2025 18:49,ANZBF725BCFD5E94D0492D5,012-345-678,11111111,DOMINO'S PIZZA ANZ,20.14,0,803690.49,DR,REF463515,ANZ,Savings
28-08-2025 19:12,ANZ29EE0DBD994046CEBC47,012-345-678,11111111,UBER EATS ANZ,90.01,0,803600.48,DR,REF258556,ANZ,Savings
28-08-2025 20:48,ANZF8166947B22F4F9FB083,012-345-678,11111111,COLES ANZ,28.3,0,803572.18,DR,REF300469,ANZ,Savings
28-08-2025 21:03,ANZ18015224D326400A9EC3,012-345-678,11111111,FLIXBUS ANZ,26.7,0,803545.48,DR,REF908019,ANZ,Savings
28-08-2025 21:10,ANZ86599BB3398343C0A2E9,012-345-678,11111111,DOMINO'S PIZZA ANZ,32.01,0,803513.47,DR,REF451799,ANZ,Savings
28-08-2025 21:11,ANZ901BCAFAF51D44AC8584,012-345-678,11111111,RAILWAY STATION ANZ,75.77,0,803437.7,DR,REF441915,ANZ,Savings
28-08-2025 21:39,ANZBF581074FF3E4ACB9F2A,012-345-678,11111111,LIQUORLAND ANZ,37.92,0,803399.78,DR,REF557950,ANZ,Savings
28-08-2025 22:11,ANZ5A701D070D084EC3BD1A,012-345-678,11111111,BP ANZ,16.76,0,803383.02,DR,REF547274,ANZ,Savings
28-08-2025 22:22,ANZ608204DFA80940878827,012-345-678,11111111,SHELL ANZ,19.61,0,803363.41,DR,REF193511,ANZ,Savings
28-08-2025 22:58,ANZ6636323E6DA340479812,012-345-678,11111111,PAYROLL CREDIT ANZ,0,5855.79,809219.2,CR,REF325778,ANZ,Savings
28-08-2025 23:16,ANZ9F0D062D47024125ACFF,012-345-678,11111111,MENULOG ANZ,16.42,0,809202.78,DR,REF231108,ANZ,Savings
28-08-2025 23:39,ANZE2F015485B36479E84D5,012-345-678,11111111,JB HI-FI ANZ,67.99,0,809134.79,DR,REF881656,ANZ,Savings
28-08-2025 23:57,ANZDEB1673CA8874101BF3D,012-345-678,11111111,PAY - SALARY ANZ,0,5199.83,814334.62,CR,REF108740,ANZ,Savings
29-08-2025 00:10,ANZ1AB335A2DAAF4992ACE4,012-345-678,11111111,UBER EATS ANZ,14.21,0,814320.41,DR,REF896735,ANZ,Savings
29-08-2025 01:24,ANZAC684D22CB2E4EC0BE03,012-345-678,11111111,BWS ANZ,56,0,814264.41,DR,REF596562,ANZ,Savings
29-08-2025 01:35,ANZE1D5B1515F274B2489C5,012-345-678,11111111,COMPANY PAYROLL ANZ,0,1068.42,815332.83,CR,REF613423,ANZ,Savings
29-08-2025 01:51,ANZC7B4A93BF6B646A7BF3C,012-345-678,11111111,WOOLWORTHS ANZ,8.25,0,815324.58,DR,REF383870,ANZ,Savings
29-08-2025 01:53,ANZ1BA4CBBE39384BA98732,012-345-678,11111111,PAYMENT GATEWAY ANZ,14.04,0,815310.54,DR,REF582487,ANZ,Savings
29-08-2025 01:59,ANZA834A49D111747B79AAA,012-345-678,11111111,COMPANY PAYROLL ANZ,0,788.93,816099.47,CR,REF434665,ANZ,Savings
29-08-2025 02:00,ANZ7AA94A10353C4D389A4D,012-345-678,11111111,ZOOM ANZ,114.99,0,815984.48,DR,REF653451,ANZ,Savings
29-08-2025 02:06,ANZD84C07FFEFEC4903927F,012-345-678,11111111,CITYLINK ANZ,28.3,0,815956.18,DR,REF211118,ANZ,Savings
29-08-2025 02:20,ANZ8ABF2A4A0FFF4502958B,012-345-678,11111111,BWS ANZ,74.05,0,815882.13,DR,REF776327,ANZ,Savings
29-08-2025 02:23,ANZ1F3B5FC6DC0F4D50817E,012-345-678,11111111,PAYROLL CREDIT ANZ,0,7534.64,823416.77,CR,REF493268,ANZ,Savings
29-08-2025 02:33,ANZF4A550420CA149859D45,012-345-678,11111111,COLES ANZ,21.24,0,823395.53,DR,REF995833,ANZ,Savings
29-08-2025 03:11,ANZF80260A03BB34E63BC63,012-345-678,11111111,CITYLINK ANZ,77.19,0,823318.34,DR,REF401740,ANZ,Savings
29-08-2025 03:41,ANZ012FBF343A4A4863A3C9,012-345-678,11111111,KFC ANZ,67.44,0,823250.9,DR,REF243988,ANZ,Savings
29-08-2025 03:57,ANZA6F3542CE6F5456582AF,012-345-678,11111111,MCDONALDS ANZ,38.36,0,823212.54,DR,REF460519,ANZ,Savings
29-08-2025 04:39,ANZB103AC91B56B47EAB25C,012-345-678,11111111,RAILWAY STATION ANZ,72.62,0,823139.92,DR,REF123641,ANZ,Savings
29-08-2025 04:43,ANZDF5CD7A2CE1948E6BCB7,012-345-678,11111111,PAY - SALARY ANZ,0,864.95,824004.87,CR,REF865131,ANZ,Savings
29-08-2025 05:09,ANZ4265441EB47F4218A07D,012-345-678,11111111,MCDONALDS ANZ,44.94,0,823959.93,DR,REF431797,ANZ,Savings
29-08-2025 05:24,ANZD011DA4BE9C14FE78383,012-345-678,11111111,STARBUCKS ANZ,46.87,0,823913.06,DR,REF953246,ANZ,Savings
29-08-2025 05:57,ANZ231672E5E67F43B2BC5F,012-345-678,11111111,TAFE BOOKSHOP ANZ,29.42,0,823883.64,DR,REF607294,ANZ,Savings
29-08-2025 06:33,ANZ08B4B1699CB24ED68FD9,012-345-678,11111111,BP ANZ,249.09,0,823634.55,DR,REF205126,ANZ,Savings
29-08-2025 06:34,ANZ8D69232A92DD44D2A853,012-345-678,11111111,SHELL ANZ,96.03,0,823538.52,DR,REF951995,ANZ,Savings
29-08-2025 06:45,ANZ136A7092F1794550AD31,012-345-678,11111111,UBER EATS ANZ,62.23,0,823476.29,DR,REF955974,ANZ,Savings
29-08-2025 07:12,ANZA5CE800A45CD411FA959,012-345-678,11111111,RAILWAY STATION ANZ,32.51,0,823443.78,DR,REF394839,ANZ,Savings
29-08-2025 07:31,ANZ8DFD52F1EA5D4A1092C8,012-345-678,11111111,PAYPAL *NETFLIX ANZ,14.22,0,823429.56,DR,REF596514,ANZ,Savings
29-08-2025 07:55,ANZA4DE212318FF4839B19F,012-345-678,11111111,BP ANZ,95.01,0,823334.55,DR,REF419400,ANZ,Savings
29-08-2025 08:21,ANZ6768739658DB415089BE,012-345-678,11111111,ZOOM ANZ,5.9,0,823328.65,DR,REF872385,ANZ,Savings
29-08-2025 08:44,ANZE805FF62550D4A219FEF,012-345-678,11111111,SPOTIFY ANZ,12.66,0,823315.99,DR,REF200838,ANZ,Savings
29-08-2025 09:12,ANZ74D4267882D747A3A7CB,012-345-678,11111111,HARVEY NORMAN ANZ,55.24,0,823260.75,DR,REF127924,ANZ,Savings
29-08-2025 09:40,ANZ10E55708CD6A4C649452,012-345-678,11111111,CITYLINK ANZ,20.07,0,823240.68,DR,REF561434,ANZ,Savings
29-08-2025 10:01,ANZ606E3F9AEF634343A734,012-345-678,11111111,BP ANZ,19.21,0,823221.47,DR,REF250363,ANZ,Savings
29-08-2025 10:26,ANZ3ADE4ECC98344969B7E9,012-345-678,11111111,STARBUCKS ANZ,165.92,0,823055.55,DR,REF120229,ANZ,Savings
29-08-2025 10:27,ANZ6F3098D9219149E6BCFD,012-345-678,11111111,INTERNET TRANSFER ANZ,73.61,0,822981.94,DR,REF613051,ANZ,Savings
29-08-2025 11:44,ANZ70939BAF50EA42898BCD,012-345-678,11111111,FLIXBUS ANZ,130.12,0,822851.82,DR,REF469881,ANZ,Savings
29-08-2025 11:54,ANZ44084158176B461196CF,012-345-678,11111111,UBER EATS ANZ,54.71,0,822797.11,DR,REF330589,ANZ,Savings
29-08-2025 12:09,ANZF2987C77A86D428D8410,012-345-678,11111111,LIQUORLAND ANZ,70.26,0,822726.85,DR,REF584049,ANZ,Savings
29-08-2025 12:34,ANZD070381263834AF88396,012-345-678,11111111,INTERNET TRANSFER ANZ,46.87,0,822679.98,DR,REF357229,ANZ,Savings
29-08-2025 12:39,ANZ3D12306173654F5EB31D,012-345-678,11111111,PAYROLL CREDIT ANZ,0,4974.16,827654.14,CR,REF719679,ANZ,Savings
29-08-2025 12:40,ANZ93B1D4A3474F482E995F,012-345-678,11111111,PAYMENT GATEWAY ANZ,25.58,0,827628.56,DR,REF382502,ANZ,Savings
29-08-2025 12:43,ANZF00CFFD096934F45AE72,012-345-678,11111111,DOMINO'S PIZZA ANZ,80.29,0,827548.27,DR,REF443117,ANZ,Savings
29-08-2025 12:45,ANZ2E2FC44FD7174E6189B3,012-345-678,11111111,FLIXBUS ANZ,128.75,0,827419.52,DR,REF921070,ANZ,Savings
29-08-2025 13:20,ANZ0B2ED1DD12554C0FB7A0,012-345-678,11111111,WOOLWORTHS ANZ,65.48,0,827354.04,DR,REF647894,ANZ,Savings
29-08-2025 13:36,ANZC40782CEF92F45E59433,012-345-678,11111111,DOMINO'S PIZZA ANZ,16.48,0,827337.56,DR,REF630155,ANZ,Savings
29-08-2025 14:20,ANZA7C1BFB7C3C04A7B9E8F,012-345-678,11111111,SPOTIFY ANZ,95.93,0,827241.63,DR,REF104190,ANZ,Savings
29-08-2025 14:21,ANZ6DC8329435D744C0ADA5,012-345-678,11111111,FLIXBUS ANZ,177.84,0,827063.79,DR,REF646478,ANZ,Savings
29-08-2025 14:23,ANZ3D9DEAB85B234B5ABC27,012-345-678,11111111,PAYPAL *NETFLIX ANZ,28.75,0,827035.04,DR,REF662475,ANZ,Savings
29-08-2025 14:29,ANZBEF25290478941BC9CE0,012-345-678,11111111,FLIXBUS ANZ,21.44,0,827013.6,DR,REF657393,ANZ,Savings
29-08-2025 15:26,ANZ2CA9EA6922C54368AEE5,012-345-678,11111111,INTERNET TRANSFER ANZ,3.29,0,827010.31,DR,REF937014,ANZ,Savings
29-08-2025 15:45,ANZFF20E45160C34DC0A975,012-345-678,11111111,WOOLWORTHS ANZ,136.45,0,826873.86,DR,REF495125,ANZ,Savings
29-08-2025 15:45,ANZ1A962C857DE34BC3B186,012-345-678,11111111,CITYLINK ANZ,13.46,0,826860.4,DR,REF363348,ANZ,Savings
29-08-2025 16:25,ANZDD647EB6980E4F9BBDFD,012-345-678,11111111,ALDI ANZ,11.13,0,826849.27,DR,REF238046,ANZ,Savings
29-08-2025 16:49,ANZ5B021CD39C6D4FDF819D,012-345-678,11111111,CITYLINK ANZ,21.2,0,826828.07,DR,REF735557,ANZ,Savings
29-08-2025 17:01,ANZD2E11FBB1B654CEBB389,012-345-678,11111111,PAYPAL *NETFLIX ANZ,17.02,0,826811.05,DR,REF450297,ANZ,Savings
29-08-2025 17:09,ANZ64DC17570C52470FAA9D,012-345-678,11111111,KFC ANZ,3.74,0,826807.31,DR,REF467864,ANZ,Savings
29-08-2025 17:29,ANZ87399ACBD18F43EB8906,012-345-678,11111111,TAFE BOOKSHOP ANZ,99.07,0,826708.24,DR,REF715361,ANZ,Savings
29-08-2025 17:32,ANZ667CB2CA6D6F4686ACC4,012-345-678,11111111,BWS ANZ,108.66,0,826599.58,DR,REF150667,ANZ,Savings
29-08-2025 17:43,ANZ08E43401807E4073A833,012-345-678,11111111,PAYPAL *NETFLIX ANZ,140.72,0,826458.86,DR,REF543824,ANZ,Savings
29-08-2025 17:52,ANZ824B0C4C9C8D47338953,012-345-678,11111111,7-ELEVEN ANZ,87.57,0,826371.29,DR,REF335215,ANZ,Savings
29-08-2025 18:19,ANZ5D0C85D56E1F47379390,012-345-678,11111111,PAYPAL *NETFLIX ANZ,47.19,0,826324.1,DR,REF129566,ANZ,Savings
29-08-2025 18:33,ANZFF3D814377A24ECC9D7D,012-345-678,11111111,WOOLWORTHS ANZ,7.78,0,826316.32,DR,REF544342,ANZ,Savings
29-08-2025 19:05,ANZF0A2638284814743892A,012-345-678,11111111,COLES ANZ,18.56,0,826297.76,DR,REF168654,ANZ,Savings
29-08-2025 19:44,ANZE3586FB2969A45528644,012-345-678,11111111,INTERNET TRANSFER ANZ,38.82,0,826258.94,DR,REF356966,ANZ,Savings
29-08-2025 19:52,INTE9E88EC524C94F34A766,012-345-678,11111111,TRANSFER FROM CBA 22222222,0,223.9,826482.84,CR,INT-78466,ANZ,Savings
29-08-2025 20:23,ANZ184A2A95F7CB4C69ADD3,012-345-678,11111111,WOOLWORTHS ANZ,18.74,0,826464.1,DR,REF969681,ANZ,Savings
29-08-2025 20:44,ANZC19542F429E1451D821F,012-345-678,11111111,MENULOG ANZ,38.36,0,826425.74,DR,REF987041,ANZ,Savings
29-08-2025 20:47,ANZ0EDA8DAE40FF44D38994,012-345-678,11111111,PAYMENT GATEWAY ANZ,103.11,0,826322.63,DR,REF114475,ANZ,Savings
29-08-2025 20:58,ANZBEABF4DD864D44ABBD72,012-345-678,11111111,TAFE BOOKSHOP ANZ,33.45,0,826289.18,DR,REF318379,ANZ,Savings
29-08-2025 21:11,ANZ584BC7BF748B430AB27E,012-345-678,11111111,SALARY PAYMENT ANZ,0,5276.7,831565.88,CR,REF939638,ANZ,Savings
29-08-2025 21:24,ANZ15EC2E4A900141C7A070,012-345-678,11111111,COLES ANZ,190.69,0,831375.19,DR,REF623700,ANZ,Savings
29-08-2025 21:42,ANZFD35FEE3594F4C96AF0E,012-345-678,11111111,DOMINO'S PIZZA ANZ,95.92,0,831279.27,DR,REF167879,ANZ,Savings
29-08-2025 22:24,ANZ39C4837FE0F34BA7AAE5,012-345-678,11111111,BP ANZ,10.75,0,831268.52,DR,REF391081,ANZ,Savings
29-08-2025 22:37,ANZ86CDAD80C96A4A368940,012-345-678,11111111,APPLE ANZ,39.88,0,831228.64,DR,REF573389,ANZ,Savings
29-08-2025 22:59,ANZ7FCF668C2062472BB618,012-345-678,11111111,STARBUCKS ANZ,28.64,0,831200,DR,REF105341,ANZ,Savings
29-08-2025 23:06,ANZB3B5433E50CD48B39B99,012-345-678,11111111,BP ANZ,8.5,0,831191.5,DR,REF369035,ANZ,Savings
29-08-2025 23:38,ANZAAAE8F1E81844989B262,012-345-678,11111111,ALDI ANZ,74.09,0,831117.41,DR,REF276096,ANZ,Savings
29-08-2025 23:52,ANZA9E1327684EC4A3F8C3C,012-345-678,11111111,BWS ANZ,17.22,0,831100.19,DR,REF952673,ANZ,Savings
30-08-2025 00:10,ANZ116720F4E5964052848A,012-345-678,11111111,KFC ANZ,62.69,0,831037.5,DR,REF916176,ANZ,Savings
30-08-2025 00:15,ANZC9A7B78C152D4A17BF6C,012-345-678,11111111,HARVEY NORMAN ANZ,108.94,0,830928.56,DR,REF595319,ANZ,Savings
30-08-2025 00:45,ANZ59C20654F70F4F7797F9,012-345-678,11111111,PAYMENT GATEWAY ANZ,51.17,0,830877.39,DR,REF855117,ANZ,Savings
30-08-2025 00:50,ANZ1663A3732DFF41ECA15C,012-345-678,11111111,FLIXBUS ANZ,196.25,0,830681.14,DR,REF126801,ANZ,Savings
30-08-2025 00:59,ANZ329E43B8FDC54031BA45,012-345-678,11111111,BANK FEE ANZ,2.19,0,830678.95,DR,REF828896,ANZ,Savings
30-08-2025 01:07,ANZ6FDB7EB2B7264D63A2FA,012-345-678,11111111,MENULOG ANZ,18.9,0,830660.05,DR,REF713312,ANZ,Savings
30-08-2025 02:08,ANZEDA05F7119CB43DB96BB,012-345-678,11111111,BP ANZ,25.42,0,830634.63,DR,REF728266,ANZ,Savings
30-08-2025 02:12,ANZE30A8977C4A84F8AB23C,012-345-678,11111111,CITYLINK ANZ,47.15,0,830587.48,DR,REF473960,ANZ,Savings
30-08-2025 02:26,ANZ890F070EE3B040A7BFC0,012-345-678,11111111,MCDONALDS ANZ,30.86,0,830556.62,DR,REF513283,ANZ,Savings
30-08-2025 02:35,ANZ1837922AE4B44A17A1C5,012-345-678,11111111,PAYMENT GATEWAY ANZ,17.22,0,830539.4,DR,REF637122,ANZ,Savings
30-08-2025 02:41,ANZ5CF0063F3DF8479485D7,012-345-678,11111111,ZOOM ANZ,33.62,0,830505.78,DR,REF734342,ANZ,Savings
30-08-2025 03:35,ANZ67C8E31257CB4FA9981C,012-345-678,11111111,ALDI ANZ,75.64,0,830430.14,DR,REF403313,ANZ,Savings
30-08-2025 03:53,ANZ7DB750CF6DB644EAA181,012-345-678,11111111,ALDI ANZ,103.98,0,830326.16,DR,REF710282,ANZ,Savings
30-08-2025 03:59,ANZ7C096B87E4E841509E3B,012-345-678,11111111,WAGES CREDIT ANZ,0,73.14,830399.3,CR,REF165729,ANZ,Savings
30-08-2025 04:05,ANZ65CA02D0AC674A37B1DC,012-345-678,11111111,COLES ANZ,73.39,0,830325.91,DR,REF489834,ANZ,Savings
30-08-2025 04:14,ANZAE3C65E9143745368A68,012-345-678,11111111,MCDONALDS ANZ,77.84,0,830248.07,DR,REF252255,ANZ,Savings
30-08-2025 04:25,ANZ8EA56A77393E405E8609,012-345-678,11111111,HARVEY NORMAN ANZ,94.95,0,830153.12,DR,REF359924,ANZ,Savings
30-08-2025 04:41,ANZ8D3AD6D44EC04D20AF0B,012-345-678,11111111,BP ANZ,9.62,0,830143.5,DR,REF341187,ANZ,Savings
30-08-2025 05:20,ANZ74F6789DE65D461BB967,012-345-678,11111111,ZOOM ANZ,37.43,0,830106.07,DR,REF128722,ANZ,Savings
30-08-2025 05:39,ANZ0A72E68A1D9244FA97A4,012-345-678,11111111,INTERNET TRANSFER ANZ,97.52,0,830008.55,DR,REF942965,ANZ,Savings
30-08-2025 05:41,ANZ19BB26F534B64914A060,012-345-678,11111111,JB HI-FI ANZ,6.23,0,830002.32,DR,REF170192,ANZ,Savings
30-08-2025 05:47,ANZ4AB5B96CF239454295B5,012-345-678,11111111,AMAZON AU ANZ,41.52,0,829960.8,DR,REF728704,ANZ,Savings
30-08-2025 06:22,ANZCE49BC6FCFD443DAA0EB,012-345-678,11111111,BP ANZ,9.14,0,829951.66,DR,REF101955,ANZ,Savings
30-08-2025 06:52,ANZ0141D4BE57374D7D8440,012-345-678,11111111,INTERNET TRANSFER ANZ,53.62,0,829898.04,DR,REF601883,ANZ,Savings
30-08-2025 07:00,ANZFA228B3198FF4B0381B1,012-345-678,11111111,APPLE ANZ,182.64,0,829715.4,DR,REF110047,ANZ,Savings
30-08-2025 07:05,ANZEFC800E2974C43F0888B,012-345-678,11111111,INTERNET TRANSFER ANZ,13.56,0,829701.84,DR,REF779319,ANZ,Savings
30-08-2025 07:15,ANZCCE4BD08B0534885AD4F,012-345-678,11111111,BP ANZ,23.11,0,829678.73,DR,REF178656,ANZ,Savings
30-08-2025 07:21,ANZ95CE031D125F4E70BF33,012-345-678,11111111,KFC ANZ,155.37,0,829523.36,DR,REF645794,ANZ,Savings
30-08-2025 07:55,ANZDA9469C728114394AE72,012-345-678,11111111,INTERNET TRANSFER ANZ,9.86,0,829513.5,DR,REF136909,ANZ,Savings
30-08-2025 08:04,ANZ8D695B33CAC94D9AA426,012-345-678,11111111,PAYPAL *NETFLIX ANZ,224.01,0,829289.49,DR,REF678458,ANZ,Savings
30-08-2025 08:11,ANZ659BD90BCD4D45F497C2,012-345-678,11111111,TAFE BOOKSHOP ANZ,39.36,0,829250.13,DR,REF555714,ANZ,Savings
30-08-2025 08:17,ANZCB5871B67B4B4DEFAC26,012-345-678,11111111,SALARY PAYMENT ANZ,0,7987.7,837237.83,CR,REF663394,ANZ,Savings
30-08-2025 08:51,ANZFB63F70ABD0142F8BD16,012-345-678,11111111,AMAZON AU ANZ,49.84,0,837187.99,DR,REF573145,ANZ,Savings
30-08-2025 09:03,ANZ6C488856DE60472DB915,012-345-678,11111111,7-ELEVEN ANZ,54.45,0,837133.54,DR,REF992476,ANZ,Savings
30-08-2025 09:11,ANZ6D4B30733F794862A912,012-345-678,11111111,SPOTIFY ANZ,28.01,0,837105.53,DR,REF304097,ANZ,Savings
30-08-2025 09:17,ANZ2A41A8EB097949479A5D,012-345-678,11111111,PAYROLL CREDIT ANZ,0,6579.94,843685.47,CR,REF582106,ANZ,Savings
30-08-2025 09:35,ANZEAE2DA13A49441D98E54,012-345-678,11111111,WOOLWORTHS ANZ,26.16,0,843659.31,DR,REF204726,ANZ,Savings
30-08-2025 09:42,ANZC257A4AD566E498DB16A,012-345-678,11111111,SALARY PAYMENT ANZ,0,528.77,844188.08,CR,REF459309,ANZ,Savings
30-08-2025 09:44,ANZ86069FC5BF6D43D8BF8F,012-345-678,11111111,FLIXBUS ANZ,52.6,0,844135.48,DR,REF947485,ANZ,Savings
30-08-2025 09:46,ANZD3EF5861D7F8495AB738,012-345-678,11111111,MCDONALDS ANZ,24.99,0,844110.49,DR,REF453643,ANZ,Savings
30-08-2025 10:22,ANZAA7C2770E2204A46B027,012-345-678,11111111,CITYLINK ANZ,10.48,0,844100.01,DR,REF693760,ANZ,Savings
30-08-2025 10:27,ANZA4A84500660A41888915,012-345-678,11111111,SHELL ANZ,22.28,0,844077.73,DR,REF826435,ANZ,Savings
30-08-2025 11:00,ANZ5C0B0A0011F04A2BA34A,012-345-678,11111111,COMPANY PAYROLL ANZ,0,450.43,844528.16,CR,REF230465,ANZ,Savings
30-08-2025 11:03,ANZ8491A401EAAE4ED88988,012-345-678,11111111,WAGES CREDIT ANZ,0,6232.58,850760.74,CR,REF951965,ANZ,Savings
30-08-2025 11:23,ANZB0D159CFC9B441BB8123,012-345-678,11111111,FLIXBUS ANZ,105.4,0,850655.34,DR,REF730487,ANZ,Savings
30-08-2025 12:27,ANZ1A3CDA0664A44A059CC3,012-345-678,11111111,TAFE BOOKSHOP ANZ,89.7,0,850565.64,DR,REF193038,ANZ,Savings
30-08-2025 12:37,ANZ84E14D01C3A844269A34,012-345-678,11111111,MCDONALDS ANZ,50.3,0,850515.34,DR,REF559346,ANZ,Savings
30-08-2025 12:39,ANZEC430AF7D7524E269D26,012-345-678,11111111,WAGES CREDIT ANZ,0,5676.17,856191.51,CR,REF787512,ANZ,Savings
30-08-2025 12:46,ANZ7AF52FB528CF40B0BE4A,012-345-678,11111111,UBER EATS ANZ,20.93,0,856170.58,DR,REF967471,ANZ,Savings
30-08-2025 12:59,ANZ99E4665F44C94F7B97F4,012-345-678,11111111,COMPANY PAYROLL ANZ,0,7566.15,863736.73,CR,REF116856,ANZ,Savings
30-08-2025 13:22,ANZ5187BC388C364AAA9CFD,012-345-678,11111111,UBER EATS ANZ,401.8,0,863334.93,DR,REF406378,ANZ,Savings
30-08-2025 13:28,INT5E68B395DB434F299A68,012-345-678,11111111,TRANSFER TO NAB 44444444,1711.65,0,861623.28,DR,INT-31430,ANZ,Savings
30-08-2025 14:07,ANZ3D3019781B224E6CBCF3,012-345-678,11111111,BP ANZ,116.12,0,861507.16,DR,REF554412,ANZ,Savings
30-08-2025 14:12,ANZ88CC97ED676E45EA94B3,012-345-678,11111111,DOMINO'S PIZZA ANZ,26.45,0,861480.71,DR,REF663039,ANZ,Savings
30-08-2025 14:33,ANZ1B4425487FE0414A9FAF,012-345-678,11111111,COMPANY PAYROLL ANZ,0,2191.65,863672.36,CR,REF284564,ANZ,Savings
30-08-2025 14:49,ANZAE5669B3E5C246E4896F,012-345-678,11111111,BIGW ANZ,18.68,0,863653.68,DR,REF730780,ANZ,Savings
30-08-2025 15:00,ANZ78288189B37A45A6AD17,012-345-678,11111111,PAY - SALARY ANZ,0,5450.86,869104.54,CR,REF725135,ANZ,Savings
30-08-2025 15:24,INTF51F4C70ED5E4FD88B81,012-345-678,11111111,TRANSFER TO CBA 22222222,1259.82,0,867844.72,DR,INT-86483,ANZ,Savings
30-08-2025 16:39,ANZ31C51904BD9649548C6C,012-345-678,11111111,PAYPAL *NETFLIX ANZ,41.82,0,867802.9,DR,REF161248,ANZ,Savings
30-08-2025 16:46,ANZC83C979285774840AD8A,012-345-678,11111111,PAYROLL CREDIT ANZ,0,2784.1,870587,CR,REF380698,ANZ,Savings
30-08-2025 16:47,ANZA6003F3AAAE84548A2FE,012-345-678,11111111,BANK FEE ANZ,5.18,0,870581.82,DR,REF764699,ANZ,Savings
30-08-2025 16:55,ANZ4A0F626E8205446E9137,012-345-678,11111111,PAY - SALARY ANZ,0,1036.5,871618.32,CR,REF535805,ANZ,Savings
30-08-2025 17:18,ANZ72D77D13A37E445990C1,012-345-678,11111111,RAILWAY STATION ANZ,216.33,0,871401.99,DR,REF931408,ANZ,Savings
30-08-2025 18:15,ANZC09F1CD66BFB4DE68738,012-345-678,11111111,DOMINO'S PIZZA ANZ,5.28,0,871396.71,DR,REF636128,ANZ,Savings
30-08-2025 18:46,ANZ995C8B4559CC411E997D,012-345-678,11111111,WOOLWORTHS ANZ,72.64,0,871324.07,DR,REF504314,ANZ,Savings
30-08-2025 19:30,ANZE023D44713AC4A708582,012-345-678,11111111,SHELL ANZ,76.66,0,871247.41,DR,REF899981,ANZ,Savings
30-08-2025 20:05,ANZ9A1ADA5915AB42AEA773,012-345-678,11111111,PAY - SALARY ANZ,0,3861.05,875108.46,CR,REF699909,ANZ,Savings
30-08-2025 20:34,ANZ879AD7EC7B8A42FE9661,012-345-678,11111111,MCDONALDS ANZ,74.17,0,875034.29,DR,REF835064,ANZ,Savings
30-08-2025 20:41,ANZ29700D31CB074AC89226,012-345-678,11111111,CITYLINK ANZ,9.77,0,875024.52,DR,REF648195,ANZ,Savings
30-08-2025 21:03,ANZED4C7F7FA091472A9493,012-345-678,11111111,BP ANZ,16.86,0,875007.66,DR,REF489268,ANZ,Savings
30-08-2025 21:15,ANZ08B30C03C30C4DF08318,012-345-678,11111111,KFC ANZ,30.85,0,874976.81,DR,REF785020,ANZ,Savings
30-08-2025 21:16,ANZF895C9CD63F74D69B395,012-345-678,11111111,APPLE ANZ,8.08,0,874968.73,DR,REF995607,ANZ,Savings
30-08-2025 21:54,ANZ7245D44D4694415BAF27,012-345-678,11111111,DOMINO'S PIZZA ANZ,21,0,874947.73,DR,REF571965,ANZ,Savings
30-08-2025 22:11,ANZC2AE6771FB064D8AB186,012-345-678,11111111,HARVEY NORMAN ANZ,11.55,0,874936.18,DR,REF900652,ANZ,Savings
30-08-2025 22:47,ANZB8B2902E813641AE8922,012-345-678,11111111,BANK FEE ANZ,93.18,0,874843,DR,REF583047,ANZ,Savings
30-08-2025 22:47,ANZF7B7FB7D4B764326B81A,012-345-678,11111111,SALARY PAYMENT ANZ,0,5071.73,879914.73,CR,REF768937,ANZ,Savings
30-08-2025 23:26,ANZ8AEE655A770A4532AAE3,012-345-678,11111111,FLIXBUS ANZ,28.99,0,879885.74,DR,REF118177,ANZ,Savings
30-08-2025 23:35,ANZ6B397CDED5D440C7BE88,012-345-678,11111111,BP ANZ,35.37,0,879850.37,DR,REF250961,ANZ,Savings
30-08-2025 23:45,ANZ24B0D8BBDA154363883D,012-345-678,11111111,LIQUORLAND ANZ,26.18,0,879824.19,DR,REF583382,ANZ,Savings
30-08-2025 23:59,ANZ2C52ABE821AA41368678,012-345-678,11111111,BIGW ANZ,9.18,0,879815.01,DR,REF108097,ANZ,Savings
31-08-2025 00:26,ANZ3A07B46BF3D948CCBB8E,012-345-678,11111111,AMAZON AU ANZ,52.94,0,879762.07,DR,REF542721,ANZ,Savings
31-08-2025 00:45,ANZDED1358B638F45A290F4,012-345-678,11111111,PAY - SALARY ANZ,0,818.79,880580.86,CR,REF867073,ANZ,Savings
31-08-2025 00:47,INT1AD4AABCA16F4E8FBA73,012-345-678,11111111,TRANSFER TO CBA 33333333,1600.15,0,878980.71,DR,INT-70561,ANZ,Savings
31-08-2025 01:00,ANZC778513F3B3943449D46,012-345-678,11111111,MENULOG ANZ,56.3,0,878924.41,DR,REF122259,ANZ,Savings
31-08-2025 01:38,ANZ4DCA1107D77B43E5AF43,012-345-678,11111111,7-ELEVEN ANZ,5.35,0,878919.06,DR,REF283039,ANZ,Savings
31-08-2025 01:57,ANZ61653D9128114F699062,012-345-678,11111111,WAGES CREDIT ANZ,0,5192.8,884111.86,CR,REF968610,ANZ,Savings
31-08-2025 01:59,ANZEF0C95F0901B4655AC0F,012-345-678,11111111,DOMINO'S PIZZA ANZ,70.27,0,884041.59,DR,REF363578,ANZ,Savings
31-08-2025 02:21,ANZD12D8E2DB4A3436A88DE,012-345-678,11111111,MENULOG ANZ,72.97,0,883968.62,DR,REF257409,ANZ,Savings
31-08-2025 02:26,ANZ8B169438BD5E456483D0,012-345-678,11111111,WOOLWORTHS ANZ,15.1,0,883953.52,DR,REF330148,ANZ,Savings
31-08-2025 03:13,ANZ266F08B46CA2433AB204,012-345-678,11111111,DOMINO'S PIZZA ANZ,50.66,0,883902.86,DR,REF973630,ANZ,Savings
31-08-2025 03:25,ANZ3E0F6847BAC7466B9CA7,012-345-678,11111111,COLES ANZ,28.55,0,883874.31,DR,REF886021,ANZ,Savings
31-08-2025 03:37,ANZ4C7D05CE2D88474FA09B,012-345-678,11111111,SPOTIFY ANZ,37.05,0,883837.26,DR,REF333382,ANZ,Savings
31-08-2025 03:50,ANZC707DC4C131141C5A648,012-345-678,11111111,MENULOG ANZ,46.32,0,883790.94,DR,REF425955,ANZ,Savings
31-08-2025 04:40,ANZ43D12ABB7FDC4CB09115,012-345-678,11111111,MENULOG ANZ,55.66,0,883735.28,DR,REF219776,ANZ,Savings
31-08-2025 04:43,ANZC2FAC96641554427BA93,012-345-678,11111111,SALARY PAYMENT ANZ,0,581.08,884316.36,CR,REF631143,ANZ,Savings
31-08-2025 05:01,ANZB146FD24B1CC42ED8B1F,012-345-678,11111111,BWS ANZ,47.35,0,884269.01,DR,REF821690,ANZ,Savings
31-08-2025 05:29,ANZ4063A1B94D8C429D9054,012-345-678,11111111,UBER EATS ANZ,37.45,0,884231.56,DR,REF605723,ANZ,Savings
31-08-2025 05:40,ANZ5BC4890A861346E18C88,012-345-678,11111111,APPLE ANZ,12.58,0,884218.98,DR,REF685224,ANZ,Savings
31-08-2025 05:42,ANZ76DB9F7E663F45938279,012-345-678,11111111,PAYROLL CREDIT ANZ,0,3721.92,887940.9,CR,REF490869,ANZ,Savings
31-08-2025 06:50,ANZ90B5A1B6BD434EDD96F8,012-345-678,11111111,ZOOM ANZ,68.39,0,887872.51,DR,REF447724,ANZ,Savings
31-08-2025 06:58,ANZ7EAF7A3D6961450E8958,012-345-678,11111111,PAYPAL *NETFLIX ANZ,35.53,0,887836.98,DR,REF609289,ANZ,Savings
31-08-2025 07:39,ANZ6EE3947B1CD440C2B5D6,012-345-678,11111111,BWS ANZ,6.04,0,887830.94,DR,REF376545,ANZ,Savings
31-08-2025 07:50,ANZ88F4968F91F84B3EAE4E,012-345-678,11111111,ALDI ANZ,48.34,0,887782.6,DR,REF550270,ANZ,Savings
31-08-2025 09:14,ANZC5E444221FDE4154B8C5,012-345-678,11111111,HARVEY NORMAN ANZ,52.02,0,887730.58,DR,REF289494,ANZ,Savings
31-08-2025 09:18,ANZEB8559274B264E8B9D82,012-345-678,11111111,SALARY PAYMENT ANZ,0,725.04,888455.62,CR,REF106703,ANZ,Savings
31-08-2025 09:19,ANZ82CB928D142F4FD58ABE,012-345-678,11111111,KFC ANZ,276.69,0,888178.93,DR,REF813914,ANZ,Savings
31-08-2025 09:25,ANZ3E53776C8083472D8E15,012-345-678,11111111,BWS ANZ,4.22,0,888174.71,DR,REF471416,ANZ,Savings
31-08-2025 09:41,ANZ985DDA677E0D429DBB44,012-345-678,11111111,BP ANZ,95.39,0,888079.32,DR,REF493511,ANZ,Savings
31-08-2025 09:43,ANZ466496AF26974ABB99C0,012-345-678,11111111,WAGES CREDIT ANZ,0,396.44,888475.76,CR,REF500539,ANZ,Savings
31-08-2025 09:44,ANZBAF0DAE7A7C346DAB6EB,012-345-678,11111111,WOOLWORTHS ANZ,87.34,0,888388.42,DR,REF377460,ANZ,Savings
31-08-2025 09:46,ANZE9FE7356BAA8488FBE86,012-345-678,11111111,BANK FEE ANZ,89.55,0,888298.87,DR,REF874815,ANZ,Savings
31-08-2025 10:03,ANZFAE9C7FBDDE047088A7A,012-345-678,11111111,BP ANZ,82.07,0,888216.8,DR,REF626349,ANZ,Savings
31-08-2025 11:18,ANZ81B03BD597DE454E9315,012-345-678,11111111,PAYMENT GATEWAY ANZ,17.24,0,888199.56,DR,REF904253,ANZ,Savings
31-08-2025 11:32,ANZ6BC44B9169C24CDBB254,012-345-678,11111111,APPLE ANZ,24.18,0,888175.38,DR,REF142715,ANZ,Savings
31-08-2025 11:52,ANZ0C32BA52ECB549FB88FD,012-345-678,11111111,SALARY PAYMENT ANZ,0,6461.8,894637.18,CR,REF614130,ANZ,Savings
31-08-2025 12:05,ANZ9A987BFBF13C4CAC9986,012-345-678,11111111,WOOLWORTHS ANZ,10.14,0,894627.04,DR,REF751711,ANZ,Savings
31-08-2025 12:22,ANZ8206031065BD4F5B9632,012-345-678,11111111,LIQUORLAND ANZ,3.56,0,894623.48,DR,REF487476,ANZ,Savings
31-08-2025 12:24,ANZ14BC6044594B45889AC0,012-345-678,11111111,STARBUCKS ANZ,29.82,0,894593.66,DR,REF620805,ANZ,Savings
31-08-2025 12:32,ANZ4293A17FEFBF47D19E53,012-345-678,11111111,INTERNET TRANSFER ANZ,16.73,0,894576.93,DR,REF329507,ANZ,Savings
31-08-2025 12:36,ANZ481676B1D46247A8B83B,012-345-678,11111111,PAYMENT GATEWAY ANZ,140.37,0,894436.56,DR,REF796801,ANZ,Savings
31-08-2025 12:37,ANZ2D18B47A42534933AA7B,012-345-678,11111111,BIGW ANZ,68.72,0,894367.84,DR,REF469559,ANZ,Savings
31-08-2025 12:43,ANZD12277408AEE409CB76E,012-345-678,11111111,INTERNET TRANSFER ANZ,21.55,0,894346.29,DR,REF585452,ANZ,Savings
31-08-2025 13:07,ANZD941E62B453149B0A0B7,012-345-678,11111111,CITYLINK ANZ,70.13,0,894276.16,DR,REF745538,ANZ,Savings
31-08-2025 13:53,ANZACE0094085204919BC73,012-345-678,11111111,COLES ANZ,9.14,0,894267.02,DR,REF853484,ANZ,Savings
31-08-2025 14:07,ANZF1D261A9C16445B18231,012-345-678,11111111,JB HI-FI ANZ,16.41,0,894250.61,DR,REF309284,ANZ,Savings
31-08-2025 14:09,ANZDB75E1E2AC894CC69861,012-345-678,11111111,WOOLWORTHS ANZ,124.87,0,894125.74,DR,REF359863,ANZ,Savings
31-08-2025 15:17,ANZE1EAFEB2E025499F8F40,012-345-678,11111111,WOOLWORTHS ANZ,18.12,0,894107.62,DR,REF369910,ANZ,Savings
31-08-2025 15:19,ANZA0F21DDA03F146ACB50C,012-345-678,11111111,APPLE ANZ,8.5,0,894099.12,DR,REF441688,ANZ,Savings
31-08-2025 15:46,ANZEBB900FA92CA4B708652,012-345-678,11111111,AMAZON AU ANZ,136.94,0,893962.18,DR,REF346037,ANZ,Savings
31-08-2025 16:28,ANZ65C0E64170354BBA82E9,012-345-678,11111111,BWS ANZ,7.74,0,893954.44,DR,REF269502,ANZ,Savings
31-08-2025 16:37,ANZBE39D4F180314B0F9864,012-345-678,11111111,COLES ANZ,21.2,0,893933.24,DR,REF643276,ANZ,Savings
31-08-2025 16:44,ANZE296760B426A40159B5E,012-345-678,11111111,TAFE BOOKSHOP ANZ,27.51,0,893905.73,DR,REF586081,ANZ,Savings
31-08-2025 17:27,ANZ272B4202D04E4B528D3D,012-345-678,11111111,KFC ANZ,4.78,0,893900.95,DR,REF433813,ANZ,Savings
31-08-2025 17:34,ANZCAF645CD82484A89B805,012-345-678,11111111,PAYPAL *NETFLIX ANZ,14.42,0,893886.53,DR,REF843995,ANZ,Savings
31-08-2025 17:53,ANZCEDFB6A48BE94EB7A808,012-345-678,11111111,FLIXBUS ANZ,20.05,0,893866.48,DR,REF628266,ANZ,Savings
31-08-2025 17:57,ANZ2A1F6C65F7B54422AB17,012-345-678,11111111,COMPANY PAYROLL ANZ,0,875.57,894742.05,CR,REF795044,ANZ,Savings
31-08-2025 18:19,ANZAC49DBF67BF34CADA399,012-345-678,11111111,WOOLWORTHS ANZ,163.13,0,894578.92,DR,REF577745,ANZ,Savings
31-08-2025 18:48,ANZ748780516C064350B467,012-345-678,11111111,PAYMENT GATEWAY ANZ,96.42,0,894482.5,DR,REF430408,ANZ,Savings
31-08-2025 18:55,ANZDA7F8A8D388B4F92BE5E,012-345-678,11111111,FLIXBUS ANZ,73.3,0,894409.2,DR,REF189178,ANZ,Savings
31-08-2025 18:56,INT041D79BCA6DE48F89129,012-345-678,11111111,TRANSFER TO CBA 33333333,1383.71,0,893025.49,DR,INT-84938,ANZ,Savings
31-08-2025 19:26,ANZ1EE2A5CB32F4488CBE99,012-345-678,11111111,BWS ANZ,104.2,0,892921.29,DR,REF172257,ANZ,Savings
31-08-2025 19:31,ANZB450B44715AE4B2BA37B,012-345-678,11111111,BWS ANZ,54.29,0,892867,DR,REF546903,ANZ,Savings
31-08-2025 19:34,ANZ3BABFF88935742938E30,012-345-678,11111111,BIGW ANZ,52.43,0,892814.57,DR,REF834837,ANZ,Savings
31-08-2025 19:41,ANZ3C494B2FA62B4830A818,012-345-678,11111111,HARVEY NORMAN ANZ,108.31,0,892706.26,DR,REF511959,ANZ,Savings
31-08-2025 19:56,ANZ1D3F3E66A1D64C00B0F2,012-345-678,11111111,FLIXBUS ANZ,46.31,0,892659.95,DR,REF358930,ANZ,Savings
31-08-2025 19:57,ANZADA127641AF14852A8EF,012-345-678,11111111,WAGES CREDIT ANZ,0,6270.31,898930.26,CR,REF888531,ANZ,Savings
31-08-2025 20:05,ANZ2B5425A3B2014435B392,012-345-678,11111111,PAYMENT GATEWAY ANZ,12.39,0,898917.87,DR,REF204286,ANZ,Savings
31-08-2025 20:50,INTD55DA9124CFF4BD8A430,012-345-678,11111111,TRANSFER TO CBA 22222222,1184.81,0,897733.06,DR,INT-91556,ANZ,Savings
31-08-2025 21:17,ANZ3585518AB02C41A1AB39,012-345-678,11111111,FLIXBUS ANZ,7.66,0,897725.4,DR,REF747020,ANZ,Savings
31-08-2025 21:33,INT73C4C72C5FF844BFA218,012-345-678,11111111,TRANSFER FROM NAB 44444444,0,1384.29,899109.69,CR,INT-74290,ANZ,Savings
31-08-2025 21:34,INT70C2D252F47645709CE5,012-345-678,11111111,TRANSFER FROM CBA 22222222,0,508.46,899618.15,CR,INT-69730,ANZ,Savings
31-08-2025 21:39,ANZ662C4FEBA7834894AF4D,012-345-678,11111111,ZOOM ANZ,10.98,0,899607.17,DR,REF670935,ANZ,Savings
31-08-2025 22:10,ANZ84C9725C54BE48249775,012-345-678,11111111,KFC ANZ,38.5,0,899568.67,DR,REF213239,ANZ,Savings
31-08-2025 22:20,ANZF164501E43F74363BBC7,012-345-678,11111111,BIGW ANZ,28.37,0,899540.3,DR,REF227897,ANZ,Savings
31-08-2025 22:33,ANZ96F2F950FC3A459F9814,012-345-678,11111111,BIGW ANZ,9.19,0,899531.11,DR,REF208066,ANZ,Savings
31-08-2025 22:37,ANZ0C2AAB76140F4276984B,012-345-678,11111111,SPOTIFY ANZ,6.79,0,899524.32,DR,REF552679,ANZ,Savings
31-08-2025 22:52,ANZ7E10A83C1C984367A668,012-345-678,11111111,PAYMENT GATEWAY ANZ,108.81,0,899415.51,DR,REF181996,ANZ,Savings
31-08-2025 22:56,ANZ54E9C9BFA05E4777928E,012-345-678,11111111,RAILWAY STATION ANZ,47.14,0,899368.37,DR,REF147123,ANZ,Savings
31-08-2025 23:41,ANZA1255ED3E6C2460692A9,012-345-678,11111111,HARVEY NORMAN ANZ,49.47,0,899318.9,DR,REF905287,ANZ,Savings
31-08-2025 23:47,ANZ437432E63657454A8133,012-345-678,11111111,AMAZON AU ANZ,96.62,0,899222.28,DR,REF774938,ANZ,Savings
01-09-2025 00:14,ANZEAE4A2CEF5C94DBE90CB,012-345-678,11111111,COMPANY PAYROLL ANZ,0,3442.82,902665.1,CR,REF863018,ANZ,Savings
01-09-2025 00:19,ANZCFE00A827D5943FE832F,012-345-678,11111111,MENULOG ANZ,8.47,0,902656.63,DR,REF972652,ANZ,Savings
01-09-2025 00:28,ANZ49CCF9745ADD4463B7F9,012-345-678,11111111,PAY - SALARY ANZ,0,6705.92,909362.55,CR,REF391537,ANZ,Savings
01-09-2025 00:40,ANZAC2BEC7379224F298E22,012-345-678,11111111,MENULOG ANZ,87.79,0,909274.76,DR,REF494609,ANZ,Savings
01-09-2025 00:41,ANZ5F2DA266D1AC40D98F9A,012-345-678,11111111,BP ANZ,41.03,0,909233.73,DR,REF621185,ANZ,Savings
01-09-2025 00:45,ANZ8995292E601A485186BC,012-345-678,11111111,TAFE BOOKSHOP ANZ,35.48,0,909198.25,DR,REF138052,ANZ,Savings
01-09-2025 01:20,ANZ55EA2234CDCC4EE0824A,012-345-678,11111111,SHELL ANZ,8.23,0,909190.02,DR,REF558013,ANZ,Savings
01-09-2025 01:27,ANZ29ED3D3971F740738EC3,012-345-678,11111111,BWS ANZ,22.03,0,909167.99,DR,REF730737,ANZ,Savings
01-09-2025 01:28,ANZ9FCB3BBE081A4863B405,012-345-678,11111111,BIGW ANZ,74,0,909093.99,DR,REF923369,ANZ,Savings
01-09-2025 01:37,ANZBC2A05E9BB0F4B9C826A,012-345-678,11111111,TAFE BOOKSHOP ANZ,7.05,0,909086.94,DR,REF137708,ANZ,Savings
01-09-2025 01:54,ANZ86D759CDAB3D4F64B3A2,012-345-678,11111111,ZOOM ANZ,7.19,0,909079.75,DR,REF506229,ANZ,Savings
01-09-2025 02:07,ANZ750B20C016DD4A13B138,012-345-678,11111111,MCDONALDS ANZ,47.8,0,909031.95,DR,REF455591,ANZ,Savings
01-09-2025 02:11,ANZ5E3D37C4EDB94F6382BE,012-345-678,11111111,TAFE BOOKSHOP ANZ,39.26,0,908992.69,DR,REF344527,ANZ,Savings
01-09-2025 02:32,ANZ1F975D7E1DFE4C1E9E09,012-345-678,11111111,SHELL ANZ,15.61,0,908977.08,DR,REF427006,ANZ,Savings
01-09-2025 02:41,ANZ8B94084E4D90424CADCC,012-345-678,11111111,AMAZON AU ANZ,18.15,0,908958.93,DR,REF721913,ANZ,Savings
01-09-2025 02:57,ANZE532B413775E472F8713,012-345-678,11111111,BANK FEE ANZ,54.1,0,908904.83,DR,REF482346,ANZ,Savings
01-09-2025 03:33,ANZ22AFEF14C25743F5A8D2,012-345-678,11111111,RAILWAY STATION ANZ,122.07,0,908782.76,DR,REF594079,ANZ,Savings
01-09-2025 03:43,ANZ57D5B84A82E84312AB5E,012-345-678,11111111,INTERNET TRANSFER ANZ,11.14,0,908771.62,DR,REF275028,ANZ,Savings
01-09-2025 04:21,ANZB5E1EEE2BDEA408C89D0,012-345-678,11111111,WOOLWORTHS ANZ,53.81,0,908717.81,DR,REF120010,ANZ,Savings
01-09-2025 04:32,ANZ11B72703AF2A4F67B920,012-345-678,11111111,SHELL ANZ,19.86,0,908697.95,DR,REF180420,ANZ,Savings
01-09-2025 04:35,ANZDCD9A98C6A544A1084C7,012-345-678,11111111,FLIXBUS ANZ,29.46,0,908668.49,DR,REF173221,ANZ,Savings
01-09-2025 04:48,ANZFACB3F509F004A118D06,012-345-678,11111111,SHELL ANZ,42.44,0,908626.05,DR,REF965458,ANZ,Savings
01-09-2025 04:53,ANZ5FC530D74EE640A094D0,012-345-678,11111111,AMAZON AU ANZ,23.04,0,908603.01,DR,REF139381,ANZ,Savings
01-09-2025 04:55,ANZC26A573E3AF64474A1A9,012-345-678,11111111,UBER EATS ANZ,4.06,0,908598.95,DR,REF325905,ANZ,Savings
01-09-2025 05:09,ANZC53CC8E8B76F46DDA27F,012-345-678,11111111,SPOTIFY ANZ,3.6,0,908595.35,DR,REF987541,ANZ,Savings
01-09-2025 05:15,ANZ12D712B51F1B4CBFA78E,012-345-678,11111111,RAILWAY STATION ANZ,129.8,0,908465.55,DR,REF612157,ANZ,Savings
01-09-2025 05:58,ANZC5189C4459864043B51D,012-345-678,11111111,AMAZON AU ANZ,64.33,0,908401.22,DR,REF490689,ANZ,Savings
01-09-2025 06:00,INT53574CD61044495FB524,012-345-678,11111111,TRANSFER FROM NAB 44444444,0,1713.75,910114.97,CR,INT-82873,ANZ,Savings
01-09-2025 06:08,ANZFFD7672FFFB0469EBA2B,012-345-678,11111111,MENULOG ANZ,158.89,0,909956.08,DR,REF471008,ANZ,Savings
01-09-2025 06:19,ANZC70412E8B944413CADEA,012-345-678,11111111,APPLE ANZ,100.13,0,909855.95,DR,REF566951,ANZ,Savings
01-09-2025 06:29,ANZ19B7B75540004919A124,012-345-678,11111111,SALARY PAYMENT ANZ,0,302.67,910158.62,CR,REF100475,ANZ,Savings
01-09-2025 07:05,ANZA49FC356D45A46EB888B,012-345-678,11111111,INTERNET TRANSFER ANZ,55.67,0,910102.95,DR,REF836858,ANZ,Savings
01-09-2025 07:15,ANZF6D2680A834C4111A0D1,012-345-678,11111111,BANK FEE ANZ,63.12,0,910039.83,DR,REF433374,ANZ,Savings
01-09-2025 07:31,ANZD610ECBF67294194B84C,012-345-678,11111111,KFC ANZ,80.25,0,909959.58,DR,REF926739,ANZ,Savings
01-09-2025 07:50,ANZ2EA1F1D6BEAE43149910,012-345-678,11111111,PAY - SALARY ANZ,0,569.75,910529.33,CR,REF308050,ANZ,Savings
01-09-2025 08:25,ANZ69CE6BD5969C4E85A786,012-345-678,11111111,STARBUCKS ANZ,9.55,0,910519.78,DR,REF494634,ANZ,Savings
01-09-2025 08:32,ANZ0FCD365AE6244739BCD9,012-345-678,11111111,CITYLINK ANZ,16.11,0,910503.67,DR,REF490538,ANZ,Savings
01-09-2025 08:48,ANZ37E988A5EDD942F3AABC,012-345-678,11111111,BWS ANZ,76.19,0,910427.48,DR,REF342889,ANZ,Savings
01-09-2025 10:42,ANZ25E990F7A8394D449801,012-345-678,11111111,STARBUCKS ANZ,106.26,0,910321.22,DR,REF795754,ANZ,Savings
01-09-2025 10:46,ANZ871414158FEB41768B5D,012-345-678,11111111,RAILWAY STATION ANZ,36.32,0,910284.9,DR,REF107998,ANZ,Savings
01-09-2025 11:04,ANZ43D635449FB941EE8990,012-345-678,11111111,SHELL ANZ,65.56,0,910219.34,DR,REF838994,ANZ,Savings
01-09-2025 11:10,ANZD8DA914DAF5A409A936E,012-345-678,11111111,COLES ANZ,148.09,0,910071.25,DR,REF763715,ANZ,Savings
01-09-2025 11:18,ANZ0E01FFAA2CF44EC6B405,012-345-678,11111111,ALDI ANZ,36.65,0,910034.6,DR,REF283469,ANZ,Savings
01-09-2025 11:24,ANZ6508C76DBC994A4BBCD0,012-345-678,11111111,COMPANY PAYROLL ANZ,0,6196.51,916231.11,CR,REF429283,ANZ,Savings
01-09-2025 11:38,ANZ50F893BC16684EF68680,012-345-678,11111111,BP ANZ,5.78,0,916225.33,DR,REF111037,ANZ,Savings
01-09-2025 11:55,ANZF4A62FF7FD464C89ACB3,012-345-678,11111111,PAYMENT GATEWAY ANZ,51.34,0,916173.99,DR,REF128684,ANZ,Savings
01-09-2025 11:59,ANZCAC86E94E0B54273BD1B,012-345-678,11111111,WAGES CREDIT ANZ,0,546.01,916720,CR,REF809685,ANZ,Savings
01-09-2025 12:06,INT66222A02FA114E99ABC3,012-345-678,11111111,TRANSFER FROM NAB 44444444,0,460.46,917180.46,CR,INT-40135,ANZ,Savings
01-09-2025 12:23,ANZ2CDF40B74EA544B18E66,012-345-678,11111111,TAFE BOOKSHOP ANZ,22.7,0,917157.76,DR,REF605590,ANZ,Savings
01-09-2025 13:48,ANZ15E73A7183CE4769A955,012-345-678,11111111,INTERNET TRANSFER ANZ,88.76,0,917069,DR,REF823525,ANZ,Savings
01-09-2025 13:50,ANZEC7AF4CADE124A7B8419,012-345-678,11111111,HARVEY NORMAN ANZ,39.63,0,917029.37,DR,REF233635,ANZ,Savings
01-09-2025 13:51,ANZC11506B879B64107A52E,012-345-678,11111111,KFC ANZ,41.2,0,916988.17,DR,REF140233,ANZ,Savings
01-09-2025 13:56,ANZE3129227DE0E4CF08719,012-345-678,11111111,COMPANY PAYROLL ANZ,0,968.92,917957.09,CR,REF557085,ANZ,Savings
01-09-2025 13:59,ANZ997C8C2DAA5444E2BA6B,012-345-678,11111111,PAYROLL CREDIT ANZ,0,419.74,918376.83,CR,REF691465,ANZ,Savings
01-09-2025 14:52,ANZ6740E65BB25A4E798DF8,012-345-678,11111111,WAGES CREDIT ANZ,0,1133.68,919510.51,CR,REF601106,ANZ,Savings
01-09-2025 15:37,ANZF43E9BC33D7F439CB664,012-345-678,11111111,LIQUORLAND ANZ,7.15,0,919503.36,DR,REF731362,ANZ,Savings
01-09-2025 16:44,ANZ646287AB7EDC40F1AED7,012-345-678,11111111,BIGW ANZ,44.89,0,919458.47,DR,REF699812,ANZ,Savings
01-09-2025 16:53,ANZ1AE4281D6B574298814D,012-345-678,11111111,COLES ANZ,20.07,0,919438.4,DR,REF467069,ANZ,Savings
01-09-2025 17:38,ANZ3332923C107A48ABA502,012-345-678,11111111,PAY - SALARY ANZ,0,6700.32,926138.72,CR,REF660028,ANZ,Savings
01-09-2025 17:43,ANZ1DAB532063F047BAA159,012-345-678,11111111,SHELL ANZ,71.96,0,926066.76,DR,REF325164,ANZ,Savings
01-09-2025 18:28,ANZ993E20540CDD469E9AD9,012-345-678,11111111,ALDI ANZ,19.62,0,926047.14,DR,REF626550,ANZ,Savings
01-09-2025 18:32,ANZD808DCECACA449ABAEFA,012-345-678,11111111,WOOLWORTHS ANZ,36.92,0,926010.22,DR,REF553319,ANZ,Savings
01-09-2025 19:00,ANZ9F6CF041ACDA4EB195F5,012-345-678,11111111,MCDONALDS ANZ,38.36,0,925971.86,DR,REF228089,ANZ,Savings
01-09-2025 19:11,ANZ94BCC8BD931245E18E07,012-345-678,11111111,BANK FEE ANZ,4.99,0,925966.87,DR,REF580039,ANZ,Savings
01-09-2025 19:20,ANZE13F2023094E4C8B8225,012-345-678,11111111,WOOLWORTHS ANZ,19.49,0,925947.38,DR,REF541327,ANZ,Savings
01-09-2025 19:31,ANZ8A34481FF55E46AAB157,012-345-678,11111111,COLES ANZ,9.77,0,925937.61,DR,REF314759,ANZ,Savings
01-09-2025 20:01,ANZA9F17C17F5964051B388,012-345-678,11111111,PAYMENT GATEWAY ANZ,110.22,0,925827.39,DR,REF910698,ANZ,Savings
01-09-2025 20:38,ANZ2C60F0BC05FB45B7AB6A,012-345-678,11111111,BIGW ANZ,8.38,0,925819.01,DR,REF915624,ANZ,Savings
01-09-2025 20:38,ANZ376735A5165D4427BC0B,012-345-678,11111111,WOOLWORTHS ANZ,103.83,0,925715.18,DR,REF733381,ANZ,Savings
01-09-2025 21:00,ANZ7262245D612E4F6BA25E,012-345-678,11111111,BWS ANZ,95.44,0,925619.74,DR,REF425040,ANZ,Savings
01-09-2025 21:06,ANZ6EB411BEFF0342FC9E60,012-345-678,11111111,CITYLINK ANZ,23.92,0,925595.82,DR,REF137887,ANZ,Savings
01-09-2025 21:09,ANZC2E37BD5289548B6937B,012-345-678,11111111,WOOLWORTHS ANZ,10.7,0,925585.12,DR,REF874471,ANZ,Savings
01-09-2025 21:38,ANZ96DA250A271D4D04A3AA,012-345-678,11111111,COLES ANZ,10.44,0,925574.68,DR,REF633190,ANZ,Savings
01-09-2025 21:52,ANZ6D17976C219143D1BA3E,012-345-678,11111111,CITYLINK ANZ,48.9,0,925525.78,DR,REF725852,ANZ,Savings
01-09-2025 21:53,ANZDDEFE96A550940C9A1C5,012-345-678,11111111,PAYPAL *NETFLIX ANZ,59.69,0,925466.09,DR,REF569010,ANZ,Savings
01-09-2025 22:32,ANZ96030B9AC02D46AF86CB,012-345-678,11111111,UBER EATS ANZ,85.27,0,925380.82,DR,REF805345,ANZ,Savings
01-09-2025 23:37,ANZ713C734C29544C7F8005,012-345-678,11111111,SALARY PAYMENT ANZ,0,951.26,926332.08,CR,REF694774,ANZ,Savings
01-09-2025 23:40,ANZCEDE815B12B644F7AE96,012-345-678,11111111,PAY - SALARY ANZ,0,7.94,926340.02,CR,REF111269,ANZ,Savings
01-09-2025 23:43,ANZ9F50E893ED1543D98A5D,012-345-678,11111111,BANK FEE ANZ,34.81,0,926305.21,DR,REF770342,ANZ,Savings
02-09-2025 00:07,ANZBC5B37968A0246FE88B3,012-345-678,11111111,COLES ANZ,15.89,0,926289.32,DR,REF517162,ANZ,Savings
02-09-2025 00:09,ANZ5CBC87F45DF54074986B,012-345-678,11111111,COLES ANZ,44.4,0,926244.92,DR,REF287330,ANZ,Savings
02-09-2025 00:16,ANZ23FA51D16F3E4896B30F,012-345-678,11111111,SPOTIFY ANZ,25.31,0,926219.61,DR,REF345275,ANZ,Savings
02-09-2025 02:11,ANZ40126CF32226437EB78B,012-345-678,11111111,UBER EATS ANZ,69.31,0,926150.3,DR,REF693627,ANZ,Savings
02-09-2025 02:19,ANZ942A75323BCF4DAF8C4C,012-345-678,11111111,DOMINO'S PIZZA ANZ,82.18,0,926068.12,DR,REF981111,ANZ,Savings
02-09-2025 02:36,ANZEBED2CDE15EF4CB88E17,012-345-678,11111111,SPOTIFY ANZ,10.27,0,926057.85,DR,REF649037,ANZ,Savings
02-09-2025 02:45,ANZF6BC3A474A3A45EC84D4,012-345-678,11111111,SALARY PAYMENT ANZ,0,3551.35,929609.2,CR,REF680121,ANZ,Savings
02-09-2025 03:04,ANZD089485AD18540798776,012-345-678,11111111,SHELL ANZ,19.13,0,929590.07,DR,REF622069,ANZ,Savings
02-09-2025 03:07,ANZ2633B54FC19242A29680,012-345-678,11111111,PAYPAL *NETFLIX ANZ,41.74,0,929548.33,DR,REF160622,ANZ,Savings
02-09-2025 03:27,INT896060E974864E13B030,012-345-678,11111111,TRANSFER FROM CBA 33333333,0,1521.12,931069.45,CR,INT-44344,ANZ,Savings
02-09-2025 03:30,ANZ57EC9E3BD13149D4A82B,012-345-678,11111111,BWS ANZ,66.79,0,931002.66,DR,REF546130,ANZ,Savings
02-09-2025 03:33,ANZ0A56A556127E488E9A65,012-345-678,11111111,INTERNET TRANSFER ANZ,8.05,0,930994.61,DR,REF270406,ANZ,Savings
02-09-2025 03:48,ANZCC753F75E15940ECB1CD,012-345-678,11111111,MENULOG ANZ,24.35,0,930970.26,DR,REF697882,ANZ,Savings
02-09-2025 04:01,ANZ7EED83104E09478D97E7,012-345-678,11111111,MENULOG ANZ,9.49,0,930960.77,DR,REF169370,ANZ,Savings
02-09-2025 04:02,ANZ8EB52542C0F547028A95,012-345-678,11111111,BANK FEE ANZ,129.8,0,930830.97,DR,REF179384,ANZ,Savings
02-09-2025 04:10,ANZ701DE878B18341F4BA27,012-345-678,11111111,BP ANZ,251.33,0,930579.64,DR,REF848601,ANZ,Savings
02-09-2025 04:10,INTFA558397BB794367B75C,012-345-678,11111111,TRANSFER FROM NAB 44444444,0,115.09,930694.73,CR,INT-77984,ANZ,Savings
02-09-2025 04:37,ANZ52F9FFB2A7644E908076,012-345-678,11111111,PAYPAL *NETFLIX ANZ,62.96,0,930631.77,DR,REF449066,ANZ,Savings
02-09-2025 04:42,ANZ051A5E08F3714A949FE5,012-345-678,11111111,7-ELEVEN ANZ,34.28,0,930597.49,DR,REF461571,ANZ,Savings
02-09-2025 05:09,ANZ8AC93CCFFC624A95878B,012-345-678,11111111,MCDONALDS ANZ,148.46,0,930449.03,DR,REF220464,ANZ,Savings
02-09-2025 05:13,ANZB78F5FD5AF6E416E9A0A,012-345-678,11111111,RAILWAY STATION ANZ,89.64,0,930359.39,DR,REF237905,ANZ,Savings
02-09-2025 05:36,ANZFAD616F1A2AB49C090B8,012-345-678,11111111,SHELL ANZ,55.4,0,930303.99,DR,REF551737,ANZ,Savings
02-09-2025 05:38,ANZB3EDD3AC1DAC44A1B925,012-345-678,11111111,BP ANZ,33.23,0,930270.76,DR,REF894933,ANZ,Savings
02-09-2025 05:40,INTB71EB9CF4DC6486EBFDE,012-345-678,11111111,TRANSFER TO CBA 22222222,1472.24,0,928798.52,DR,INT-48776,ANZ,Savings
02-09-2025 06:00,ANZAA51E827A32E43BA9E19,012-345-678,11111111,ZOOM ANZ,39.5,0,928759.02,DR,REF205307,ANZ,Savings
02-09-2025 06:25,ANZ4A1BBFCC3046436B830B,012-345-678,11111111,DOMINO'S PIZZA ANZ,5,0,928754.02,DR,REF941959,ANZ,Savings
02-09-2025 06:52,ANZ5236B8B21DA2476A9264,012-345-678,11111111,WOOLWORTHS ANZ,57.59,0,928696.43,DR,REF661816,ANZ,Savings
02-09-2025 07:01,ANZCFA77414A76E4B51A9A6,012-345-678,11111111,PAYMENT GATEWAY ANZ,8.34,0,928688.09,DR,REF745514,ANZ,Savings
02-09-2025 07:49,ANZF953D2B3E9DA48378B81,012-345-678,11111111,PAYMENT GATEWAY ANZ,7.1,0,928680.99,DR,REF160411,ANZ,Savings
02-09-2025 07:50,ANZ5FF9B209716A4F1C89F4,012-345-678,11111111,SPOTIFY ANZ,36.84,0,928644.15,DR,REF468432,ANZ,Savings
02-09-2025 07:54,ANZ068222271DD9414C8E7E,012-345-678,11111111,BWS ANZ,3.19,0,928640.96,DR,REF272782,ANZ,Savings
02-09-2025 09:19,ANZ8B1A7BE90E66479A8AF5,012-345-678,11111111,LIQUORLAND ANZ,47.63,0,928593.33,DR,REF243518,ANZ,Savings
02-09-2025 09:43,ANZD395002F2D0A4F03B18D,012-345-678,11111111,PAYMENT GATEWAY ANZ,19.09,0,928574.24,DR,REF384287,ANZ,Savings
02-09-2025 09:48,ANZ1C34FFE6BAF142D6BA80,012-345-678,11111111,MENULOG ANZ,27.67,0,928546.57,DR,REF603335,ANZ,Savings
02-09-2025 09:54,INT1B99747D84F846F68C69,012-345-678,11111111,TRANSFER TO CBA 22222222,1920.57,0,926626,DR,INT-66963,ANZ,Savings
02-09-2025 10:04,ANZD3086076ACDD49FC99DB,012-345-678,11111111,RAILWAY STATION ANZ,22.64,0,926603.36,DR,REF189322,ANZ,Savings
02-09-2025 10:28,ANZD45DEC96A7FA418A92D6,012-345-678,11111111,LIQUORLAND ANZ,71.72,0,926531.64,DR,REF495626,ANZ,Savings
02-09-2025 10:36,ANZ9C5A8DD914C94626A70D,012-345-678,11111111,AMAZON AU ANZ,42.67,0,926488.97,DR,REF805732,ANZ,Savings
02-09-2025 10:37,ANZEEED7F40FE2C44C49476,012-345-678,11111111,UBER EATS ANZ,16.21,0,926472.76,DR,REF399920,ANZ,Savings
02-09-2025 10:38,ANZ97CDC8D6C0A44097A430,012-345-678,11111111,WOOLWORTHS ANZ,58.13,0,926414.63,DR,REF809619,ANZ,Savings
02-09-2025 11:01,ANZ82EF5E4C8CCC448C8E6B,012-345-678,11111111,AMAZON AU ANZ,41.16,0,926373.47,DR,REF684801,ANZ,Savings
02-09-2025 11:05,ANZ3C343D8236D047DBA652,012-345-678,11111111,KFC ANZ,159.1,0,926214.37,DR,REF560989,ANZ,Savings
02-09-2025 11:34,ANZ6572507594AA4E5790FD,012-345-678,11111111,APPLE ANZ,11.08,0,926203.29,DR,REF133711,ANZ,Savings
02-09-2025 12:21,ANZ51AEBA04FB8C487BBA1D,012-345-678,11111111,RAILWAY STATION ANZ,21.9,0,926181.39,DR,REF724935,ANZ,Savings
02-09-2025 12:35,ANZ472C5298299944DFAEA8,012-345-678,11111111,TAFE BOOKSHOP ANZ,11.82,0,926169.57,DR,REF226378,ANZ,Savings
02-09-2025 12:38,ANZD90073F78CAE46699067,012-345-678,11111111,MCDONALDS ANZ,32.83,0,926136.74,DR,REF341517,ANZ,Savings
02-09-2025 12:49,ANZCF4F63A318E242439B7A,012-345-678,11111111,BANK FEE ANZ,24.07,0,926112.67,DR,REF333263,ANZ,Savings
02-09-2025 12:53,ANZ3E7A440E133A46CF8FA9,012-345-678,11111111,MENULOG ANZ,15.91,0,926096.76,DR,REF607958,ANZ,Savings
02-09-2025 13:37,ANZ3132AB7FD20A45C0A44D,012-345-678,11111111,ZOOM ANZ,84.45,0,926012.31,DR,REF703659,ANZ,Savings
02-09-2025 13:50,ANZA0509AF840014070A166,012-345-678,11111111,APPLE ANZ,101.57,0,925910.74,DR,REF209229,ANZ,Savings
02-09-2025 14:25,ANZCDAD47B45A7A4C3BA457,012-345-678,11111111,HARVEY NORMAN ANZ,26.04,0,925884.7,DR,REF768638,ANZ,Savings
02-09-2025 14:56,ANZ5E1F7751E72A498AADA8,012-345-678,11111111,COMPANY PAYROLL ANZ,0,810.65,926695.35,CR,REF836720,ANZ,Savings
02-09-2025 15:17,ANZB744C775BD1E44B0A679,012-345-678,11111111,MENULOG ANZ,24.97,0,926670.38,DR,REF955885,ANZ,Savings
02-09-2025 15:31,ANZ08079267666B4603BDA0,012-345-678,11111111,PAYMENT GATEWAY ANZ,33.29,0,926637.09,DR,REF954789,ANZ,Savings
02-09-2025 15:34,ANZC2EB5589CF6D47BF9076,012-345-678,11111111,SPOTIFY ANZ,4.99,0,926632.1,DR,REF146210,ANZ,Savings
02-09-2025 15:35,ANZ417D8E0BF58643449BE6,012-345-678,11111111,WOOLWORTHS ANZ,35.52,0,926596.58,DR,REF720530,ANZ,Savings
02-09-2025 16:56,ANZ47152B59A8A5432BBF77,012-345-678,11111111,STARBUCKS ANZ,9.47,0,926587.11,DR,REF959684,ANZ,Savings
02-09-2025 17:10,ANZC1EB5BCA886F470FB1D6,012-345-678,11111111,FLIXBUS ANZ,18.72,0,926568.39,DR,REF772174,ANZ,Savings
02-09-2025 17:38,ANZ73F592FF25F14FAA9B93,012-345-678,11111111,INTERNET TRANSFER ANZ,184.75,0,926383.64,DR,REF524801,ANZ,Savings
02-09-2025 18:07,ANZD7616A7E437A4B93ACD2,012-345-678,11111111,HARVEY NORMAN ANZ,19.71,0,926363.93,DR,REF483154,ANZ,Savings
02-09-2025 18:34,ANZ9D696FFCECBF42B3AB7A,012-345-678,11111111,PAYPAL *NETFLIX ANZ,17.08,0,926346.85,DR,REF864634,ANZ,Savings
02-09-2025 19:14,ANZ6FEF9D1407614BB5B018,012-345-678,11111111,UBER EATS ANZ,66.22,0,926280.63,DR,REF894444,ANZ,Savings
02-09-2025 19:30,ANZ7252CD8A400E48A29E7F,012-345-678,11111111,WOOLWORTHS ANZ,14.78,0,926265.85,DR,REF213348,ANZ,Savings
02-09-2025 20:15,ANZ8E180097B426485BA793,012-345-678,11111111,INTERNET TRANSFER ANZ,7.35,0,926258.5,DR,REF898306,ANZ,Savings
02-09-2025 20:21,ANZ5A5096F22544452E9C69,012-345-678,11111111,BP ANZ,51.93,0,926206.57,DR,REF256877,ANZ,Savings
02-09-2025 20:42,ANZ42D216F14FDB4F6F9579,012-345-678,11111111,PAY - SALARY ANZ,0,4689.96,930896.53,CR,REF629370,ANZ,Savings
02-09-2025 20:51,ANZ7F7A7E60507D4CEBA1F4,012-345-678,11111111,INTERNET TRANSFER ANZ,58.45,0,930838.08,DR,REF388020,ANZ,Savings
02-09-2025 21:14,ANZFD23D07292AF41CFB313,012-345-678,11111111,BANK FEE ANZ,10.49,0,930827.59,DR,REF511975,ANZ,Savings
02-09-2025 22:31,ANZ09EC66674129412A94F0,012-345-678,11111111,COLES ANZ,51.39,0,930776.2,DR,REF565763,ANZ,Savings
02-09-2025 22:40,ANZF112D2B3A8FE4D92BF54,012-345-678,11111111,KFC ANZ,52.36,0,930723.84,DR,REF394300,ANZ,Savings
02-09-2025 22:51,ANZ280A75C31D864F1DB63A,012-345-678,11111111,ZOOM ANZ,48.95,0,930674.89,DR,REF587459,ANZ,Savings
02-09-2025 22:58,ANZ69AF19AEC5F84417AE17,012-345-678,11111111,CITYLINK ANZ,31.43,0,930643.46,DR,REF462595,ANZ,Savings
02-09-2025 23:04,ANZ14AEEBC8D4574FB7A41A,012-345-678,11111111,PAYPAL *NETFLIX ANZ,47.94,0,930595.52,DR,REF832972,ANZ,Savings
03-09-2025 00:53,ANZ580C1E7189724868A890,012-345-678,11111111,INTERNET TRANSFER ANZ,22.15,0,930573.37,DR,REF461352,ANZ,Savings
03-09-2025 01:11,ANZ4792FBE21BFF4DCD9259,012-345-678,11111111,PAYROLL CREDIT ANZ,0,7209.92,937783.29,CR,REF503960,ANZ,Savings
03-09-2025 01:25,ANZD4DC9416F7B7495F81DA,012-345-678,11111111,DOMINO'S PIZZA ANZ,12.85,0,937770.44,DR,REF220375,ANZ,Savings
03-09-2025 01:29,ANZ91EFEBF1464D42D6A069,012-345-678,11111111,RAILWAY STATION ANZ,64.32,0,937706.12,DR,REF121539,ANZ,Savings
03-09-2025 02:02,ANZ6E55526EE3DA49F9A700,012-345-678,11111111,JB HI-FI ANZ,120.33,0,937585.79,DR,REF324209,ANZ,Savings
03-09-2025 02:06,ANZ695D897D63D04A7C8F18,012-345-678,11111111,HARVEY NORMAN ANZ,13.07,0,937572.72,DR,REF332478,ANZ,Savings
03-09-2025 02:18,INTEF388DA29F9748F182B7,012-345-678,11111111,TRANSFER TO CBA 22222222,84.08,0,937488.64,DR,INT-43082,ANZ,Savings
03-09-2025 02:41,ANZ16BC28663BFF44BCB368,012-345-678,11111111,STARBUCKS ANZ,64.92,0,937423.72,DR,REF311821,ANZ,Savings
03-09-2025 02:51,ANZD28DD457E9D647238327,012-345-678,11111111,PAYPAL *NETFLIX ANZ,70.27,0,937353.45,DR,REF295392,ANZ,Savings
03-09-2025 03:14,ANZA86D7D706DD64ABCBEAC,012-345-678,11111111,SHELL ANZ,7.44,0,937346.01,DR,REF591638,ANZ,Savings
03-09-2025 03:21,ANZ2CB1E7C6CA4947269472,012-345-678,11111111,PAY - SALARY ANZ,0,4426.36,941772.37,CR,REF506217,ANZ,Savings
03-09-2025 03:56,ANZ222B5B9A84554C189B16,012-345-678,11111111,PAYPAL *NETFLIX ANZ,17.94,0,941754.43,DR,REF430925,ANZ,Savings
03-09-2025 04:10,ANZC7466ED6286E41BBABE3,012-345-678,11111111,FLIXBUS ANZ,99.26,0,941655.17,DR,REF981434,ANZ,Savings
03-09-2025 04:32,ANZAB2948814F4842738EC5,012-345-678,11111111,CITYLINK ANZ,3.89,0,941651.28,DR,REF319384,ANZ,Savings
03-09-2025 05:08,ANZ1AAD595810B74C7C8007,012-345-678,11111111,FLIXBUS ANZ,27.97,0,941623.31,DR,REF333204,ANZ,Savings
03-09-2025 05:21,ANZABF67ADAE252425F8381,012-345-678,11111111,DOMINO'S PIZZA ANZ,148.62,0,941474.69,DR,REF916780,ANZ,Savings
03-09-2025 05:43,ANZC98B29A7AF0644C5A009,012-345-678,11111111,FLIXBUS ANZ,5.78,0,941468.91,DR,REF477361,ANZ,Savings
03-09-2025 05:51,ANZED704C83413947E18C2C,012-345-678,11111111,BWS ANZ,55.52,0,941413.39,DR,REF464879,ANZ,Savings
03-09-2025 06:00,ANZ0718356051EF4BC08771,012-345-678,11111111,HARVEY NORMAN ANZ,10.38,0,941403.01,DR,REF435591,ANZ,Savings
03-09-2025 06:11,ANZ80E669FF5E984DAAA04D,012-345-678,11111111,INTERNET TRANSFER ANZ,17.89,0,941385.12,DR,REF816998,ANZ,Savings
03-09-2025 06:13,ANZ84215C1A7C9A4992BAFF,012-345-678,11111111,APPLE ANZ,8.7,0,941376.42,DR,REF582540,ANZ,Savings
03-09-2025 06:36,ANZCC15711054374E9BA2A3,012-345-678,11111111,LIQUORLAND ANZ,39.19,0,941337.23,DR,REF665909,ANZ,Savings
03-09-2025 07:19,ANZ70B283332ECF49B9AF79,012-345-678,11111111,SPOTIFY ANZ,33.13,0,941304.1,DR,REF790914,ANZ,Savings
03-09-2025 07:24,ANZCE8F32F025B7438F9869,012-345-678,11111111,KFC ANZ,40.82,0,941263.28,DR,REF601329,ANZ,Savings
03-09-2025 09:17,ANZB6AB731E36E44580BA6B,012-345-678,11111111,LIQUORLAND ANZ,64.49,0,941198.79,DR,REF858569,ANZ,Savings
03-09-2025 09:34,ANZ50C5ABA5611F4C81AAC3,012-345-678,11111111,HARVEY NORMAN ANZ,22,0,941176.79,DR,REF526347,ANZ,Savings
03-09-2025 10:26,ANZ56DD1C2A944B499BAA21,012-345-678,11111111,INTERNET TRANSFER ANZ,48.61,0,941128.18,DR,REF694610,ANZ,Savings
03-09-2025 10:35,ANZBAE3394B8E6B4825A204,012-345-678,11111111,PAYMENT GATEWAY ANZ,73.45,0,941054.73,DR,REF539844,ANZ,Savings
03-09-2025 11:03,ANZDF2310F02E6C492FB49B,012-345-678,11111111,PAYMENT GATEWAY ANZ,36.05,0,941018.68,DR,REF457631,ANZ,Savings
03-09-2025 11:20,ANZ760B29DF6A35497C9E7C,012-345-678,11111111,CITYLINK ANZ,64.17,0,940954.51,DR,REF447277,ANZ,Savings
03-09-2025 11:23,ANZCC650D51726D4F3AAA4D,012-345-678,11111111,DOMINO'S PIZZA ANZ,35.5,0,940919.01,DR,REF142669,ANZ,Savings
03-09-2025 11:49,ANZ86E613CC50754CE5B152,012-345-678,11111111,TAFE BOOKSHOP ANZ,22.73,0,940896.28,DR,REF460260,ANZ,Savings
03-09-2025 11:53,ANZFCF28D4FB5ED4AE99083,012-345-678,11111111,AMAZON AU ANZ,66.27,0,940830.01,DR,REF552916,ANZ,Savings
03-09-2025 12:01,ANZ7CC950547FF1465AABBC,012-345-678,11111111,TAFE BOOKSHOP ANZ,75.99,0,940754.02,DR,REF775747,ANZ,Savings
03-09-2025 12:39,ANZE4802D7A1B2B43BCBB66,012-345-678,11111111,INTERNET TRANSFER ANZ,10.04,0,940743.98,DR,REF707837,ANZ,Savings
03-09-2025 13:00,ANZ933C86C0FFE2481C83FF,012-345-678,11111111,STARBUCKS ANZ,63.66,0,940680.32,DR,REF198301,ANZ,Savings
03-09-2025 13:22,ANZ03068914A10147D7B599,012-345-678,11111111,PAYROLL CREDIT ANZ,0,2448.47,943128.79,CR,REF463439,ANZ,Savings
03-09-2025 13:26,ANZB7C2F20D278E43769466,012-345-678,11111111,RAILWAY STATION ANZ,7.86,0,943120.93,DR,REF650776,ANZ,Savings
03-09-2025 13:31,ANZ99B3EAE59E334273AED5,012-345-678,11111111,BANK FEE ANZ,121.41,0,942999.52,DR,REF942564,ANZ,Savings
03-09-2025 13:46,ANZ44E2DF5E16FF42C2B20D,012-345-678,11111111,PAYROLL CREDIT ANZ,0,1020.7,944020.22,CR,REF811979,ANZ,Savings
03-09-2025 14:15,ANZ78FA3DC62A014BFFB022,012-345-678,11111111,JB HI-FI ANZ,6.56,0,944013.66,DR,REF941951,ANZ,Savings
03-09-2025 14:36,ANZ9B599022B1874A2CA83E,012-345-678,11111111,HARVEY NORMAN ANZ,17.84,0,943995.82,DR,REF105747,ANZ,Savings
03-09-2025 14:42,ANZ6B2605550CCC45C69F64,012-345-678,11111111,KFC ANZ,18.17,0,943977.65,DR,REF559961,ANZ,Savings
03-09-2025 15:11,INT684A5F6C0D9E4D908CBB,012-345-678,11111111,TRANSFER TO CBA 33333333,123.49,0,943854.16,DR,INT-73744,ANZ,Savings
03-09-2025 15:16,ANZD0313F8251E9445C8746,012-345-678,11111111,BIGW ANZ,10.02,0,943844.14,DR,REF861423,ANZ,Savings
03-09-2025 15:19,ANZ9D17931A1A674158BA0F,012-345-678,11111111,INTERNET TRANSFER ANZ,19.7,0,943824.44,DR,REF871165,ANZ,Savings
03-09-2025 16:00,INT95389E0C888B418292B5,012-345-678,11111111,TRANSFER TO NAB 44444444,596.96,0,943227.48,DR,INT-55613,ANZ,Savings
03-09-2025 16:18,ANZ45FAB34135874B3BB62A,012-345-678,11111111,INTERNET TRANSFER ANZ,25.15,0,943202.33,DR,REF146291,ANZ,Savings
03-09-2025 16:19,ANZ4A8A4438CA69454992A1,012-345-678,11111111,SHELL ANZ,115.52,0,943086.81,DR,REF992295,ANZ,Savings
03-09-2025 16:41,ANZ6E58DC3E580545FB8551,012-345-678,11111111,PAY - SALARY ANZ,0,1741.08,944827.89,CR,REF129404,ANZ,Savings
03-09-2025 17:12,ANZ8EA5E5772C4948038346,012-345-678,11111111,SALARY PAYMENT ANZ,0,3348,948175.89,CR,REF766254,ANZ,Savings
03-09-2025 17:15,ANZEBA06EAD650547839A20,012-345-678,11111111,CITYLINK ANZ,15.52,0,948160.37,DR,REF117195,ANZ,Savings
03-09-2025 17:17,ANZA003721CD1C74961BD2B,012-345-678,11111111,WAGES CREDIT ANZ,0,6797.43,954957.8,CR,REF107454,ANZ,Savings
03-09-2025 17:33,ANZADBD096A97844FC7A448,012-345-678,11111111,MENULOG ANZ,22.31,0,954935.49,DR,REF815159,ANZ,Savings
03-09-2025 17:47,ANZDCBEC70D6CB4437FAF35,012-345-678,11111111,UBER EATS ANZ,77.08,0,954858.41,DR,REF787726,ANZ,Savings
03-09-2025 17:47,ANZD8AB08810AEC4653A079,012-345-678,11111111,ALDI ANZ,12.75,0,954845.66,DR,REF174442,ANZ,Savings
03-09-2025 17:49,ANZ577227F197374DD48710,012-345-678,11111111,SPOTIFY ANZ,2.39,0,954843.27,DR,REF702677,ANZ,Savings
03-09-2025 18:03,ANZC6116C53907946DFAE90,012-345-678,11111111,WOOLWORTHS ANZ,27.54,0,954815.73,DR,REF736908,ANZ,Savings
03-09-2025 18:06,ANZFE9C0767BC1C43889A79,012-345-678,11111111,ZOOM ANZ,32.27,0,954783.46,DR,REF962081,ANZ,Savings
03-09-2025 18:10,ANZ78253AE1328E4FEFB1B3,012-345-678,11111111,INTERNET TRANSFER ANZ,25.31,0,954758.15,DR,REF824252,ANZ,Savings
03-09-2025 19:03,ANZ00A4BE396BAB4A0094F6,012-345-678,11111111,WOOLWORTHS ANZ,102.23,0,954655.92,DR,REF539094,ANZ,Savings
03-09-2025 19:05,ANZC1B4F1ED930C4D3BA671,012-345-678,11111111,MCDONALDS ANZ,128.91,0,954527.01,DR,REF894311,ANZ,Savings
03-09-2025 19:22,ANZCDC45EAF90B84E03876A,012-345-678,11111111,BWS ANZ,63.08,0,954463.93,DR,REF420452,ANZ,Savings
03-09-2025 19:27,ANZB8923B25D51743C681DD,012-345-678,11111111,BANK FEE ANZ,89.53,0,954374.4,DR,REF483795,ANZ,Savings
03-09-2025 19:33,ANZF8D9C76E6D204A84A06B,012-345-678,11111111,MENULOG ANZ,9.83,0,954364.57,DR,REF738935,ANZ,Savings
03-09-2025 19:36,ANZ1CB59E96C2184E969CBB,012-345-678,11111111,TAFE BOOKSHOP ANZ,147.41,0,954217.16,DR,REF551581,ANZ,Savings
03-09-2025 19:43,ANZBB3FF23A7C114A4EB8FE,012-345-678,11111111,DOMINO'S PIZZA ANZ,31.23,0,954185.93,DR,REF740086,ANZ,Savings
03-09-2025 20:33,ANZ2984A48F3F02438EA630,012-345-678,11111111,UBER EATS ANZ,33.84,0,954152.09,DR,REF906647,ANZ,Savings
03-09-2025 20:38,ANZ29529BB129A9435FA756,012-345-678,11111111,INTERNET TRANSFER ANZ,84.33,0,954067.76,DR,REF709582,ANZ,Savings
03-09-2025 20:59,ANZA0569B2AEA3A414B995D,012-345-678,11111111,PAYMENT GATEWAY ANZ,77.26,0,953990.5,DR,REF675006,ANZ,Savings
03-09-2025 21:09,ANZF93A45FC29294790B95D,012-345-678,11111111,PAYROLL CREDIT ANZ,0,3057.75,957048.25,CR,REF147298,ANZ,Savings
03-09-2025 21:43,ANZ7F493CE5734B481FB8EB,012-345-678,11111111,COLES ANZ,42.51,0,957005.74,DR,REF582791,ANZ,Savings
03-09-2025 21:43,ANZAA0A649BF01B4A06A712,012-345-678,11111111,BIGW ANZ,7,0,956998.74,DR,REF787075,ANZ,Savings
03-09-2025 21:59,ANZ0EAC3C21594246E6AB4E,012-345-678,11111111,MENULOG ANZ,22.94,0,956975.8,DR,REF601870,ANZ,Savings
03-09-2025 22:21,ANZDB4170CFA31F419A979F,012-345-678,11111111,HARVEY NORMAN ANZ,65.9,0,956909.9,DR,REF584615,ANZ,Savings
04-09-2025 00:00,ANZ68BF0F2C64624252ADD6,012-345-678,11111111,BANK FEE ANZ,8.06,0,956901.84,DR,REF121196,ANZ,Savings
04-09-2025 00:11,ANZ8C196502D1094BB4AE09,012-345-678,11111111,AMAZON AU ANZ,54.32,0,956847.52,DR,REF950445,ANZ,Savings
04-09-2025 00:19,ANZBCB7157C19E94187A97B,012-345-678,11111111,PAYPAL *NETFLIX ANZ,17.7,0,956829.82,DR,REF117145,ANZ,Savings
04-09-2025 00:35,ANZ0DA5E9923A5F46FAAC4A,012-345-678,11111111,KFC ANZ,33.79,0,956796.03,DR,REF751276,ANZ,Savings
04-09-2025 00:43,INTA02441CCAD94432B973F,012-345-678,11111111,TRANSFER FROM CBA 22222222,0,656.83,957452.86,CR,INT-26724,ANZ,Savings
04-09-2025 00:55,ANZC15CA3D6953244649DCF,012-345-678,11111111,HARVEY NORMAN ANZ,20.78,0,957432.08,DR,REF712508,ANZ,Savings
04-09-2025 01:11,ANZAECDC33895814C06B8D0,012-345-678,11111111,ALDI ANZ,16.05,0,957416.03,DR,REF139522,ANZ,Savings
04-09-2025 01:20,INT0DA0C6B0E15845D5AF93,012-345-678,11111111,TRANSFER FROM NAB 44444444,0,1522.79,958938.82,CR,INT-68390,ANZ,Savings
04-09-2025 01:48,ANZ192A8C827C9C4C8980D0,012-345-678,11111111,MENULOG ANZ,48.16,0,958890.66,DR,REF837802,ANZ,Savings
04-09-2025 02:11,ANZ0E7E1912CFF54008A3AD,012-345-678,11111111,BWS ANZ,15.79,0,958874.87,DR,REF487487,ANZ,Savings
04-09-2025 02:15,ANZC9D1C862C898437492E0,012-345-678,11111111,ALDI ANZ,39.1,0,958835.77,DR,REF251773,ANZ,Savings
04-09-2025 02:37,ANZ428042BDCD19447FBCFD,012-345-678,11111111,SALARY PAYMENT ANZ,0,5115.92,963951.69,CR,REF482873,ANZ,Savings
04-09-2025 02:56,ANZ9B6A345E01044504BD5D,012-345-678,11111111,INTERNET TRANSFER ANZ,139.12,0,963812.57,DR,REF525855,ANZ,Savings
04-09-2025 03:05,INT99CCB3A5643040A6BA2F,012-345-678,11111111,TRANSFER TO CBA 22222222,1921.45,0,961891.12,DR,INT-87753,ANZ,Savings
04-09-2025 03:17,ANZ6FBC5A7AE3BB44CAB908,012-345-678,11111111,BANK FEE ANZ,18.34,0,961872.78,DR,REF855163,ANZ,Savings
04-09-2025 03:59,ANZ6ABFA682270D4739A343,012-345-678,11111111,PAYROLL CREDIT ANZ,0,3693.72,965566.5,CR,REF677334,ANZ,Savings
04-09-2025 05:09,ANZEFD5156F989E4F3E8E1C,012-345-678,11111111,MENULOG ANZ,105.18,0,965461.32,DR,REF331585,ANZ,Savings
04-09-2025 05:53,ANZC001566DCE924E518857,012-345-678,11111111,AMAZON AU ANZ,37.29,0,965424.03,DR,REF307404,ANZ,Savings
04-09-2025 05:56,ANZ28A3DFBE905F45029A27,012-345-678,11111111,HARVEY NORMAN ANZ,63.37,0,965360.66,DR,REF901502,ANZ,Savings
04-09-2025 06:11,ANZ1FFBD1576BD14D5A9184,012-345-678,11111111,JB HI-FI ANZ,145.02,0,965215.64,DR,REF850181,ANZ,Savings
04-09-2025 06:20,ANZBE4D59C616314226B81F,012-345-678,11111111,UBER EATS ANZ,65.78,0,965149.86,DR,REF927029,ANZ,Savings
04-09-2025 06:35,ANZDC7BE36103AD493198F2,012-345-678,11111111,LIQUORLAND ANZ,350.64,0,964799.22,DR,REF857898,ANZ,Savings
04-09-2025 06:37,ANZ9D88E289DE864A6D9CDB,012-345-678,11111111,BANK FEE ANZ,199.25,0,964599.97,DR,REF286637,ANZ,Savings
04-09-2025 06:38,ANZ8B43624C22FE44FE9685,012-345-678,11111111,PAYMENT GATEWAY ANZ,225.46,0,964374.51,DR,REF131680,ANZ,Savings
04-09-2025 06:50,ANZ56A7C4E3258C4C3DA4CE,012-345-678,11111111,JB HI-FI ANZ,272.03,0,964102.48,DR,REF922383,ANZ,Savings
04-09-2025 06:58,ANZ6399F30BD0BC49FBA7C9,012-345-678,11111111,PAYMENT GATEWAY ANZ,16.08,0,964086.4,DR,REF748586,ANZ,Savings
04-09-2025 07:10,ANZC17EEBBD2ED7415C93B5,012-345-678,11111111,SALARY PAYMENT ANZ,0,630.87,964717.27,CR,REF331186,ANZ,Savings
04-09-2025 07:51,ANZ8F14131DB98042429030,012-345-678,11111111,ZOOM ANZ,66.47,0,964650.8,DR,REF688654,ANZ,Savings
04-09-2025 08:04,ANZEC184BFDB71C4C538F31,012-345-678,11111111,TAFE BOOKSHOP ANZ,10.13,0,964640.67,DR,REF777471,ANZ,Savings
04-09-2025 08:53,ANZFDB321453C8D4F5C8305,012-345-678,11111111,UBER EATS ANZ,103.12,0,964537.55,DR,REF801811,ANZ,Savings
04-09-2025 08:55,ANZ34F4BA532D0A4E2EA1E4,012-345-678,11111111,PAYMENT GATEWAY ANZ,77.27,0,964460.28,DR,REF269781,ANZ,Savings
04-09-2025 09:03,ANZ7581FA494A5F48DB8B48,012-345-678,11111111,ALDI ANZ,217.76,0,964242.52,DR,REF489239,ANZ,Savings
04-09-2025 09:12,ANZ927CDA7ECFF74E259E17,012-345-678,11111111,COMPANY PAYROLL ANZ,0,303.03,964545.55,CR,REF623834,ANZ,Savings
04-09-2025 09:27,ANZD6D26216707842069FC7,012-345-678,11111111,HARVEY NORMAN ANZ,34.88,0,964510.67,DR,REF812196,ANZ,Savings
04-09-2025 09:50,ANZAD80E57C252447038D96,012-345-678,11111111,7-ELEVEN ANZ,127.74,0,964382.93,DR,REF451821,ANZ,Savings
04-09-2025 10:32,ANZ1220F7D249384DAF9F9F,012-345-678,11111111,BIGW ANZ,53.44,0,964329.49,DR,REF276505,ANZ,Savings
04-09-2025 10:40,ANZA8DFC5BE03064841B57E,012-345-678,11111111,FLIXBUS ANZ,35.13,0,964294.36,DR,REF930691,ANZ,Savings
04-09-2025 10:53,ANZA7B2421832A14D0B8AE6,012-345-678,11111111,BANK FEE ANZ,17.48,0,964276.88,DR,REF795504,ANZ,Savings
04-09-2025 11:06,ANZ6AEBDE96F492464C9BD9,012-345-678,11111111,MCDONALDS ANZ,23.67,0,964253.21,DR,REF919789,ANZ,Savings
04-09-2025 11:10,ANZ9659E06F3F9043F691FC,012-345-678,11111111,PAYROLL CREDIT ANZ,0,205.45,964458.66,CR,REF698294,ANZ,Savings
04-09-2025 11:18,ANZ11A83EEFD56D47AD9542,012-345-678,11111111,ALDI ANZ,13.95,0,964444.71,DR,REF121915,ANZ,Savings
04-09-2025 11:40,ANZ7BC0907C1E6C45209E72,012-345-678,11111111,BANK FEE ANZ,59.69,0,964385.02,DR,REF956751,ANZ,Savings
04-09-2025 11:43,ANZF57054BE52434397B402,012-345-678,11111111,INTERNET TRANSFER ANZ,14.68,0,964370.34,DR,REF173435,ANZ,Savings
04-09-2025 12:59,ANZ8CC3257E33204764BE5B,012-345-678,11111111,APPLE ANZ,7.1,0,964363.24,DR,REF649341,ANZ,Savings
04-09-2025 13:06,ANZD2B679C23E8F46E4AC60,012-345-678,11111111,KFC ANZ,127.85,0,964235.39,DR,REF390605,ANZ,Savings
04-09-2025 13:14,ANZ3AF2ACBA5A634661A1C3,012-345-678,11111111,MCDONALDS ANZ,37.1,0,964198.29,DR,REF158877,ANZ,Savings
04-09-2025 13:16,ANZ23A47FA11D304FAFAC2B,012-345-678,11111111,PAYROLL CREDIT ANZ,0,804.06,965002.35,CR,REF490348,ANZ,Savings
04-09-2025 13:17,ANZD8BF786AB1EC4655AE19,012-345-678,11111111,CITYLINK ANZ,60.19,0,964942.16,DR,REF452701,ANZ,Savings
04-09-2025 13:30,ANZ0FB033AE8C3544E39E80,012-345-678,11111111,HARVEY NORMAN ANZ,80.9,0,964861.26,DR,REF547313,ANZ,Savings
04-09-2025 13:33,ANZF8E0A6601CB74F06A125,012-345-678,11111111,BIGW ANZ,7.39,0,964853.87,DR,REF778338,ANZ,Savings
04-09-2025 13:33,ANZ2BD1C866124C4982A5D1,012-345-678,11111111,STARBUCKS ANZ,113.54,0,964740.33,DR,REF179849,ANZ,Savings
04-09-2025 14:04,ANZ41AC7C6DD90240FCBDA7,012-345-678,11111111,KFC ANZ,10.37,0,964729.96,DR,REF666084,ANZ,Savings
04-09-2025 14:20,ANZF90814DE3BC94898ACC6,012-345-678,11111111,PAYPAL *NETFLIX ANZ,78.58,0,964651.38,DR,REF674552,ANZ,Savings
04-09-2025 14:33,ANZB0D816852EEC489BB70C,012-345-678,11111111,LIQUORLAND ANZ,31.25,0,964620.13,DR,REF985041,ANZ,Savings
04-09-2025 14:37,ANZAB784E05C7D54F9DADE4,012-345-678,11111111,BP ANZ,23.02,0,964597.11,DR,REF285632,ANZ,Savings
04-09-2025 15:08,ANZ5DCD9CE3392D4F9FBE0F,012-345-678,11111111,BIGW ANZ,37.06,0,964560.05,DR,REF659588,ANZ,Savings
04-09-2025 15:09,ANZ7980209D71704927BF66,012-345-678,11111111,INTERNET TRANSFER ANZ,25.8,0,964534.25,DR,REF888004,ANZ,Savings
04-09-2025 15:18,ANZ286283DB90E045338777,012-345-678,11111111,MCDONALDS ANZ,63.52,0,964470.73,DR,REF822037,ANZ,Savings
04-09-2025 15:22,ANZAB9A11D4F9634A038DFF,012-345-678,11111111,DOMINO'S PIZZA ANZ,7.39,0,964463.34,DR,REF289376,ANZ,Savings
04-09-2025 15:56,ANZBA17EA2B442144EB9B09,012-345-678,11111111,TAFE BOOKSHOP ANZ,37.33,0,964426.01,DR,REF969516,ANZ,Savings
04-09-2025 15:56,ANZAF40EA97BB0E42DD99C5,012-345-678,11111111,MENULOG ANZ,24.31,0,964401.7,DR,REF168170,ANZ,Savings
04-09-2025 15:59,ANZCBB1D3F834CC48E4A50B,012-345-678,11111111,HARVEY NORMAN ANZ,63.71,0,964337.99,DR,REF449888,ANZ,Savings
04-09-2025 16:00,ANZCE7A100EFFDC4719A5F8,012-345-678,11111111,TAFE BOOKSHOP ANZ,10.8,0,964327.19,DR,REF963812,ANZ,Savings
04-09-2025 16:41,ANZ1302D0BF62324D099004,012-345-678,11111111,BANK FEE ANZ,200.92,0,964126.27,DR,REF474174,ANZ,Savings
04-09-2025 16:46,ANZ3E1D6364C3A64A88B611,012-345-678,11111111,BIGW ANZ,30.19,0,964096.08,DR,REF619497,ANZ,Savings
04-09-2025 16:55,ANZ8AC42F7651CE44828327,012-345-678,11111111,ZOOM ANZ,49.58,0,964046.5,DR,REF849197,ANZ,Savings
04-09-2025 16:57,ANZB6F86E65807B44E9B7B4,012-345-678,11111111,BP ANZ,8.27,0,964038.23,DR,REF951511,ANZ,Savings
04-09-2025 16:59,ANZA9E1695327304C34ACCC,012-345-678,11111111,UBER EATS ANZ,4.08,0,964034.15,DR,REF332830,ANZ,Savings
04-09-2025 17:26,ANZ2B99136D7FF04325A7B5,012-345-678,11111111,WAGES CREDIT ANZ,0,1623.44,965657.59,CR,REF453362,ANZ,Savings
04-09-2025 17:36,ANZ296054F969644C66A2D1,012-345-678,11111111,BP ANZ,14.61,0,965642.98,DR,REF566091,ANZ,Savings
04-09-2025 19:00,ANZFBB64BD2EB634804A249,012-345-678,11111111,UBER EATS ANZ,24.85,0,965618.13,DR,REF581509,ANZ,Savings
04-09-2025 19:02,ANZ2F0AB805CED942E6B617,012-345-678,11111111,STARBUCKS ANZ,183.55,0,965434.58,DR,REF369764,ANZ,Savings
04-09-2025 19:05,ANZC80DF49824594063B4E5,012-345-678,11111111,INTERNET TRANSFER ANZ,108.57,0,965326.01,DR,REF700818,ANZ,Savings
04-09-2025 20:04,ANZ37E4BD8AC3064EA3AEFA,012-345-678,11111111,JB HI-FI ANZ,63.55,0,965262.46,DR,REF174535,ANZ,Savings
04-09-2025 20:41,ANZ1754C302EF3C48CD8C32,012-345-678,11111111,BIGW ANZ,21,0,965241.46,DR,REF879398,ANZ,Savings
04-09-2025 21:39,ANZAD00E81904BA4813B8B6,012-345-678,11111111,DOMINO'S PIZZA ANZ,8.79,0,965232.67,DR,REF539274,ANZ,Savings
04-09-2025 22:04,ANZ84C993707AD8454FAB56,012-345-678,11111111,BIGW ANZ,147.64,0,965085.03,DR,REF859843,ANZ,Savings
04-09-2025 22:32,INTC9A7758564AC468C9696,012-345-678,11111111,TRANSFER TO CBA 33333333,1101.36,0,963983.67,DR,INT-48011,ANZ,Savings
04-09-2025 22:52,ANZE605079CD56946CFACBA,012-345-678,11111111,SHELL ANZ,64.93,0,963918.74,DR,REF147146,ANZ,Savings
04-09-2025 23:44,ANZ9044F98612374E5FA483,012-345-678,11111111,UBER EATS ANZ,48.2,0,963870.54,DR,REF784150,ANZ,Savings
05-09-2025 00:11,ANZB7E43A3ADD4E4CA782BD,012-345-678,11111111,ALDI ANZ,39.38,0,963831.16,DR,REF615585,ANZ,Savings
05-09-2025 00:21,ANZ109473E38EF145CF9418,012-345-678,11111111,PAYROLL CREDIT ANZ,0,2854.32,966685.48,CR,REF580949,ANZ,Savings
05-09-2025 00:26,ANZ3403A4B5020341F6A161,012-345-678,11111111,BP ANZ,28.85,0,966656.63,DR,REF720294,ANZ,Savings
05-09-2025 00:27,ANZCAA1D008B15742A0B352,012-345-678,11111111,JB HI-FI ANZ,158.28,0,966498.35,DR,REF403761,ANZ,Savings
05-09-2025 00:55,ANZ47B77893F31D402B970F,012-345-678,11111111,RAILWAY STATION ANZ,154.53,0,966343.82,DR,REF456736,ANZ,Savings
05-09-2025 01:01,ANZ57F51FF1BEAD443D879B,012-345-678,11111111,HARVEY NORMAN ANZ,19.99,0,966323.83,DR,REF916289,ANZ,Savings
05-09-2025 01:26,ANZ44A08AEFACE04C62BCB6,012-345-678,11111111,JB HI-FI ANZ,28.98,0,966294.85,DR,REF785339,ANZ,Savings
05-09-2025 01:32,ANZF88F19DF45A74E2FB760,012-345-678,11111111,FLIXBUS ANZ,23.37,0,966271.48,DR,REF232153,ANZ,Savings
05-09-2025 01:54,ANZ34D7A02153D5482BA7FA,012-345-678,11111111,KFC ANZ,25.78,0,966245.7,DR,REF490844,ANZ,Savings
05-09-2025 03:13,ANZF4D40C6886EC4A98BE92,012-345-678,11111111,LIQUORLAND ANZ,47.38,0,966198.32,DR,REF642981,ANZ,Savings
05-09-2025 03:26,ANZFBC567CC2AA44223A62A,012-345-678,11111111,BWS ANZ,20.24,0,966178.08,DR,REF539387,ANZ,Savings
05-09-2025 03:32,ANZCB62935F73BD4DDBBDAC,012-345-678,11111111,RAILWAY STATION ANZ,10.54,0,966167.54,DR,REF789183,ANZ,Savings
05-09-2025 03:51,ANZ4E8CD44D7610470BB85C,012-345-678,11111111,BP ANZ,101.53,0,966066.01,DR,REF870864,ANZ,Savings
05-09-2025 03:52,ANZC2DC9550238042A38F6F,012-345-678,11111111,DOMINO'S PIZZA ANZ,89.51,0,965976.5,DR,REF759309,ANZ,Savings
05-09-2025 04:11,ANZBE82FE5487C043E5A5E0,012-345-678,11111111,AMAZON AU ANZ,27.52,0,965948.98,DR,REF261608,ANZ,Savings
05-09-2025 04:13,ANZ70DF72EF3098426FBE14,012-345-678,11111111,BWS ANZ,15.98,0,965933,DR,REF781753,ANZ,Savings
05-09-2025 04:28,ANZD7EF96FD4D5741CA9A07,012-345-678,11111111,MCDONALDS ANZ,133.48,0,965799.52,DR,REF791151,ANZ,Savings
05-09-2025 04:28,ANZ41C79E70F5314CD39448,012-345-678,11111111,BIGW ANZ,82.62,0,965716.9,DR,REF378673,ANZ,Savings
05-09-2025 04:30,ANZ47FE8CD258884DA8992D,012-345-678,11111111,PAYMENT GATEWAY ANZ,115.97,0,965600.93,DR,REF298180,ANZ,Savings
05-09-2025 05:14,ANZ3C17C189FF9A4954BF7B,012-345-678,11111111,APPLE ANZ,24.83,0,965576.1,DR,REF255481,ANZ,Savings
05-09-2025 05:17,ANZ1C8F2CF263A24471B984,012-345-678,11111111,RAILWAY STATION ANZ,23.64,0,965552.46,DR,REF942289,ANZ,Savings
05-09-2025 05:22,ANZ608D9365C1834D81801C,012-345-678,11111111,SHELL ANZ,9.87,0,965542.59,DR,REF680472,ANZ,Savings
05-09-2025 05:28,ANZ2BE15BB4685E4FD6804B,012-345-678,11111111,WOOLWORTHS ANZ,4.28,0,965538.31,DR,REF918179,ANZ,Savings
05-09-2025 05:52,INT8F79721E43934F9499BB,012-345-678,11111111,TRANSFER TO CBA 33333333,963.59,0,964574.72,DR,INT-50879,ANZ,Savings
05-09-2025 05:54,ANZF22A2AAC92824C27834E,012-345-678,11111111,COMPANY PAYROLL ANZ,0,418.06,964992.78,CR,REF702131,ANZ,Savings
05-09-2025 06:09,ANZB30735530EE6473D9531,012-345-678,11111111,UBER EATS ANZ,32.79,0,964959.99,DR,REF601038,ANZ,Savings
05-09-2025 06:31,ANZAD3DA2AC2C4F40808498,012-345-678,11111111,PAYPAL *NETFLIX ANZ,13.83,0,964946.16,DR,REF298442,ANZ,Savings
05-09-2025 06:31,ANZ375F9441C5024EFFB518,012-345-678,11111111,BIGW ANZ,25.41,0,964920.75,DR,REF943351,ANZ,Savings
05-09-2025 06:48,ANZ79DF56705AB340638B6C,012-345-678,11111111,LIQUORLAND ANZ,16.87,0,964903.88,DR,REF429728,ANZ,Savings
05-09-2025 06:50,ANZD6B1513827E245EF84C6,012-345-678,11111111,LIQUORLAND ANZ,24.95,0,964878.93,DR,REF966970,ANZ,Savings
05-09-2025 07:01,ANZ3D729DF00F6443B79A93,012-345-678,11111111,APPLE ANZ,27.59,0,964851.34,DR,REF442140,ANZ,Savings
05-09-2025 07:04,ANZA8C240577F894E56AC22,012-345-678,11111111,DOMINO'S PIZZA ANZ,12.74,0,964838.6,DR,REF385041,ANZ,Savings
05-09-2025 07:24,ANZ11CA503DE1154EB48DB7,012-345-678,11111111,BANK FEE ANZ,155.78,0,964682.82,DR,REF327661,ANZ,Savings
05-09-2025 07:32,ANZ26A2DBC0E449471B89E1,012-345-678,11111111,ZOOM ANZ,156.35,0,964526.47,DR,REF590063,ANZ,Savings
05-09-2025 07:40,ANZDF96206A29D549BE895D,012-345-678,11111111,INTERNET TRANSFER ANZ,1.99,0,964524.48,DR,REF180957,ANZ,Savings
05-09-2025 08:00,ANZ515F3FF134EE44D5B993,012-345-678,11111111,SPOTIFY ANZ,60.18,0,964464.3,DR,REF218066,ANZ,Savings
05-09-2025 09:29,INT3617D24C0EF5489C9BA2,012-345-678,11111111,TRANSFER FROM CBA 33333333,0,1500.49,965964.79,CR,INT-58768,ANZ,Savings
05-09-2025 09:41,ANZ2175ECD6B3CF4097B539,012-345-678,11111111,STARBUCKS ANZ,57.79,0,965907,DR,REF508500,ANZ,Savings
05-09-2025 09:44,ANZ2B546FC2AB3A4DF89CDB,012-345-678,11111111,COLES ANZ,3.69,0,965903.31,DR,REF623428,ANZ,Savings
05-09-2025 10:05,ANZ0DB2FCCDCC474F2A8F60,012-345-678,11111111,DOMINO'S PIZZA ANZ,36.24,0,965867.07,DR,REF262596,ANZ,Savings
05-09-2025 10:10,ANZ18284FB2063C4D6AB7AB,012-345-678,11111111,TAFE BOOKSHOP ANZ,50.96,0,965816.11,DR,REF171067,ANZ,Savings
05-09-2025 10:23,ANZ95849E94347D4B179007,012-345-678,11111111,TAFE BOOKSHOP ANZ,46.05,0,965770.06,DR,REF654425,ANZ,Savings
05-09-2025 10:59,ANZ220176AD2CDF4D24BB5B,012-345-678,11111111,PAYROLL CREDIT ANZ,0,1790.23,967560.29,CR,REF790875,ANZ,Savings
05-09-2025 11:03,ANZ48B260A8952C44B7BAFF,012-345-678,11111111,BP ANZ,66.47,0,967493.82,DR,REF525372,ANZ,Savings
05-09-2025 11:03,ANZCFA7DDCB428A4347A847,012-345-678,11111111,LIQUORLAND ANZ,58.81,0,967435.01,DR,REF223829,ANZ,Savings
05-09-2025 11:55,INTE344A4F8EBDD4D40B57E,012-345-678,11111111,TRANSFER FROM CBA 33333333,0,498.65,967933.66,CR,INT-10472,ANZ,Savings
05-09-2025 12:18,ANZE1F54416284D4BB08A4E,012-345-678,11111111,ALDI ANZ,11.6,0,967922.06,DR,REF280907,ANZ,Savings
05-09-2025 12:22,ANZA15A3313D4CA4EDE9217,012-345-678,11111111,BANK FEE ANZ,173.77,0,967748.29,DR,REF839144,ANZ,Savings
05-09-2025 12:30,ANZ573A2AFC8D584F168DDF,012-345-678,11111111,SHELL ANZ,3.47,0,967744.82,DR,REF874337,ANZ,Savings
05-09-2025 12:31,ANZ4C6295E7C02441C4B75E,012-345-678,11111111,JB HI-FI ANZ,87.69,0,967657.13,DR,REF391833,ANZ,Savings
05-09-2025 12:34,ANZB307A76CA9A24D25B785,012-345-678,11111111,PAY - SALARY ANZ,0,2153.77,969810.9,CR,REF993117,ANZ,Savings
05-09-2025 12:54,ANZF7F0C15AEA55459FB2EE,012-345-678,11111111,COLES ANZ,63.4,0,969747.5,DR,REF295059,ANZ,Savings
05-09-2025 13:05,ANZE608F2F8DB964DED94F9,012-345-678,11111111,PAYMENT GATEWAY ANZ,9.44,0,969738.06,DR,REF460113,ANZ,Savings
05-09-2025 13:21,ANZ552B4D536EFE4065A3E7,012-345-678,11111111,INTERNET TRANSFER ANZ,8.36,0,969729.7,DR,REF463308,ANZ,Savings
05-09-2025 13:23,ANZ2491860F1C1A4757A710,012-345-678,11111111,BP ANZ,68.65,0,969661.05,DR,REF134835,ANZ,Savings
05-09-2025 13:46,ANZFC810EC5EC644CF5BC0B,012-345-678,11111111,KFC ANZ,62.78,0,969598.27,DR,REF769671,ANZ,Savings
05-09-2025 13:55,ANZE6F831F50F1D4E4ABE21,012-345-678,11111111,MCDONALDS ANZ,37.84,0,969560.43,DR,REF731604,ANZ,Savings
05-09-2025 14:36,INT0FBEDD9C2B8C4349ACD2,012-345-678,11111111,TRANSFER TO NAB 44444444,1597.43,0,967963,DR,INT-16218,ANZ,Savings
05-09-2025 15:22,INT6B25BC6E930E4E1DA226,012-345-678,11111111,TRANSFER TO CBA 22222222,1141.68,0,966821.32,DR,INT-47138,ANZ,Savings
05-09-2025 16:04,ANZ5A1F0D288705450BB391,012-345-678,11111111,WOOLWORTHS ANZ,42.89,0,966778.43,DR,REF926780,ANZ,Savings
05-09-2025 16:09,ANZ6EFC2C3925E345B8A5E2,012-345-678,11111111,7-ELEVEN ANZ,39.9,0,966738.53,DR,REF377035,ANZ,Savings
05-09-2025 16:10,ANZ10B9139632064A72A7F6,012-345-678,11111111,FLIXBUS ANZ,10.52,0,966728.01,DR,REF668394,ANZ,Savings
05-09-2025 16:17,ANZ30EAD53FD3F8448D9248,012-345-678,11111111,PAY - SALARY ANZ,0,6883.02,973611.03,CR,REF455499,ANZ,Savings
05-09-2025 16:19,ANZD4FB1AFD8B0A4DE98663,012-345-678,11111111,INTERNET TRANSFER ANZ,31.49,0,973579.54,DR,REF710889,ANZ,Savings
05-09-2025 16:48,ANZAA1A0BEC8EE24E3DB0C4,012-345-678,11111111,APPLE ANZ,15.9,0,973563.64,DR,REF164715,ANZ,Savings
05-09-2025 16:55,ANZF4BCB6E1317347DCA1EB,012-345-678,11111111,PAY - SALARY ANZ,0,4159.57,977723.21,CR,REF630351,ANZ,Savings
05-09-2025 17:00,ANZ53208A325D364C1B91DE,012-345-678,11111111,7-ELEVEN ANZ,67.8,0,977655.41,DR,REF363529,ANZ,Savings
05-09-2025 17:15,ANZBFA8C8C70E714E32A345,012-345-678,11111111,WAGES CREDIT ANZ,0,7734.06,985389.47,CR,REF442390,ANZ,Savings
05-09-2025 17:21,ANZFF6E3F6A296040878CCF,012-345-678,11111111,7-ELEVEN ANZ,87.49,0,985301.98,DR,REF866620,ANZ,Savings
05-09-2025 17:23,ANZ27F16AE78260447D9A32,012-345-678,11111111,MENULOG ANZ,15.83,0,985286.15,DR,REF747466,ANZ,Savings
05-09-2025 17:31,ANZ8B47FE7EEBFF4833AC1F,012-345-678,11111111,UBER EATS ANZ,107.31,0,985178.84,DR,REF594158,ANZ,Savings
05-09-2025 17:35,ANZ0105C5A4E60D4ECEBA44,012-345-678,11111111,FLIXBUS ANZ,24.47,0,985154.37,DR,REF166856,ANZ,Savings
05-09-2025 17:43,ANZEA1F6F38AE1A44FD804A,012-345-678,11111111,RAILWAY STATION ANZ,73.46,0,985080.91,DR,REF563462,ANZ,Savings
05-09-2025 18:15,ANZF5151374C624451B924A,012-345-678,11111111,MENULOG ANZ,22.78,0,985058.13,DR,REF988184,ANZ,Savings
05-09-2025 18:51,ANZA05B33890294418D99B8,012-345-678,11111111,RAILWAY STATION ANZ,107.42,0,984950.71,DR,REF743608,ANZ,Savings
05-09-2025 19:31,ANZ352C5A9036E34F038478,012-345-678,11111111,KFC ANZ,5.09,0,984945.62,DR,REF132755,ANZ,Savings
05-09-2025 19:38,ANZ6DFF2F05285E4C038755,012-345-678,11111111,BIGW ANZ,42.78,0,984902.84,DR,REF588419,ANZ,Savings
05-09-2025 19:47,ANZ325E3226D8F04460AB21,012-345-678,11111111,7-ELEVEN ANZ,59.45,0,984843.39,DR,REF544660,ANZ,Savings
05-09-2025 19:57,ANZA83A048D6D4B4812AD44,012-345-678,11111111,HARVEY NORMAN ANZ,10.25,0,984833.14,DR,REF799683,ANZ,Savings
05-09-2025 20:02,ANZA0B7248F47D34473BFE4,012-345-678,11111111,RAILWAY STATION ANZ,15.36,0,984817.78,DR,REF736709,ANZ,Savings
05-09-2025 20:16,ANZ3578D362861047BF8DDB,012-345-678,11111111,AMAZON AU ANZ,13.18,0,984804.6,DR,REF268148,ANZ,Savings
05-09-2025 20:27,ANZ5017D034EE374E1FA3D6,012-345-678,11111111,CITYLINK ANZ,122.16,0,984682.44,DR,REF828957,ANZ,Savings
05-09-2025 20:37,ANZD84E849F393B46508BB7,012-345-678,11111111,WAGES CREDIT ANZ,0,3285.5,987967.94,CR,REF273885,ANZ,Savings
05-09-2025 20:41,ANZF3D352346F394BBAB9C5,012-345-678,11111111,APPLE ANZ,188.55,0,987779.39,DR,REF689937,ANZ,Savings
05-09-2025 21:15,ANZ063DAA5858474D5A8C3F,012-345-678,11111111,CITYLINK ANZ,54.84,0,987724.55,DR,REF108088,ANZ,Savings
05-09-2025 21:26,ANZ50A570055DB3417C8C33,012-345-678,11111111,FLIXBUS ANZ,63.3,0,987661.25,DR,REF887334,ANZ,Savings
05-09-2025 21:26,ANZ3171D6EA2B704B51ACA7,012-345-678,11111111,JB HI-FI ANZ,28.12,0,987633.13,DR,REF121199,ANZ,Savings
05-09-2025 21:39,INTEBA1E253816F48258A31,012-345-678,11111111,TRANSFER FROM CBA 22222222,0,1370.15,989003.28,CR,INT-69971,ANZ,Savings
05-09-2025 21:51,ANZ090A268D733A4B4093F0,012-345-678,11111111,BIGW ANZ,4.9,0,988998.38,DR,REF896883,ANZ,Savings
05-09-2025 21:54,ANZ10A8D94897C04A3799F3,012-345-678,11111111,BWS ANZ,146.91,0,988851.47,DR,REF899483,ANZ,Savings
05-09-2025 22:49,INTCE75D3B259554D57B60E,012-345-678,11111111,TRANSFER TO CBA 22222222,465.48,0,988385.99,DR,INT-30761,ANZ,Savings
05-09-2025 23:05,ANZ7C5239A5ECD0419DA2EE,012-345-678,11111111,PAYMENT GATEWAY ANZ,120.61,0,988265.38,DR,REF225361,ANZ,Savings
05-09-2025 23:16,ANZ42F43717B16F41009770,012-345-678,11111111,MCDONALDS ANZ,33.91,0,988231.47,DR,REF342765,ANZ,Savings
05-09-2025 23:24,ANZ34E60B3C71FA43F8A759,012-345-678,11111111,DOMINO'S PIZZA ANZ,2.36,0,988229.11,DR,REF867464,ANZ,Savings
05-09-2025 23:48,ANZBBC60DF3936F49C4A2CD,012-345-678,11111111,SPOTIFY ANZ,42.6,0,988186.51,DR,REF459622,ANZ,Savings
06-09-2025 00:02,ANZ8539DECF5E69437CA631,012-345-678,11111111,PAYMENT GATEWAY ANZ,19.18,0,988167.33,DR,REF733262,ANZ,Savings
06-09-2025 00:16,ANZ03E6095FB50743F1952F,012-345-678,11111111,PAYPAL *NETFLIX ANZ,22.05,0,988145.28,DR,REF503820,ANZ,Savings
06-09-2025 00:42,ANZD5BA587FF5824B9BAFEF,012-345-678,11111111,ZOOM ANZ,5.91,0,988139.37,DR,REF187959,ANZ,Savings
06-09-2025 00:53,ANZDD3EB08C948046D2AE47,012-345-678,11111111,WOOLWORTHS ANZ,90.58,0,988048.79,DR,REF509926,ANZ,Savings
06-09-2025 01:25,ANZ5351D0844FEE4587B6DD,012-345-678,11111111,WAGES CREDIT ANZ,0,3817.31,991866.1,CR,REF346852,ANZ,Savings
06-09-2025 01:26,ANZ94959FD60D65414397BA,012-345-678,11111111,STARBUCKS ANZ,43.53,0,991822.57,DR,REF919082,ANZ,Savings
06-09-2025 01:29,ANZ56451C150D67486AB2EE,012-345-678,11111111,BP ANZ,25.63,0,991796.94,DR,REF729385,ANZ,Savings
06-09-2025 01:33,ANZ3D6CCA668FE647168B27,012-345-678,11111111,JB HI-FI ANZ,9.03,0,991787.91,DR,REF471820,ANZ,Savings
06-09-2025 01:36,ANZDD7C78172DEA4FA294EF,012-345-678,11111111,BANK FEE ANZ,38.2,0,991749.71,DR,REF125064,ANZ,Savings
06-09-2025 01:42,ANZE0A36B41EBD5456E9775,012-345-678,11111111,SALARY PAYMENT ANZ,0,2941.25,994690.96,CR,REF652867,ANZ,Savings
06-09-2025 01:52,INT4FB8AA8E07734CABB224,012-345-678,11111111,TRANSFER TO CBA 33333333,384.55,0,994306.41,DR,INT-94651,ANZ,Savings
06-09-2025 01:54,ANZ0B531685E0D94CADB364,012-345-678,11111111,7-ELEVEN ANZ,36.69,0,994269.72,DR,REF636656,ANZ,Savings
06-09-2025 02:01,ANZ468E7C4F28BC4010B21C,012-345-678,11111111,ZOOM ANZ,15.76,0,994253.96,DR,REF766585,ANZ,Savings
06-09-2025 02:26,ANZE01AA4A24EEF439D8D65,012-345-678,11111111,UBER EATS ANZ,46.76,0,994207.2,DR,REF749686,ANZ,Savings
06-09-2025 02:45,ANZC067A7547FBD4BB897D6,012-345-678,11111111,COLES ANZ,72.96,0,994134.24,DR,REF529235,ANZ,Savings
06-09-2025 02:52,ANZB5400693A2424B1AB6D1,012-345-678,11111111,ALDI ANZ,33.26,0,994100.98,DR,REF532210,ANZ,Savings
06-09-2025 03:37,ANZB1AB7980AA5A4843893E,012-345-678,11111111,PAYPAL *NETFLIX ANZ,7.59,0,994093.39,DR,REF496146,ANZ,Savings
06-09-2025 04:08,ANZE4B2196244FF499482C2,012-345-678,11111111,JB HI-FI ANZ,50.6,0,994042.79,DR,REF196866,ANZ,Savings
06-09-2025 04:12,ANZ3F9045AB43944ED88670,012-345-678,11111111,UBER EATS ANZ,63.03,0,993979.76,DR,REF970474,ANZ,Savings
06-09-2025 04:12,ANZ7DC1357EF16C40CB80DD,012-345-678,11111111,UBER EATS ANZ,142.06,0,993837.7,DR,REF888032,ANZ,Savings
06-09-2025 04:42,ANZ9F8CB286368C4F9EAAA5,012-345-678,11111111,HARVEY NORMAN ANZ,6.36,0,993831.34,DR,REF742741,ANZ,Savings
06-09-2025 04:50,ANZ79214B5BFA6444A2B103,012-345-678,11111111,ZOOM ANZ,38.66,0,993792.68,DR,REF292095,ANZ,Savings
06-09-2025 05:02,ANZ378BDA8970184C0DAED1,012-345-678,11111111,WOOLWORTHS ANZ,133.28,0,993659.4,DR,REF615123,ANZ,Savings
06-09-2025 05:42,ANZFDD07326497C400EA42A,012-345-678,11111111,WOOLWORTHS ANZ,16.68,0,993642.72,DR,REF186957,ANZ,Savings
06-09-2025 05:45,ANZ22D6442884284E738E0A,012-345-678,11111111,JB HI-FI ANZ,37.24,0,993605.48,DR,REF527557,ANZ,Savings
06-09-2025 05:49,ANZ8B32EEE02870453F915F,012-345-678,11111111,MCDONALDS ANZ,62.6,0,993542.88,DR,REF525433,ANZ,Savings
06-09-2025 05:55,ANZDB2FF859A5904AFCB4B8,012-345-678,11111111,SPOTIFY ANZ,12.62,0,993530.26,DR,REF588703,ANZ,Savings
06-09-2025 06:02,ANZ6959C5E1AD314DFE8CCD,012-345-678,11111111,RAILWAY STATION ANZ,19.55,0,993510.71,DR,REF885030,ANZ,Savings
06-09-2025 06:05,ANZB8CA1273BA1C4ED9BB3F,012-345-678,11111111,PAYMENT GATEWAY ANZ,17.51,0,993493.2,DR,REF294811,ANZ,Savings
06-09-2025 06:09,ANZ6401AF0156BD42EBA4CA,012-345-678,11111111,BP ANZ,36.24,0,993456.96,DR,REF347566,ANZ,Savings
06-09-2025 06:15,ANZD4CEF89D7DC44AD5A73A,012-345-678,11111111,PAYROLL CREDIT ANZ,0,3298.39,996755.35,CR,REF739092,ANZ,Savings
06-09-2025 06:17,INTE92C9AB48379425B8286,012-345-678,11111111,TRANSFER TO NAB 44444444,1256.54,0,995498.81,DR,INT-17342,ANZ,Savings
06-09-2025 06:27,ANZ273B32EAEE964436AB8B,012-345-678,11111111,COLES ANZ,9.95,0,995488.86,DR,REF769128,ANZ,Savings
06-09-2025 07:09,ANZACB96A6AA0E94EFBA825,012-345-678,11111111,7-ELEVEN ANZ,7.19,0,995481.67,DR,REF898181,ANZ,Savings
06-09-2025 07:13,ANZ468D7FE5F5CA403DB7FA,012-345-678,11111111,BP ANZ,5.77,0,995475.9,DR,REF864992,ANZ,Savings
06-09-2025 07:24,ANZ3865C46C903D459B8BD4,012-345-678,11111111,STARBUCKS ANZ,12.39,0,995463.51,DR,REF474937,ANZ,Savings
06-09-2025 07:27,ANZ61D1BD8EC3C64AFAA986,012-345-678,11111111,PAY - SALARY ANZ,0,3422.24,998885.75,CR,REF271574,ANZ,Savings
06-09-2025 07:32,ANZFA1F680024F943FB9AE6,012-345-678,11111111,WOOLWORTHS ANZ,103.88,0,998781.87,DR,REF887705,ANZ,Savings
06-09-2025 07:39,ANZ53DFC5AF6E1646BE9860,012-345-678,11111111,MCDONALDS ANZ,89.92,0,998691.95,DR,REF420973,ANZ,Savings
06-09-2025 07:45,ANZD8C4DE3C5FDB41A18CFC,012-345-678,11111111,RAILWAY STATION ANZ,22.04,0,998669.91,DR,REF839063,ANZ,Savings
06-09-2025 08:03,ANZ191C988072544C32BC44,012-345-678,11111111,ALDI ANZ,5.75,0,998664.16,DR,REF820993,ANZ,Savings
06-09-2025 08:19,ANZ19B083AC9D12436095A6,012-345-678,11111111,WOOLWORTHS ANZ,211.15,0,998453.01,DR,REF781995,ANZ,Savings
06-09-2025 08:24,ANZEC2D925E08DC47C88728,012-345-678,11111111,TAFE BOOKSHOP ANZ,9.86,0,998443.15,DR,REF721937,ANZ,Savings
06-09-2025 08:52,ANZF6290ED105274D7C8815,012-345-678,11111111,PAYMENT GATEWAY ANZ,87.45,0,998355.7,DR,REF805649,ANZ,Savings
06-09-2025 08:53,ANZ4921122044E44C519E9A,012-345-678,11111111,CITYLINK ANZ,4.05,0,998351.65,DR,REF182020,ANZ,Savings
06-09-2025 09:13,ANZFD0B62B71865467A8323,012-345-678,11111111,BIGW ANZ,103.16,0,998248.49,DR,REF735973,ANZ,Savings
06-09-2025 09:42,ANZA9CE086AB8E443DD93C0,012-345-678,11111111,7-ELEVEN ANZ,33.29,0,998215.2,DR,REF734464,ANZ,Savings
06-09-2025 09:45,ANZ513C2040F8534ED3A079,012-345-678,11111111,PAYPAL *NETFLIX ANZ,27.46,0,998187.74,DR,REF297191,ANZ,Savings
06-09-2025 10:04,ANZC21B7D089D374BA08110,012-345-678,11111111,INTERNET TRANSFER ANZ,79.18,0,998108.56,DR,REF901269,ANZ,Savings
06-09-2025 10:11,ANZ569467D814414D00ACB0,012-345-678,11111111,COMPANY PAYROLL ANZ,0,134.75,998243.31,CR,REF183955,ANZ,Savings
06-09-2025 10:14,INT87820BE51FBC4794B301,012-345-678,11111111,TRANSFER FROM NAB 44444444,0,72.87,998316.18,CR,INT-58556,ANZ,Savings
06-09-2025 10:28,ANZ7BD6BFCE81CD42C7B255,012-345-678,11111111,PAY - SALARY ANZ,0,4684.1,1003000.28,CR,REF367296,ANZ,Savings
06-09-2025 10:31,ANZ3E17EF34545F40DAA6A0,012-345-678,11111111,MENULOG ANZ,79.92,0,1002920.36,DR,REF454027,ANZ,Savings
06-09-2025 10:48,ANZ2B746FC244384F5886D2,012-345-678,11111111,LIQUORLAND ANZ,8.07,0,1002912.29,DR,REF293889,ANZ,Savings
06-09-2025 10:50,ANZ0ACF5150021D47EAB9F6,012-345-678,11111111,COMPANY PAYROLL ANZ,0,4254.58,1007166.87,CR,REF400327,ANZ,Savings
06-09-2025 11:10,ANZB3722246EB2E42619BF2,012-345-678,11111111,7-ELEVEN ANZ,76.79,0,1007090.08,DR,REF195428,ANZ,Savings
06-09-2025 11:54,ANZ435D2AC5EE914F17A919,012-345-678,11111111,JB HI-FI ANZ,100.68,0,1006989.4,DR,REF330900,ANZ,Savings
06-09-2025 12:39,ANZ18C4A4989198406C8DC4,012-345-678,11111111,MCDONALDS ANZ,25.87,0,1006963.53,DR,REF618438,ANZ,Savings
06-09-2025 13:13,ANZC29054958DEA4DDCA69C,012-345-678,11111111,7-ELEVEN ANZ,9.77,0,1006953.76,DR,REF337822,ANZ,Savings
06-09-2025 13:24,INT4B4A8537C9454C9CB4C7,012-345-678,11111111,TRANSFER FROM NAB 44444444,0,986.88,1007940.64,CR,INT-38689,ANZ,Savings
06-09-2025 13:53,ANZ3C659E29E6C144BFA75B,012-345-678,11111111,DOMINO'S PIZZA ANZ,82.29,0,1007858.35,DR,REF663762,ANZ,Savings
06-09-2025 13:58,ANZ98DE0E391A70445882A8,012-345-678,11111111,TAFE BOOKSHOP ANZ,44.01,0,1007814.34,DR,REF204263,ANZ,Savings
06-09-2025 14:15,ANZEA82410CFB9249AEBC71,012-345-678,11111111,HARVEY NORMAN ANZ,32.6,0,1007781.74,DR,REF638041,ANZ,Savings
06-09-2025 15:32,ANZ9520ADEFCF434D008E58,012-345-678,11111111,STARBUCKS ANZ,181.13,0,1007600.61,DR,REF569993,ANZ,Savings
06-09-2025 15:33,ANZCB1C44E5A70140A7B05B,012-345-678,11111111,MENULOG ANZ,7.74,0,1007592.87,DR,REF648935,ANZ,Savings
06-09-2025 15:45,ANZ37B6FA49A0514DDCBA2A,012-345-678,11111111,SPOTIFY ANZ,24.05,0,1007568.82,DR,REF261321,ANZ,Savings
06-09-2025 16:09,ANZD9517A212DA74980A3C8,012-345-678,11111111,COMPANY PAYROLL ANZ,0,4444.89,1012013.71,CR,REF878693,ANZ,Savings
06-09-2025 16:56,ANZ6930021C7B304291BE6A,012-345-678,11111111,AMAZON AU ANZ,4.06,0,1012009.65,DR,REF500860,ANZ,Savings
06-09-2025 16:58,ANZ3B89872A5EA94C6A81BD,012-345-678,11111111,HARVEY NORMAN ANZ,66.71,0,1011942.94,DR,REF414307,ANZ,Savings
06-09-2025 17:05,ANZ48086D1F14BA4CF39BFD,012-345-678,11111111,PAYPAL *NETFLIX ANZ,3.67,0,1011939.27,DR,REF430222,ANZ,Savings
06-09-2025 17:17,ANZ831A6154437049EA971D,012-345-678,11111111,INTERNET TRANSFER ANZ,24.53,0,1011914.74,DR,REF467683,ANZ,Savings
06-09-2025 17:21,ANZ8B1CCC8A35A946CAB82C,012-345-678,11111111,INTERNET TRANSFER ANZ,198.7,0,1011716.04,DR,REF419917,ANZ,Savings
06-09-2025 17:37,ANZ3000AA4A52F546B4BCAA,012-345-678,11111111,STARBUCKS ANZ,36.1,0,1011679.94,DR,REF404879,ANZ,Savings
06-09-2025 17:38,ANZ5A78AFE3134F40D2B56F,012-345-678,11111111,ZOOM ANZ,8.2,0,1011671.74,DR,REF975933,ANZ,Savings
06-09-2025 18:19,ANZ64F940BBBC7D4CF3A236,012-345-678,11111111,PAYROLL CREDIT ANZ,0,660.58,1012332.32,CR,REF617749,ANZ,Savings
06-09-2025 19:16,ANZE91A80CD579B4F63B540,012-345-678,11111111,HARVEY NORMAN ANZ,16.53,0,1012315.79,DR,REF585640,ANZ,Savings
06-09-2025 19:32,ANZCFC9AD6CA98046428A1E,012-345-678,11111111,PAYPAL *NETFLIX ANZ,9.24,0,1012306.55,DR,REF781387,ANZ,Savings
06-09-2025 20:04,ANZCCD1C630A9AB4F39AD27,012-345-678,11111111,COLES ANZ,152.88,0,1012153.67,DR,REF636662,ANZ,Savings
06-09-2025 20:28,ANZD381CFA98184460A8C37,012-345-678,11111111,UBER EATS ANZ,58.84,0,1012094.83,DR,REF998900,ANZ,Savings
06-09-2025 20:48,ANZFBC495641CB64317B1F8,012-345-678,11111111,ZOOM ANZ,8.97,0,1012085.86,DR,REF702887,ANZ,Savings
06-09-2025 20:52,ANZ3858557FF2AA466495A3,012-345-678,11111111,WOOLWORTHS ANZ,4.04,0,1012081.82,DR,REF772250,ANZ,Savings
06-09-2025 21:01,ANZF4AEB41A0C8043BD8DB1,012-345-678,11111111,APPLE ANZ,32.21,0,1012049.61,DR,REF667949,ANZ,Savings
06-09-2025 21:07,ANZ267AE42228A94504AB23,012-345-678,11111111,SHELL ANZ,32.94,0,1012016.67,DR,REF837646,ANZ,Savings
06-09-2025 21:09,ANZA32448EB93594B7192A0,012-345-678,11111111,HARVEY NORMAN ANZ,6.61,0,1012010.06,DR,REF721792,ANZ,Savings
06-09-2025 21:24,ANZ052679427C854777B9E1,012-345-678,11111111,SHELL ANZ,120.96,0,1011889.1,DR,REF296534,ANZ,Savings
06-09-2025 21:30,ANZ41B6AF9D97E945E1ABC9,012-345-678,11111111,STARBUCKS ANZ,2.64,0,1011886.46,DR,REF870149,ANZ,Savings
06-09-2025 21:51,ANZE32ACBF664AC4344AB9D,012-345-678,11111111,ALDI ANZ,107.41,0,1011779.05,DR,REF371779,ANZ,Savings
06-09-2025 22:08,ANZ274B4826172549BBA131,012-345-678,11111111,ALDI ANZ,46.96,0,1011732.09,DR,REF291876,ANZ,Savings
06-09-2025 22:17,ANZ6AD78391CF7B4AA89284,012-345-678,11111111,RAILWAY STATION ANZ,32.2,0,1011699.89,DR,REF459367,ANZ,Savings
06-09-2025 22:28,ANZ17BF9F91FC564BF6898E,012-345-678,11111111,BIGW ANZ,52.2,0,1011647.69,DR,REF816831,ANZ,Savings
06-09-2025 22:29,ANZF8933ACFE6634B32A513,012-345-678,11111111,TAFE BOOKSHOP ANZ,3.14,0,1011644.55,DR,REF743700,ANZ,Savings
06-09-2025 22:35,ANZ01CFF82A69704AA9B2C7,012-345-678,11111111,BIGW ANZ,8.02,0,1011636.53,DR,REF139703,ANZ,Savings
06-09-2025 22:42,ANZ6844A88F43054DCB8705,012-345-678,11111111,CITYLINK ANZ,9.35,0,1011627.18,DR,REF976965,ANZ,Savings
06-09-2025 22:48,INT64E896253EB44B149C23,012-345-678,11111111,TRANSFER FROM NAB 44444444,0,1441.17,1013068.35,CR,INT-82764,ANZ,Savings
06-09-2025 23:16,ANZ3AAE822448D04548B16B,012-345-678,11111111,DOMINO'S PIZZA ANZ,56.34,0,1013012.01,DR,REF702295,ANZ,Savings
06-09-2025 23:51,ANZ23D6623C1E5A47229D65,012-345-678,11111111,RAILWAY STATION ANZ,5.03,0,1013006.98,DR,REF565047,ANZ,Savings
06-09-2025 23:51,ANZ4A424A7815CF44C484EA,012-345-678,11111111,ZOOM ANZ,56.53,0,1012950.45,DR,REF544768,ANZ,Savings
07-09-2025 00:07,ANZ5217808E3BC1451F9D9E,012-345-678,11111111,BANK FEE ANZ,173.1,0,1012777.35,DR,REF235479,ANZ,Savings
07-09-2025 00:13,ANZ285B3FB061FD457AAFC1,012-345-678,11111111,HARVEY NORMAN ANZ,71.72,0,1012705.63,DR,REF109323,ANZ,Savings
07-09-2025 00:36,INT2344A429C69046C68690,012-345-678,11111111,TRANSFER FROM CBA 33333333,0,1633.42,1014339.05,CR,INT-60836,ANZ,Savings
07-09-2025 01:21,ANZ204AAC4B543F4703915D,012-345-678,11111111,SPOTIFY ANZ,58.75,0,1014280.3,DR,REF915088,ANZ,Savings
07-09-2025 01:23,ANZ87518F12AA8F41FEAD18,012-345-678,11111111,7-ELEVEN ANZ,16.59,0,1014263.71,DR,REF824029,ANZ,Savings
07-09-2025 01:27,ANZAF877D4898C94AC8A6C9,012-345-678,11111111,PAYMENT GATEWAY ANZ,16.87,0,1014246.84,DR,REF351837,ANZ,Savings
07-09-2025 01:48,ANZ955A45810F3A474699B1,012-345-678,11111111,LIQUORLAND ANZ,50.5,0,1014196.34,DR,REF755636,ANZ,Savings
07-09-2025 01:49,ANZ748DFA604206484B9492,012-345-678,11111111,PAYROLL CREDIT ANZ,0,226.56,1014422.9,CR,REF386928,ANZ,Savings
07-09-2025 01:55,ANZ724F7D7B6B2A40E5BCE2,012-345-678,11111111,CITYLINK ANZ,13.71,0,1014409.19,DR,REF836815,ANZ,Savings
07-09-2025 01:58,ANZ4B640DB257564471ACCD,012-345-678,11111111,JB HI-FI ANZ,13.03,0,1014396.16,DR,REF235033,ANZ,Savings
07-09-2025 02:00,ANZ604A12416A894798AC00,012-345-678,11111111,HARVEY NORMAN ANZ,65.36,0,1014330.8,DR,REF392751,ANZ,Savings
07-09-2025 02:23,ANZF057CF87A1BE40988EDC,012-345-678,11111111,PAYPAL *NETFLIX ANZ,159.03,0,1014171.77,DR,REF975260,ANZ,Savings
07-09-2025 02:50,ANZC7259F18D0EF47A88F23,012-345-678,11111111,COLES ANZ,98.13,0,1014073.64,DR,REF240242,ANZ,Savings
07-09-2025 03:12,ANZF029617325424F17BF89,012-345-678,11111111,MENULOG ANZ,26.43,0,1014047.21,DR,REF469008,ANZ,Savings
07-09-2025 03:19,ANZF04842ED63654CDAA2D1,012-345-678,11111111,INTERNET TRANSFER ANZ,14.26,0,1014032.95,DR,REF697127,ANZ,Savings
07-09-2025 03:33,ANZ39916237722F4A01A2AD,012-345-678,11111111,FLIXBUS ANZ,39.95,0,1013993,DR,REF604051,ANZ,Savings
07-09-2025 03:35,INT597E6D05DCFF42BB98BC,012-345-678,11111111,TRANSFER TO NAB 44444444,1131.69,0,1012861.31,DR,INT-62747,ANZ,Savings
07-09-2025 03:42,ANZ1CEE0F72FB894B33A2D9,012-345-678,11111111,MENULOG ANZ,83.51,0,1012777.8,DR,REF698312,ANZ,Savings
07-09-2025 03:47,INT00C4AB45B3A142A4A46B,012-345-678,11111111,TRANSFER TO CBA 33333333,1550.87,0,1011226.93,DR,INT-66811,ANZ,Savings
07-09-2025 03:58,ANZDB4B1A104ED44B61B97B,012-345-678,11111111,AMAZON AU ANZ,39.17,0,1011187.76,DR,REF555881,ANZ,Savings
07-09-2025 04:03,ANZ452ABD00D08940128940,012-345-678,11111111,UBER EATS ANZ,21.56,0,1011166.2,DR,REF309132,ANZ,Savings
07-09-2025 04:04,ANZ0FB55A81DF6546F6A003,012-345-678,11111111,TAFE BOOKSHOP ANZ,4.57,0,1011161.63,DR,REF388151,ANZ,Savings
07-09-2025 04:23,ANZ4DBA21792EE84526B23F,012-345-678,11111111,STARBUCKS ANZ,44.34,0,1011117.29,DR,REF871723,ANZ,Savings
07-09-2025 04:27,ANZACD0FD3B632B40FC8607,012-345-678,11111111,MENULOG ANZ,38.48,0,1011078.81,DR,REF479417,ANZ,Savings
07-09-2025 04:58,ANZ4A5CB56D336741B1B4DD,012-345-678,11111111,WOOLWORTHS ANZ,67.83,0,1011010.98,DR,REF542146,ANZ,Savings
07-09-2025 05:10,ANZ27B4FBA92A79468AB928,012-345-678,11111111,SPOTIFY ANZ,88.1,0,1010922.88,DR,REF661595,ANZ,Savings
07-09-2025 05:12,ANZCA7B119D95B14DD2BC36,012-345-678,11111111,WAGES CREDIT ANZ,0,1123.92,1012046.8,CR,REF290769,ANZ,Savings
07-09-2025 05:18,ANZEE5C2B3D76054A629B0D,012-345-678,11111111,AMAZON AU ANZ,128.49,0,1011918.31,DR,REF537309,ANZ,Savings
07-09-2025 05:26,ANZ6324766E41BC4423A437,012-345-678,11111111,MCDONALDS ANZ,12.95,0,1011905.36,DR,REF847753,ANZ,Savings
07-09-2025 05:28,ANZF4842590853041F09EED,012-345-678,11111111,ALDI ANZ,4.09,0,1011901.27,DR,REF181968,ANZ,Savings
07-09-2025 05:34,ANZ303FF0807CA24186A83B,012-345-678,11111111,BP ANZ,24.13,0,1011877.14,DR,REF980507,ANZ,Savings
07-09-2025 07:21,ANZC207E8F4AAC842E0A898,012-345-678,11111111,CITYLINK ANZ,44.32,0,1011832.82,DR,REF235383,ANZ,Savings
07-09-2025 07:56,ANZF847B774B89B4CF28EBB,012-345-678,11111111,FLIXBUS ANZ,3.07,0,1011829.75,DR,REF321058,ANZ,Savings
07-09-2025 08:15,ANZ88447B88C46A4AFB87B6,012-345-678,11111111,WOOLWORTHS ANZ,104.56,0,1011725.19,DR,REF409364,ANZ,Savings
07-09-2025 08:27,ANZD95B47E0EE4943BBBEE6,012-345-678,11111111,ALDI ANZ,109.62,0,1011615.57,DR,REF181406,ANZ,Savings
07-09-2025 08:45,ANZ89E91B52EF2B47869384,012-345-678,11111111,RAILWAY STATION ANZ,9.11,0,1011606.46,DR,REF854188,ANZ,Savings
07-09-2025 09:48,ANZFBB737B027A340B29B6C,012-345-678,11111111,BWS ANZ,5.18,0,1011601.28,DR,REF318320,ANZ,Savings
07-09-2025 10:24,ANZD8181D0B4A864B489138,012-345-678,11111111,CITYLINK ANZ,166.32,0,1011434.96,DR,REF317713,ANZ,Savings
07-09-2025 10:42,ANZ134EFF65026946EFA28A,012-345-678,11111111,7-ELEVEN ANZ,37.07,0,1011397.89,DR,REF576469,ANZ,Savings
07-09-2025 10:53,ANZ7C1A57DC16A849A8B174,012-345-678,11111111,INTERNET TRANSFER ANZ,88.95,0,1011308.94,DR,REF461527,ANZ,Savings
07-09-2025 11:05,ANZED92196E78A248A58D1F,012-345-678,11111111,PAYPAL *NETFLIX ANZ,47.77,0,1011261.17,DR,REF809912,ANZ,Savings
07-09-2025 11:22,ANZ2C74617C2C3E423BB28E,012-345-678,11111111,INTERNET TRANSFER ANZ,2.87,0,1011258.3,DR,REF338992,ANZ,Savings
07-09-2025 12:08,ANZBD98EA0126424552A384,012-345-678,11111111,INTERNET TRANSFER ANZ,156.31,0,1011101.99,DR,REF836686,ANZ,Savings
07-09-2025 12:32,ANZD6059B60B7174C4BA5DE,012-345-678,11111111,WAGES CREDIT ANZ,0,2342.53,1013444.52,CR,REF392556,ANZ,Savings
07-09-2025 12:36,ANZ6719E6DBF73C45A1B850,012-345-678,11111111,FLIXBUS ANZ,50.56,0,1013393.96,DR,REF122222,ANZ,Savings
07-09-2025 12:41,INT02BEA2405ABB408783D8,012-345-678,11111111,TRANSFER FROM NAB 44444444,0,60.23,1013454.19,CR,INT-89846,ANZ,Savings
07-09-2025 13:08,ANZB4E096B74BA54E8AA328,012-345-678,11111111,HARVEY NORMAN ANZ,20.68,0,1013433.51,DR,REF778322,ANZ,Savings
07-09-2025 13:15,ANZ08FAA19B6D0442B3A891,012-345-678,11111111,COMPANY PAYROLL ANZ,0,914.97,1014348.48,CR,REF526744,ANZ,Savings
07-09-2025 14:02,ANZ4D24621C7D704F4BBC0F,012-345-678,11111111,BWS ANZ,28.88,0,1014319.6,DR,REF637033,ANZ,Savings
07-09-2025 14:08,ANZ7BFA0252A17F4AD7B668,012-345-678,11111111,AMAZON AU ANZ,63.29,0,1014256.31,DR,REF858031,ANZ,Savings
07-09-2025 14:14,ANZBA54CC82FEF24BAA876A,012-345-678,11111111,CITYLINK ANZ,55.27,0,1014201.04,DR,REF131936,ANZ,Savings
07-09-2025 14:30,ANZAF66372FA9794DBF9468,012-345-678,11111111,DOMINO'S PIZZA ANZ,4.4,0,1014196.64,DR,REF103827,ANZ,Savings
07-09-2025 14:45,ANZB68A1155D6854372ADA2,012-345-678,11111111,KFC ANZ,45.24,0,1014151.4,DR,REF802839,ANZ,Savings
07-09-2025 14:47,INT3A96E416A2824578A37B,012-345-678,11111111,TRANSFER TO NAB 44444444,1347.99,0,1012803.41,DR,INT-49976,ANZ,Savings
07-09-2025 15:23,INTCBCAB72939CE423C92D0,012-345-678,11111111,TRANSFER FROM NAB 44444444,0,1366.97,1014170.38,CR,INT-14324,ANZ,Savings
07-09-2025 15:47,ANZCE21238AF3F14CDE951B,012-345-678,11111111,KFC ANZ,50.98,0,1014119.4,DR,REF610475,ANZ,Savings
07-09-2025 15:56,ANZ1812E0211F8A47E386D3,012-345-678,11111111,MENULOG ANZ,129.41,0,1013989.99,DR,REF301525,ANZ,Savings
07-09-2025 16:10,ANZA0700C93C95842A38D69,012-345-678,11111111,ALDI ANZ,59.91,0,1013930.08,DR,REF575982,ANZ,Savings
07-09-2025 16:25,ANZ0834E2A1766243649DF9,012-345-678,11111111,7-ELEVEN ANZ,29.19,0,1013900.89,DR,REF992095,ANZ,Savings
07-09-2025 17:01,INT7C9300661C9B44E7B0EF,012-345-678,11111111,TRANSFER TO CBA 22222222,642.51,0,1013258.38,DR,INT-26434,ANZ,Savings
07-09-2025 17:10,ANZE2C9AA7BB56D4AFBA28A,012-345-678,11111111,CITYLINK ANZ,86.48,0,1013171.9,DR,REF690853,ANZ,Savings
07-09-2025 17:23,ANZF44D12A3BD3F408B8E89,012-345-678,11111111,ALDI ANZ,7.93,0,1013163.97,DR,REF334120,ANZ,Savings
07-09-2025 18:22,ANZ0E3ED392F4FF41A88D48,012-345-678,11111111,LIQUORLAND ANZ,17.34,0,1013146.63,DR,REF429453,ANZ,Savings
07-09-2025 18:33,ANZ13590BBACBC94BBD90FF,012-345-678,11111111,JB HI-FI ANZ,19.08,0,1013127.55,DR,REF807840,ANZ,Savings
07-09-2025 19:59,ANZ20F9F4C25C744C1AAC0C,012-345-678,11111111,RAILWAY STATION ANZ,13.13,0,1013114.42,DR,REF560593,ANZ,Savings
07-09-2025 20:03,ANZ1447D08804A640218E34,012-345-678,11111111,SALARY PAYMENT ANZ,0,4741.61,1017856.03,CR,REF528475,ANZ,Savings
07-09-2025 20:23,ANZD12A2C2CF0A54E789A79,012-345-678,11111111,7-ELEVEN ANZ,60.52,0,1017795.51,DR,REF799340,ANZ,Savings
07-09-2025 21:03,ANZ13D016E54C4048E3BB2A,012-345-678,11111111,JB HI-FI ANZ,124.28,0,1017671.23,DR,REF867275,ANZ,Savings
07-09-2025 21:34,ANZ6F900F4D3F0C4DAF85F7,012-345-678,11111111,DOMINO'S PIZZA ANZ,30.5,0,1017640.73,DR,REF234432,ANZ,Savings
07-09-2025 21:49,INT605CAD0BF50E47F48A52,012-345-678,11111111,TRANSFER FROM CBA 33333333,0,998.74,1018639.47,CR,INT-74665,ANZ,Savings
07-09-2025 21:54,ANZ15719631CAB94245A83C,012-345-678,11111111,ZOOM ANZ,92.37,0,1018547.1,DR,REF726396,ANZ,Savings
07-09-2025 23:50,ANZ8C144373F7934F71AE01,012-345-678,11111111,COLES ANZ,9.83,0,1018537.27,DR,REF362570,ANZ,Savings
08-09-2025 00:06,ANZ4625B33C16C54A72BF09,012-345-678,11111111,UBER EATS ANZ,71.75,0,1018465.52,DR,REF944764,ANZ,Savings
08-09-2025 00:26,INT169D5E7F9FE74D13B99E,012-345-678,11111111,TRANSFER FROM CBA 33333333,0,855.51,1019321.03,CR,INT-52103,ANZ,Savings
08-09-2025 00:33,ANZA5CC281202BB47FEB5E4,012-345-678,11111111,LIQUORLAND ANZ,80.81,0,1019240.22,DR,REF124621,ANZ,Savings
08-09-2025 01:10,ANZCE28F11054D346A2B4F9,012-345-678,11111111,BWS ANZ,119.07,0,1019121.15,DR,REF602103,ANZ,Savings
08-09-2025 01:10,ANZ43C4A490EEE549168306,012-345-678,11111111,BANK FEE ANZ,19.05,0,1019102.1,DR,REF730604,ANZ,Savings
08-09-2025 01:36,ANZ78058843FB794BD281DB,012-345-678,11111111,ALDI ANZ,180.5,0,1018921.6,DR,REF251381,ANZ,Savings
08-09-2025 01:47,ANZBE8C850BBF654D2BA4E9,012-345-678,11111111,ALDI ANZ,3.58,0,1018918.02,DR,REF246724,ANZ,Savings
08-09-2025 01:50,ANZB846A679A31A4D678C27,012-345-678,11111111,FLIXBUS ANZ,28.33,0,1018889.69,DR,REF751379,ANZ,Savings
08-09-2025 02:16,ANZBE77677205794B9CA6B9,012-345-678,11111111,AMAZON AU ANZ,86.17,0,1018803.52,DR,REF990585,ANZ,Savings
08-09-2025 03:19,ANZ1F67E132BB97407DB9FD,012-345-678,11111111,WAGES CREDIT ANZ,0,3034.48,1021838,CR,REF382938,ANZ,Savings
08-09-2025 03:55,ANZ9BB8BBAAAF0B45A9AB3C,012-345-678,11111111,INTERNET TRANSFER ANZ,63.69,0,1021774.31,DR,REF942828,ANZ,Savings
08-09-2025 04:01,ANZ64E9CA5DD07248349B62,012-345-678,11111111,DOMINO'S PIZZA ANZ,17.08,0,1021757.23,DR,REF769793,ANZ,Savings
08-09-2025 04:37,ANZ51F2A729DB8A4B8B9EE8,012-345-678,11111111,PAYPAL *NETFLIX ANZ,61.66,0,1021695.57,DR,REF154201,ANZ,Savings
08-09-2025 05:03,ANZ26FC1A9597D54C6EAC16,012-345-678,11111111,RAILWAY STATION ANZ,116.42,0,1021579.15,DR,REF131709,ANZ,Savings
08-09-2025 05:13,ANZ9185EF0E2BC74A858015,012-345-678,11111111,BANK FEE ANZ,77.89,0,1021501.26,DR,REF557455,ANZ,Savings
08-09-2025 06:39,ANZE4004162336F4EB6BEA7,012-345-678,11111111,BWS ANZ,28.49,0,1021472.77,DR,REF397042,ANZ,Savings
08-09-2025 07:02,ANZBA50C9F42ED44E07A0C6,012-345-678,11111111,PAYPAL *NETFLIX ANZ,115.09,0,1021357.68,DR,REF844880,ANZ,Savings
08-09-2025 07:03,ANZFE4828A767DF4C21B585,012-345-678,11111111,MCDONALDS ANZ,179.86,0,1021177.82,DR,REF408352,ANZ,Savings
08-09-2025 07:11,ANZ2CB3E04E0EAA41A2AA14,012-345-678,11111111,BP ANZ,74.81,0,1021103.01,DR,REF690296,ANZ,Savings
08-09-2025 07:56,ANZ1002D48D2C294634962A,012-345-678,11111111,AMAZON AU ANZ,21.74,0,1021081.27,DR,REF274775,ANZ,Savings
08-09-2025 08:06,ANZ5036C9CFE0E545A389FB,012-345-678,11111111,WAGES CREDIT ANZ,0,5606.83,1026688.1,CR,REF710002,ANZ,Savings
08-09-2025 08:23,ANZF4892577BD4047F8AC8E,012-345-678,11111111,RAILWAY STATION ANZ,25.53,0,1026662.57,DR,REF892335,ANZ,Savings
08-09-2025 08:31,ANZ1E051B4B81F14164BF33,012-345-678,11111111,RAILWAY STATION ANZ,17.17,0,1026645.4,DR,REF336294,ANZ,Savings
08-09-2025 08:40,ANZEF3B798A94A84C94B341,012-345-678,11111111,HARVEY NORMAN ANZ,30.28,0,1026615.12,DR,REF622401,ANZ,Savings
08-09-2025 09:17,ANZ459FEDAB27264B68A747,012-345-678,11111111,UBER EATS ANZ,46.25,0,1026568.87,DR,REF321557,ANZ,Savings
08-09-2025 09:20,ANZC7042541715743EB99FC,012-345-678,11111111,MCDONALDS ANZ,27.86,0,1026541.01,DR,REF958033,ANZ,Savings
08-09-2025 10:24,INTD17BCA18938B4A16BC8F,012-345-678,11111111,TRANSFER FROM CBA 33333333,0,305.7,1026846.71,CR,INT-96103,ANZ,Savings
08-09-2025 10:32,ANZ64AAE54FBFC747928BD8,012-345-678,11111111,ZOOM ANZ,5.18,0,1026841.53,DR,REF939355,ANZ,Savings
08-09-2025 10:39,ANZ6F84AB01E1A34F9BBD25,012-345-678,11111111,PAYMENT GATEWAY ANZ,15.75,0,1026825.78,DR,REF412299,ANZ,Savings
08-09-2025 11:13,ANZ570AEA8B28524B098443,012-345-678,11111111,SALARY PAYMENT ANZ,0,382.37,1027208.15,CR,REF695772,ANZ,Savings
08-09-2025 11:40,ANZD3FE5121FA404AD8A6C9,012-345-678,11111111,SPOTIFY ANZ,19.98,0,1027188.17,DR,REF355809,ANZ,Savings
08-09-2025 11:57,ANZ2875D29FFFDF40ADB242,012-345-678,11111111,JB HI-FI ANZ,10.12,0,1027178.05,DR,REF983318,ANZ,Savings
08-09-2025 12:10,ANZ2A769BE3D8B14C37BB5E,012-345-678,11111111,TAFE BOOKSHOP ANZ,26.18,0,1027151.87,DR,REF605263,ANZ,Savings
08-09-2025 12:18,ANZF9D5802EF8254864986F,012-345-678,11111111,COLES ANZ,7.63,0,1027144.24,DR,REF305807,ANZ,Savings
08-09-2025 13:42,ANZDDE38375E1A3450CA43E,012-345-678,11111111,KFC ANZ,25.28,0,1027118.96,DR,REF146205,ANZ,Savings
08-09-2025 14:03,INT2E41247C43B24A4D80A7,012-345-678,11111111,TRANSFER TO CBA 33333333,305.06,0,1026813.9,DR,INT-27797,ANZ,Savings
08-09-2025 14:20,INTBD6961E6882E48D89287,012-345-678,11111111,TRANSFER FROM CBA 33333333,0,1094.9,1027908.8,CR,INT-90727,ANZ,Savings
08-09-2025 14:33,ANZ80E922C9B7B941729998,012-345-678,11111111,CITYLINK ANZ,175.83,0,1027732.97,DR,REF455792,ANZ,Savings
08-09-2025 15:05,ANZ21B9EE934E9844A181AA,012-345-678,11111111,STARBUCKS ANZ,28.57,0,1027704.4,DR,REF592865,ANZ,Savings
08-09-2025 15:34,ANZ745A96B9D6DA405EB141,012-345-678,11111111,DOMINO'S PIZZA ANZ,10.6,0,1027693.8,DR,REF957490,ANZ,Savings
08-09-2025 16:45,ANZB3D07D5FB78541BA88F2,012-345-678,11111111,RAILWAY STATION ANZ,16.02,0,1027677.78,DR,REF593627,ANZ,Savings
08-09-2025 17:10,ANZ355DB5D790824E0AA934,012-345-678,11111111,PAY - SALARY ANZ,0,6628.5,1034306.28,CR,REF280385,ANZ,Savings
08-09-2025 17:22,ANZ132503BB2E224DAA836E,012-345-678,11111111,APPLE ANZ,9.02,0,1034297.26,DR,REF755682,ANZ,Savings
08-09-2025 17:41,ANZ6590B43F51B34B09A78C,012-345-678,11111111,SPOTIFY ANZ,23.52,0,1034273.74,DR,REF133388,ANZ,Savings
08-09-2025 17:42,ANZE265BDCC924A4F4791B7,012-345-678,11111111,PAYMENT GATEWAY ANZ,57.71,0,1034216.03,DR,REF675243,ANZ,Savings
08-09-2025 18:21,ANZ0AE77BE91B474ECB93C7,012-345-678,11111111,PAYROLL CREDIT ANZ,0,761.16,1034977.19,CR,REF583109,ANZ,Savings
08-09-2025 18:32,ANZ12B2DCC240004807AB6F,012-345-678,11111111,7-ELEVEN ANZ,50.24,0,1034926.95,DR,REF891946,ANZ,Savings
08-09-2025 18:36,ANZ7A7C42DD232A44F3B689,012-345-678,11111111,JB HI-FI ANZ,36.93,0,1034890.02,DR,REF968502,ANZ,Savings
08-09-2025 19:03,ANZB722F29702414075B7B8,012-345-678,11111111,FLIXBUS ANZ,176.62,0,1034713.4,DR,REF610916,ANZ,Savings
08-09-2025 19:26,ANZ2653D4698BA1415294B5,012-345-678,11111111,KFC ANZ,12.37,0,1034701.03,DR,REF300990,ANZ,Savings
08-09-2025 20:03,ANZB1A2491E739443B0B456,012-345-678,11111111,WOOLWORTHS ANZ,70.21,0,1034630.82,DR,REF660539,ANZ,Savings
08-09-2025 20:04,ANZ52C1BB7CF0AA442092CE,012-345-678,11111111,DOMINO'S PIZZA ANZ,23.7,0,1034607.12,DR,REF173512,ANZ,Savings
08-09-2025 20:11,ANZ596F96673AC74F5A8B68,012-345-678,11111111,APPLE ANZ,110.23,0,1034496.89,DR,REF593040,ANZ,Savings
08-09-2025 20:14,ANZD8DC28CE66F9447A937C,012-345-678,11111111,SHELL ANZ,33.36,0,1034463.53,DR,REF509653,ANZ,Savings
08-09-2025 20:41,ANZ6FA3A847347F44348B8A,012-345-678,11111111,RAILWAY STATION ANZ,77.45,0,1034386.08,DR,REF606966,ANZ,Savings
08-09-2025 21:03,ANZDD729FCF5C384C798F92,012-345-678,11111111,MENULOG ANZ,75.44,0,1034310.64,DR,REF811703,ANZ,Savings
08-09-2025 21:29,ANZ62E205A19F964354820A,012-345-678,11111111,COMPANY PAYROLL ANZ,0,2307.62,1036618.26,CR,REF259866,ANZ,Savings
08-09-2025 21:30,ANZB93D731628A34A7EB33A,012-345-678,11111111,FLIXBUS ANZ,4.94,0,1036613.32,DR,REF326263,ANZ,Savings
08-09-2025 21:32,ANZD239EAF8EC7C4DE2B6EA,012-345-678,11111111,HARVEY NORMAN ANZ,10.79,0,1036602.53,DR,REF819754,ANZ,Savings
08-09-2025 21:32,ANZF6D9F1E767FF419BB33B,012-345-678,11111111,UBER EATS ANZ,57.67,0,1036544.86,DR,REF770501,ANZ,Savings
08-09-2025 21:59,ANZ1B9BC071E34D4B5F8E8E,012-345-678,11111111,PAY - SALARY ANZ,0,467.82,1037012.68,CR,REF899101,ANZ,Savings
08-09-2025 22:28,ANZ146680A6A5C4481BB1D4,012-345-678,11111111,7-ELEVEN ANZ,36.24,0,1036976.44,DR,REF358618,ANZ,Savings
08-09-2025 22:43,ANZDDF0D1763807467BB95D,012-345-678,11111111,INTERNET TRANSFER ANZ,17.29,0,1036959.15,DR,REF583656,ANZ,Savings
08-09-2025 23:21,ANZ46384036042242819B23,012-345-678,11111111,WAGES CREDIT ANZ,0,780.84,1037739.99,CR,REF684203,ANZ,Savings
08-09-2025 23:33,ANZ3D4D5B9320D04486A744,012-345-678,11111111,WOOLWORTHS ANZ,24.32,0,1037715.67,DR,REF282032,ANZ,Savings
08-09-2025 23:46,ANZ940AB02864A04C868485,012-345-678,11111111,WAGES CREDIT ANZ,0,2647.86,1040363.53,CR,REF109256,ANZ,Savings
08-09-2025 23:53,ANZC34B474BF5364445BC0C,012-345-678,11111111,AMAZON AU ANZ,56.16,0,1040307.37,DR,REF473915,ANZ,Savings
09-09-2025 01:04,ANZ04A0162E17A84193B665,012-345-678,11111111,SHELL ANZ,49.01,0,1040258.36,DR,REF961034,ANZ,Savings
09-09-2025 01:27,ANZA81BE7D64BC845739D9B,012-345-678,11111111,COMPANY PAYROLL ANZ,0,278.74,1040537.1,CR,REF642737,ANZ,Savings
09-09-2025 02:16,ANZF3DBE8D7A2A94E1DB4C9,012-345-678,11111111,ZOOM ANZ,39.3,0,1040497.8,DR,REF554243,ANZ,Savings
09-09-2025 02:38,ANZ78D8FB7DAE1845E0BF2C,012-345-678,11111111,MENULOG ANZ,2.31,0,1040495.49,DR,REF644361,ANZ,Savings
09-09-2025 02:40,ANZ4646189DB0384C6ABB28,012-345-678,11111111,FLIXBUS ANZ,226.94,0,1040268.55,DR,REF904982,ANZ,Savings
09-09-2025 03:08,ANZCF8F7C20C7B042F6BA12,012-345-678,11111111,DOMINO'S PIZZA ANZ,62.86,0,1040205.69,DR,REF872161,ANZ,Savings
09-09-2025 03:13,ANZ87BDE419AC304E2785CA,012-345-678,11111111,DOMINO'S PIZZA ANZ,50.02,0,1040155.67,DR,REF843378,ANZ,Savings
09-09-2025 04:03,ANZF3D750D84B5E4F4AAB9E,012-345-678,11111111,7-ELEVEN ANZ,19.93,0,1040135.74,DR,REF440948,ANZ,Savings
09-09-2025 05:10,ANZFD57BD419C49422DBBBD,012-345-678,11111111,COMPANY PAYROLL ANZ,0,14.14,1040149.88,CR,REF591041,ANZ,Savings
09-09-2025 05:24,ANZ8CA96A49156541338B8C,012-345-678,11111111,CITYLINK ANZ,87.97,0,1040061.91,DR,REF934663,ANZ,Savings
09-09-2025 05:46,ANZE0131E5C1E0C40E5BB6A,012-345-678,11111111,HARVEY NORMAN ANZ,39.04,0,1040022.87,DR,REF104750,ANZ,Savings
09-09-2025 06:25,ANZ3736C381E49C4350AD30,012-345-678,11111111,ALDI ANZ,19.8,0,1040003.07,DR,REF695106,ANZ,Savings
09-09-2025 06:43,ANZ88988BC85345427FBC9E,012-345-678,11111111,ZOOM ANZ,60.53,0,1039942.54,DR,REF562011,ANZ,Savings
09-09-2025 07:02,ANZDB16BB4836614D3188E6,012-345-678,11111111,APPLE ANZ,17.49,0,1039925.05,DR,REF276925,ANZ,Savings
09-09-2025 07:07,ANZ603DA29032AE4B0FB5A5,012-345-678,11111111,CITYLINK ANZ,109.03,0,1039816.02,DR,REF280966,ANZ,Savings
09-09-2025 07:15,ANZBF2738E099384FACAE09,012-345-678,11111111,PAYPAL *NETFLIX ANZ,4.42,0,1039811.6,DR,REF314558,ANZ,Savings
09-09-2025 07:26,ANZA5367E90395E48879E68,012-345-678,11111111,WOOLWORTHS ANZ,58.36,0,1039753.24,DR,REF194924,ANZ,Savings
09-09-2025 07:28,INTE0BD27CF97484D34BAC5,012-345-678,11111111,TRANSFER FROM CBA 22222222,0,218.33,1039971.57,CR,INT-81609,ANZ,Savings
09-09-2025 08:18,ANZD8F09B5FD53747C5AE09,012-345-678,11111111,AMAZON AU ANZ,11.44,0,1039960.13,DR,REF470222,ANZ,Savings
09-09-2025 08:38,ANZ2B2AD3C6EBFE44F9BB23,012-345-678,11111111,LIQUORLAND ANZ,13.79,0,1039946.34,DR,REF671146,ANZ,Savings
09-09-2025 08:49,ANZ1A0A343E8D644F11B270,012-345-678,11111111,AMAZON AU ANZ,12.67,0,1039933.67,DR,REF910354,ANZ,Savings
09-09-2025 09:01,ANZ21743748F2F346D4A707,012-345-678,11111111,CITYLINK ANZ,37.21,0,1039896.46,DR,REF751580,ANZ,Savings
09-09-2025 10:12,ANZD835F7070AC84C13A5C0,012-345-678,11111111,SHELL ANZ,11.75,0,1039884.71,DR,REF232319,ANZ,Savings
09-09-2025 10:26,ANZ94419BE165E54890860D,012-345-678,11111111,PAY - SALARY ANZ,0,1078.4,1040963.11,CR,REF274976,ANZ,Savings
09-09-2025 10:26,ANZ0690FCC544214B8E9434,012-345-678,11111111,LIQUORLAND ANZ,33.67,0,1040929.44,DR,REF417347,ANZ,Savings
09-09-2025 11:21,ANZB60DDDE596414677BF6B,012-345-678,11111111,LIQUORLAND ANZ,58.61,0,1040870.83,DR,REF910399,ANZ,Savings
09-09-2025 11:46,ANZ722D752A805743D4B3F6,012-345-678,11111111,PAYPAL *NETFLIX ANZ,11.66,0,1040859.17,DR,REF253635,ANZ,Savings
09-09-2025 12:07,ANZ0A3FDB843715461B8840,012-345-678,11111111,INTERNET TRANSFER ANZ,143.25,0,1040715.92,DR,REF376309,ANZ,Savings
09-09-2025 12:24,ANZEAEF06191B8C4B588A97,012-345-678,11111111,CITYLINK ANZ,72.27,0,1040643.65,DR,REF430271,ANZ,Savings
09-09-2025 13:05,ANZA182CFA1934B41389BDB,012-345-678,11111111,JB HI-FI ANZ,33.98,0,1040609.67,DR,REF447307,ANZ,Savings
09-09-2025 13:41,ANZ5C73B767E36A42A2A5E2,012-345-678,11111111,BWS ANZ,118.06,0,1040491.61,DR,REF714078,ANZ,Savings
09-09-2025 13:59,ANZ953C80B19CAA4124BA20,012-345-678,11111111,INTERNET TRANSFER ANZ,15.52,0,1040476.09,DR,REF735465,ANZ,Savings
09-09-2025 14:03,ANZAD26C309D42F4B7FBDB9,012-345-678,11111111,BIGW ANZ,50.33,0,1040425.76,DR,REF290838,ANZ,Savings
09-09-2025 14:15,ANZ0A4DEE1399DA42ACBC15,012-345-678,11111111,DOMINO'S PIZZA ANZ,20.96,0,1040404.8,DR,REF644346,ANZ,Savings
09-09-2025 14:36,ANZE1DEC7017849439293AE,012-345-678,11111111,PAYMENT GATEWAY ANZ,110.12,0,1040294.68,DR,REF900716,ANZ,Savings
09-09-2025 14:49,INT6383E7FDB7154864B9A8,012-345-678,11111111,TRANSFER FROM NAB 44444444,0,1689.13,1041983.81,CR,INT-45034,ANZ,Savings
09-09-2025 16:18,ANZ743AFE53F3EE468D88A7,012-345-678,11111111,PAYPAL *NETFLIX ANZ,29.31,0,1041954.5,DR,REF955150,ANZ,Savings
09-09-2025 16:26,ANZDA2569D1E09744CCA83B,012-345-678,11111111,AMAZON AU ANZ,16.47,0,1041938.03,DR,REF746082,ANZ,Savings
09-09-2025 16:26,ANZ2BCB791790C14253A725,012-345-678,11111111,ALDI ANZ,6.93,0,1041931.1,DR,REF453488,ANZ,Savings
09-09-2025 16:54,ANZ736EEF409B4F4DD6A2E0,012-345-678,11111111,FLIXBUS ANZ,57.93,0,1041873.17,DR,REF978349,ANZ,Savings
09-09-2025 17:00,ANZ968DA6D7068348DCB799,012-345-678,11111111,TAFE BOOKSHOP ANZ,46.74,0,1041826.43,DR,REF224308,ANZ,Savings
09-09-2025 17:44,ANZ135343EA91B949D59BE2,012-345-678,11111111,SPOTIFY ANZ,71.62,0,1041754.81,DR,REF267483,ANZ,Savings
09-09-2025 17:51,ANZ8AB474AA2CE2446E82A7,012-345-678,11111111,RAILWAY STATION ANZ,41.9,0,1041712.91,DR,REF400758,ANZ,Savings
09-09-2025 18:10,ANZ5295439337014A62B18E,012-345-678,11111111,KFC ANZ,44.04,0,1041668.87,DR,REF938754,ANZ,Savings
09-09-2025 18:12,ANZ11F069E4811841AA9A3A,012-345-678,11111111,SHELL ANZ,57.65,0,1041611.22,DR,REF910042,ANZ,Savings
09-09-2025 18:57,ANZD36A7B56D7B641ECA3C9,012-345-678,11111111,PAY - SALARY ANZ,0,937.94,1042549.16,CR,REF637274,ANZ,Savings
09-09-2025 19:40,ANZ8EFCB145863B4BF7AA99,012-345-678,11111111,JB HI-FI ANZ,103.31,0,1042445.85,DR,REF428135,ANZ,Savings
09-09-2025 20:41,ANZ43342C45C9BE41FEA2EE,012-345-678,11111111,PAYPAL *NETFLIX ANZ,12.3,0,1042433.55,DR,REF523663,ANZ,Savings
09-09-2025 20:57,ANZ858C563B26264060ACC0,012-345-678,11111111,UBER EATS ANZ,181.96,0,1042251.59,DR,REF404631,ANZ,Savings
09-09-2025 21:23,ANZE724AFE2E1C147C8A5D1,012-345-678,11111111,WOOLWORTHS ANZ,234.8,0,1042016.79,DR,REF598419,ANZ,Savings
09-09-2025 22:23,ANZ389D2B4F3B784524A9B6,012-345-678,11111111,SALARY PAYMENT ANZ,0,2261.78,1044278.57,CR,REF634832,ANZ,Savings
09-09-2025 23:06,ANZ1951C5DA070A4850ADF7,012-345-678,11111111,WAGES CREDIT ANZ,0,4714.08,1048992.65,CR,REF829580,ANZ,Savings
09-09-2025 23:28,ANZA100BE4B6ADA43858EA5,012-345-678,11111111,WAGES CREDIT ANZ,0,7143.25,1056135.9,CR,REF617625,ANZ,Savings
09-09-2025 23:49,ANZ66E660DE96CA44E7931A,012-345-678,11111111,BP ANZ,32.36,0,1056103.54,DR,REF804069,ANZ,Savings
09-09-2025 23:57,ANZ65FB5B58ECB44BC9A422,012-345-678,11111111,BWS ANZ,12.36,0,1056091.18,DR,REF898834,ANZ,Savings
09-09-2025 23:57,ANZ72C694C83E1C4C568538,012-345-678,11111111,WOOLWORTHS ANZ,12.68,0,1056078.5,DR,REF330465,ANZ,Savings
10-09-2025 00:56,ANZ5BFA60DEC77947BE989D,012-345-678,11111111,BP ANZ,113.82,0,1055964.68,DR,REF289478,ANZ,Savings
10-09-2025 01:15,ANZ2DC7982F01654B129DF6,012-345-678,11111111,BP ANZ,67.05,0,1055897.63,DR,REF286314,ANZ,Savings
10-09-2025 01:54,ANZADFC477ADCD34E27AE91,012-345-678,11111111,LIQUORLAND ANZ,19.27,0,1055878.36,DR,REF813766,ANZ,Savings
10-09-2025 02:08,ANZ248C8C254432499E8584,012-345-678,11111111,PAY - SALARY ANZ,0,341.17,1056219.53,CR,REF760037,ANZ,Savings
10-09-2025 02:12,ANZB103E37A4025490CB26C,012-345-678,11111111,APPLE ANZ,71.93,0,1056147.6,DR,REF420177,ANZ,Savings
10-09-2025 02:14,ANZ727B5905499A4050A496,012-345-678,11111111,LIQUORLAND ANZ,14.17,0,1056133.43,DR,REF587066,ANZ,Savings
10-09-2025 02:21,ANZBA3502C6CAF2443F8447,012-345-678,11111111,BIGW ANZ,32.08,0,1056101.35,DR,REF374264,ANZ,Savings
10-09-2025 02:34,ANZ7E53A0A2A48E4BBE803C,012-345-678,11111111,BIGW ANZ,23.87,0,1056077.48,DR,REF606406,ANZ,Savings
10-09-2025 03:02,INTEDD7043E3BA34A978784,012-345-678,11111111,TRANSFER TO CBA 22222222,1951.3,0,1054126.18,DR,INT-79326,ANZ,Savings
10-09-2025 03:21,ANZ6621AFE9509C4CA98CDB,012-345-678,11111111,ALDI ANZ,91.23,0,1054034.95,DR,REF472969,ANZ,Savings
10-09-2025 03:21,ANZ8014A914673041B9ABCF,012-345-678,11111111,BP ANZ,19.14,0,1054015.81,DR,REF841131,ANZ,Savings
10-09-2025 03:28,ANZ8DCFB898394848D692AF,012-345-678,11111111,PAYPAL *NETFLIX ANZ,81.47,0,1053934.34,DR,REF768330,ANZ,Savings
10-09-2025 03:40,ANZ62436F8E35E44AFAAF09,012-345-678,11111111,COLES ANZ,41.7,0,1053892.64,DR,REF603780,ANZ,Savings
10-09-2025 04:02,ANZ2008B382B9BA4BC9AE1C,012-345-678,11111111,BIGW ANZ,27.97,0,1053864.67,DR,REF440179,ANZ,Savings
10-09-2025 04:13,ANZ3D36009A6AA04172B74E,012-345-678,11111111,WAGES CREDIT ANZ,0,2022.31,1055886.98,CR,REF840639,ANZ,Savings
10-09-2025 04:46,ANZAA46615B58714295BB03,012-345-678,11111111,APPLE ANZ,7.22,0,1055879.76,DR,REF988843,ANZ,Savings
10-09-2025 04:54,ANZ6911132DC65B4650BEF6,012-345-678,11111111,MENULOG ANZ,43.48,0,1055836.28,DR,REF234590,ANZ,Savings
10-09-2025 04:55,ANZ6019E82145FC4B798F7E,012-345-678,11111111,INTERNET TRANSFER ANZ,41.27,0,1055795.01,DR,REF678290,ANZ,Savings
10-09-2025 04:55,ANZ937B065522E54C37B643,012-345-678,11111111,KFC ANZ,73.88,0,1055721.13,DR,REF835447,ANZ,Savings
10-09-2025 05:18,ANZ1650EB1F23044C019907,012-345-678,11111111,SHELL ANZ,22.12,0,1055699.01,DR,REF593125,ANZ,Savings
10-09-2025 05:32,ANZ805CAEC2FF7447CAB011,012-345-678,11111111,LIQUORLAND ANZ,54.76,0,1055644.25,DR,REF734150,ANZ,Savings
10-09-2025 06:03,ANZ23FE998D82B54BF2ABAF,012-345-678,11111111,PAYROLL CREDIT ANZ,0,6428.02,1062072.27,CR,REF952607,ANZ,Savings
10-09-2025 06:08,ANZ33178F2DEF404E2BAC8A,012-345-678,11111111,APPLE ANZ,5.23,0,1062067.04,DR,REF596800,ANZ,Savings
10-09-2025 06:22,ANZ1EAC67D35D9C4940BDE6,012-345-678,11111111,PAYMENT GATEWAY ANZ,119.68,0,1061947.36,DR,REF902768,ANZ,Savings
10-09-2025 06:34,ANZF63546215C704E308D9E,012-345-678,11111111,FLIXBUS ANZ,30.71,0,1061916.65,DR,REF108450,ANZ,Savings
10-09-2025 07:11,ANZ70702D894D334F0D84EA,012-345-678,11111111,RAILWAY STATION ANZ,75.15,0,1061841.5,DR,REF109922,ANZ,Savings
10-09-2025 07:22,ANZ5146B84E011248579082,012-345-678,11111111,ZOOM ANZ,15.78,0,1061825.72,DR,REF104610,ANZ,Savings
10-09-2025 07:47,ANZCBA0F57D23FF4753BF4F,012-345-678,11111111,SALARY PAYMENT ANZ,0,7835.3,1069661.02,CR,REF164490,ANZ,Savings
10-09-2025 07:49,ANZ2B31593A93AC447AAED6,012-345-678,11111111,SPOTIFY ANZ,51.76,0,1069609.26,DR,REF798451,ANZ,Savings
10-09-2025 08:03,ANZ96BDC642B76042DA91E4,012-345-678,11111111,AMAZON AU ANZ,136.7,0,1069472.56,DR,REF658329,ANZ,Savings
10-09-2025 08:07,ANZ0D6A1DFDF28A4E45AE66,012-345-678,11111111,BIGW ANZ,7.17,0,1069465.39,DR,REF903582,ANZ,Savings
10-09-2025 08:26,ANZBB6D8A8BBA3E4CDF9C36,012-345-678,11111111,PAYPAL *NETFLIX ANZ,15.08,0,1069450.31,DR,REF715126,ANZ,Savings
10-09-2025 08:31,INTE85C1946D3AD41799EEE,012-345-678,11111111,TRANSFER TO NAB 44444444,1409.14,0,1068041.17,DR,INT-55163,ANZ,Savings
10-09-2025 08:56,ANZF6A80DAA32C14DE8B700,012-345-678,11111111,ALDI ANZ,4.88,0,1068036.29,DR,REF622836,ANZ,Savings
10-09-2025 09:04,ANZ06491576C69B415F878D,012-345-678,11111111,WAGES CREDIT ANZ,0,2195.61,1070231.9,CR,REF228457,ANZ,Savings
10-09-2025 09:21,ANZ537007BDC4DF4D03AF4C,012-345-678,11111111,INTERNET TRANSFER ANZ,51.19,0,1070180.71,DR,REF459913,ANZ,Savings
10-09-2025 09:21,ANZC14ADA108B014D41B8D2,012-345-678,11111111,APPLE ANZ,16.48,0,1070164.23,DR,REF492767,ANZ,Savings
10-09-2025 09:28,INT7C28BBE09D104E65A172,012-345-678,11111111,TRANSFER FROM CBA 33333333,0,1544.31,1071708.54,CR,INT-61262,ANZ,Savings
10-09-2025 10:28,ANZ03F02FDECA3142B695CE,012-345-678,11111111,CITYLINK ANZ,13.59,0,1071694.95,DR,REF344709,ANZ,Savings
10-09-2025 11:09,ANZ03D84AF9DA8D48E996CC,012-345-678,11111111,MENULOG ANZ,29.95,0,1071665,DR,REF103952,ANZ,Savings
10-09-2025 11:24,ANZ5DAA0425475B46CBB219,012-345-678,11111111,INTERNET TRANSFER ANZ,38.98,0,1071626.02,DR,REF294673,ANZ,Savings
10-09-2025 11:28,ANZ5F48CB7F9EEF433281A3,012-345-678,11111111,SHELL ANZ,10.19,0,1071615.83,DR,REF362145,ANZ,Savings
10-09-2025 11:44,ANZA105B80148894D318CD5,012-345-678,11111111,SPOTIFY ANZ,70.11,0,1071545.72,DR,REF264419,ANZ,Savings
10-09-2025 11:48,ANZ082EF0DD9FE2442CA939,012-345-678,11111111,BANK FEE ANZ,36.18,0,1071509.54,DR,REF752688,ANZ,Savings
10-09-2025 12:00,ANZ7D472F5A3C514C139A84,012-345-678,11111111,SPOTIFY ANZ,4.48,0,1071505.06,DR,REF788542,ANZ,Savings
10-09-2025 12:15,ANZE1D54411519E4A00B818,012-345-678,11111111,BP ANZ,153.6,0,1071351.46,DR,REF421940,ANZ,Savings
10-09-2025 12:59,ANZEEFB1D0D533445A7921C,012-345-678,11111111,BWS ANZ,2.15,0,1071349.31,DR,REF689913,ANZ,Savings
10-09-2025 14:17,ANZ926D0701769E44ACBD0C,012-345-678,11111111,FLIXBUS ANZ,42.17,0,1071307.14,DR,REF163073,ANZ,Savings
10-09-2025 14:36,ANZ809CE580DFA743E8A8F3,012-345-678,11111111,PAYROLL CREDIT ANZ,0,4461.22,1075768.36,CR,REF298700,ANZ,Savings
10-09-2025 14:43,ANZ4349367C3B0C47D7838F,012-345-678,11111111,PAY - SALARY ANZ,0,44.47,1075812.83,CR,REF688867,ANZ,Savings
10-09-2025 14:43,ANZC47F190B5A3E48C199A1,012-345-678,11111111,PAY - SALARY ANZ,0,6356.17,1082169,CR,REF610680,ANZ,Savings
10-09-2025 14:52,INT12FE613D49434FCEBA2C,012-345-678,11111111,TRANSFER FROM NAB 44444444,0,445.45,1082614.45,CR,INT-97764,ANZ,Savings
10-09-2025 15:12,ANZ6D31222EA413415B9D0C,012-345-678,11111111,PAYMENT GATEWAY ANZ,28.94,0,1082585.51,DR,REF651620,ANZ,Savings
10-09-2025 15:25,ANZACEF89640E064AFDB993,012-345-678,11111111,LIQUORLAND ANZ,43.57,0,1082541.94,DR,REF721797,ANZ,Savings
10-09-2025 15:59,INT1EB0ED70861A40D18AB9,012-345-678,11111111,TRANSFER TO NAB 44444444,1501.7,0,1081040.24,DR,INT-48688,ANZ,Savings
10-09-2025 16:00,ANZ1CC7C16D401A4B20B267,012-345-678,11111111,ALDI ANZ,23.31,0,1081016.93,DR,REF217789,ANZ,Savings
10-09-2025 16:13,ANZ9662815620D24B159357,012-345-678,11111111,WAGES CREDIT ANZ,0,1829.66,1082846.59,CR,REF881863,ANZ,Savings
10-09-2025 16:25,ANZF3A52E493AFA42409182,012-345-678,11111111,FLIXBUS ANZ,86.24,0,1082760.35,DR,REF539206,ANZ,Savings
10-09-2025 16:41,ANZ9858AD61643D45459ED4,012-345-678,11111111,SHELL ANZ,243.05,0,1082517.3,DR,REF161878,ANZ,Savings
10-09-2025 16:46,ANZ2A866D2896384978B268,012-345-678,11111111,MCDONALDS ANZ,40.03,0,1082477.27,DR,REF209761,ANZ,Savings
10-09-2025 16:49,ANZCB04E0D4E09841FB8A33,012-345-678,11111111,ZOOM ANZ,131.07,0,1082346.2,DR,REF333550,ANZ,Savings
10-09-2025 16:53,ANZ1453C3E97EC7434E8E08,012-345-678,11111111,LIQUORLAND ANZ,12.11,0,1082334.09,DR,REF217006,ANZ,Savings
10-09-2025 17:16,ANZ81A1D3440D30413DB830,012-345-678,11111111,RAILWAY STATION ANZ,57.55,0,1082276.54,DR,REF777121,ANZ,Savings
10-09-2025 17:22,ANZBAA78FB0133046B2AD90,012-345-678,11111111,DOMINO'S PIZZA ANZ,172.7,0,1082103.84,DR,REF706175,ANZ,Savings
10-09-2025 17:56,ANZ07ED084368EF4FB19878,012-345-678,11111111,BP ANZ,47.1,0,1082056.74,DR,REF185730,ANZ,Savings
10-09-2025 18:08,ANZ51E433220D004D9F959F,012-345-678,11111111,HARVEY NORMAN ANZ,70.19,0,1081986.55,DR,REF345715,ANZ,Savings
10-09-2025 18:10,ANZFCEB10059CCA4357B552,012-345-678,11111111,UBER EATS ANZ,127.6,0,1081858.95,DR,REF876722,ANZ,Savings
10-09-2025 18:44,ANZ7B96FFBDDA014C85B8F7,012-345-678,11111111,RAILWAY STATION ANZ,10.28,0,1081848.67,DR,REF290563,ANZ,Savings
10-09-2025 19:26,ANZ4C7DFE52261E49F798E5,012-345-678,11111111,SPOTIFY ANZ,114.28,0,1081734.39,DR,REF225505,ANZ,Savings
10-09-2025 19:51,ANZ814A8559EA4F478FB9B3,012-345-678,11111111,SALARY PAYMENT ANZ,0,255.56,1081989.95,CR,REF432299,ANZ,Savings
10-09-2025 20:09,ANZ42DCA2F366174F809744,012-345-678,11111111,CITYLINK ANZ,77.61,0,1081912.34,DR,REF651768,ANZ,Savings
10-09-2025 20:13,ANZ8C7108303FED4CB5A7A4,012-345-678,11111111,INTERNET TRANSFER ANZ,37.44,0,1081874.9,DR,REF737220,ANZ,Savings
10-09-2025 21:19,ANZ0DF065F88E114D0A8A4E,012-345-678,11111111,UBER EATS ANZ,250.35,0,1081624.55,DR,REF637200,ANZ,Savings
10-09-2025 21:22,ANZ31D76C7B4C144443B1C8,012-345-678,11111111,BP ANZ,51.55,0,1081573,DR,REF918541,ANZ,Savings
10-09-2025 21:23,ANZ55480951C9EB49CAA6F6,012-345-678,11111111,WAGES CREDIT ANZ,0,868.17,1082441.17,CR,REF162828,ANZ,Savings
10-09-2025 21:42,ANZ5EC1DDAC25954B69A64B,012-345-678,11111111,COLES ANZ,21.73,0,1082419.44,DR,REF705894,ANZ,Savings
10-09-2025 22:32,ANZ19147CAED5E04A02A32F,012-345-678,11111111,PAYMENT GATEWAY ANZ,39.01,0,1082380.43,DR,REF853276,ANZ,Savings
10-09-2025 22:37,ANZFA72153A52F3444EA32F,012-345-678,11111111,WOOLWORTHS ANZ,4.3,0,1082376.13,DR,REF909249,ANZ,Savings
10-09-2025 23:37,ANZ6F29B82955174FF58AF7,012-345-678,11111111,BIGW ANZ,122.18,0,1082253.95,DR,REF301818,ANZ,Savings
10-09-2025 23:57,ANZ32B12A49F2F04390BC52,012-345-678,11111111,APPLE ANZ,93.18,0,1082160.77,DR,REF979552,ANZ,Savings
10-09-2025 23:57,ANZ5AA189A4F4514AC49659,012-345-678,11111111,UBER EATS ANZ,3.79,0,1082156.98,DR,REF992675,ANZ,Savings
11-09-2025 00:00,ANZ4B5A98F152694FA490E5,012-345-678,11111111,SALARY PAYMENT ANZ,0,5774.2,1087931.18,CR,REF369483,ANZ,Savings
11-09-2025 00:16,ANZ49E237EA312B4046B0B7,012-345-678,11111111,JB HI-FI ANZ,28.95,0,1087902.23,DR,REF387216,ANZ,Savings
11-09-2025 00:17,ANZ8562DF9F0E534E7EB944,012-345-678,11111111,PAYROLL CREDIT ANZ,0,6947.58,1094849.81,CR,REF505279,ANZ,Savings
11-09-2025 00:43,ANZC185B207C9234B39A2F8,012-345-678,11111111,PAYMENT GATEWAY ANZ,174.19,0,1094675.62,DR,REF921444,ANZ,Savings
11-09-2025 01:02,ANZAA7B0E77AAE741CC8F2B,012-345-678,11111111,COMPANY PAYROLL ANZ,0,231.81,1094907.43,CR,REF965980,ANZ,Savings
11-09-2025 01:06,ANZ73A6D326CA06462BB32B,012-345-678,11111111,PAYROLL CREDIT ANZ,0,4456.39,1099363.82,CR,REF199561,ANZ,Savings
11-09-2025 01:08,ANZ712D358F1CC0401C8D11,012-345-678,11111111,PAYMENT GATEWAY ANZ,35.31,0,1099328.51,DR,REF180811,ANZ,Savings
11-09-2025 01:12,ANZ4A6AF2576EF6411C88BB,012-345-678,11111111,INTERNET TRANSFER ANZ,4.77,0,1099323.74,DR,REF633661,ANZ,Savings
11-09-2025 01:15,ANZAFC2DFDE0F78462AAA04,012-345-678,11111111,BWS ANZ,15.37,0,1099308.37,DR,REF173773,ANZ,Savings
11-09-2025 02:04,ANZ12131B6858B340CAAD10,012-345-678,11111111,PAYROLL CREDIT ANZ,0,6937.86,1106246.23,CR,REF389749,ANZ,Savings
11-09-2025 02:09,ANZ51B5F42723EB4AC1BC8B,012-345-678,11111111,MCDONALDS ANZ,81.88,0,1106164.35,DR,REF325754,ANZ,Savings
11-09-2025 02:18,ANZ23DF59922AF34DE185CA,012-345-678,11111111,BWS ANZ,47.91,0,1106116.44,DR,REF104693,ANZ,Savings
11-09-2025 02:59,ANZCF577C2FD7D741EE80CE,012-345-678,11111111,BIGW ANZ,69.45,0,1106046.99,DR,REF716865,ANZ,Savings
11-09-2025 03:01,ANZ652C32795AF14BF0B7F0,012-345-678,11111111,BANK FEE ANZ,18.16,0,1106028.83,DR,REF602054,ANZ,Savings
11-09-2025 03:15,ANZ12839705B4E14924A33D,012-345-678,11111111,FLIXBUS ANZ,8.85,0,1106019.98,DR,REF526403,ANZ,Savings
11-09-2025 03:45,ANZDE9C09B3797C42B89DB2,012-345-678,11111111,COLES ANZ,111.35,0,1105908.63,DR,REF812906,ANZ,Savings
11-09-2025 04:06,INT113AF7741CB54F1C8CC1,012-345-678,11111111,TRANSFER TO CBA 22222222,290.81,0,1105617.82,DR,INT-48487,ANZ,Savings
11-09-2025 04:09,ANZ7DBB16467DE94AA4B862,012-345-678,11111111,7-ELEVEN ANZ,21.53,0,1105596.29,DR,REF261458,ANZ,Savings
11-09-2025 04:26,ANZB5D705ECF67E42FBB671,012-345-678,11111111,7-ELEVEN ANZ,79.88,0,1105516.41,DR,REF681716,ANZ,Savings
11-09-2025 04:51,INTFA147E82218D490EABDD,012-345-678,11111111,TRANSFER TO CBA 33333333,288.43,0,1105227.98,DR,INT-23096,ANZ,Savings
11-09-2025 05:07,ANZFCD4986D36124B0EA596,012-345-678,11111111,KFC ANZ,122.57,0,1105105.41,DR,REF907518,ANZ,Savings
11-09-2025 05:27,ANZ99D53D58B5164137AA92,012-345-678,11111111,SHELL ANZ,37.48,0,1105067.93,DR,REF469846,ANZ,Savings
11-09-2025 05:28,ANZB24DFAD347854CF39DE3,012-345-678,11111111,BIGW ANZ,41.12,0,1105026.81,DR,REF910156,ANZ,Savings
11-09-2025 05:38,ANZ2B689F1DC8BE4910B493,012-345-678,11111111,RAILWAY STATION ANZ,20.52,0,1105006.29,DR,REF591742,ANZ,Savings
11-09-2025 05:41,ANZ04474C79A7C848539CC0,012-345-678,11111111,COLES ANZ,9.37,0,1104996.92,DR,REF236393,ANZ,Savings
11-09-2025 05:47,ANZ73AF8D7013394D09ADC2,012-345-678,11111111,BP ANZ,86.02,0,1104910.9,DR,REF389940,ANZ,Savings
11-09-2025 06:51,ANZ6B51731BFD894A9DBA15,012-345-678,11111111,PAYPAL *NETFLIX ANZ,7.87,0,1104903.03,DR,REF696756,ANZ,Savings
11-09-2025 07:02,ANZ4B6E6A68616B4AF1B69C,012-345-678,11111111,SALARY PAYMENT ANZ,0,4305.87,1109208.9,CR,REF666565,ANZ,Savings
11-09-2025 07:06,ANZ85EDBB6F43E245B59EB6,012-345-678,11111111,COLES ANZ,29.68,0,1109179.22,DR,REF877915,ANZ,Savings
11-09-2025 07:18,ANZ1C3DB8100F9E4A3D907E,012-345-678,11111111,COMPANY PAYROLL ANZ,0,2053.3,1111232.52,CR,REF815828,ANZ,Savings
11-09-2025 07:21,ANZ2DA09F96F5DC41BFB22E,012-345-678,11111111,TAFE BOOKSHOP ANZ,27.66,0,1111204.86,DR,REF735482,ANZ,Savings
11-09-2025 08:06,ANZF452BF11070F40C5A6F9,012-345-678,11111111,CITYLINK ANZ,113.48,0,1111091.38,DR,REF952575,ANZ,Savings
11-09-2025 08:18,ANZ096EEF4E42A149469B4B,012-345-678,11111111,BIGW ANZ,41.61,0,1111049.77,DR,REF359548,ANZ,Savings
11-09-2025 09:39,ANZC4B3D9188EF446AFBD5E,012-345-678,11111111,APPLE ANZ,43.36,0,1111006.41,DR,REF300501,ANZ,Savings
11-09-2025 10:13,ANZ9144CD3D9EA94D138F74,012-345-678,11111111,KFC ANZ,120.74,0,1110885.67,DR,REF564353,ANZ,Savings
11-09-2025 10:16,ANZAD8E8A4EE39941EEB1DD,012-345-678,11111111,SHELL ANZ,18.48,0,1110867.19,DR,REF397497,ANZ,Savings
11-09-2025 10:39,ANZ6466F7F54E5C46529E1C,012-345-678,11111111,WOOLWORTHS ANZ,9.77,0,1110857.42,DR,REF186376,ANZ,Savings
11-09-2025 10:59,ANZ18F2F8EACA864EB3ABC0,012-345-678,11111111,BWS ANZ,30.05,0,1110827.37,DR,REF998580,ANZ,Savings
11-09-2025 11:33,ANZFC27B13B27384E19BA76,012-345-678,11111111,UBER EATS ANZ,110.03,0,1110717.34,DR,REF218998,ANZ,Savings
11-09-2025 11:35,ANZ6BA729E2A5184153A8FF,012-345-678,11111111,BWS ANZ,25.02,0,1110692.32,DR,REF397853,ANZ,Savings
11-09-2025 11:37,ANZ96DD664879254CB3A66C,012-345-678,11111111,RAILWAY STATION ANZ,52.39,0,1110639.93,DR,REF866422,ANZ,Savings
11-09-2025 11:44,ANZ00763692FCD3498AB250,012-345-678,11111111,MENULOG ANZ,39.54,0,1110600.39,DR,REF482787,ANZ,Savings
11-09-2025 11:52,ANZ7667A28FE5994CEA812D,012-345-678,11111111,SHELL ANZ,43.21,0,1110557.18,DR,REF850415,ANZ,Savings
11-09-2025 13:24,ANZ883A8A3D0F73431BAA74,012-345-678,11111111,RAILWAY STATION ANZ,10.95,0,1110546.23,DR,REF824317,ANZ,Savings
11-09-2025 13:32,ANZF1C4A20E12144C588571,012-345-678,11111111,DOMINO'S PIZZA ANZ,13.8,0,1110532.43,DR,REF311459,ANZ,Savings
11-09-2025 13:40,INTDD8E5219DF8C476DA368,012-345-678,11111111,TRANSFER FROM NAB 44444444,0,303.05,1110835.48,CR,INT-66474,ANZ,Savings
11-09-2025 13:50,ANZ159CA08DD4744EECBECC,012-345-678,11111111,ZOOM ANZ,64.97,0,1110770.51,DR,REF704076,ANZ,Savings
11-09-2025 14:15,ANZ49DE517A22D840D29897,012-345-678,11111111,PAYMENT GATEWAY ANZ,35.6,0,1110734.91,DR,REF347720,ANZ,Savings
11-09-2025 14:33,ANZ0D55547EFD6547758916,012-345-678,11111111,BANK FEE ANZ,147.16,0,1110587.75,DR,REF181877,ANZ,Savings
11-09-2025 14:44,ANZ7BA56C11D89041338B5A,012-345-678,11111111,FLIXBUS ANZ,19.93,0,1110567.82,DR,REF994883,ANZ,Savings
11-09-2025 15:22,ANZ53D3E298BF804831AC42,012-345-678,11111111,BP ANZ,56.11,0,1110511.71,DR,REF305372,ANZ,Savings
11-09-2025 15:34,INT05D878BC80644C32BB7C,012-345-678,11111111,TRANSFER FROM CBA 22222222,0,1217.1,1111728.81,CR,INT-49270,ANZ,Savings
11-09-2025 15:42,ANZ9C7E8AC2DA4844AFAE18,012-345-678,11111111,PAYROLL CREDIT ANZ,0,7314.36,1119043.17,CR,REF162924,ANZ,Savings
11-09-2025 16:08,ANZ4192307ACFB74FBBBF5B,012-345-678,11111111,PAYPAL *NETFLIX ANZ,17.51,0,1119025.66,DR,REF740030,ANZ,Savings
11-09-2025 16:28,ANZ8FE119A302E544DE93C4,012-345-678,11111111,PAYMENT GATEWAY ANZ,20.68,0,1119004.98,DR,REF517669,ANZ,Savings
11-09-2025 17:01,ANZ8291DD23EF7B4D998AF2,012-345-678,11111111,BWS ANZ,23.75,0,1118981.23,DR,REF333725,ANZ,Savings
11-09-2025 17:45,ANZED8C364B6111447C880E,012-345-678,11111111,RAILWAY STATION ANZ,89.88,0,1118891.35,DR,REF561312,ANZ,Savings
11-09-2025 18:17,ANZF25A6E57CA44483C8B96,012-345-678,11111111,UBER EATS ANZ,11.01,0,1118880.34,DR,REF428567,ANZ,Savings
11-09-2025 18:23,ANZ908E4C0FDA324A618972,012-345-678,11111111,BANK FEE ANZ,18.04,0,1118862.3,DR,REF157072,ANZ,Savings
11-09-2025 18:33,ANZD31154F88C78484FB53B,012-345-678,11111111,WOOLWORTHS ANZ,182.75,0,1118679.55,DR,REF206799,ANZ,Savings
11-09-2025 18:40,ANZF2B9881B7F0F4D3993E6,012-345-678,11111111,BWS ANZ,28.44,0,1118651.11,DR,REF799041,ANZ,Savings
11-09-2025 18:49,ANZBF2F2B0A72DC4DBEB6A1,012-345-678,11111111,PAYMENT GATEWAY ANZ,37.1,0,1118614.01,DR,REF417113,ANZ,Savings
11-09-2025 20:00,ANZ525E179071664688A634,012-345-678,11111111,HARVEY NORMAN ANZ,61.24,0,1118552.77,DR,REF651148,ANZ,Savings
11-09-2025 20:12,ANZ8E1DDB59B49D499E826D,012-345-678,11111111,WAGES CREDIT ANZ,0,5484.79,1124037.56,CR,REF537293,ANZ,Savings
11-09-2025 20:34,ANZ78E731C72C074743ADB9,012-345-678,11111111,JB HI-FI ANZ,83.98,0,1123953.58,DR,REF349857,ANZ,Savings
11-09-2025 20:39,INTDA2A6AE2FF50451E8C05,012-345-678,11111111,TRANSFER TO CBA 22222222,714.21,0,1123239.37,DR,INT-62999,ANZ,Savings
11-09-2025 20:57,ANZ9B6A317FFB864EEBAA04,012-345-678,11111111,INTERNET TRANSFER ANZ,33.82,0,1123205.55,DR,REF235917,ANZ,Savings
11-09-2025 21:05,ANZE50D51A4D8104DC6B20C,012-345-678,11111111,COMPANY PAYROLL ANZ,0,6084.6,1129290.15,CR,REF515551,ANZ,Savings
11-09-2025 21:45,ANZ0BD81C241D6640869036,012-345-678,11111111,BWS ANZ,8.77,0,1129281.38,DR,REF315410,ANZ,Savings
11-09-2025 22:53,ANZB9DB21EF7CDD4B1A9E7A,012-345-678,11111111,FLIXBUS ANZ,31.45,0,1129249.93,DR,REF717548,ANZ,Savings
11-09-2025 23:44,ANZ9EB7F5C8D2A443DDA012,012-345-678,11111111,WOOLWORTHS ANZ,61.73,0,1129188.2,DR,REF292912,ANZ,Savings
12-09-2025 00:13,INT00923318CCCC45CAA70E,012-345-678,11111111,TRANSFER TO CBA 22222222,1107.55,0,1128080.65,DR,INT-60368,ANZ,Savings
12-09-2025 00:18,ANZ9FA5D8C6E3DE49099513,012-345-678,11111111,7-ELEVEN ANZ,1.51,0,1128079.14,DR,REF279739,ANZ,Savings
12-09-2025 01:37,ANZCCAE72A091C24019BD92,012-345-678,11111111,BANK FEE ANZ,42.42,0,1128036.72,DR,REF439154,ANZ,Savings
12-09-2025 02:12,ANZ49DD3A9B733441C69123,012-345-678,11111111,FLIXBUS ANZ,85.55,0,1127951.17,DR,REF420847,ANZ,Savings
12-09-2025 02:13,ANZD9DC80D2933F4DFE8CD7,012-345-678,11111111,DOMINO'S PIZZA ANZ,129.21,0,1127821.96,DR,REF986830,ANZ,Savings
12-09-2025 02:33,ANZ327803256BB24C17B62A,012-345-678,11111111,PAYROLL CREDIT ANZ,0,4269.87,1132091.83,CR,REF871199,ANZ,Savings
12-09-2025 02:40,ANZEAF91EFBBA1B4B9387AF,012-345-678,11111111,COLES ANZ,76.93,0,1132014.9,DR,REF377794,ANZ,Savings
12-09-2025 03:26,ANZ1446B55484CD4A0E98B7,012-345-678,11111111,BANK FEE ANZ,13.54,0,1132001.36,DR,REF266990,ANZ,Savings
12-09-2025 03:33,ANZ7EF8D68DDA834FEA8391,012-345-678,11111111,SHELL ANZ,113.04,0,1131888.32,DR,REF574041,ANZ,Savings
12-09-2025 03:43,ANZ0BBB153EB63B4290B8BE,012-345-678,11111111,BANK FEE ANZ,48.13,0,1131840.19,DR,REF953470,ANZ,Savings
12-09-2025 04:02,ANZ52C9AC0FC4F94B899820,012-345-678,11111111,LIQUORLAND ANZ,20.52,0,1131819.67,DR,REF750654,ANZ,Savings
12-09-2025 04:02,ANZBC776118C14D49709865,012-345-678,11111111,ZOOM ANZ,53.27,0,1131766.4,DR,REF987541,ANZ,Savings
12-09-2025 04:18,ANZ4A63D31AE6EF43269914,012-345-678,11111111,PAYROLL CREDIT ANZ,0,2543,1134309.4,CR,REF533752,ANZ,Savings
12-09-2025 04:27,ANZDAE3E566BB4345B1A5FB,012-345-678,11111111,BWS ANZ,35.44,0,1134273.96,DR,REF196837,ANZ,Savings
12-09-2025 04:32,ANZDFC798E1D0924FB98747,012-345-678,11111111,7-ELEVEN ANZ,66.57,0,1134207.39,DR,REF896427,ANZ,Savings
12-09-2025 04:39,ANZ6BEEF0BF11534EC89D18,012-345-678,11111111,MENULOG ANZ,45.19,0,1134162.2,DR,REF158811,ANZ,Savings
12-09-2025 04:47,ANZ8D82C20A0E284F92B222,012-345-678,11111111,MENULOG ANZ,102.11,0,1134060.09,DR,REF905240,ANZ,Savings
12-09-2025 04:49,ANZDD37E90E58FF4739837A,012-345-678,11111111,UBER EATS ANZ,3.25,0,1134056.84,DR,REF565952,ANZ,Savings
12-09-2025 05:03,ANZ94E7394B65F64D0AB1FD,012-345-678,11111111,HARVEY NORMAN ANZ,22.94,0,1134033.9,DR,REF882218,ANZ,Savings
12-09-2025 05:10,ANZEBABF02F281C41A5A013,012-345-678,11111111,WOOLWORTHS ANZ,29.67,0,1134004.23,DR,REF551556,ANZ,Savings
12-09-2025 05:10,ANZ233BF6E910554A1DA938,012-345-678,11111111,MCDONALDS ANZ,258.73,0,1133745.5,DR,REF445057,ANZ,Savings
12-09-2025 05:16,ANZ7D0D9C90EE384DE2AFB6,012-345-678,11111111,COLES ANZ,49.9,0,1133695.6,DR,REF928425,ANZ,Savings
12-09-2025 05:43,ANZBB0D8C1EB6C0420EA8D0,012-345-678,11111111,PAYMENT GATEWAY ANZ,35.42,0,1133660.18,DR,REF960385,ANZ,Savings
12-09-2025 05:43,ANZ975C61D23AF74ADB831E,012-345-678,11111111,MCDONALDS ANZ,206.18,0,1133454,DR,REF783410,ANZ,Savings
12-09-2025 05:50,ANZFE5A1A3AC23E45E58DFF,012-345-678,11111111,AMAZON AU ANZ,8.02,0,1133445.98,DR,REF645112,ANZ,Savings
12-09-2025 05:58,ANZ2855B86112084E0BBC16,012-345-678,11111111,JB HI-FI ANZ,102.23,0,1133343.75,DR,REF874137,ANZ,Savings
12-09-2025 05:59,ANZ59BE2706786E49488D16,012-345-678,11111111,AMAZON AU ANZ,8,0,1133335.75,DR,REF205269,ANZ,Savings
12-09-2025 06:33,ANZ1AFABD3ECC9D44EBA675,012-345-678,11111111,APPLE ANZ,28.45,0,1133307.3,DR,REF445105,ANZ,Savings
12-09-2025 07:06,ANZBCA40FFDA7044AEAA09D,012-345-678,11111111,MCDONALDS ANZ,30.99,0,1133276.31,DR,REF710371,ANZ,Savings
12-09-2025 07:56,ANZCDE0DA50B52245FAAB2C,012-345-678,11111111,APPLE ANZ,5.49,0,1133270.82,DR,REF867489,ANZ,Savings
12-09-2025 08:22,ANZE5BF67F17E2B450E94EF,012-345-678,11111111,BP ANZ,69.15,0,1133201.67,DR,REF315243,ANZ,Savings
12-09-2025 08:42,ANZF13B9D1184EE4CD98D4A,012-345-678,11111111,BANK FEE ANZ,62.17,0,1133139.5,DR,REF133299,ANZ,Savings
12-09-2025 09:23,ANZCAF395D667D74D6ABFB1,012-345-678,11111111,APPLE ANZ,44.29,0,1133095.21,DR,REF388178,ANZ,Savings
12-09-2025 09:32,ANZDC7B805B3746489CBB7F,012-345-678,11111111,UBER EATS ANZ,32.08,0,1133063.13,DR,REF176850,ANZ,Savings
12-09-2025 09:48,ANZA0A3AE6C89994F698BF8,012-345-678,11111111,BP ANZ,97.03,0,1132966.1,DR,REF665140,ANZ,Savings
12-09-2025 09:59,ANZ4C3603BDDF124CDDBC4D,012-345-678,11111111,BP ANZ,18.87,0,1132947.23,DR,REF433840,ANZ,Savings
12-09-2025 10:03,ANZ57EA320E821A4240B331,012-345-678,11111111,KFC ANZ,32.17,0,1132915.06,DR,REF872775,ANZ,Savings
12-09-2025 11:09,ANZD621634B66A24B5CAD0A,012-345-678,11111111,BIGW ANZ,6.89,0,1132908.17,DR,REF423909,ANZ,Savings
12-09-2025 11:52,ANZ3647AEA61F814D7F8F35,012-345-678,11111111,TAFE BOOKSHOP ANZ,6.3,0,1132901.87,DR,REF897232,ANZ,Savings
12-09-2025 12:03,INT76287FB41F364EACA16C,012-345-678,11111111,TRANSFER TO CBA 22222222,555,0,1132346.87,DR,INT-63578,ANZ,Savings
12-09-2025 12:17,ANZ274446AFAF4B4259A1F9,012-345-678,11111111,COMPANY PAYROLL ANZ,0,3817.1,1136163.97,CR,REF456350,ANZ,Savings
12-09-2025 12:18,ANZ1D3EF96C152C44D489F4,012-345-678,11111111,DOMINO'S PIZZA ANZ,23.58,0,1136140.39,DR,REF398723,ANZ,Savings
12-09-2025 12:21,ANZ5E23CC721BC644B9936A,012-345-678,11111111,KFC ANZ,4.31,0,1136136.08,DR,REF613569,ANZ,Savings
12-09-2025 12:36,ANZ25B5D5EE24F448FFA15D,012-345-678,11111111,SHELL ANZ,43.09,0,1136092.99,DR,REF951473,ANZ,Savings
12-09-2025 13:33,ANZ7F725337E09D40F38CB7,012-345-678,11111111,MENULOG ANZ,9.59,0,1136083.4,DR,REF897204,ANZ,Savings
12-09-2025 13:52,ANZ6FCC5068850C4901834A,012-345-678,11111111,CITYLINK ANZ,137.92,0,1135945.48,DR,REF723544,ANZ,Savings
12-09-2025 15:00,ANZ0AF5B06DE12F4A979627,012-345-678,11111111,PAYMENT GATEWAY ANZ,74.41,0,1135871.07,DR,REF985380,ANZ,Savings
12-09-2025 15:04,ANZBF12F6AA24F748A3A68A,012-345-678,11111111,MCDONALDS ANZ,119.88,0,1135751.19,DR,REF684700,ANZ,Savings
12-09-2025 15:19,ANZ5F75D4C380F84FA18BB1,012-345-678,11111111,AMAZON AU ANZ,31.82,0,1135719.37,DR,REF459696,ANZ,Savings
12-09-2025 15:28,INT06CFBE566ECF43748550,012-345-678,11111111,TRANSFER FROM CBA 22222222,0,1158.69,1136878.06,CR,INT-13382,ANZ,Savings
12-09-2025 15:52,ANZ874E4DAF51724B41B46B,012-345-678,11111111,INTERNET TRANSFER ANZ,9.43,0,1136868.63,DR,REF296871,ANZ,Savings
12-09-2025 15:55,ANZ00E3CDD3453640689212,012-345-678,11111111,APPLE ANZ,103.44,0,1136765.19,DR,REF498370,ANZ,Savings
12-09-2025 15:56,ANZE925B7789207472E9D64,012-345-678,11111111,PAY - SALARY ANZ,0,5895.15,1142660.34,CR,REF103165,ANZ,Savings
12-09-2025 15:58,ANZ5A1F13142A16471CA99C,012-345-678,11111111,ZOOM ANZ,43.43,0,1142616.91,DR,REF828643,ANZ,Savings
12-09-2025 16:41,ANZE9E7201FAEFB488F814A,012-345-678,11111111,WOOLWORTHS ANZ,6.2,0,1142610.71,DR,REF443130,ANZ,Savings
12-09-2025 17:05,ANZAD044CB309F847999B5B,012-345-678,11111111,AMAZON AU ANZ,143.2,0,1142467.51,DR,REF735600,ANZ,Savings
12-09-2025 17:26,ANZ6F14A2DA70184521B57D,012-345-678,11111111,WAGES CREDIT ANZ,0,5217.14,1147684.65,CR,REF636111,ANZ,Savings
12-09-2025 17:29,ANZ76325E7E64804D5180CD,012-345-678,11111111,RAILWAY STATION ANZ,8.87,0,1147675.78,DR,REF845074,ANZ,Savings
12-09-2025 17:42,ANZ517DBD4BB13745758694,012-345-678,11111111,WAGES CREDIT ANZ,0,405.08,1148080.86,CR,REF164885,ANZ,Savings
12-09-2025 18:08,ANZ881D29AE4F3340A98DDD,012-345-678,11111111,HARVEY NORMAN ANZ,44.06,0,1148036.8,DR,REF998340,ANZ,Savings
12-09-2025 18:46,ANZ951B97734EB74801992A,012-345-678,11111111,RAILWAY STATION ANZ,46.86,0,1147989.94,DR,REF810459,ANZ,Savings
12-09-2025 18:51,ANZ2D2916E59ADA472F88ED,012-345-678,11111111,BANK FEE ANZ,66.8,0,1147923.14,DR,REF694469,ANZ,Savings
12-09-2025 19:25,ANZ1B646C782A1949AF8D5C,012-345-678,11111111,APPLE ANZ,15.98,0,1147907.16,DR,REF659506,ANZ,Savings
12-09-2025 19:28,ANZ1AC87CB7B8C44E7D95EA,012-345-678,11111111,UBER EATS ANZ,131.75,0,1147775.41,DR,REF939922,ANZ,Savings
12-09-2025 19:39,ANZ94A378DFFD534AFA9A3C,012-345-678,11111111,PAYPAL *NETFLIX ANZ,123.95,0,1147651.46,DR,REF578417,ANZ,Savings
12-09-2025 19:41,ANZ834E3D21B3B045B0AA0E,012-345-678,11111111,RAILWAY STATION ANZ,16.05,0,1147635.41,DR,REF811716,ANZ,Savings
12-09-2025 20:16,ANZE7A8AD45DE4E4945BC9C,012-345-678,11111111,INTERNET TRANSFER ANZ,10.48,0,1147624.93,DR,REF272733,ANZ,Savings
12-09-2025 20:20,ANZ628204F08AA4433DAD2D,012-345-678,11111111,BWS ANZ,7.42,0,1147617.51,DR,REF896991,ANZ,Savings
12-09-2025 20:23,ANZFD4931B9EEFB4B55BA83,012-345-678,11111111,AMAZON AU ANZ,67.54,0,1147549.97,DR,REF225281,ANZ,Savings
12-09-2025 20:26,ANZB84CF58929B54A648E77,012-345-678,11111111,MCDONALDS ANZ,4.73,0,1147545.24,DR,REF307078,ANZ,Savings
12-09-2025 20:31,ANZF51740019E6C449F8D13,012-345-678,11111111,JB HI-FI ANZ,32.88,0,1147512.36,DR,REF181680,ANZ,Savings
12-09-2025 20:35,ANZF7477F18463841A9A3F2,012-345-678,11111111,TAFE BOOKSHOP ANZ,17.35,0,1147495.01,DR,REF753271,ANZ,Savings
12-09-2025 20:37,ANZCD5B59B15D114FC09A5F,012-345-678,11111111,AMAZON AU ANZ,16.87,0,1147478.14,DR,REF576605,ANZ,Savings
12-09-2025 20:41,INT85DCFBFBC3C74F6AAF0C,012-345-678,11111111,TRANSFER TO NAB 44444444,911.67,0,1146566.47,DR,INT-41386,ANZ,Savings
12-09-2025 20:50,ANZ0CD2473281A64C379440,012-345-678,11111111,7-ELEVEN ANZ,32.63,0,1146533.84,DR,REF742788,ANZ,Savings
12-09-2025 20:59,ANZ9480DFDE7AD64CDFAB52,012-345-678,11111111,7-ELEVEN ANZ,52.38,0,1146481.46,DR,REF483834,ANZ,Savings
12-09-2025 21:03,ANZ37EDBA56387641808CFF,012-345-678,11111111,RAILWAY STATION ANZ,7.55,0,1146473.91,DR,REF815035,ANZ,Savings
12-09-2025 21:23,ANZ92BCEF3C500A49F5B903,012-345-678,11111111,CITYLINK ANZ,100.39,0,1146373.52,DR,REF934700,ANZ,Savings
12-09-2025 21:30,ANZBAD87BEDB42B4D4280E1,012-345-678,11111111,SALARY PAYMENT ANZ,0,459.96,1146833.48,CR,REF636884,ANZ,Savings
12-09-2025 22:12,ANZ1467FD2612854A478DBA,012-345-678,11111111,KFC ANZ,174.53,0,1146658.95,DR,REF596812,ANZ,Savings
12-09-2025 22:15,ANZ28279A42F28543378960,012-345-678,11111111,WOOLWORTHS ANZ,154.97,0,1146503.98,DR,REF458692,ANZ,Savings
12-09-2025 22:39,ANZ2D352F371F6D411BBC23,012-345-678,11111111,AMAZON AU ANZ,50.57,0,1146453.41,DR,REF286985,ANZ,Savings
12-09-2025 22:43,ANZ975E9D8E68CA44E48A7B,012-345-678,11111111,KFC ANZ,13.67,0,1146439.74,DR,REF468775,ANZ,Savings
12-09-2025 22:51,ANZ4FFB687A0AFA423EABB8,012-345-678,11111111,AMAZON AU ANZ,12.5,0,1146427.24,DR,REF788570,ANZ,Savings
12-09-2025 23:05,ANZA217370789564ED38557,012-345-678,11111111,BWS ANZ,121.48,0,1146305.76,DR,REF347415,ANZ,Savings
12-09-2025 23:10,ANZF5694D4FE16B4F6D95ED,012-345-678,11111111,SHELL ANZ,13.7,0,1146292.06,DR,REF826366,ANZ,Savings
12-09-2025 23:15,ANZBC22F1BC8B6D4CF8A5ED,012-345-678,11111111,ZOOM ANZ,8.19,0,1146283.87,DR,REF602754,ANZ,Savings
12-09-2025 23:28,ANZC1D07910713D4653ABB1,012-345-678,11111111,PAYMENT GATEWAY ANZ,16.86,0,1146267.01,DR,REF565748,ANZ,Savings
12-09-2025 23:31,ANZEE9FEFB82DF741CCB05F,012-345-678,11111111,INTERNET TRANSFER ANZ,116.64,0,1146150.37,DR,REF275371,ANZ,Savings
12-09-2025 23:36,ANZ885D30B8BBE843409BC0,012-345-678,11111111,KFC ANZ,26.13,0,1146124.24,DR,REF247245,ANZ,Savings
12-09-2025 23:36,ANZ8102C79345D44D57A081,012-345-678,11111111,MENULOG ANZ,57.3,0,1146066.94,DR,REF164515,ANZ,Savings
12-09-2025 23:47,ANZ4C874F390CA24E8DA120,012-345-678,11111111,RAILWAY STATION ANZ,77.26,0,1145989.68,DR,REF448433,ANZ,Savings
13-09-2025 00:20,ANZ24C630710C94492084BE,012-345-678,11111111,COMPANY PAYROLL ANZ,0,2491.5,1148481.18,CR,REF646086,ANZ,Savings
13-09-2025 00:38,ANZ618CCA7703244545B6A4,012-345-678,11111111,FLIXBUS ANZ,66.68,0,1148414.5,DR,REF256341,ANZ,Savings
13-09-2025 00:46,ANZ4494CC38A6F74112A3C1,012-345-678,11111111,WAGES CREDIT ANZ,0,309.15,1148723.65,CR,REF827761,ANZ,Savings
13-09-2025 01:13,ANZ4D6D547734CC4DA4BFC7,012-345-678,11111111,SALARY PAYMENT ANZ,0,135.14,1148858.79,CR,REF499580,ANZ,Savings
13-09-2025 01:17,ANZ001298F46AAD41E28E15,012-345-678,11111111,KFC ANZ,28.55,0,1148830.24,DR,REF848605,ANZ,Savings
13-09-2025 01:42,ANZ18485A51A66044A684A1,012-345-678,11111111,ZOOM ANZ,84.92,0,1148745.32,DR,REF145399,ANZ,Savings
13-09-2025 01:49,ANZDAC82F2560CD404D8343,012-345-678,11111111,STARBUCKS ANZ,177.87,0,1148567.45,DR,REF990719,ANZ,Savings
13-09-2025 01:52,ANZD80E1AD57446421BA026,012-345-678,11111111,SHELL ANZ,29.92,0,1148537.53,DR,REF714588,ANZ,Savings
13-09-2025 01:55,ANZ381AEC05C2BA4B0786FB,012-345-678,11111111,PAY - SALARY ANZ,0,4540.42,1153077.95,CR,REF307382,ANZ,Savings
13-09-2025 02:05,ANZ675A6AB0A14E4C82A86D,012-345-678,11111111,CITYLINK ANZ,69.86,0,1153008.09,DR,REF282263,ANZ,Savings
13-09-2025 02:14,ANZ09B9C01508D14D118C44,012-345-678,11111111,COLES ANZ,31.13,0,1152976.96,DR,REF688826,ANZ,Savings
13-09-2025 02:32,ANZ4460D74A59A949A2B855,012-345-678,11111111,STARBUCKS ANZ,68.88,0,1152908.08,DR,REF798831,ANZ,Savings
13-09-2025 02:57,ANZ02C1F504420D4F2FB834,012-345-678,11111111,CITYLINK ANZ,79.6,0,1152828.48,DR,REF428899,ANZ,Savings
13-09-2025 03:32,ANZ948D42F207B04BF6AC6A,012-345-678,11111111,PAY - SALARY ANZ,0,464.19,1153292.67,CR,REF937913,ANZ,Savings
13-09-2025 03:32,ANZ7F72D31FEACA47AFBD36,012-345-678,11111111,BIGW ANZ,9.32,0,1153283.35,DR,REF187281,ANZ,Savings
13-09-2025 03:39,ANZ16A70ABCEB5343AC916F,012-345-678,11111111,TAFE BOOKSHOP ANZ,34.77,0,1153248.58,DR,REF784440,ANZ,Savings
13-09-2025 03:47,ANZ0144A323871946E087CD,012-345-678,11111111,PAYROLL CREDIT ANZ,0,5685.78,1158934.36,CR,REF920046,ANZ,Savings
13-09-2025 04:09,ANZ19D02D9FBB9045759A76,012-345-678,11111111,TAFE BOOKSHOP ANZ,71.5,0,1158862.86,DR,REF206538,ANZ,Savings
13-09-2025 04:13,ANZ4615E27B0B0E42ECBBC9,012-345-678,11111111,COMPANY PAYROLL ANZ,0,7877.21,1166740.07,CR,REF235482,ANZ,Savings
13-09-2025 04:31,ANZ64E8369E348F4A84A1D1,012-345-678,11111111,PAYPAL *NETFLIX ANZ,3.63,0,1166736.44,DR,REF348371,ANZ,Savings
13-09-2025 04:38,ANZ4E6ACE9E24A74DD39E7D,012-345-678,11111111,BANK FEE ANZ,22.09,0,1166714.35,DR,REF803729,ANZ,Savings
13-09-2025 05:00,ANZ9DD7CEEF3C4E4A32BFE1,012-345-678,11111111,COLES ANZ,138.53,0,1166575.82,DR,REF553390,ANZ,Savings
13-09-2025 05:11,ANZA6BEB3E8B61D4FBFBBBC,012-345-678,11111111,TAFE BOOKSHOP ANZ,92.75,0,1166483.07,DR,REF384479,ANZ,Savings
13-09-2025 05:26,ANZ7571B7CE71404102BD86,012-345-678,11111111,WOOLWORTHS ANZ,30.75,0,1166452.32,DR,REF988552,ANZ,Savings
13-09-2025 06:30,ANZB412CA6FCD594B2986FA,012-345-678,11111111,PAYMENT GATEWAY ANZ,11.33,0,1166440.99,DR,REF145243,ANZ,Savings
13-09-2025 06:51,ANZ5AFDC36991D04740AB5A,012-345-678,11111111,DOMINO'S PIZZA ANZ,142.38,0,1166298.61,DR,REF411664,ANZ,Savings
13-09-2025 07:22,INT526D0476229F4BB8BCE0,012-345-678,11111111,TRANSFER FROM CBA 33333333,0,112.99,1166411.6,CR,INT-69767,ANZ,Savings
13-09-2025 07:47,ANZ0BF781C77B8748518EB9,012-345-678,11111111,PAYPAL *NETFLIX ANZ,37.5,0,1166374.1,DR,REF651879,ANZ,Savings
13-09-2025 08:36,ANZ6A5F4C46144D4EE6842B,012-345-678,11111111,ZOOM ANZ,53.42,0,1166320.68,DR,REF211293,ANZ,Savings
13-09-2025 09:51,ANZ949B917E869342E8BBB3,012-345-678,11111111,RAILWAY STATION ANZ,102.97,0,1166217.71,DR,REF902651,ANZ,Savings
13-09-2025 09:54,ANZB2058859112D498AB334,012-345-678,11111111,KFC ANZ,40.6,0,1166177.11,DR,REF213897,ANZ,Savings
13-09-2025 09:57,ANZ6458041A53384E4B8247,012-345-678,11111111,MCDONALDS ANZ,37.2,0,1166139.91,DR,REF275210,ANZ,Savings
13-09-2025 10:34,ANZ4442FDBA12534C968A84,012-345-678,11111111,UBER EATS ANZ,72.87,0,1166067.04,DR,REF676444,ANZ,Savings
13-09-2025 10:57,ANZ3497224478A44A71A06E,012-345-678,11111111,BIGW ANZ,14.03,0,1166053.01,DR,REF436825,ANZ,Savings
13-09-2025 11:14,ANZ2E62352C8E3247C5AC65,012-345-678,11111111,PAY - SALARY ANZ,0,1674.14,1167727.15,CR,REF571844,ANZ,Savings
13-09-2025 11:16,ANZB44D6B5147BA4AFEB162,012-345-678,11111111,AMAZON AU ANZ,7.82,0,1167719.33,DR,REF981119,ANZ,Savings
13-09-2025 11:23,ANZ69E13EB9628D46E08AAE,012-345-678,11111111,APPLE ANZ,53.42,0,1167665.91,DR,REF442367,ANZ,Savings
13-09-2025 12:04,ANZD50838733C0449839496,012-345-678,11111111,BWS ANZ,163.62,0,1167502.29,DR,REF367016,ANZ,Savings
13-09-2025 12:47,ANZC9020E10A94E4A2E95D1,012-345-678,11111111,BANK FEE ANZ,69.22,0,1167433.07,DR,REF336373,ANZ,Savings
13-09-2025 12:59,ANZE4789628C417459A8422,012-345-678,11111111,RAILWAY STATION ANZ,71.77,0,1167361.3,DR,REF636028,ANZ,Savings
13-09-2025 13:14,ANZEB2BA882FE1148D9A26B,012-345-678,11111111,ZOOM ANZ,110.4,0,1167250.9,DR,REF552449,ANZ,Savings
13-09-2025 13:54,ANZ7B375182345D4CE99BD9,012-345-678,11111111,BWS ANZ,73.22,0,1167177.68,DR,REF183945,ANZ,Savings
13-09-2025 14:05,ANZFFC24E48FC154932A0A9,012-345-678,11111111,AMAZON AU ANZ,5.31,0,1167172.37,DR,REF786758,ANZ,Savings
13-09-2025 14:32,ANZ58877E8A7FB240429FB1,012-345-678,11111111,DOMINO'S PIZZA ANZ,10.94,0,1167161.43,DR,REF636074,ANZ,Savings
13-09-2025 14:39,ANZ1908FBF6F30646BE9CD2,012-345-678,11111111,HARVEY NORMAN ANZ,5.49,0,1167155.94,DR,REF695484,ANZ,Savings
13-09-2025 14:41,ANZ441FD4FA1E084E6F8A3D,012-345-678,11111111,SALARY PAYMENT ANZ,0,7278.96,1174434.9,CR,REF558337,ANZ,Savings
13-09-2025 14:58,ANZ1E21254FB52C4EB7954E,012-345-678,11111111,7-ELEVEN ANZ,50.76,0,1174384.14,DR,REF386659,ANZ,Savings
13-09-2025 15:56,ANZBEE1F6714C444F42B7BF,012-345-678,11111111,MCDONALDS ANZ,26.94,0,1174357.2,DR,REF629071,ANZ,Savings
13-09-2025 16:32,ANZ147205DE9E6F4D71B9B3,012-345-678,11111111,PAYPAL *NETFLIX ANZ,49.81,0,1174307.39,DR,REF415512,ANZ,Savings
13-09-2025 16:34,ANZ1F6EE8A7A60548C29A7B,012-345-678,11111111,APPLE ANZ,24.38,0,1174283.01,DR,REF799081,ANZ,Savings
13-09-2025 16:58,ANZ590DD1161893437EAEAE,012-345-678,11111111,HARVEY NORMAN ANZ,79.68,0,1174203.33,DR,REF411001,ANZ,Savings
13-09-2025 17:15,ANZ1E32EB6A4B224AA3B210,012-345-678,11111111,MCDONALDS ANZ,44.09,0,1174159.24,DR,REF510644,ANZ,Savings
13-09-2025 17:18,ANZ2BCDE55CDF4D4F03A818,012-345-678,11111111,WOOLWORTHS ANZ,26.66,0,1174132.58,DR,REF333141,ANZ,Savings
13-09-2025 17:25,ANZACDEDB25E29C4948B459,012-345-678,11111111,KFC ANZ,64.5,0,1174068.08,DR,REF801068,ANZ,Savings
13-09-2025 17:27,ANZ3F2E20724B5440698E3A,012-345-678,11111111,BWS ANZ,143.14,0,1173924.94,DR,REF725257,ANZ,Savings
13-09-2025 17:57,ANZ302BE0C9B6804AD4BB0C,012-345-678,11111111,AMAZON AU ANZ,2.69,0,1173922.25,DR,REF319693,ANZ,Savings
13-09-2025 18:37,ANZF794AB64A18840B4A5E4,012-345-678,11111111,INTERNET TRANSFER ANZ,286.15,0,1173636.1,DR,REF568185,ANZ,Savings
13-09-2025 18:50,ANZD579181BC74249A0A0E2,012-345-678,11111111,SHELL ANZ,29.93,0,1173606.17,DR,REF212483,ANZ,Savings
13-09-2025 18:59,ANZ910DD7A849F746598231,012-345-678,11111111,UBER EATS ANZ,15.14,0,1173591.03,DR,REF544992,ANZ,Savings
13-09-2025 19:53,INT25BC89A153134E379D32,012-345-678,11111111,TRANSFER FROM NAB 44444444,0,972.85,1174563.88,CR,INT-10969,ANZ,Savings
13-09-2025 19:59,INTD5FAA8437EDE4F04AC27,012-345-678,11111111,TRANSFER TO CBA 22222222,399.37,0,1174164.51,DR,INT-82824,ANZ,Savings
13-09-2025 20:21,ANZB32AC9B6638C44A98715,012-345-678,11111111,MENULOG ANZ,180.27,0,1173984.24,DR,REF143415,ANZ,Savings
13-09-2025 20:58,ANZ3FFA29DA1BEF45F48E8B,012-345-678,11111111,COLES ANZ,70.76,0,1173913.48,DR,REF613640,ANZ,Savings
13-09-2025 21:07,ANZ7A2728202DF14850A8A3,012-345-678,11111111,STARBUCKS ANZ,91.54,0,1173821.94,DR,REF954855,ANZ,Savings
13-09-2025 21:16,ANZ380A8572FA5B42B7951E,012-345-678,11111111,ZOOM ANZ,119.12,0,1173702.82,DR,REF551581,ANZ,Savings
13-09-2025 21:32,ANZ2413A96C182347299BD8,012-345-678,11111111,AMAZON AU ANZ,15.76,0,1173687.06,DR,REF983742,ANZ,Savings
13-09-2025 21:44,ANZ7D6F8E5529DF40B8A5F7,012-345-678,11111111,MCDONALDS ANZ,131.08,0,1173555.98,DR,REF433127,ANZ,Savings
13-09-2025 22:11,ANZDAC90E962EAF4153BE58,012-345-678,11111111,APPLE ANZ,32.07,0,1173523.91,DR,REF283467,ANZ,Savings
13-09-2025 22:24,ANZ1B34CFC320E54BEEA70B,012-345-678,11111111,PAYMENT GATEWAY ANZ,7.27,0,1173516.64,DR,REF704160,ANZ,Savings
13-09-2025 22:27,ANZ7B7BC9C5105F4819B7D9,012-345-678,11111111,PAY - SALARY ANZ,0,4832.58,1178349.22,CR,REF401402,ANZ,Savings
13-09-2025 22:27,ANZ10DD4AFB87714EE899AA,012-345-678,11111111,CITYLINK ANZ,78.57,0,1178270.65,DR,REF982997,ANZ,Savings
13-09-2025 22:52,ANZ95F4C7D347384E2BA03E,012-345-678,11111111,UBER EATS ANZ,50.84,0,1178219.81,DR,REF445122,ANZ,Savings
13-09-2025 23:13,ANZ60CD5843B9FA4809B6CE,012-345-678,11111111,STARBUCKS ANZ,11.53,0,1178208.28,DR,REF988751,ANZ,Savings
13-09-2025 23:25,ANZFD4E92A3E6D9494AB9C6,012-345-678,11111111,INTERNET TRANSFER ANZ,7.87,0,1178200.41,DR,REF832480,ANZ,Savings
13-09-2025 23:42,ANZ03BCEAA0B18547F68584,012-345-678,11111111,JB HI-FI ANZ,13.11,0,1178187.3,DR,REF892637,ANZ,Savings
13-09-2025 23:58,ANZ29CD3F29BAB24FD78439,012-345-678,11111111,SPOTIFY ANZ,51.62,0,1178135.68,DR,REF573619,ANZ,Savings
14-09-2025 00:01,ANZ84B52A5BC963463EA056,012-345-678,11111111,PAYROLL CREDIT ANZ,0,3262.33,1181398.01,CR,REF114310,ANZ,Savings
14-09-2025 00:21,ANZ702FBADBB4EC4415B8A1,012-345-678,11111111,BP ANZ,5.77,0,1181392.24,DR,REF672766,ANZ,Savings
14-09-2025 00:31,ANZ8D40015FA5954995A16E,012-345-678,11111111,MENULOG ANZ,53.78,0,1181338.46,DR,REF770547,ANZ,Savings
14-09-2025 00:39,ANZ04ED73CF5E07454286CE,012-345-678,11111111,BP ANZ,45.69,0,1181292.77,DR,REF365141,ANZ,Savings
14-09-2025 00:39,ANZB44646CD2C494678A950,012-345-678,11111111,LIQUORLAND ANZ,81.39,0,1181211.38,DR,REF847975,ANZ,Savings
14-09-2025 00:44,INT1D72CFA432244C289119,012-345-678,11111111,TRANSFER FROM NAB 44444444,0,1806.28,1183017.66,CR,INT-53404,ANZ,Savings
14-09-2025 01:00,ANZB06FB62ACFCB4A94870C,012-345-678,11111111,COMPANY PAYROLL ANZ,0,637.49,1183655.15,CR,REF662099,ANZ,Savings
14-09-2025 01:06,ANZ9C58F58033684843A57D,012-345-678,11111111,BWS ANZ,113.41,0,1183541.74,DR,REF857861,ANZ,Savings
14-09-2025 01:23,ANZ6F3EEBA8DD5B4B379563,012-345-678,11111111,PAYROLL CREDIT ANZ,0,1139.23,1184680.97,CR,REF110639,ANZ,Savings
14-09-2025 02:00,ANZ6470C3DA76974029A047,012-345-678,11111111,MCDONALDS ANZ,228.75,0,1184452.22,DR,REF833118,ANZ,Savings
14-09-2025 03:07,INTEF30719D66434DF0A7FB,012-345-678,11111111,TRANSFER TO CBA 33333333,1724.65,0,1182727.57,DR,INT-97098,ANZ,Savings
14-09-2025 03:12,ANZD25FD39C943C49208F49,012-345-678,11111111,MCDONALDS ANZ,2.99,0,1182724.58,DR,REF217075,ANZ,Savings
14-09-2025 03:24,INT49CB010172C54A9186BF,012-345-678,11111111,TRANSFER TO CBA 22222222,956.67,0,1181767.91,DR,INT-40190,ANZ,Savings
14-09-2025 04:06,ANZA0EF2D23DB8F4497A6AC,012-345-678,11111111,WOOLWORTHS ANZ,60.23,0,1181707.68,DR,REF378401,ANZ,Savings
14-09-2025 04:11,ANZ519831E6BF98432EB799,012-345-678,11111111,HARVEY NORMAN ANZ,18.51,0,1181689.17,DR,REF424577,ANZ,Savings
14-09-2025 04:19,ANZ029B3B289F0D4FA1A417,012-345-678,11111111,CITYLINK ANZ,59.13,0,1181630.04,DR,REF369323,ANZ,Savings
14-09-2025 04:45,ANZA53A455B27C0485295D1,012-345-678,11111111,COLES ANZ,1.48,0,1181628.56,DR,REF277131,ANZ,Savings
14-09-2025 06:08,ANZ0533529C5CFE4B10897A,012-345-678,11111111,ZOOM ANZ,113.52,0,1181515.04,DR,REF513075,ANZ,Savings
14-09-2025 06:28,ANZD1AFF861ABF44A09B71C,012-345-678,11111111,MENULOG ANZ,71.75,0,1181443.29,DR,REF172801,ANZ,Savings
14-09-2025 06:41,ANZ766006AFA08349159AA2,012-345-678,11111111,WAGES CREDIT ANZ,0,5475.36,1186918.65,CR,REF960613,ANZ,Savings
14-09-2025 06:47,ANZC89E620FDB6F4012B931,012-345-678,11111111,PAYPAL *NETFLIX ANZ,148.29,0,1186770.36,DR,REF320749,ANZ,Savings
14-09-2025 07:10,ANZF1F3211E2269403EAD7D,012-345-678,11111111,BP ANZ,26.27,0,1186744.09,DR,REF649079,ANZ,Savings
14-09-2025 07:21,INT6F61C779A2C2459B847D,012-345-678,11111111,TRANSFER FROM NAB 44444444,0,326.54,1187070.63,CR,INT-82785,ANZ,Savings
14-09-2025 07:22,ANZE18B417F13C14ADEBE09,012-345-678,11111111,HARVEY NORMAN ANZ,10.79,0,1187059.84,DR,REF995597,ANZ,Savings
14-09-2025 07:31,ANZ806BD94A24284CCEB2CD,012-345-678,11111111,HARVEY NORMAN ANZ,73.53,0,1186986.31,DR,REF913061,ANZ,Savings
14-09-2025 08:07,ANZF596C82827274041B45A,012-345-678,11111111,APPLE ANZ,66.74,0,1186919.57,DR,REF402551,ANZ,Savings
14-09-2025 08:10,ANZBCF4DBBF7EFF41FEBEA5,012-345-678,11111111,BP ANZ,26.87,0,1186892.7,DR,REF232616,ANZ,Savings
14-09-2025 08:12,ANZC5A0305ED13042E4A224,012-345-678,11111111,ALDI ANZ,13.69,0,1186879.01,DR,REF763557,ANZ,Savings
14-09-2025 08:57,ANZ9EAC8E6F5F264F9FBE35,012-345-678,11111111,ALDI ANZ,44.36,0,1186834.65,DR,REF962724,ANZ,Savings
14-09-2025 09:02,ANZ0BA95F7060674433B425,012-345-678,11111111,AMAZON AU ANZ,12.11,0,1186822.54,DR,REF110962,ANZ,Savings
14-09-2025 09:15,ANZ23FCE9E92CFE4B5EBEFC,012-345-678,11111111,STARBUCKS ANZ,85.95,0,1186736.59,DR,REF712780,ANZ,Savings
14-09-2025 09:29,ANZ16F486A75DBC4317BE29,012-345-678,11111111,PAYMENT GATEWAY ANZ,83.28,0,1186653.31,DR,REF414462,ANZ,Savings
14-09-2025 09:39,ANZD64E10A0E00B47A2953E,012-345-678,11111111,PAYMENT GATEWAY ANZ,4.02,0,1186649.29,DR,REF269704,ANZ,Savings
14-09-2025 09:56,ANZ84980B92A8044262A369,012-345-678,11111111,BIGW ANZ,35.34,0,1186613.95,DR,REF184394,ANZ,Savings
14-09-2025 10:28,ANZ9CBB465308514B7091AF,012-345-678,11111111,COLES ANZ,267.97,0,1186345.98,DR,REF331444,ANZ,Savings
14-09-2025 10:30,ANZ09BB8B9DE11B4AA68F2A,012-345-678,11111111,TAFE BOOKSHOP ANZ,75.37,0,1186270.61,DR,REF231289,ANZ,Savings
14-09-2025 10:48,ANZ08FC78D3594E492F96C2,012-345-678,11111111,BANK FEE ANZ,50.18,0,1186220.43,DR,REF696075,ANZ,Savings
14-09-2025 10:48,ANZ3237B5F7ACE94579AE80,012-345-678,11111111,PAY - SALARY ANZ,0,2816.17,1189036.6,CR,REF167973,ANZ,Savings
14-09-2025 10:58,ANZ73BCAB02112E4E74B3DB,012-345-678,11111111,WOOLWORTHS ANZ,186.13,0,1188850.47,DR,REF137711,ANZ,Savings
14-09-2025 11:12,ANZ217E1FEB43134C0FB137,012-345-678,11111111,PAYPAL *NETFLIX ANZ,117.31,0,1188733.16,DR,REF876489,ANZ,Savings
14-09-2025 11:35,ANZ1351EFF271904C5485B1,012-345-678,11111111,ALDI ANZ,31.92,0,1188701.24,DR,REF176975,ANZ,Savings
14-09-2025 11:58,ANZ4A65CD9428A54BF798FD,012-345-678,11111111,WOOLWORTHS ANZ,31.12,0,1188670.12,DR,REF414682,ANZ,Savings
14-09-2025 12:11,ANZ0AE734A9A04D409BAD9A,012-345-678,11111111,RAILWAY STATION ANZ,17.14,0,1188652.98,DR,REF595438,ANZ,Savings
14-09-2025 12:21,ANZF5E28B5D52894EEAB03B,012-345-678,11111111,STARBUCKS ANZ,46.03,0,1188606.95,DR,REF365901,ANZ,Savings
14-09-2025 12:36,ANZA67384FD97BB4B138A17,012-345-678,11111111,TAFE BOOKSHOP ANZ,43.72,0,1188563.23,DR,REF628932,ANZ,Savings
14-09-2025 12:37,INT69EB674EDF0B4F838445,012-345-678,11111111,TRANSFER FROM NAB 44444444,0,1677.15,1190240.38,CR,INT-63331,ANZ,Savings
14-09-2025 12:37,ANZ0981F789742E48038E65,012-345-678,11111111,INTERNET TRANSFER ANZ,66.32,0,1190174.06,DR,REF950348,ANZ,Savings
14-09-2025 12:55,ANZ1A9E4EC2D32E48378EE0,012-345-678,11111111,BIGW ANZ,94.55,0,1190079.51,DR,REF295702,ANZ,Savings
14-09-2025 14:12,ANZF7DE4B2CC9AD4C9D84B5,012-345-678,11111111,MENULOG ANZ,40.49,0,1190039.02,DR,REF992717,ANZ,Savings
14-09-2025 14:18,ANZ663DB125DA804B92BF2F,012-345-678,11111111,MENULOG ANZ,56.75,0,1189982.27,DR,REF401518,ANZ,Savings
14-09-2025 14:25,ANZ9B7AB1D8A82048478F14,012-345-678,11111111,BWS ANZ,44.91,0,1189937.36,DR,REF594027,ANZ,Savings
14-09-2025 14:26,ANZ445A7B977FF24F8B9267,012-345-678,11111111,BIGW ANZ,34.51,0,1189902.85,DR,REF959789,ANZ,Savings
14-09-2025 14:34,ANZF66F7140630E4E67952F,012-345-678,11111111,JB HI-FI ANZ,17.41,0,1189885.44,DR,REF937847,ANZ,Savings
14-09-2025 14:43,ANZ6426C1C952824C7EAE28,012-345-678,11111111,INTERNET TRANSFER ANZ,25.33,0,1189860.11,DR,REF969537,ANZ,Savings
14-09-2025 14:46,ANZF7F9295B1D0C40AC9BE1,012-345-678,11111111,KFC ANZ,12.87,0,1189847.24,DR,REF232980,ANZ,Savings
14-09-2025 14:48,ANZB8065023C4A84F3EB8D4,012-345-678,11111111,STARBUCKS ANZ,12.1,0,1189835.14,DR,REF867295,ANZ,Savings
14-09-2025 14:59,ANZ80A7FDEE3E8D4F63AE2C,012-345-678,11111111,APPLE ANZ,136.41,0,1189698.73,DR,REF341185,ANZ,Savings
14-09-2025 15:11,ANZ8778E4897A664994B4A8,012-345-678,11111111,TAFE BOOKSHOP ANZ,18.73,0,1189680,DR,REF822736,ANZ,Savings
14-09-2025 15:12,ANZE3EE410DB31B4554A6B0,012-345-678,11111111,MCDONALDS ANZ,131.78,0,1189548.22,DR,REF276889,ANZ,Savings
14-09-2025 15:22,ANZ047CF9C3F4964A31AC6C,012-345-678,11111111,BANK FEE ANZ,31.49,0,1189516.73,DR,REF144963,ANZ,Savings
14-09-2025 15:27,ANZ26008947AAD04B36B6FE,012-345-678,11111111,BANK FEE ANZ,22.1,0,1189494.63,DR,REF401550,ANZ,Savings
14-09-2025 15:39,ANZ72C947E34D34485EB730,012-345-678,11111111,APPLE ANZ,30.67,0,1189463.96,DR,REF882283,ANZ,Savings
14-09-2025 15:39,ANZDA1CB4C1BCFD4FCDBCBB,012-345-678,11111111,JB HI-FI ANZ,19.18,0,1189444.78,DR,REF684077,ANZ,Savings
14-09-2025 15:43,ANZ6A1BBE72E11240B5B64B,012-345-678,11111111,COMPANY PAYROLL ANZ,0,7600.31,1197045.09,CR,REF535952,ANZ,Savings
14-09-2025 15:59,ANZE5379D0595EB4B1D8B6C,012-345-678,11111111,KFC ANZ,34.72,0,1197010.37,DR,REF169201,ANZ,Savings
14-09-2025 16:04,ANZE53B94608F714188A0C2,012-345-678,11111111,SALARY PAYMENT ANZ,0,7939.22,1204949.59,CR,REF455181,ANZ,Savings
14-09-2025 16:07,INTDC5807C77BF641348892,012-345-678,11111111,TRANSFER TO NAB 44444444,1995.88,0,1202953.71,DR,INT-76222,ANZ,Savings
14-09-2025 16:14,ANZB77C29743911482EB99F,012-345-678,11111111,PAYPAL *NETFLIX ANZ,88.39,0,1202865.32,DR,REF235898,ANZ,Savings
14-09-2025 16:38,INT64F34059242B46FEB179,012-345-678,11111111,TRANSFER FROM CBA 22222222,0,493.55,1203358.87,CR,INT-12960,ANZ,Savings
14-09-2025 17:12,ANZBCA8B40C711F4434B467,012-345-678,11111111,INTERNET TRANSFER ANZ,8.09,0,1203350.78,DR,REF388571,ANZ,Savings
14-09-2025 17:18,ANZ0035B0F6CE504B02A8ED,012-345-678,11111111,DOMINO'S PIZZA ANZ,32.48,0,1203318.3,DR,REF625876,ANZ,Savings
14-09-2025 17:38,ANZ879EF22B2B2F4B3A99C2,012-345-678,11111111,ALDI ANZ,51.23,0,1203267.07,DR,REF155385,ANZ,Savings
14-09-2025 17:59,ANZ8F73F8DFBE6E4591A72B,012-345-678,11111111,BANK FEE ANZ,1.87,0,1203265.2,DR,REF447113,ANZ,Savings
14-09-2025 18:04,ANZDEEBBF8EF0E040E7B65D,012-345-678,11111111,PAYPAL *NETFLIX ANZ,13.75,0,1203251.45,DR,REF983195,ANZ,Savings
14-09-2025 18:18,INTA27E35F8EC074C84A676,012-345-678,11111111,TRANSFER FROM CBA 33333333,0,1332.51,1204583.96,CR,INT-60869,ANZ,Savings
14-09-2025 18:33,ANZE6E1108B4B444E1E9536,012-345-678,11111111,LIQUORLAND ANZ,114.17,0,1204469.79,DR,REF198550,ANZ,Savings
14-09-2025 18:41,ANZ909F59B9ABC9432FB8CE,012-345-678,11111111,WAGES CREDIT ANZ,0,6876.85,1211346.64,CR,REF645324,ANZ,Savings
14-09-2025 19:14,ANZ18E21FDEC2584A9DA731,012-345-678,11111111,INTERNET TRANSFER ANZ,14.23,0,1211332.41,DR,REF225119,ANZ,Savings
14-09-2025 19:24,ANZFB53E264B7B846979E11,012-345-678,11111111,RAILWAY STATION ANZ,44.17,0,1211288.24,DR,REF889339,ANZ,Savings
14-09-2025 19:26,ANZF292EE264B324FB5B94C,012-345-678,11111111,PAYROLL CREDIT ANZ,0,38.33,1211326.57,CR,REF174838,ANZ,Savings
14-09-2025 19:44,ANZACEEB4D9DE0D4C678D45,012-345-678,11111111,ZOOM ANZ,60.7,0,1211265.87,DR,REF725133,ANZ,Savings
14-09-2025 19:46,ANZ1A881C7886764E59BF38,012-345-678,11111111,LIQUORLAND ANZ,45.3,0,1211220.57,DR,REF796831,ANZ,Savings
14-09-2025 19:53,ANZ4B2994C817F941EC902C,012-345-678,11111111,AMAZON AU ANZ,274.95,0,1210945.62,DR,REF390961,ANZ,Savings
14-09-2025 19:54,ANZF35C01AE7BE2475E8295,012-345-678,11111111,SPOTIFY ANZ,71.54,0,1210874.08,DR,REF357957,ANZ,Savings
14-09-2025 19:56,ANZ78C48A7DA8BC4E308A11,012-345-678,11111111,CITYLINK ANZ,16.52,0,1210857.56,DR,REF998305,ANZ,Savings
14-09-2025 20:04,ANZ987696B4333640429792,012-345-678,11111111,AMAZON AU ANZ,73.2,0,1210784.36,DR,REF210408,ANZ,Savings
14-09-2025 20:20,ANZ308AE9F997214E588A5C,012-345-678,11111111,BWS ANZ,39.07,0,1210745.29,DR,REF642919,ANZ,Savings
14-09-2025 20:40,ANZF75D75A701094946A31D,012-345-678,11111111,PAYMENT GATEWAY ANZ,19.74,0,1210725.55,DR,REF763650,ANZ,Savings
14-09-2025 20:52,ANZ444DAB765A694C9D8A58,012-345-678,11111111,BP ANZ,36.85,0,1210688.7,DR,REF864263,ANZ,Savings
14-09-2025 20:56,ANZ73486083E44C42C69996,012-345-678,11111111,PAYMENT GATEWAY ANZ,102.77,0,1210585.93,DR,REF207718,ANZ,Savings
14-09-2025 21:00,ANZDC60422B4EE54DFBACBF,012-345-678,11111111,TAFE BOOKSHOP ANZ,61.18,0,1210524.75,DR,REF733166,ANZ,Savings
14-09-2025 21:01,ANZ2A4F741A03C74E32A23B,012-345-678,11111111,WOOLWORTHS ANZ,71.22,0,1210453.53,DR,REF514450,ANZ,Savings
14-09-2025 22:15,ANZAB9BC10838BA41998097,012-345-678,11111111,COLES ANZ,172.83,0,1210280.7,DR,REF378094,ANZ,Savings
14-09-2025 22:35,INTBBBA129C41BA4E03AF28,012-345-678,11111111,TRANSFER TO CBA 33333333,1868.12,0,1208412.58,DR,INT-26134,ANZ,Savings
14-09-2025 22:50,ANZE62EC3F498454602BAB0,012-345-678,11111111,SHELL ANZ,79.83,0,1208332.75,DR,REF151429,ANZ,Savings
14-09-2025 22:51,ANZ115B8EE654B246A5851F,012-345-678,11111111,PAYMENT GATEWAY ANZ,106.51,0,1208226.24,DR,REF358251,ANZ,Savings
14-09-2025 23:18,ANZ914869F6D8F94CB797BF,012-345-678,11111111,UBER EATS ANZ,102.33,0,1208123.91,DR,REF120793,ANZ,Savings
14-09-2025 23:39,ANZD763C2B5CCC945C89E4B,012-345-678,11111111,INTERNET TRANSFER ANZ,16.19,0,1208107.72,DR,REF502234,ANZ,Savings
15-09-2025 00:08,ANZEFED179788DE4CE883C4,012-345-678,11111111,UBER EATS ANZ,46.51,0,1208061.21,DR,REF800484,ANZ,Savings
15-09-2025 01:26,ANZ832AB38F30EE4A048728,012-345-678,11111111,SALARY PAYMENT ANZ,0,7762.3,1215823.51,CR,REF606936,ANZ,Savings
15-09-2025 01:40,ANZ21654BBD63DC4006B321,012-345-678,11111111,PAYROLL CREDIT ANZ,0,145.32,1215968.83,CR,REF612035,ANZ,Savings
15-09-2025 02:11,ANZ209906AC06554218B2D3,012-345-678,11111111,PAYPAL *NETFLIX ANZ,71.11,0,1215897.72,DR,REF387592,ANZ,Savings
15-09-2025 02:25,ANZF2A1F1C3E84D42F68118,012-345-678,11111111,AMAZON AU ANZ,19.58,0,1215878.14,DR,REF413530,ANZ,Savings
15-09-2025 03:24,ANZEEB3ADBF70434244BE10,012-345-678,11111111,CITYLINK ANZ,25.12,0,1215853.02,DR,REF536775,ANZ,Savings
15-09-2025 03:24,ANZB452D7D6D9B148FEA326,012-345-678,11111111,7-ELEVEN ANZ,17.23,0,1215835.79,DR,REF594322,ANZ,Savings
15-09-2025 03:35,ANZ5C8BDCE0E0CA481A9D5D,012-345-678,11111111,INTERNET TRANSFER ANZ,4.11,0,1215831.68,DR,REF825569,ANZ,Savings
15-09-2025 03:45,ANZ233CA5F7AC864718B57E,012-345-678,11111111,CITYLINK ANZ,198.84,0,1215632.84,DR,REF652208,ANZ,Savings
15-09-2025 04:01,ANZC557CEC5F50543F085B6,012-345-678,11111111,TAFE BOOKSHOP ANZ,150.3,0,1215482.54,DR,REF354805,ANZ,Savings
15-09-2025 04:21,ANZD400DA54BB2D4C0387EF,012-345-678,11111111,INTERNET TRANSFER ANZ,35.83,0,1215446.71,DR,REF560730,ANZ,Savings
15-09-2025 04:46,ANZ73FE0AEAE11B456FB605,012-345-678,11111111,STARBUCKS ANZ,31.68,0,1215415.03,DR,REF428502,ANZ,Savings
15-09-2025 04:54,ANZ1E14C867C43E4AE48422,012-345-678,11111111,MCDONALDS ANZ,83.03,0,1215332,DR,REF919568,ANZ,Savings
15-09-2025 06:40,ANZ3F377A33AF9543EAB8A1,012-345-678,11111111,SPOTIFY ANZ,4.63,0,1215327.37,DR,REF183279,ANZ,Savings
15-09-2025 06:41,ANZ8E0ACE2D4955455783F6,012-345-678,11111111,WOOLWORTHS ANZ,14.16,0,1215313.21,DR,REF253061,ANZ,Savings
15-09-2025 07:02,ANZE4F78019F405407BABC1,012-345-678,11111111,BP ANZ,74.63,0,1215238.58,DR,REF794252,ANZ,Savings
15-09-2025 07:08,ANZ2F382AE997E4449CA575,012-345-678,11111111,MENULOG ANZ,141.33,0,1215097.25,DR,REF207047,ANZ,Savings
15-09-2025 07:17,ANZ3439CFE73E894EE48B89,012-345-678,11111111,BANK FEE ANZ,17.5,0,1215079.75,DR,REF195907,ANZ,Savings
15-09-2025 07:55,ANZD50FFF180BF14F988291,012-345-678,11111111,SALARY PAYMENT ANZ,0,82.12,1215161.87,CR,REF258648,ANZ,Savings
15-09-2025 08:02,ANZ1D195A9386E04777985A,012-345-678,11111111,APPLE ANZ,83.26,0,1215078.61,DR,REF584234,ANZ,Savings
15-09-2025 08:04,INT83F974E23495422C9AAE,012-345-678,11111111,TRANSFER FROM CBA 33333333,0,1347.79,1216426.4,CR,INT-40113,ANZ,Savings
15-09-2025 08:13,ANZFA64FD31C75D4CE3B27A,012-345-678,11111111,AMAZON AU ANZ,24.38,0,1216402.02,DR,REF402743,ANZ,Savings
15-09-2025 08:17,ANZ1895C46707C64B85BEB6,012-345-678,11111111,ZOOM ANZ,43.39,0,1216358.63,DR,REF898510,ANZ,Savings
15-09-2025 08:24,ANZ969CA54991374947BD10,012-345-678,11111111,APPLE ANZ,45.39,0,1216313.24,DR,REF340721,ANZ,Savings
15-09-2025 08:36,ANZ045206649AC5498FA0BD,012-345-678,11111111,BWS ANZ,87.63,0,1216225.61,DR,REF876654,ANZ,Savings
15-09-2025 08:51,ANZ83EE8513EC314612BC75,012-345-678,11111111,TAFE BOOKSHOP ANZ,59.12,0,1216166.49,DR,REF536188,ANZ,Savings
15-09-2025 08:55,ANZF91BF016995A4A0D8B10,012-345-678,11111111,INTERNET TRANSFER ANZ,32.76,0,1216133.73,DR,REF394500,ANZ,Savings
15-09-2025 09:00,ANZCB2A293384AC4C45B6B1,012-345-678,11111111,PAYROLL CREDIT ANZ,0,5158.37,1221292.1,CR,REF713710,ANZ,Savings
15-09-2025 09:05,ANZ4BD53D7A63014DE085CA,012-345-678,11111111,RAILWAY STATION ANZ,100.63,0,1221191.47,DR,REF255323,ANZ,Savings
15-09-2025 09:25,ANZ37963D413067455E90FD,012-345-678,11111111,APPLE ANZ,10.75,0,1221180.72,DR,REF116437,ANZ,Savings
15-09-2025 10:06,ANZDC13F1DCF077401EB06C,012-345-678,11111111,WAGES CREDIT ANZ,0,4394.53,1225575.25,CR,REF870739,ANZ,Savings
15-09-2025 10:12,ANZ1CE5023FD66D4E8C9EF0,012-345-678,11111111,CITYLINK ANZ,34.49,0,1225540.76,DR,REF964186,ANZ,Savings
15-09-2025 10:23,ANZ633C41773C2741C18CA9,012-345-678,11111111,STARBUCKS ANZ,65.17,0,1225475.59,DR,REF375374,ANZ,Savings
15-09-2025 10:33,ANZ6E25FD7B92B0461A8C26,012-345-678,11111111,SHELL ANZ,67.63,0,1225407.96,DR,REF739173,ANZ,Savings
15-09-2025 10:37,ANZF8989B6E4A864D9BB513,012-345-678,11111111,BWS ANZ,5.5,0,1225402.46,DR,REF827823,ANZ,Savings
15-09-2025 10:44,ANZ1BACEAED9C0A475DB313,012-345-678,11111111,DOMINO'S PIZZA ANZ,38.03,0,1225364.43,DR,REF223460,ANZ,Savings
15-09-2025 11:44,ANZ529D6EF90F4C4C028809,012-345-678,11111111,PAY - SALARY ANZ,0,967.92,1226332.35,CR,REF219966,ANZ,Savings
15-09-2025 11:49,ANZ4BBF2F2788D6454F8A55,012-345-678,11111111,MCDONALDS ANZ,50.97,0,1226281.38,DR,REF560557,ANZ,Savings
15-09-2025 12:06,INT39E3A4D96F16491ABC91,012-345-678,11111111,TRANSFER FROM CBA 22222222,0,1711.14,1227992.52,CR,INT-23993,ANZ,Savings
15-09-2025 12:26,ANZ13517D9E4B4A4579B6CD,012-345-678,11111111,SPOTIFY ANZ,53.45,0,1227939.07,DR,REF418479,ANZ,Savings
15-09-2025 13:15,ANZ0DEB9C56B4AE4A318F80,012-345-678,11111111,COLES ANZ,59.89,0,1227879.18,DR,REF222203,ANZ,Savings
15-09-2025 13:32,ANZDC86C617A2BE40EC837D,012-345-678,11111111,MCDONALDS ANZ,131.17,0,1227748.01,DR,REF938830,ANZ,Savings
15-09-2025 13:35,ANZE69D14DE90534F0EB8E4,012-345-678,11111111,BIGW ANZ,27.01,0,1227721,DR,REF265959,ANZ,Savings
15-09-2025 15:10,INT7E52AF2FE29F42A09EA5,012-345-678,11111111,TRANSFER FROM CBA 33333333,0,918.61,1228639.61,CR,INT-62501,ANZ,Savings
15-09-2025 15:30,ANZ45770D9B9FE94595B042,012-345-678,11111111,HARVEY NORMAN ANZ,16.64,0,1228622.97,DR,REF778594,ANZ,Savings
15-09-2025 16:00,ANZ6398747B733A442AAA2C,012-345-678,11111111,BWS ANZ,68.37,0,1228554.6,DR,REF108636,ANZ,Savings
15-09-2025 16:25,ANZ78328650FC6E432C92F6,012-345-678,11111111,FLIXBUS ANZ,68.18,0,1228486.42,DR,REF266280,ANZ,Savings
15-09-2025 16:43,ANZ757C96872D404673937E,012-345-678,11111111,DOMINO'S PIZZA ANZ,63.67,0,1228422.75,DR,REF499355,ANZ,Savings
15-09-2025 16:54,ANZC9314B15855244048312,012-345-678,11111111,STARBUCKS ANZ,28.24,0,1228394.51,DR,REF398708,ANZ,Savings
15-09-2025 17:04,ANZ69717BE4E49C4181BE44,012-345-678,11111111,UBER EATS ANZ,97.65,0,1228296.86,DR,REF255518,ANZ,Savings
15-09-2025 17:36,ANZFAC117DD75B14B04A424,012-345-678,11111111,CITYLINK ANZ,3.35,0,1228293.51,DR,REF856243,ANZ,Savings
15-09-2025 17:41,ANZ9C247E7C27BC4D03ADF8,012-345-678,11111111,PAYMENT GATEWAY ANZ,130.3,0,1228163.21,DR,REF150672,ANZ,Savings
15-09-2025 17:45,ANZB226EDBFC3054BEFAF83,012-345-678,11111111,BIGW ANZ,67.17,0,1228096.04,DR,REF637923,ANZ,Savings
15-09-2025 17:53,ANZ9710DED6C4F9417A9008,012-345-678,11111111,BWS ANZ,41.69,0,1228054.35,DR,REF202235,ANZ,Savings
15-09-2025 17:58,ANZ48FF2687B1A041EDA8CB,012-345-678,11111111,AMAZON AU ANZ,110.39,0,1227943.96,DR,REF568974,ANZ,Savings
15-09-2025 18:27,INTFC575A9149B84A95968D,012-345-678,11111111,TRANSFER TO NAB 44444444,735.56,0,1227208.4,DR,INT-96773,ANZ,Savings
15-09-2025 18:52,ANZ123FB94D9A944B95A393,012-345-678,11111111,SALARY PAYMENT ANZ,0,4344.72,1231553.12,CR,REF945917,ANZ,Savings
15-09-2025 20:04,ANZFB2D72E818374B0D9632,012-345-678,11111111,JB HI-FI ANZ,21.95,0,1231531.17,DR,REF967689,ANZ,Savings
15-09-2025 20:17,ANZ4908ADDECAA745C3B9BC,012-345-678,11111111,SPOTIFY ANZ,9.56,0,1231521.61,DR,REF523331,ANZ,Savings
15-09-2025 20:25,ANZ26B4F9DFE2CD4EFA9491,012-345-678,11111111,JB HI-FI ANZ,33.96,0,1231487.65,DR,REF555236,ANZ,Savings
15-09-2025 20:29,ANZ571936ABEC9945EDBFE3,012-345-678,11111111,MCDONALDS ANZ,49.56,0,1231438.09,DR,REF298581,ANZ,Savings
15-09-2025 20:31,ANZ161C79DE45494E108241,012-345-678,11111111,PAY - SALARY ANZ,0,7858.51,1239296.6,CR,REF154342,ANZ,Savings
15-09-2025 20:51,ANZ5F6F24DFBE404A179AA0,012-345-678,11111111,MCDONALDS ANZ,15.08,0,1239281.52,DR,REF201789,ANZ,Savings
15-09-2025 20:53,ANZEAB189F1E82C405E81D1,012-345-678,11111111,PAYROLL CREDIT ANZ,0,5800.65,1245082.17,CR,REF424054,ANZ,Savings
15-09-2025 21:14,ANZ6BDD0ABF08F44088B59A,012-345-678,11111111,HARVEY NORMAN ANZ,6.34,0,1245075.83,DR,REF787924,ANZ,Savings
15-09-2025 21:15,ANZBAFFB7BAC17E4762B32D,012-345-678,11111111,TAFE BOOKSHOP ANZ,38.67,0,1245037.16,DR,REF375978,ANZ,Savings
15-09-2025 21:16,ANZ6D5343B1EDCC413DBD2C,012-345-678,11111111,ZOOM ANZ,48.46,0,1244988.7,DR,REF182790,ANZ,Savings
15-09-2025 21:27,ANZ0C18DEFAE5C243D982DC,012-345-678,11111111,JB HI-FI ANZ,5.68,0,1244983.02,DR,REF927674,ANZ,Savings
15-09-2025 21:30,ANZ5D95D116644549CEBD00,012-345-678,11111111,BP ANZ,96.72,0,1244886.3,DR,REF645291,ANZ,Savings
15-09-2025 21:45,ANZ885C85F2BE374DF588ED,012-345-678,11111111,CITYLINK ANZ,139.86,0,1244746.44,DR,REF905138,ANZ,Savings
15-09-2025 21:48,ANZ95EC8E0BD42B4EA1BF4B,012-345-678,11111111,BIGW ANZ,15.41,0,1244731.03,DR,REF863821,ANZ,Savings
15-09-2025 22:08,ANZ4A6B1BF748A94430B7F7,012-345-678,11111111,LIQUORLAND ANZ,99.38,0,1244631.65,DR,REF689737,ANZ,Savings
15-09-2025 22:18,ANZ1FA0822D7C9547C8BE9E,012-345-678,11111111,SHELL ANZ,61.97,0,1244569.68,DR,REF481751,ANZ,Savings
15-09-2025 22:23,ANZE307E774AA4A4F2EAD1A,012-345-678,11111111,STARBUCKS ANZ,20.84,0,1244548.84,DR,REF480163,ANZ,Savings
15-09-2025 22:37,ANZ3EC97B5AEC0B4C8DA5E8,012-345-678,11111111,COMPANY PAYROLL ANZ,0,1821.84,1246370.68,CR,REF432438,ANZ,Savings
15-09-2025 23:01,ANZ067FB166688043669F40,012-345-678,11111111,ALDI ANZ,17.75,0,1246352.93,DR,REF330989,ANZ,Savings
15-09-2025 23:09,ANZ27382E4810C247D680AA,012-345-678,11111111,SALARY PAYMENT ANZ,0,7776.97,1254129.9,CR,REF224720,ANZ,Savings
15-09-2025 23:27,ANZ5305370E6E4241A692C0,012-345-678,11111111,CITYLINK ANZ,4.74,0,1254125.16,DR,REF957063,ANZ,Savings
15-09-2025 23:52,ANZB6F78DC666324CDA85FC,012-345-678,11111111,PAYPAL *NETFLIX ANZ,31.33,0,1254093.83,DR,REF944139,ANZ,Savings
15-09-2025 23:52,ANZF6365462FFD94F71B0ED,012-345-678,11111111,JB HI-FI ANZ,73.63,0,1254020.2,DR,REF622346,ANZ,Savings
16-09-2025 00:12,ANZBEFF2B46CADD46B6A8A3,012-345-678,11111111,7-ELEVEN ANZ,18.74,0,1254001.46,DR,REF452582,ANZ,Savings
16-09-2025 00:17,ANZB2D50AD6F4F647448486,012-345-678,11111111,7-ELEVEN ANZ,20.23,0,1253981.23,DR,REF816004,ANZ,Savings
16-09-2025 00:34,ANZ84679486C6E1489D95B5,012-345-678,11111111,DOMINO'S PIZZA ANZ,7.07,0,1253974.16,DR,REF808331,ANZ,Savings
16-09-2025 00:39,ANZ575B8558736A4612A7E2,012-345-678,11111111,APPLE ANZ,15.58,0,1253958.58,DR,REF678188,ANZ,Savings
16-09-2025 01:47,ANZE69D9DC925CA4D4AB66C,012-345-678,11111111,SPOTIFY ANZ,48.25,0,1253910.33,DR,REF843950,ANZ,Savings
16-09-2025 01:57,ANZA4A937D28087494195F4,012-345-678,11111111,UBER EATS ANZ,23.03,0,1253887.3,DR,REF943374,ANZ,Savings
16-09-2025 02:14,ANZ08EA2257399F4C01B4FC,012-345-678,11111111,ALDI ANZ,23.25,0,1253864.05,DR,REF457899,ANZ,Savings
16-09-2025 02:32,ANZ7EEBF04D23074B56A195,012-345-678,11111111,BANK FEE ANZ,12.43,0,1253851.62,DR,REF564112,ANZ,Savings
16-09-2025 02:33,ANZ9BEB0B910B564A8DADF4,012-345-678,11111111,ZOOM ANZ,173.78,0,1253677.84,DR,REF210404,ANZ,Savings
16-09-2025 02:48,ANZ6C4F151CF714412497B4,012-345-678,11111111,DOMINO'S PIZZA ANZ,56.03,0,1253621.81,DR,REF903405,ANZ,Savings
16-09-2025 02:54,ANZEF65B90703864A8288B9,012-345-678,11111111,BWS ANZ,47.6,0,1253574.21,DR,REF898216,ANZ,Savings
16-09-2025 02:56,ANZ103CA5E40C614F3EBCAF,012-345-678,11111111,7-ELEVEN ANZ,35.38,0,1253538.83,DR,REF874149,ANZ,Savings
16-09-2025 03:16,ANZ6D24837064F64C68AB81,012-345-678,11111111,LIQUORLAND ANZ,21.66,0,1253517.17,DR,REF205776,ANZ,Savings
16-09-2025 03:29,ANZE69D984765C849599140,012-345-678,11111111,PAYROLL CREDIT ANZ,0,5092.81,1258609.98,CR,REF413034,ANZ,Savings
16-09-2025 03:43,ANZ0FB662237A3A41D59BBB,012-345-678,11111111,WAGES CREDIT ANZ,0,789.42,1259399.4,CR,REF374672,ANZ,Savings
16-09-2025 04:26,ANZ6FCC25782AC049D8BF9F,012-345-678,11111111,RAILWAY STATION ANZ,46.59,0,1259352.81,DR,REF224059,ANZ,Savings
16-09-2025 05:33,ANZ08C8D3807E8D4690B966,012-345-678,11111111,APPLE ANZ,107.66,0,1259245.15,DR,REF641195,ANZ,Savings
16-09-2025 05:41,ANZ1A2FAE26939C424EB0C8,012-345-678,11111111,WOOLWORTHS ANZ,13.06,0,1259232.09,DR,REF731964,ANZ,Savings
16-09-2025 06:12,ANZB2313612848D41BF87EB,012-345-678,11111111,MENULOG ANZ,69.06,0,1259163.03,DR,REF156893,ANZ,Savings
16-09-2025 06:20,ANZB67E202D1A6E4791A380,012-345-678,11111111,ALDI ANZ,8.07,0,1259154.96,DR,REF253069,ANZ,Savings
16-09-2025 06:41,ANZ6EF12269F00D4C6DBA31,012-345-678,11111111,MCDONALDS ANZ,45.13,0,1259109.83,DR,REF869059,ANZ,Savings
16-09-2025 06:57,ANZ90946A212CA942D9A914,012-345-678,11111111,STARBUCKS ANZ,50,0,1259059.83,DR,REF652526,ANZ,Savings
16-09-2025 07:13,ANZDB39D11F7A1C45CB956D,012-345-678,11111111,BWS ANZ,45.01,0,1259014.82,DR,REF881994,ANZ,Savings
16-09-2025 07:13,ANZ2FC28A12B5BF47FB9192,012-345-678,11111111,AMAZON AU ANZ,26.41,0,1258988.41,DR,REF592412,ANZ,Savings
16-09-2025 07:44,ANZEB3EE155C4BC48519F69,012-345-678,11111111,CITYLINK ANZ,32.19,0,1258956.22,DR,REF208150,ANZ,Savings
16-09-2025 07:53,ANZ37A2E15DFEF4426D929D,012-345-678,11111111,APPLE ANZ,84.71,0,1258871.51,DR,REF790658,ANZ,Savings
16-09-2025 08:04,ANZ3E01AC57C8E5427D804B,012-345-678,11111111,PAYPAL *NETFLIX ANZ,68.43,0,1258803.08,DR,REF195253,ANZ,Savings
16-09-2025 08:10,ANZ7DFD50115F204D7A891E,012-345-678,11111111,SALARY PAYMENT ANZ,0,5853.73,1264656.81,CR,REF887491,ANZ,Savings
16-09-2025 08:19,ANZ28814084AD7444F893C8,012-345-678,11111111,WOOLWORTHS ANZ,4.22,0,1264652.59,DR,REF202582,ANZ,Savings
16-09-2025 08:37,ANZB85591008276446090BC,012-345-678,11111111,JB HI-FI ANZ,105.52,0,1264547.07,DR,REF512083,ANZ,Savings
16-09-2025 09:21,ANZED289747413342489A83,012-345-678,11111111,BWS ANZ,15.02,0,1264532.05,DR,REF997581,ANZ,Savings
16-09-2025 09:22,ANZE1301690BFC74C30955D,012-345-678,11111111,COLES ANZ,42.69,0,1264489.36,DR,REF866689,ANZ,Savings
16-09-2025 09:27,ANZE6E3B8402EE540AEAC82,012-345-678,11111111,BWS ANZ,34.75,0,1264454.61,DR,REF233440,ANZ,Savings
16-09-2025 09:32,ANZ578605AA75EE44AAB1B1,012-345-678,11111111,MCDONALDS ANZ,11.45,0,1264443.16,DR,REF999133,ANZ,Savings
16-09-2025 09:34,ANZ3FD4BFEAA20240C4A1FF,012-345-678,11111111,HARVEY NORMAN ANZ,36.27,0,1264406.89,DR,REF747956,ANZ,Savings
16-09-2025 09:54,ANZ4E16DA743116445495DA,012-345-678,11111111,WOOLWORTHS ANZ,306.94,0,1264099.95,DR,REF506037,ANZ,Savings
16-09-2025 09:59,ANZ439BC3174528474FAEF4,012-345-678,11111111,BANK FEE ANZ,43.16,0,1264056.79,DR,REF542539,ANZ,Savings
16-09-2025 10:13,ANZ6D9E0620DED54F3BB891,012-345-678,11111111,HARVEY NORMAN ANZ,26.02,0,1264030.77,DR,REF770429,ANZ,Savings
16-09-2025 10:16,ANZ1D28369E94244674B41B,012-345-678,11111111,CITYLINK ANZ,51.4,0,1263979.37,DR,REF736196,ANZ,Savings
16-09-2025 10:17,ANZ8B0177792D3B4FAEBD60,012-345-678,11111111,LIQUORLAND ANZ,39.08,0,1263940.29,DR,REF569269,ANZ,Savings
16-09-2025 10:30,ANZ626A041A7A694401880D,012-345-678,11111111,TAFE BOOKSHOP ANZ,109.35,0,1263830.94,DR,REF201175,ANZ,Savings
16-09-2025 10:39,ANZ0E32991A3B8E433B8222,012-345-678,11111111,PAYMENT GATEWAY ANZ,103.64,0,1263727.3,DR,REF487701,ANZ,Savings
16-09-2025 10:56,ANZF022C2EAC0FE45359238,012-345-678,11111111,SPOTIFY ANZ,23.11,0,1263704.19,DR,REF266825,ANZ,Savings
16-09-2025 10:58,ANZ9B65BA9A6A64475CA307,012-345-678,11111111,FLIXBUS ANZ,25.04,0,1263679.15,DR,REF430679,ANZ,Savings
16-09-2025 11:10,ANZ1A282B8EE4B74B66B194,012-345-678,11111111,RAILWAY STATION ANZ,10.13,0,1263669.02,DR,REF602213,ANZ,Savings
16-09-2025 11:16,ANZF0F64912D2994B2CB487,012-345-678,11111111,LIQUORLAND ANZ,133.05,0,1263535.97,DR,REF649423,ANZ,Savings
16-09-2025 11:33,ANZ4B8A962E134640A3AEB4,012-345-678,11111111,BP ANZ,14.96,0,1263521.01,DR,REF209934,ANZ,Savings
16-09-2025 11:52,ANZ30EDA328B7B3456CBAEA,012-345-678,11111111,ALDI ANZ,69.05,0,1263451.96,DR,REF839834,ANZ,Savings
16-09-2025 11:54,ANZDE2184E6A2914BC4AD15,012-345-678,11111111,7-ELEVEN ANZ,26.75,0,1263425.21,DR,REF540967,ANZ,Savings
16-09-2025 12:05,ANZACD6074EA56640D1A75E,012-345-678,11111111,ALDI ANZ,43.88,0,1263381.33,DR,REF294436,ANZ,Savings
16-09-2025 12:20,ANZ58B24A92294E44F5A471,012-345-678,11111111,ZOOM ANZ,370.2,0,1263011.13,DR,REF338475,ANZ,Savings
16-09-2025 13:13,ANZFBD6C160D2C14C40B743,012-345-678,11111111,ALDI ANZ,24.39,0,1262986.74,DR,REF603905,ANZ,Savings
16-09-2025 13:35,ANZDA8C3A41343C4BCA84C1,012-345-678,11111111,UBER EATS ANZ,143.38,0,1262843.36,DR,REF588516,ANZ,Savings
16-09-2025 13:38,ANZFDB3F4A4D1F5426CA3E5,012-345-678,11111111,PAYMENT GATEWAY ANZ,69.06,0,1262774.3,DR,REF912602,ANZ,Savings
16-09-2025 13:40,ANZAE8AA8E488E2447C955A,012-345-678,11111111,TAFE BOOKSHOP ANZ,8.92,0,1262765.38,DR,REF902522,ANZ,Savings
16-09-2025 13:49,ANZ3C7AC6640B6B49168223,012-345-678,11111111,INTERNET TRANSFER ANZ,62.95,0,1262702.43,DR,REF120423,ANZ,Savings
16-09-2025 14:04,ANZF12892971F614881AF8F,012-345-678,11111111,BANK FEE ANZ,213.14,0,1262489.29,DR,REF365669,ANZ,Savings
16-09-2025 14:47,ANZEC3BFD55004649F8B95F,012-345-678,11111111,INTERNET TRANSFER ANZ,70.95,0,1262418.34,DR,REF974374,ANZ,Savings
16-09-2025 15:21,ANZ8FBBB5A43AA24727BE70,012-345-678,11111111,COMPANY PAYROLL ANZ,0,6735.53,1269153.87,CR,REF664216,ANZ,Savings
16-09-2025 15:28,ANZ78575C759B0D464D8C61,012-345-678,11111111,INTERNET TRANSFER ANZ,8.52,0,1269145.35,DR,REF598206,ANZ,Savings
16-09-2025 15:30,ANZ70FB3694036C472D9F1A,012-345-678,11111111,JB HI-FI ANZ,10.82,0,1269134.53,DR,REF958809,ANZ,Savings
16-09-2025 15:54,ANZ5401CB0BA1EB4E0FB62B,012-345-678,11111111,LIQUORLAND ANZ,7.62,0,1269126.91,DR,REF827243,ANZ,Savings
16-09-2025 16:14,ANZCE28AE3FB0D6422E84C1,012-345-678,11111111,BWS ANZ,10.26,0,1269116.65,DR,REF756481,ANZ,Savings
16-09-2025 16:29,ANZFBA9AAFC771F4E8B9C79,012-345-678,11111111,INTERNET TRANSFER ANZ,33.13,0,1269083.52,DR,REF675042,ANZ,Savings
16-09-2025 16:37,ANZC380C71034C648D48062,012-345-678,11111111,CITYLINK ANZ,5.42,0,1269078.1,DR,REF298245,ANZ,Savings
16-09-2025 17:13,ANZ0B8F1E2F70E442C983BA,012-345-678,11111111,WOOLWORTHS ANZ,29.1,0,1269049,DR,REF392083,ANZ,Savings
16-09-2025 17:38,ANZC0D483949DF743C48151,012-345-678,11111111,HARVEY NORMAN ANZ,60.36,0,1268988.64,DR,REF978526,ANZ,Savings
16-09-2025 17:47,ANZF2D515D82D6044DBB31E,012-345-678,11111111,TAFE BOOKSHOP ANZ,183.15,0,1268805.49,DR,REF814612,ANZ,Savings
16-09-2025 18:46,ANZ6781EDBDE4C44AF3AC85,012-345-678,11111111,BP ANZ,2.2,0,1268803.29,DR,REF902101,ANZ,Savings
16-09-2025 18:47,ANZ7A4565DE92EB4EB29D1B,012-345-678,11111111,7-ELEVEN ANZ,50.1,0,1268753.19,DR,REF139052,ANZ,Savings
16-09-2025 18:50,ANZCE43F24068C74F728A82,012-345-678,11111111,KFC ANZ,38.94,0,1268714.25,DR,REF466019,ANZ,Savings
16-09-2025 19:05,ANZBCD68E7A8D464721AF59,012-345-678,11111111,CITYLINK ANZ,12.84,0,1268701.41,DR,REF270022,ANZ,Savings
16-09-2025 19:17,ANZ28B2FE386FDB40619DBC,012-345-678,11111111,BP ANZ,87.08,0,1268614.33,DR,REF796696,ANZ,Savings
16-09-2025 19:37,ANZA84FE889071E459DA9A8,012-345-678,11111111,BP ANZ,44.15,0,1268570.18,DR,REF682873,ANZ,Savings
16-09-2025 19:57,ANZE371B105703E489891D7,012-345-678,11111111,BIGW ANZ,4.48,0,1268565.7,DR,REF132549,ANZ,Savings
16-09-2025 19:57,ANZ37D5B1471E724BCA85BB,012-345-678,11111111,DOMINO'S PIZZA ANZ,16.96,0,1268548.74,DR,REF429034,ANZ,Savings
16-09-2025 20:08,ANZ57F9C09A1F694291BD2E,012-345-678,11111111,LIQUORLAND ANZ,58.98,0,1268489.76,DR,REF245528,ANZ,Savings
16-09-2025 20:19,ANZ1B147F1FF68D4B03962B,012-345-678,11111111,WOOLWORTHS ANZ,102.34,0,1268387.42,DR,REF443161,ANZ,Savings
16-09-2025 21:33,ANZ891C7092D7154DEF8D6E,012-345-678,11111111,PAY - SALARY ANZ,0,2922.42,1271309.84,CR,REF671338,ANZ,Savings
16-09-2025 21:44,ANZF9B53C182D3C4BCF8E15,012-345-678,11111111,BANK FEE ANZ,11.37,0,1271298.47,DR,REF828005,ANZ,Savings
16-09-2025 22:48,ANZA6B26DEC5962411C8908,012-345-678,11111111,STARBUCKS ANZ,13.02,0,1271285.45,DR,REF335913,ANZ,Savings
16-09-2025 22:49,ANZ1D25BA8D9ABC40AE9EBD,012-345-678,11111111,PAYPAL *NETFLIX ANZ,77.86,0,1271207.59,DR,REF768684,ANZ,Savings
16-09-2025 23:02,INT6D455F3621EF4C918560,012-345-678,11111111,TRANSFER TO CBA 33333333,1774.27,0,1269433.32,DR,INT-20224,ANZ,Savings
16-09-2025 23:13,ANZ8D48F33B589444FC94A2,012-345-678,11111111,DOMINO'S PIZZA ANZ,42.63,0,1269390.69,DR,REF681388,ANZ,Savings
17-09-2025 00:26,ANZ9BDC93B4707C46AB96C7,012-345-678,11111111,7-ELEVEN ANZ,69.6,0,1269321.09,DR,REF175359,ANZ,Savings
17-09-2025 00:39,ANZ80399A5F19E045498374,012-345-678,11111111,ALDI ANZ,40.09,0,1269281,DR,REF962906,ANZ,Savings
17-09-2025 01:10,ANZ13A05179082449DAA415,012-345-678,11111111,BIGW ANZ,67.92,0,1269213.08,DR,REF630565,ANZ,Savings
17-09-2025 01:17,ANZ26CB373951864E569CE5,012-345-678,11111111,7-ELEVEN ANZ,7.11,0,1269205.97,DR,REF379031,ANZ,Savings
17-09-2025 01:29,ANZ3AB0A98E3DFA455BB12E,012-345-678,11111111,SHELL ANZ,43.53,0,1269162.44,DR,REF652571,ANZ,Savings
17-09-2025 01:54,ANZ9D90BBEA4E334A95BCF1,012-345-678,11111111,BIGW ANZ,11.91,0,1269150.53,DR,REF282304,ANZ,Savings
17-09-2025 02:03,ANZ311F09CEB27D4EACA767,012-345-678,11111111,BWS ANZ,109.11,0,1269041.42,DR,REF890042,ANZ,Savings
17-09-2025 02:24,ANZ7D2FBD65E89542588F95,012-345-678,11111111,ZOOM ANZ,6.33,0,1269035.09,DR,REF409236,ANZ,Savings
17-09-2025 02:38,ANZE7A4BE235A5447109C4D,012-345-678,11111111,PAY - SALARY ANZ,0,1189.33,1270224.42,CR,REF697833,ANZ,Savings
17-09-2025 03:01,ANZ6AB5FFD0C0444036B3B3,012-345-678,11111111,JB HI-FI ANZ,58.7,0,1270165.72,DR,REF478342,ANZ,Savings
17-09-2025 03:21,ANZD14E8E2FEDB44B38AFE7,012-345-678,11111111,KFC ANZ,144.72,0,1270021,DR,REF552405,ANZ,Savings
17-09-2025 03:52,ANZE1F2E64B6BE744DA9AE0,012-345-678,11111111,CITYLINK ANZ,89.57,0,1269931.43,DR,REF843311,ANZ,Savings
17-09-2025 04:09,ANZ2E9FD040126A421C82DC,012-345-678,11111111,MCDONALDS ANZ,16.98,0,1269914.45,DR,REF614025,ANZ,Savings
17-09-2025 04:50,ANZ62EDE6CA878B4F25BA83,012-345-678,11111111,ZOOM ANZ,12.62,0,1269901.83,DR,REF857613,ANZ,Savings
17-09-2025 05:49,ANZ5F35B019F87445E5B3FA,012-345-678,11111111,RAILWAY STATION ANZ,12.78,0,1269889.05,DR,REF325785,ANZ,Savings
17-09-2025 05:56,ANZDDC37E4A05054C46894D,012-345-678,11111111,MENULOG ANZ,64.56,0,1269824.49,DR,REF234835,ANZ,Savings
17-09-2025 05:56,ANZB4A645E889614BB5AA40,012-345-678,11111111,ZOOM ANZ,60.45,0,1269764.04,DR,REF348906,ANZ,Savings
17-09-2025 06:12,ANZ6C22C895117E4A359A2C,012-345-678,11111111,HARVEY NORMAN ANZ,25.87,0,1269738.17,DR,REF222840,ANZ,Savings
17-09-2025 06:30,ANZB2036CDF29344D61BDE2,012-345-678,11111111,BANK FEE ANZ,22.67,0,1269715.5,DR,REF785796,ANZ,Savings
17-09-2025 06:33,ANZF500D605AEDD4C16A07D,012-345-678,11111111,FLIXBUS ANZ,17.13,0,1269698.37,DR,REF691522,ANZ,Savings
17-09-2025 06:48,ANZ247B40AE337B45D59716,012-345-678,11111111,WOOLWORTHS ANZ,167.1,0,1269531.27,DR,REF373244,ANZ,Savings
17-09-2025 07:05,ANZC66A23F6F69C4782BB01,012-345-678,11111111,MENULOG ANZ,32.6,0,1269498.67,DR,REF463046,ANZ,Savings
17-09-2025 07:41,ANZ589C04E752C048D79C29,012-345-678,11111111,BANK FEE ANZ,46.99,0,1269451.68,DR,REF944519,ANZ,Savings
17-09-2025 08:32,ANZ4CBA95B4415B44638260,012-345-678,11111111,PAY - SALARY ANZ,0,3972.99,1273424.67,CR,REF469345,ANZ,Savings
17-09-2025 08:32,ANZ38D23AC022894FA9B79A,012-345-678,11111111,SPOTIFY ANZ,19.04,0,1273405.63,DR,REF237682,ANZ,Savings
17-09-2025 08:42,ANZ7483EECF9EB2494BA6FC,012-345-678,11111111,SPOTIFY ANZ,92.85,0,1273312.78,DR,REF785995,ANZ,Savings
17-09-2025 08:43,INT19D8F2FDAFFB4BABB7D2,012-345-678,11111111,TRANSFER TO CBA 33333333,1138.24,0,1272174.54,DR,INT-77526,ANZ,Savings
17-09-2025 09:13,ANZ76DF757FDCC64377BB93,012-345-678,11111111,COLES ANZ,66.98,0,1272107.56,DR,REF432334,ANZ,Savings
17-09-2025 09:15,ANZ75C0B49264404C88948D,012-345-678,11111111,UBER EATS ANZ,15.99,0,1272091.57,DR,REF666681,ANZ,Savings
17-09-2025 09:33,ANZF89A20A0875648E5B8B5,012-345-678,11111111,HARVEY NORMAN ANZ,22.24,0,1272069.33,DR,REF115535,ANZ,Savings
17-09-2025 10:10,ANZ8CD2A2D30FB840D78D9B,012-345-678,11111111,WAGES CREDIT ANZ,0,4856.83,1276926.16,CR,REF357145,ANZ,Savings
17-09-2025 10:12,ANZD84B6AA54BD84FA6BBCC,012-345-678,11111111,PAYROLL CREDIT ANZ,0,6136.87,1283063.03,CR,REF414583,ANZ,Savings
17-09-2025 10:31,INT99E92DA137CF4149B479,012-345-678,11111111,TRANSFER FROM CBA 22222222,0,201.17,1283264.2,CR,INT-15306,ANZ,Savings
17-09-2025 11:19,ANZ30797042D4FD45D68CA4,012-345-678,11111111,UBER EATS ANZ,31.64,0,1283232.56,DR,REF144247,ANZ,Savings
17-09-2025 11:25,ANZ288A23BE7BCC4E6A892A,012-345-678,11111111,APPLE ANZ,13.87,0,1283218.69,DR,REF338978,ANZ,Savings
17-09-2025 12:19,ANZ6717D99450834EBFA251,012-345-678,11111111,INTERNET TRANSFER ANZ,53.26,0,1283165.43,DR,REF832404,ANZ,Savings
17-09-2025 12:21,ANZD2F54681D8A84AE4A1A7,012-345-678,11111111,JB HI-FI ANZ,69.06,0,1283096.37,DR,REF127209,ANZ,Savings
17-09-2025 12:22,ANZ4289B53872A84142B684,012-345-678,11111111,WOOLWORTHS ANZ,14.3,0,1283082.07,DR,REF723996,ANZ,Savings
17-09-2025 12:29,ANZ07C9243B522C4B3C9FEF,012-345-678,11111111,PAY - SALARY ANZ,0,7011.09,1290093.16,CR,REF165828,ANZ,Savings
17-09-2025 12:45,ANZ0F4995E8230E4F1B8548,012-345-678,11111111,HARVEY NORMAN ANZ,21.33,0,1290071.83,DR,REF864507,ANZ,Savings
17-09-2025 12:53,ANZ7D371D42F44748C8A52A,012-345-678,11111111,LIQUORLAND ANZ,225.47,0,1289846.36,DR,REF991387,ANZ,Savings
17-09-2025 14:37,ANZ9C8593105DA84294AC4B,012-345-678,11111111,JB HI-FI ANZ,23.36,0,1289823,DR,REF325665,ANZ,Savings
17-09-2025 14:49,ANZ05CEC42DD26145D2945A,012-345-678,11111111,FLIXBUS ANZ,42.43,0,1289780.57,DR,REF894788,ANZ,Savings
17-09-2025 14:53,ANZC0704399AA3E4269A2C9,012-345-678,11111111,APPLE ANZ,16.06,0,1289764.51,DR,REF413772,ANZ,Savings
17-09-2025 15:20,ANZ5A4A3DB8D402489DAF0A,012-345-678,11111111,BWS ANZ,161.53,0,1289602.98,DR,REF401171,ANZ,Savings
17-09-2025 15:22,ANZ3E353BF62B9843CC9A92,012-345-678,11111111,PAYPAL *NETFLIX ANZ,66.54,0,1289536.44,DR,REF448891,ANZ,Savings
17-09-2025 15:48,ANZ9FB8A7C55DF34682B5EE,012-345-678,11111111,RAILWAY STATION ANZ,99.22,0,1289437.22,DR,REF797748,ANZ,Savings
17-09-2025 16:15,ANZF9C5795F1C5743E8A265,012-345-678,11111111,DOMINO'S PIZZA ANZ,26.89,0,1289410.33,DR,REF179794,ANZ,Savings
17-09-2025 16:39,ANZ870D533A0F954FD68507,012-345-678,11111111,WAGES CREDIT ANZ,0,2615.55,1292025.88,CR,REF183962,ANZ,Savings
17-09-2025 17:01,ANZ969B496A3DFE4DC897CD,012-345-678,11111111,COLES ANZ,22.74,0,1292003.14,DR,REF246664,ANZ,Savings
17-09-2025 17:08,ANZ856F832C8F494F4380C4,012-345-678,11111111,SALARY PAYMENT ANZ,0,387.58,1292390.72,CR,REF380156,ANZ,Savings
17-09-2025 17:14,ANZBA05F730675A477EAB74,012-345-678,11111111,INTERNET TRANSFER ANZ,80.54,0,1292310.18,DR,REF351681,ANZ,Savings
17-09-2025 17:46,ANZ4F3FD432669947388812,012-345-678,11111111,PAY - SALARY ANZ,0,3941.18,1296251.36,CR,REF305476,ANZ,Savings
17-09-2025 18:07,ANZ8FD611DF90944A8C9E5F,012-345-678,11111111,LIQUORLAND ANZ,73.23,0,1296178.13,DR,REF752256,ANZ,Savings
17-09-2025 18:54,ANZ4F09BB05A8E249939F6C,012-345-678,11111111,FLIXBUS ANZ,9.18,0,1296168.95,DR,REF283183,ANZ,Savings
17-09-2025 19:28,ANZD352AE86129B45A283C9,012-345-678,11111111,FLIXBUS ANZ,27.45,0,1296141.5,DR,REF438507,ANZ,Savings
17-09-2025 19:28,ANZ74AC8678B07847D587E1,012-345-678,11111111,SPOTIFY ANZ,73.07,0,1296068.43,DR,REF317542,ANZ,Savings
17-09-2025 19:57,ANZBDADCED1FB1940E99171,012-345-678,11111111,ZOOM ANZ,28.91,0,1296039.52,DR,REF848867,ANZ,Savings
17-09-2025 20:17,ANZA97883BD68864FA295EC,012-345-678,11111111,ZOOM ANZ,41.13,0,1295998.39,DR,REF303303,ANZ,Savings
17-09-2025 20:26,ANZ020979D557E9467AAD8A,012-345-678,11111111,BANK FEE ANZ,39.56,0,1295958.83,DR,REF774019,ANZ,Savings
17-09-2025 20:58,ANZ7EBDE8D37328473EB0A8,012-345-678,11111111,CITYLINK ANZ,11.27,0,1295947.56,DR,REF273781,ANZ,Savings
17-09-2025 20:59,ANZD7F5689CA3EF406FAFE8,012-345-678,11111111,ZOOM ANZ,20.94,0,1295926.62,DR,REF162915,ANZ,Savings
17-09-2025 21:50,INT83FC2F906F80432E966E,012-345-678,11111111,TRANSFER FROM CBA 22222222,0,1205.46,1297132.08,CR,INT-56963,ANZ,Savings
17-09-2025 22:21,ANZC143520A44374A49812A,012-345-678,11111111,TAFE BOOKSHOP ANZ,29.29,0,1297102.79,DR,REF185828,ANZ,Savings
17-09-2025 22:45,ANZAF5CCE8BF6F64C2E9A5C,012-345-678,11111111,JB HI-FI ANZ,20.51,0,1297082.28,DR,REF309380,ANZ,Savings
17-09-2025 22:53,ANZDA7D155C1CD54AEB90D9,012-345-678,11111111,STARBUCKS ANZ,6.76,0,1297075.52,DR,REF473181,ANZ,Savings
17-09-2025 22:54,ANZ18F2472256DB4835AD4C,012-345-678,11111111,PAYPAL *NETFLIX ANZ,142.53,0,1296932.99,DR,REF804806,ANZ,Savings
17-09-2025 23:19,ANZ3970E1A52BD1402EBE1A,012-345-678,11111111,BIGW ANZ,5.07,0,1296927.92,DR,REF615492,ANZ,Savings
17-09-2025 23:36,ANZ6B25C96CC7E44ABF8C09,012-345-678,11111111,7-ELEVEN ANZ,66.62,0,1296861.3,DR,REF944593,ANZ,Savings
18-09-2025 00:18,ANZE9F3176B14934F37AD78,012-345-678,11111111,UBER EATS ANZ,46.29,0,1296815.01,DR,REF435282,ANZ,Savings
18-09-2025 00:24,ANZC58A6DEE74914F15A8E6,012-345-678,11111111,PAYPAL *NETFLIX ANZ,118.2,0,1296696.81,DR,REF421425,ANZ,Savings
18-09-2025 00:26,ANZCDCB12BE637A47E98814,012-345-678,11111111,HARVEY NORMAN ANZ,58.35,0,1296638.46,DR,REF609228,ANZ,Savings
18-09-2025 00:41,INT2293820412044C37BD82,012-345-678,11111111,TRANSFER TO CBA 33333333,1768.25,0,1294870.21,DR,INT-52121,ANZ,Savings
18-09-2025 01:16,ANZF90103D014B042A796E6,012-345-678,11111111,JB HI-FI ANZ,69.01,0,1294801.2,DR,REF817145,ANZ,Savings
18-09-2025 01:19,ANZE5C60272B4564E1588CA,012-345-678,11111111,TAFE BOOKSHOP ANZ,18.85,0,1294782.35,DR,REF449967,ANZ,Savings
18-09-2025 01:43,INT20580EAFF7B34104B538,012-345-678,11111111,TRANSFER FROM NAB 44444444,0,838.89,1295621.24,CR,INT-76338,ANZ,Savings
18-09-2025 02:05,ANZ7F71805AEC3D4E1394DC,012-345-678,11111111,HARVEY NORMAN ANZ,36.92,0,1295584.32,DR,REF609598,ANZ,Savings
18-09-2025 02:23,ANZ5FD3AAF0042E4C03AAF9,012-345-678,11111111,DOMINO'S PIZZA ANZ,104.66,0,1295479.66,DR,REF507821,ANZ,Savings
18-09-2025 02:25,ANZ89736D04233B41748CEB,012-345-678,11111111,JB HI-FI ANZ,128.86,0,1295350.8,DR,REF928322,ANZ,Savings
18-09-2025 02:29,ANZ084C0707FFA349F792DB,012-345-678,11111111,UBER EATS ANZ,6.35,0,1295344.45,DR,REF605404,ANZ,Savings
18-09-2025 03:05,ANZA2956D5B4F744CB1B497,012-345-678,11111111,BANK FEE ANZ,4.11,0,1295340.34,DR,REF228682,ANZ,Savings
18-09-2025 03:25,ANZCFE03AAD45E54B06BFF1,012-345-678,11111111,ALDI ANZ,13.56,0,1295326.78,DR,REF578266,ANZ,Savings
18-09-2025 03:29,ANZ76BF67CD6A914BB78F99,012-345-678,11111111,SPOTIFY ANZ,34.84,0,1295291.94,DR,REF212342,ANZ,Savings
18-09-2025 03:44,ANZ33890BF0F13E41F7BAEC,012-345-678,11111111,PAYMENT GATEWAY ANZ,24,0,1295267.94,DR,REF147742,ANZ,Savings
18-09-2025 04:00,ANZ545F65B6A37A4213B7FF,012-345-678,11111111,TAFE BOOKSHOP ANZ,159.05,0,1295108.89,DR,REF260360,ANZ,Savings
18-09-2025 04:05,ANZ998EC21548974FA2BA97,012-345-678,11111111,LIQUORLAND ANZ,27.25,0,1295081.64,DR,REF949464,ANZ,Savings
18-09-2025 04:15,ANZ5D635F457DAA400EBA16,012-345-678,11111111,SALARY PAYMENT ANZ,0,944.05,1296025.69,CR,REF653042,ANZ,Savings
18-09-2025 04:16,ANZ82E054E9FC224BA29B66,012-345-678,11111111,BIGW ANZ,31.16,0,1295994.53,DR,REF594769,ANZ,Savings
18-09-2025 04:32,ANZD14FE7A84AD04A729B69,012-345-678,11111111,CITYLINK ANZ,21.69,0,1295972.84,DR,REF673124,ANZ,Savings
18-09-2025 04:37,ANZ00E21D5832FC46748906,012-345-678,11111111,CITYLINK ANZ,135.63,0,1295837.21,DR,REF432803,ANZ,Savings
18-09-2025 05:42,ANZD9B6CE5750C54BA68974,012-345-678,11111111,PAYPAL *NETFLIX ANZ,78.4,0,1295758.81,DR,REF569023,ANZ,Savings
18-09-2025 05:59,ANZ1ECDF5C6EEEE4873AB3F,012-345-678,11111111,PAYMENT GATEWAY ANZ,46.63,0,1295712.18,DR,REF184426,ANZ,Savings
18-09-2025 07:00,ANZCC762E2A0AF5472CA8F5,012-345-678,11111111,UBER EATS ANZ,56.23,0,1295655.95,DR,REF165930,ANZ,Savings
18-09-2025 07:05,ANZ83C51B9583D347B1ADA9,012-345-678,11111111,SHELL ANZ,13.85,0,1295642.1,DR,REF677099,ANZ,Savings
18-09-2025 07:21,ANZ9B830D434DB348B3A382,012-345-678,11111111,UBER EATS ANZ,36.39,0,1295605.71,DR,REF664316,ANZ,Savings
18-09-2025 07:49,ANZ1287E097A681496C9CC3,012-345-678,11111111,LIQUORLAND ANZ,36.71,0,1295569,DR,REF808113,ANZ,Savings
18-09-2025 09:02,ANZ9D028E7E1B114A5BB4E9,012-345-678,11111111,ZOOM ANZ,28.22,0,1295540.78,DR,REF802208,ANZ,Savings
18-09-2025 09:50,ANZ663742241A6841F7AF3E,012-345-678,11111111,PAY - SALARY ANZ,0,4550.26,1300091.04,CR,REF943918,ANZ,Savings
18-09-2025 10:29,ANZF69380F0CCEF4DBDA523,012-345-678,11111111,TAFE BOOKSHOP ANZ,4.78,0,1300086.26,DR,REF991342,ANZ,Savings
18-09-2025 10:43,ANZ67925FF429654B3B88E7,012-345-678,11111111,UBER EATS ANZ,60.48,0,1300025.78,DR,REF959797,ANZ,Savings
18-09-2025 10:45,ANZB2287A619DFD47C89750,012-345-678,11111111,HARVEY NORMAN ANZ,12.97,0,1300012.81,DR,REF889022,ANZ,Savings
18-09-2025 10:55,ANZA123DBA41AE54987A7EC,012-345-678,11111111,KFC ANZ,15.11,0,1299997.7,DR,REF519211,ANZ,Savings
18-09-2025 12:15,ANZA225C67B24194AE3A185,012-345-678,11111111,SALARY PAYMENT ANZ,0,2930.84,1302928.54,CR,REF229556,ANZ,Savings
18-09-2025 13:13,ANZFB834B09C4A24B74BF38,012-345-678,11111111,BANK FEE ANZ,18.9,0,1302909.64,DR,REF549663,ANZ,Savings
18-09-2025 13:47,ANZDC123D21365143268084,012-345-678,11111111,TAFE BOOKSHOP ANZ,95,0,1302814.64,DR,REF648727,ANZ,Savings
18-09-2025 14:24,ANZ076503916F604D72817E,012-345-678,11111111,SPOTIFY ANZ,55.3,0,1302759.34,DR,REF308760,ANZ,Savings
18-09-2025 14:26,ANZDC0539E2108142EEB09A,012-345-678,11111111,TAFE BOOKSHOP ANZ,52.84,0,1302706.5,DR,REF355096,ANZ,Savings
18-09-2025 14:52,ANZB1E73D545EC145BFB15A,012-345-678,11111111,CITYLINK ANZ,27.54,0,1302678.96,DR,REF931056,ANZ,Savings
18-09-2025 15:03,ANZ8BE99D2D2B494AE9A7DF,012-345-678,11111111,HARVEY NORMAN ANZ,47.72,0,1302631.24,DR,REF869002,ANZ,Savings
18-09-2025 16:08,ANZ71DC6A7326524EAAAA16,012-345-678,11111111,PAYMENT GATEWAY ANZ,61.68,0,1302569.56,DR,REF634192,ANZ,Savings
18-09-2025 16:15,ANZ8ECB193C3DAB448AA4C5,012-345-678,11111111,STARBUCKS ANZ,67.44,0,1302502.12,DR,REF670094,ANZ,Savings
18-09-2025 16:20,ANZ29ED0FBB62BB4E729BF9,012-345-678,11111111,PAYROLL CREDIT ANZ,0,7173.59,1309675.71,CR,REF480089,ANZ,Savings
18-09-2025 16:31,ANZD3786D3D0F7B499095FC,012-345-678,11111111,BIGW ANZ,24.91,0,1309650.8,DR,REF214768,ANZ,Savings
18-09-2025 16:31,ANZA468F9D5919144CDB430,012-345-678,11111111,WAGES CREDIT ANZ,0,3806.18,1313456.98,CR,REF311992,ANZ,Savings
18-09-2025 16:53,ANZ67833D7AE3BD43B096DE,012-345-678,11111111,ALDI ANZ,34.8,0,1313422.18,DR,REF253032,ANZ,Savings
18-09-2025 17:18,ANZAD5ABD22606F46FC8265,012-345-678,11111111,BP ANZ,16,0,1313406.18,DR,REF252397,ANZ,Savings
18-09-2025 17:24,ANZA50AF9FF45B74FC09EEF,012-345-678,11111111,RAILWAY STATION ANZ,32.07,0,1313374.11,DR,REF473041,ANZ,Savings
18-09-2025 17:46,ANZ13C84DDD604B426E805E,012-345-678,11111111,CITYLINK ANZ,98.29,0,1313275.82,DR,REF757599,ANZ,Savings
18-09-2025 17:47,ANZB232C281CE8B41AC9B82,012-345-678,11111111,ALDI ANZ,60.52,0,1313215.3,DR,REF513148,ANZ,Savings
18-09-2025 17:51,ANZ08C5361FBE724A739175,012-345-678,11111111,RAILWAY STATION ANZ,43.29,0,1313172.01,DR,REF709610,ANZ,Savings
18-09-2025 18:25,ANZAAA2E948910848519187,012-345-678,11111111,FLIXBUS ANZ,101.9,0,1313070.11,DR,REF792987,ANZ,Savings
18-09-2025 19:19,ANZC8393D5BC97C42858B23,012-345-678,11111111,RAILWAY STATION ANZ,4.94,0,1313065.17,DR,REF492385,ANZ,Savings
18-09-2025 19:25,ANZ3358C6201745415E92ED,012-345-678,11111111,HARVEY NORMAN ANZ,36.47,0,1313028.7,DR,REF677009,ANZ,Savings
18-09-2025 19:56,ANZ1D94088C858C469DA224,012-345-678,11111111,RAILWAY STATION ANZ,17.81,0,1313010.89,DR,REF727365,ANZ,Savings
18-09-2025 20:29,ANZ9FA783B8409E46B295D8,012-345-678,11111111,KFC ANZ,58.32,0,1312952.57,DR,REF455073,ANZ,Savings
18-09-2025 20:37,ANZ9D60CDC295634D0F9CD8,012-345-678,11111111,KFC ANZ,56.62,0,1312895.95,DR,REF791921,ANZ,Savings
18-09-2025 20:46,ANZB229DD76D6FE4A96BFB4,012-345-678,11111111,PAYROLL CREDIT ANZ,0,101.42,1312997.37,CR,REF915582,ANZ,Savings
18-09-2025 21:15,ANZF6D6CBDDC44446B29AEA,012-345-678,11111111,TAFE BOOKSHOP ANZ,27.34,0,1312970.03,DR,REF321120,ANZ,Savings
18-09-2025 22:24,ANZAFA5A66B991846AA9F7D,012-345-678,11111111,TAFE BOOKSHOP ANZ,54.51,0,1312915.52,DR,REF619167,ANZ,Savings
18-09-2025 22:25,ANZ829625D0687A42F989C5,012-345-678,11111111,PAYPAL *NETFLIX ANZ,1.91,0,1312913.61,DR,REF834895,ANZ,Savings
18-09-2025 22:56,ANZ0BD17CE4E573496699AF,012-345-678,11111111,BWS ANZ,57.25,0,1312856.36,DR,REF355218,ANZ,Savings
18-09-2025 23:03,ANZ225CB9802BAB4716B546,012-345-678,11111111,MCDONALDS ANZ,66.44,0,1312789.92,DR,REF256602,ANZ,Savings
18-09-2025 23:44,ANZ97F327C8691C451B9C7B,012-345-678,11111111,AMAZON AU ANZ,5.81,0,1312784.11,DR,REF944310,ANZ,Savings
19-09-2025 00:05,ANZ59D2BA19BF8240DD9B97,012-345-678,11111111,HARVEY NORMAN ANZ,71.2,0,1312712.91,DR,REF707018,ANZ,Savings
19-09-2025 00:38,ANZ851444375BE84BE092D0,012-345-678,11111111,STARBUCKS ANZ,6.16,0,1312706.75,DR,REF613556,ANZ,Savings
19-09-2025 00:42,ANZ6F7036FD44EB43FBB805,012-345-678,11111111,7-ELEVEN ANZ,45.23,0,1312661.52,DR,REF724389,ANZ,Savings
19-09-2025 00:50,ANZ7A1DD4ADD45741B38552,012-345-678,11111111,FLIXBUS ANZ,71.59,0,1312589.93,DR,REF283176,ANZ,Savings
19-09-2025 01:22,ANZB572ACAFD1DF47A69D93,012-345-678,11111111,SHELL ANZ,200.08,0,1312389.85,DR,REF160789,ANZ,Savings
19-09-2025 01:28,ANZD7B26B6F209C4B5E9810,012-345-678,11111111,UBER EATS ANZ,23.69,0,1312366.16,DR,REF835831,ANZ,Savings
19-09-2025 01:33,ANZ7D191FBA9A6945EAA0A4,012-345-678,11111111,BANK FEE ANZ,66.08,0,1312300.08,DR,REF426850,ANZ,Savings
19-09-2025 02:02,ANZEC51C528C74D4AECA0F2,012-345-678,11111111,APPLE ANZ,39.79,0,1312260.29,DR,REF563593,ANZ,Savings
19-09-2025 02:56,ANZ980ADBEF7D314FCF83F0,012-345-678,11111111,KFC ANZ,23.7,0,1312236.59,DR,REF350062,ANZ,Savings
19-09-2025 03:30,ANZA6B817A4FC1941A8BF51,012-345-678,11111111,APPLE ANZ,19.01,0,1312217.58,DR,REF385733,ANZ,Savings
19-09-2025 03:54,INT902E6C93427B47F29194,012-345-678,11111111,TRANSFER FROM NAB 44444444,0,734.73,1312952.31,CR,INT-19646,ANZ,Savings
19-09-2025 03:56,ANZ5AA4B74E6AB242208235,012-345-678,11111111,UBER EATS ANZ,5.97,0,1312946.34,DR,REF609521,ANZ,Savings
19-09-2025 03:57,ANZ0DFC9D82844A4C3F80BF,012-345-678,11111111,KFC ANZ,4.75,0,1312941.59,DR,REF397885,ANZ,Savings
19-09-2025 04:05,ANZ5D1FE36C1D974742819D,012-345-678,11111111,WOOLWORTHS ANZ,82.28,0,1312859.31,DR,REF239349,ANZ,Savings
19-09-2025 04:35,ANZ85DE2D833AF64F65B4D7,012-345-678,11111111,ZOOM ANZ,46.75,0,1312812.56,DR,REF498972,ANZ,Savings
19-09-2025 04:35,ANZEFF015EC8A2546A5BC33,012-345-678,11111111,BP ANZ,156.54,0,1312656.02,DR,REF170852,ANZ,Savings
19-09-2025 04:52,ANZ3E5BA9F449AE46A380E4,012-345-678,11111111,TAFE BOOKSHOP ANZ,17.48,0,1312638.54,DR,REF480251,ANZ,Savings
19-09-2025 06:14,ANZD4259C85D55F4890B70F,012-345-678,11111111,COMPANY PAYROLL ANZ,0,4655.5,1317294.04,CR,REF253220,ANZ,Savings
19-09-2025 06:17,ANZBE66C10C64A64DE4A5A3,012-345-678,11111111,AMAZON AU ANZ,48.02,0,1317246.02,DR,REF110518,ANZ,Savings
19-09-2025 06:35,ANZ8A514FDB365846D28BD6,012-345-678,11111111,SHELL ANZ,200.35,0,1317045.67,DR,REF753626,ANZ,Savings
19-09-2025 07:05,ANZ24E15DE38C99466D9123,012-345-678,11111111,UBER EATS ANZ,19,0,1317026.67,DR,REF923560,ANZ,Savings
19-09-2025 07:27,ANZ9DBDCEBFC6464642A8B2,012-345-678,11111111,HARVEY NORMAN ANZ,135.37,0,1316891.3,DR,REF986045,ANZ,Savings
19-09-2025 07:29,ANZ90F086D85F9C4A279A71,012-345-678,11111111,SHELL ANZ,95.04,0,1316796.26,DR,REF598245,ANZ,Savings
19-09-2025 07:54,ANZDF7C6B2FC8794744A14B,012-345-678,11111111,APPLE ANZ,29.42,0,1316766.84,DR,REF200801,ANZ,Savings
19-09-2025 08:23,ANZF65AE4EAB3AD430D98BD,012-345-678,11111111,KFC ANZ,26.72,0,1316740.12,DR,REF748549,ANZ,Savings
19-09-2025 09:48,ANZDE4907854A77440BA7DB,012-345-678,11111111,ZOOM ANZ,42.28,0,1316697.84,DR,REF241498,ANZ,Savings
19-09-2025 10:09,ANZD1B77692F49249E3BB58,012-345-678,11111111,COLES ANZ,93.07,0,1316604.77,DR,REF132259,ANZ,Savings
19-09-2025 10:22,ANZ102320D02E1B46DFB59F,012-345-678,11111111,RAILWAY STATION ANZ,13.65,0,1316591.12,DR,REF654903,ANZ,Savings
19-09-2025 10:30,ANZ6D5DE6A1E06145C8A633,012-345-678,11111111,BANK FEE ANZ,37.91,0,1316553.21,DR,REF436197,ANZ,Savings
19-09-2025 10:36,ANZ37DA486B81BE410CBA6D,012-345-678,11111111,PAYPAL *NETFLIX ANZ,66.92,0,1316486.29,DR,REF660904,ANZ,Savings
19-09-2025 11:02,ANZ8252F3C9CD72495AB213,012-345-678,11111111,APPLE ANZ,9.29,0,1316477,DR,REF756087,ANZ,Savings
19-09-2025 11:23,ANZ9390C1CCCDB74AF59C66,012-345-678,11111111,FLIXBUS ANZ,143.85,0,1316333.15,DR,REF362895,ANZ,Savings
19-09-2025 11:40,ANZ01CCA6A39D4E464D853E,012-345-678,11111111,BANK FEE ANZ,17.06,0,1316316.09,DR,REF218427,ANZ,Savings
19-09-2025 11:44,ANZD11FDC0989A841D2AD8A,012-345-678,11111111,SALARY PAYMENT ANZ,0,6715.8,1323031.89,CR,REF156731,ANZ,Savings
19-09-2025 12:20,ANZFF59F8D20D704B7481DF,012-345-678,11111111,PAY - SALARY ANZ,0,57.34,1323089.23,CR,REF899685,ANZ,Savings
19-09-2025 12:39,ANZFC4405E65E3F47C4BCB9,012-345-678,11111111,SHELL ANZ,23.11,0,1323066.12,DR,REF147334,ANZ,Savings
19-09-2025 13:14,ANZBABD210256DC4AFBA5A0,012-345-678,11111111,BANK FEE ANZ,19.68,0,1323046.44,DR,REF965652,ANZ,Savings
19-09-2025 13:31,ANZD4CFBE5AD3D240F0B40A,012-345-678,11111111,TAFE BOOKSHOP ANZ,78,0,1322968.44,DR,REF336618,ANZ,Savings
19-09-2025 13:39,ANZ1877DEEBC06B4422A441,012-345-678,11111111,JB HI-FI ANZ,14.34,0,1322954.1,DR,REF639666,ANZ,Savings
19-09-2025 14:41,ANZEA8B60769D684BEFA8CF,012-345-678,11111111,HARVEY NORMAN ANZ,13.14,0,1322940.96,DR,REF478767,ANZ,Savings
19-09-2025 14:56,INT3B7DA61EADFB42C09BEF,012-345-678,11111111,TRANSFER FROM CBA 33333333,0,1859.16,1324800.12,CR,INT-26812,ANZ,Savings
19-09-2025 15:23,ANZ30D32A707AFC4F928BEB,012-345-678,11111111,WOOLWORTHS ANZ,5.24,0,1324794.88,DR,REF609730,ANZ,Savings
19-09-2025 15:41,ANZ1092E5BC57424D06A167,012-345-678,11111111,BWS ANZ,40.64,0,1324754.24,DR,REF430803,ANZ,Savings
19-09-2025 16:04,ANZ59187CBD0C7F45D5AE91,012-345-678,11111111,UBER EATS ANZ,4.47,0,1324749.77,DR,REF866785,ANZ,Savings
19-09-2025 16:29,ANZB683B84FDD7344ABA794,012-345-678,11111111,WOOLWORTHS ANZ,44.6,0,1324705.17,DR,REF571741,ANZ,Savings
19-09-2025 17:22,ANZ610CC38CC1944B7A8A54,012-345-678,11111111,CITYLINK ANZ,75.62,0,1324629.55,DR,REF238982,ANZ,Savings
19-09-2025 17:29,ANZ7698B272C4F3403DBA13,012-345-678,11111111,STARBUCKS ANZ,6.77,0,1324622.78,DR,REF320524,ANZ,Savings
19-09-2025 17:32,ANZB4469BF3D0754A0DA76F,012-345-678,11111111,BP ANZ,6.96,0,1324615.82,DR,REF268614,ANZ,Savings
19-09-2025 20:09,ANZC1C581A0E4C84E1796B3,012-345-678,11111111,COLES ANZ,89.8,0,1324526.02,DR,REF907393,ANZ,Savings
19-09-2025 20:15,INT0A5AC3C7FFFC4553B42E,012-345-678,11111111,TRANSFER FROM CBA 22222222,0,88.83,1324614.85,CR,INT-57339,ANZ,Savings
19-09-2025 20:34,ANZ1ECD6DD78B61490E9459,012-345-678,11111111,PAYROLL CREDIT ANZ,0,1746.05,1326360.9,CR,REF358629,ANZ,Savings
19-09-2025 20:35,ANZ5BF48EE52B3D4998A722,012-345-678,11111111,JB HI-FI ANZ,36.89,0,1326324.01,DR,REF175893,ANZ,Savings
19-09-2025 20:37,ANZ345F29B748204AECAF3B,012-345-678,11111111,FLIXBUS ANZ,39.05,0,1326284.96,DR,REF208169,ANZ,Savings
19-09-2025 21:28,ANZ0A63CFA6E75E4D739B92,012-345-678,11111111,7-ELEVEN ANZ,37.62,0,1326247.34,DR,REF712874,ANZ,Savings
19-09-2025 21:55,ANZE17E1460EEB544B98AD9,012-345-678,11111111,APPLE ANZ,84.85,0,1326162.49,DR,REF282899,ANZ,Savings
19-09-2025 22:54,ANZ0A948AD9701644869088,012-345-678,11111111,ZOOM ANZ,11.02,0,1326151.47,DR,REF673825,ANZ,Savings
19-09-2025 23:05,ANZF1AA90761D744FD186E2,012-345-678,11111111,ALDI ANZ,9.91,0,1326141.56,DR,REF866680,ANZ,Savings
19-09-2025 23:09,ANZ6EF718FE924D4C89B11E,012-345-678,11111111,KFC ANZ,21,0,1326120.56,DR,REF869233,ANZ,Savings
19-09-2025 23:13,ANZ0E7BD1383A2B4E338F90,012-345-678,11111111,ALDI ANZ,45.3,0,1326075.26,DR,REF417188,ANZ,Savings
20-09-2025 00:03,ANZF9A155A672E24E4ABF70,012-345-678,11111111,PAY - SALARY ANZ,0,5495.82,1331571.08,CR,REF309905,ANZ,Savings
20-09-2025 00:15,ANZ40C9DF3A652941DD8379,012-345-678,11111111,BANK FEE ANZ,15.78,0,1331555.3,DR,REF953955,ANZ,Savings
20-09-2025 00:17,ANZ7B53D61D476C4DCBA548,012-345-678,11111111,ZOOM ANZ,62.32,0,1331492.98,DR,REF147594,ANZ,Savings
20-09-2025 00:19,ANZ5EE1A6DAB41F4CD68EA4,012-345-678,11111111,SPOTIFY ANZ,20.56,0,1331472.42,DR,REF485479,ANZ,Savings
20-09-2025 00:25,ANZF55D20F1C2C145C28661,012-345-678,11111111,MCDONALDS ANZ,47.98,0,1331424.44,DR,REF938142,ANZ,Savings
20-09-2025 00:26,ANZB55ED5A2340F469394EF,012-345-678,11111111,ALDI ANZ,2.07,0,1331422.37,DR,REF504115,ANZ,Savings
20-09-2025 01:42,ANZ490A879BCC054D299A82,012-345-678,11111111,WAGES CREDIT ANZ,0,4659.44,1336081.81,CR,REF540857,ANZ,Savings
20-09-2025 01:48,ANZ35F66B56086A4DD2BE2F,012-345-678,11111111,WOOLWORTHS ANZ,21.16,0,1336060.65,DR,REF859022,ANZ,Savings
20-09-2025 01:59,ANZ0BAFC47F9B034AF7A775,012-345-678,11111111,DOMINO'S PIZZA ANZ,179.4,0,1335881.25,DR,REF507312,ANZ,Savings
20-09-2025 02:59,ANZ8C8FEF88B54446BA98F9,012-345-678,11111111,INTERNET TRANSFER ANZ,17.95,0,1335863.3,DR,REF338110,ANZ,Savings
20-09-2025 03:13,ANZ92294EFFA78941CBA540,012-345-678,11111111,PAY - SALARY ANZ,0,2234.18,1338097.48,CR,REF667925,ANZ,Savings
20-09-2025 03:19,INT2373EE238FDD423F8432,012-345-678,11111111,TRANSFER FROM NAB 44444444,0,556.68,1338654.16,CR,INT-56930,ANZ,Savings
20-09-2025 03:24,ANZCD10047D344249F180E9,012-345-678,11111111,INTERNET TRANSFER ANZ,147.7,0,1338506.46,DR,REF534926,ANZ,Savings
20-09-2025 03:24,ANZ29BA177E1AF54C97807D,012-345-678,11111111,PAYPAL *NETFLIX ANZ,14.84,0,1338491.62,DR,REF616492,ANZ,Savings
20-09-2025 04:07,ANZBFC35E9229BF4E28AFB1,012-345-678,11111111,INTERNET TRANSFER ANZ,28.05,0,1338463.57,DR,REF622869,ANZ,Savings
20-09-2025 04:09,ANZ96758D0FEC3B462AB30F,012-345-678,11111111,PAYMENT GATEWAY ANZ,73.54,0,1338390.03,DR,REF494088,ANZ,Savings
20-09-2025 04:10,ANZ37737799C5C64E908469,012-345-678,11111111,BP ANZ,119.35,0,1338270.68,DR,REF975207,ANZ,Savings
20-09-2025 04:33,ANZD889E9EFDC0142B4AFA1,012-345-678,11111111,FLIXBUS ANZ,102.71,0,1338167.97,DR,REF148202,ANZ,Savings
20-09-2025 05:21,ANZC2889E465AB04040AC35,012-345-678,11111111,RAILWAY STATION ANZ,10.22,0,1338157.75,DR,REF290234,ANZ,Savings
20-09-2025 05:50,ANZC38CE2B156604883A352,012-345-678,11111111,WAGES CREDIT ANZ,0,937.87,1339095.62,CR,REF660511,ANZ,Savings
20-09-2025 06:32,ANZFC0FB7DF7AC243FC854F,012-345-678,11111111,STARBUCKS ANZ,143.41,0,1338952.21,DR,REF100492,ANZ,Savings
20-09-2025 07:06,ANZABD38135188745269EBF,012-345-678,11111111,AMAZON AU ANZ,25.5,0,1338926.71,DR,REF142609,ANZ,Savings
20-09-2025 07:15,ANZB2CFEB846E774B7085D9,012-345-678,11111111,RAILWAY STATION ANZ,47.34,0,1338879.37,DR,REF235509,ANZ,Savings
20-09-2025 07:27,ANZ581E1B2592234E5E9508,012-345-678,11111111,ALDI ANZ,8.75,0,1338870.62,DR,REF240902,ANZ,Savings
20-09-2025 07:46,ANZ243622EA92E349429377,012-345-678,11111111,PAYROLL CREDIT ANZ,0,6801.5,1345672.12,CR,REF184605,ANZ,Savings
20-09-2025 07:46,ANZ48DE34CEFAED4C46A6EF,012-345-678,11111111,JB HI-FI ANZ,2.89,0,1345669.23,DR,REF131349,ANZ,Savings
20-09-2025 07:59,ANZE63A35F4E7C14B3ABB70,012-345-678,11111111,INTERNET TRANSFER ANZ,70.82,0,1345598.41,DR,REF165888,ANZ,Savings
20-09-2025 08:32,ANZ6789B30AD84641CE938B,012-345-678,11111111,CITYLINK ANZ,58.6,0,1345539.81,DR,REF697336,ANZ,Savings
20-09-2025 08:34,ANZ33635FC3EE324696A1DC,012-345-678,11111111,PAYROLL CREDIT ANZ,0,753.4,1346293.21,CR,REF324438,ANZ,Savings
20-09-2025 08:37,ANZ8FAFDFC16A8B4001A619,012-345-678,11111111,UBER EATS ANZ,41.6,0,1346251.61,DR,REF739791,ANZ,Savings
20-09-2025 08:53,ANZ0CE93328AD7040DCB6B6,012-345-678,11111111,DOMINO'S PIZZA ANZ,9.84,0,1346241.77,DR,REF527455,ANZ,Savings
20-09-2025 09:46,ANZ43055D69F492448D9994,012-345-678,11111111,JB HI-FI ANZ,20.36,0,1346221.41,DR,REF258828,ANZ,Savings
20-09-2025 10:32,ANZ46D6ABA7028440E59E7E,012-345-678,11111111,KFC ANZ,191.04,0,1346030.37,DR,REF139226,ANZ,Savings
20-09-2025 10:56,ANZ4E522F7E9FA24627ABA7,012-345-678,11111111,SALARY PAYMENT ANZ,0,6407.74,1352438.11,CR,REF357069,ANZ,Savings
20-09-2025 11:24,ANZ3516E8694B6043AE9E1D,012-345-678,11111111,PAYMENT GATEWAY ANZ,15.15,0,1352422.96,DR,REF317042,ANZ,Savings
20-09-2025 11:30,ANZE1CFB06CF33C469A958F,012-345-678,11111111,BIGW ANZ,20.41,0,1352402.55,DR,REF724233,ANZ,Savings
20-09-2025 11:37,ANZD148962AD80C4CCD803A,012-345-678,11111111,ALDI ANZ,25.38,0,1352377.17,DR,REF995253,ANZ,Savings
20-09-2025 11:40,ANZD12D9E15768E471D9F3D,012-345-678,11111111,SPOTIFY ANZ,43.98,0,1352333.19,DR,REF978703,ANZ,Savings
20-09-2025 12:02,ANZDC88DD981FDF41179601,012-345-678,11111111,MCDONALDS ANZ,103.3,0,1352229.89,DR,REF382773,ANZ,Savings
20-09-2025 12:11,ANZ02D052B553E6497AA9BF,012-345-678,11111111,BIGW ANZ,29.29,0,1352200.6,DR,REF653165,ANZ,Savings
20-09-2025 12:23,ANZ729025FF2D3B4E89872D,012-345-678,11111111,ZOOM ANZ,45.12,0,1352155.48,DR,REF255045,ANZ,Savings
20-09-2025 12:25,ANZ7A50E5BE64C44AE4A9E3,012-345-678,11111111,7-ELEVEN ANZ,54.51,0,1352100.97,DR,REF827686,ANZ,Savings
20-09-2025 12:56,ANZB3C2F3EA6A4B47289D2B,012-345-678,11111111,BP ANZ,92.17,0,1352008.8,DR,REF777476,ANZ,Savings
20-09-2025 13:00,ANZA8A9F78BC5C94298A496,012-345-678,11111111,7-ELEVEN ANZ,14.5,0,1351994.3,DR,REF498740,ANZ,Savings
20-09-2025 13:06,ANZ5F7E42FB92644949B37C,012-345-678,11111111,ZOOM ANZ,26.57,0,1351967.73,DR,REF159077,ANZ,Savings
20-09-2025 13:47,ANZB495F372E4ED43AAB834,012-345-678,11111111,ZOOM ANZ,75.01,0,1351892.72,DR,REF604315,ANZ,Savings
20-09-2025 14:18,ANZ1C50C7D9706A4014A9C9,012-345-678,11111111,BWS ANZ,35.71,0,1351857.01,DR,REF143350,ANZ,Savings
20-09-2025 14:19,ANZB849116AB3C34B1786D3,012-345-678,11111111,CITYLINK ANZ,15.85,0,1351841.16,DR,REF288910,ANZ,Savings
20-09-2025 14:22,ANZ94E15D61F51244D999FD,012-345-678,11111111,BANK FEE ANZ,2.82,0,1351838.34,DR,REF709320,ANZ,Savings
20-09-2025 14:36,ANZ67AA1D1DE4594BD886AB,012-345-678,11111111,COLES ANZ,23.08,0,1351815.26,DR,REF539752,ANZ,Savings
20-09-2025 15:06,ANZ5FE8AC194C184BFA9673,012-345-678,11111111,BANK FEE ANZ,13.47,0,1351801.79,DR,REF316760,ANZ,Savings
20-09-2025 15:31,ANZ867E3F908A884900975F,012-345-678,11111111,APPLE ANZ,14.52,0,1351787.27,DR,REF651246,ANZ,Savings
20-09-2025 15:41,ANZ52E42B208EBD43B09AC9,012-345-678,11111111,SALARY PAYMENT ANZ,0,1794.17,1353581.44,CR,REF433226,ANZ,Savings
20-09-2025 16:01,INT2CDE1ECAF05042A38915,012-345-678,11111111,TRANSFER FROM CBA 33333333,0,1816.32,1355397.76,CR,INT-74566,ANZ,Savings
20-09-2025 16:03,ANZ126AA2229F414C6F9D3F,012-345-678,11111111,DOMINO'S PIZZA ANZ,65.02,0,1355332.74,DR,REF930081,ANZ,Savings
20-09-2025 16:16,ANZ2B042BCF9C4D4B66A9E1,012-345-678,11111111,HARVEY NORMAN ANZ,62.89,0,1355269.85,DR,REF146239,ANZ,Savings
20-09-2025 16:25,ANZ3930351046BE4190AEA1,012-345-678,11111111,APPLE ANZ,53.24,0,1355216.61,DR,REF499616,ANZ,Savings
20-09-2025 17:30,ANZBF0947D689924215A81B,012-345-678,11111111,STARBUCKS ANZ,90.95,0,1355125.66,DR,REF561559,ANZ,Savings
20-09-2025 17:48,ANZB447AA953D9B4D95BD14,012-345-678,11111111,ZOOM ANZ,67.55,0,1355058.11,DR,REF751209,ANZ,Savings
20-09-2025 18:36,ANZF507F3E02FF84B71B7BD,012-345-678,11111111,LIQUORLAND ANZ,52.71,0,1355005.4,DR,REF124707,ANZ,Savings
20-09-2025 18:40,ANZB3A527CE03E14452B38D,012-345-678,11111111,ALDI ANZ,10.18,0,1354995.22,DR,REF539603,ANZ,Savings
20-09-2025 18:42,ANZ081A49A90F124DB3829C,012-345-678,11111111,PAYMENT GATEWAY ANZ,11.61,0,1354983.61,DR,REF195160,ANZ,Savings
20-09-2025 19:01,ANZ7734B4BBDD8A4C82BE0B,012-345-678,11111111,TAFE BOOKSHOP ANZ,18.27,0,1354965.34,DR,REF350915,ANZ,Savings
20-09-2025 19:03,ANZ85DF3F8F8CD54FCAB60A,012-345-678,11111111,TAFE BOOKSHOP ANZ,84,0,1354881.34,DR,REF574877,ANZ,Savings
20-09-2025 19:07,ANZ2833651AFD294D4185A0,012-345-678,11111111,UBER EATS ANZ,29.04,0,1354852.3,DR,REF762311,ANZ,Savings
20-09-2025 19:28,ANZ59002E98A3F14DAB9C32,012-345-678,11111111,FLIXBUS ANZ,100.26,0,1354752.04,DR,REF809679,ANZ,Savings
20-09-2025 19:32,ANZC933504A6B954EB1A385,012-345-678,11111111,INTERNET TRANSFER ANZ,141.68,0,1354610.36,DR,REF719597,ANZ,Savings
20-09-2025 19:33,ANZ27E16EE908BB4C1C86D4,012-345-678,11111111,JB HI-FI ANZ,53.56,0,1354556.8,DR,REF941495,ANZ,Savings
20-09-2025 20:02,ANZ817F414E6BFD417C8B90,012-345-678,11111111,APPLE ANZ,13.84,0,1354542.96,DR,REF300771,ANZ,Savings
20-09-2025 20:29,ANZB69138B018684156B8A8,012-345-678,11111111,BIGW ANZ,53.36,0,1354489.6,DR,REF793061,ANZ,Savings
20-09-2025 20:42,ANZ8B7A96E76271421FB68D,012-345-678,11111111,LIQUORLAND ANZ,62.25,0,1354427.35,DR,REF807530,ANZ,Savings
20-09-2025 20:55,ANZ1F5A5B6CE83D4DA39073,012-345-678,11111111,TAFE BOOKSHOP ANZ,48.39,0,1354378.96,DR,REF381947,ANZ,Savings
20-09-2025 20:58,ANZA2B8CB56EDB24783A272,012-345-678,11111111,DOMINO'S PIZZA ANZ,7.12,0,1354371.84,DR,REF836660,ANZ,Savings
20-09-2025 21:03,ANZ4DB6F247AA3E42AFBB82,012-345-678,11111111,UBER EATS ANZ,46.52,0,1354325.32,DR,REF781112,ANZ,Savings
20-09-2025 21:22,ANZB61EE01CF5E84484B876,012-345-678,11111111,COLES ANZ,94.04,0,1354231.28,DR,REF476011,ANZ,Savings
20-09-2025 22:00,ANZ811208BB061741168465,012-345-678,11111111,BWS ANZ,65.08,0,1354166.2,DR,REF997264,ANZ,Savings
20-09-2025 23:07,INTA97F76F244E541DC8BB4,012-345-678,11111111,TRANSFER FROM CBA 33333333,0,326.11,1354492.31,CR,INT-19219,ANZ,Savings
20-09-2025 23:35,ANZE663C6EC231641738510,012-345-678,11111111,ALDI ANZ,78.98,0,1354413.33,DR,REF360125,ANZ,Savings
20-09-2025 23:42,ANZF096553793B6434295E9,012-345-678,11111111,BP ANZ,10.34,0,1354402.99,DR,REF149963,ANZ,Savings
20-09-2025 23:55,INT12D6BC2A96F94AC19B4E,012-345-678,11111111,TRANSFER FROM NAB 44444444,0,1510.35,1355913.34,CR,INT-37780,ANZ,Savings
20-09-2025 23:56,ANZ4182329FE60E4F748B4C,012-345-678,11111111,TAFE BOOKSHOP ANZ,31.23,0,1355882.11,DR,REF434568,ANZ,Savings
21-09-2025 00:09,ANZBE96D82FB70F4209A1DC,012-345-678,11111111,UBER EATS ANZ,6.39,0,1355875.72,DR,REF566013,ANZ,Savings
21-09-2025 00:19,ANZ23324538DCB44EBEB3D6,012-345-678,11111111,UBER EATS ANZ,18.13,0,1355857.59,DR,REF900959,ANZ,Savings
21-09-2025 00:23,ANZEFE0E4E1167B4F17A46D,012-345-678,11111111,INTERNET TRANSFER ANZ,2.74,0,1355854.85,DR,REF297600,ANZ,Savings
21-09-2025 00:44,ANZFB9EDCAEAC774D23ACA4,012-345-678,11111111,WAGES CREDIT ANZ,0,603.96,1356458.81,CR,REF684153,ANZ,Savings
21-09-2025 00:47,ANZ5A2D7013B0C44E858160,012-345-678,11111111,ZOOM ANZ,9.93,0,1356448.88,DR,REF792629,ANZ,Savings
21-09-2025 00:49,ANZC26B917762F945469FB7,012-345-678,11111111,HARVEY NORMAN ANZ,153.9,0,1356294.98,DR,REF520045,ANZ,Savings
21-09-2025 01:07,ANZFD9808243B164D64A290,012-345-678,11111111,INTERNET TRANSFER ANZ,71.33,0,1356223.65,DR,REF610043,ANZ,Savings
21-09-2025 01:37,ANZDB7922B37CCE406996F4,012-345-678,11111111,ZOOM ANZ,7.62,0,1356216.03,DR,REF924105,ANZ,Savings
21-09-2025 01:53,ANZ50C6584472E94B518586,012-345-678,11111111,INTERNET TRANSFER ANZ,9.45,0,1356206.58,DR,REF144860,ANZ,Savings
21-09-2025 02:10,ANZ5BD5272446D34C208456,012-345-678,11111111,CITYLINK ANZ,53.56,0,1356153.02,DR,REF262695,ANZ,Savings
21-09-2025 02:53,ANZ52884F756CE4418EB4FF,012-345-678,11111111,APPLE ANZ,45.11,0,1356107.91,DR,REF658278,ANZ,Savings
21-09-2025 03:11,ANZF470F12720344F61A23D,012-345-678,11111111,FLIXBUS ANZ,12.73,0,1356095.18,DR,REF982338,ANZ,Savings
21-09-2025 03:17,ANZBC649138C44440FB8A7A,012-345-678,11111111,MCDONALDS ANZ,195.31,0,1355899.87,DR,REF812377,ANZ,Savings
21-09-2025 03:26,INT06FD975726E94EEDA831,012-345-678,11111111,TRANSFER TO CBA 33333333,120.5,0,1355779.37,DR,INT-52803,ANZ,Savings
21-09-2025 03:43,ANZDAF431813BD0424DA1F3,012-345-678,11111111,STARBUCKS ANZ,19.25,0,1355760.12,DR,REF967796,ANZ,Savings
21-09-2025 03:47,ANZ57E463A03D3B4D8A8BDD,012-345-678,11111111,DOMINO'S PIZZA ANZ,21.24,0,1355738.88,DR,REF344803,ANZ,Savings
21-09-2025 03:54,ANZF85797FFCDAE431497F3,012-345-678,11111111,PAY - SALARY ANZ,0,4667.97,1360406.85,CR,REF460194,ANZ,Savings
21-09-2025 04:01,ANZ875CB16C24924B928215,012-345-678,11111111,PAY - SALARY ANZ,0,3193.38,1363600.23,CR,REF743679,ANZ,Savings
21-09-2025 04:05,ANZDCB198F5F0D64B33B9E5,012-345-678,11111111,APPLE ANZ,5.8,0,1363594.43,DR,REF788160,ANZ,Savings
21-09-2025 04:13,ANZ051D6AD6A7064C8687E6,012-345-678,11111111,UBER EATS ANZ,15.38,0,1363579.05,DR,REF962532,ANZ,Savings
21-09-2025 04:14,ANZ6B4338FFB4DA4946AB4A,012-345-678,11111111,INTERNET TRANSFER ANZ,7.3,0,1363571.75,DR,REF207767,ANZ,Savings
21-09-2025 05:06,INTB4F219884FD54ABB8399,012-345-678,11111111,TRANSFER FROM CBA 22222222,0,998.97,1364570.72,CR,INT-43881,ANZ,Savings
21-09-2025 05:09,ANZ5FB22773B69C4FB89267,012-345-678,11111111,PAYPAL *NETFLIX ANZ,16.05,0,1364554.67,DR,REF863930,ANZ,Savings
21-09-2025 05:21,ANZFFCC192358FA40139190,012-345-678,11111111,PAYPAL *NETFLIX ANZ,31.05,0,1364523.62,DR,REF162551,ANZ,Savings
21-09-2025 06:04,ANZAE83FE9F3338434992BD,012-345-678,11111111,FLIXBUS ANZ,24.78,0,1364498.84,DR,REF786037,ANZ,Savings
21-09-2025 06:13,ANZ8D8B8AD5587C4770BD7B,012-345-678,11111111,SHELL ANZ,100.28,0,1364398.56,DR,REF423558,ANZ,Savings
21-09-2025 06:26,ANZF02450616A1E4F9E9EE5,012-345-678,11111111,SALARY PAYMENT ANZ,0,7328.69,1371727.25,CR,REF851113,ANZ,Savings
21-09-2025 06:43,ANZ8DF3C63D2EA241648569,012-345-678,11111111,WOOLWORTHS ANZ,203.71,0,1371523.54,DR,REF614871,ANZ,Savings
21-09-2025 07:00,ANZ19153CB9B3FC4131A8D3,012-345-678,11111111,SHELL ANZ,21.25,0,1371502.29,DR,REF945244,ANZ,Savings
21-09-2025 07:07,INTB35AF3CD582449358862,012-345-678,11111111,TRANSFER FROM CBA 33333333,0,451.29,1371953.58,CR,INT-98802,ANZ,Savings
21-09-2025 07:14,ANZ4D6387061F204872925F,012-345-678,11111111,BANK FEE ANZ,97.05,0,1371856.53,DR,REF822208,ANZ,Savings
21-09-2025 08:01,ANZA669BCB7BA6F4829A9EA,012-345-678,11111111,RAILWAY STATION ANZ,15.7,0,1371840.83,DR,REF229926,ANZ,Savings
21-09-2025 08:16,ANZ48D267EB44104090AECE,012-345-678,11111111,UBER EATS ANZ,244.28,0,1371596.55,DR,REF252605,ANZ,Savings
21-09-2025 08:26,ANZAAC27285E4F5446A8055,012-345-678,11111111,SPOTIFY ANZ,21.56,0,1371574.99,DR,REF181784,ANZ,Savings
21-09-2025 08:27,ANZC088687785B24DF1A5D7,012-345-678,11111111,TAFE BOOKSHOP ANZ,1.55,0,1371573.44,DR,REF731414,ANZ,Savings
21-09-2025 08:43,ANZ25A2AE1D93554D0CA530,012-345-678,11111111,HARVEY NORMAN ANZ,71.75,0,1371501.69,DR,REF455196,ANZ,Savings
21-09-2025 08:59,ANZ656B997236A5492BBF50,012-345-678,11111111,PAYPAL *NETFLIX ANZ,74.18,0,1371427.51,DR,REF412281,ANZ,Savings
21-09-2025 09:00,ANZE2CE79EA94A943798319,012-345-678,11111111,HARVEY NORMAN ANZ,28.37,0,1371399.14,DR,REF971346,ANZ,Savings
21-09-2025 09:11,ANZ5B6DC45A5E1843E7BB1C,012-345-678,11111111,LIQUORLAND ANZ,11.79,0,1371387.35,DR,REF653492,ANZ,Savings
21-09-2025 10:00,ANZBB51CABAEC1E4EC89A41,012-345-678,11111111,STARBUCKS ANZ,71.72,0,1371315.63,DR,REF493530,ANZ,Savings
21-09-2025 10:10,ANZ40EC116F66F1494995CD,012-345-678,11111111,7-ELEVEN ANZ,88.7,0,1371226.93,DR,REF449026,ANZ,Savings
21-09-2025 10:27,ANZ726AC919258548E59B0F,012-345-678,11111111,BWS ANZ,9.79,0,1371217.14,DR,REF351802,ANZ,Savings
21-09-2025 10:55,ANZF1509E813D1143B5825A,012-345-678,11111111,PAYMENT GATEWAY ANZ,57.76,0,1371159.38,DR,REF409148,ANZ,Savings
21-09-2025 11:23,ANZ0D3717F623B64DC5BEC2,012-345-678,11111111,ZOOM ANZ,85.64,0,1371073.74,DR,REF872899,ANZ,Savings
21-09-2025 11:31,ANZF188EACD215C4FA2911A,012-345-678,11111111,MENULOG ANZ,2.59,0,1371071.15,DR,REF974334,ANZ,Savings
21-09-2025 11:43,ANZCC6A0BB3A6094A4FB3E6,012-345-678,11111111,7-ELEVEN ANZ,13.16,0,1371057.99,DR,REF424952,ANZ,Savings
21-09-2025 12:01,ANZDB1A3111008E464F8A9F,012-345-678,11111111,COLES ANZ,17.75,0,1371040.24,DR,REF532851,ANZ,Savings
21-09-2025 12:19,ANZ0B3C63884DFF49CD8878,012-345-678,11111111,FLIXBUS ANZ,48.67,0,1370991.57,DR,REF570703,ANZ,Savings
21-09-2025 12:27,ANZ738DB0A09C334781BA32,012-345-678,11111111,HARVEY NORMAN ANZ,9.03,0,1370982.54,DR,REF742640,ANZ,Savings
21-09-2025 12:27,ANZ3A87134C3CBF49008E40,012-345-678,11111111,WOOLWORTHS ANZ,43.2,0,1370939.34,DR,REF323565,ANZ,Savings
21-09-2025 12:37,ANZ6686830BCD6244F18816,012-345-678,11111111,KFC ANZ,143.28,0,1370796.06,DR,REF866969,ANZ,Savings
21-09-2025 12:38,ANZ1F1DC2DC27094A59A965,012-345-678,11111111,FLIXBUS ANZ,60.4,0,1370735.66,DR,REF521514,ANZ,Savings
21-09-2025 13:01,INT9C6B3363ACC94D1B88E8,012-345-678,11111111,TRANSFER FROM CBA 22222222,0,255.39,1370991.05,CR,INT-84456,ANZ,Savings
21-09-2025 13:06,ANZ90CE46E53144474A9DD3,012-345-678,11111111,FLIXBUS ANZ,102.84,0,1370888.21,DR,REF458260,ANZ,Savings
21-09-2025 13:10,ANZ6FA83B2BE9E540AD8C1B,012-345-678,11111111,PAYROLL CREDIT ANZ,0,2362.67,1373250.88,CR,REF611537,ANZ,Savings
21-09-2025 13:25,ANZA83158935E2E4BF6A82F,012-345-678,11111111,PAY - SALARY ANZ,0,47.59,1373298.47,CR,REF152692,ANZ,Savings
21-09-2025 13:40,INTDCD20DF6A9634B5CB898,012-345-678,11111111,TRANSFER TO CBA 33333333,261.94,0,1373036.53,DR,INT-81719,ANZ,Savings
21-09-2025 13:42,ANZD7A9936B66564746B492,012-345-678,11111111,HARVEY NORMAN ANZ,22.6,0,1373013.93,DR,REF758287,ANZ,Savings
21-09-2025 14:17,ANZ0E8EDDAA33244FD5A7BF,012-345-678,11111111,HARVEY NORMAN ANZ,72.72,0,1372941.21,DR,REF268984,ANZ,Savings
21-09-2025 14:22,ANZBBE9F2F622E84D9CBADB,012-345-678,11111111,MENULOG ANZ,23.86,0,1372917.35,DR,REF284759,ANZ,Savings
21-09-2025 14:43,ANZBE551089F32148198E8E,012-345-678,11111111,FLIXBUS ANZ,14.45,0,1372902.9,DR,REF926270,ANZ,Savings
21-09-2025 14:47,ANZBCDB15177F91499BB4B0,012-345-678,11111111,COMPANY PAYROLL ANZ,0,7297,1380199.9,CR,REF646507,ANZ,Savings
21-09-2025 14:48,ANZB9EF596C18F04C05B1E3,012-345-678,11111111,FLIXBUS ANZ,50.02,0,1380149.88,DR,REF761533,ANZ,Savings
21-09-2025 15:04,ANZD6BFE26E330748368B7A,012-345-678,11111111,SPOTIFY ANZ,37.92,0,1380111.96,DR,REF699711,ANZ,Savings
21-09-2025 15:14,ANZC9EF50E2AC9E4EF3B0AA,012-345-678,11111111,PAYMENT GATEWAY ANZ,22.05,0,1380089.91,DR,REF620569,ANZ,Savings
21-09-2025 15:52,ANZ874978261E4F43EDA3CC,012-345-678,11111111,BWS ANZ,139,0,1379950.91,DR,REF492472,ANZ,Savings
21-09-2025 16:04,ANZ0BB83F12161743EBB1B1,012-345-678,11111111,CITYLINK ANZ,49.01,0,1379901.9,DR,REF403373,ANZ,Savings
21-09-2025 16:11,ANZ813397495F2B4E5AA070,012-345-678,11111111,MCDONALDS ANZ,16.31,0,1379885.59,DR,REF567047,ANZ,Savings
21-09-2025 16:41,ANZ607AC200423C4717B4DD,012-345-678,11111111,SHELL ANZ,46.38,0,1379839.21,DR,REF692274,ANZ,Savings
21-09-2025 17:30,ANZ7616E9B5DEDE4642A287,012-345-678,11111111,PAYMENT GATEWAY ANZ,19.97,0,1379819.24,DR,REF867114,ANZ,Savings
21-09-2025 17:40,ANZAE3A1227ECCB482E831F,012-345-678,11111111,BWS ANZ,18.83,0,1379800.41,DR,REF132010,ANZ,Savings
21-09-2025 17:54,ANZB4B76D759C3A4B1A989A,012-345-678,11111111,BP ANZ,8.55,0,1379791.86,DR,REF457655,ANZ,Savings
21-09-2025 18:28,ANZ324B5397C7D64326A646,012-345-678,11111111,AMAZON AU ANZ,14.43,0,1379777.43,DR,REF446456,ANZ,Savings
21-09-2025 18:29,ANZ5A66FB36B670440D8A72,012-345-678,11111111,PAYMENT GATEWAY ANZ,29.39,0,1379748.04,DR,REF662231,ANZ,Savings
21-09-2025 18:44,ANZF1D51BAC198D42E7A56B,012-345-678,11111111,7-ELEVEN ANZ,29.27,0,1379718.77,DR,REF958653,ANZ,Savings
21-09-2025 18:57,ANZE2F227627FC147C1AF7A,012-345-678,11111111,7-ELEVEN ANZ,42.79,0,1379675.98,DR,REF766293,ANZ,Savings
21-09-2025 19:00,ANZFB2908BAB4C74D31933D,012-345-678,11111111,WOOLWORTHS ANZ,60.9,0,1379615.08,DR,REF588279,ANZ,Savings
21-09-2025 19:26,ANZABEFC817325A454CAC5E,012-345-678,11111111,BWS ANZ,64.43,0,1379550.65,DR,REF724557,ANZ,Savings
21-09-2025 20:21,ANZ3964273A8FC4406EB376,012-345-678,11111111,BWS ANZ,6.49,0,1379544.16,DR,REF908824,ANZ,Savings
21-09-2025 21:04,ANZ26E3D4CCC80D4F858A6D,012-345-678,11111111,MENULOG ANZ,5.61,0,1379538.55,DR,REF251506,ANZ,Savings
21-09-2025 21:35,ANZ7DBE7BC2C2034DA181F1,012-345-678,11111111,PAYPAL *NETFLIX ANZ,4.21,0,1379534.34,DR,REF692081,ANZ,Savings
21-09-2025 22:01,ANZB6D75AE5EDAE443897F3,012-345-678,11111111,MCDONALDS ANZ,84.04,0,1379450.3,DR,REF384605,ANZ,Savings
21-09-2025 22:03,ANZ3E1726553D9C4496B014,012-345-678,11111111,BWS ANZ,69.8,0,1379380.5,DR,REF992837,ANZ,Savings
21-09-2025 22:12,ANZ79C52993C0B94E6EA295,012-345-678,11111111,ZOOM ANZ,47.62,0,1379332.88,DR,REF489626,ANZ,Savings
21-09-2025 22:21,ANZC48D556CE4D742078122,012-345-678,11111111,7-ELEVEN ANZ,77.35,0,1379255.53,DR,REF823550,ANZ,Savings
21-09-2025 22:23,ANZ22BF2143A3AA452FB4EA,012-345-678,11111111,SALARY PAYMENT ANZ,0,275.42,1379530.95,CR,REF730924,ANZ,Savings
21-09-2025 22:43,ANZ8F24D04F123D4F0091F7,012-345-678,11111111,FLIXBUS ANZ,6.22,0,1379524.73,DR,REF687144,ANZ,Savings
21-09-2025 23:12,ANZCC8397F5E9CB4B05A2D4,012-345-678,11111111,MENULOG ANZ,89.34,0,1379435.39,DR,REF529602,ANZ,Savings
21-09-2025 23:32,ANZE85EB9E6FE8B4BDA9FE1,012-345-678,11111111,HARVEY NORMAN ANZ,23.57,0,1379411.82,DR,REF688441,ANZ,Savings
22-09-2025 00:14,ANZ20A385B816B148B68FD9,012-345-678,11111111,MCDONALDS ANZ,47.43,0,1379364.39,DR,REF440123,ANZ,Savings
22-09-2025 00:30,ANZ060AE8932FBE47E6981F,012-345-678,11111111,SHELL ANZ,214.31,0,1379150.08,DR,REF110548,ANZ,Savings
22-09-2025 00:41,ANZ63546182D5014D949B00,012-345-678,11111111,APPLE ANZ,118.49,0,1379031.59,DR,REF167049,ANZ,Savings
22-09-2025 00:51,ANZ63AFB0615B7A43D7A60D,012-345-678,11111111,MENULOG ANZ,93.4,0,1378938.19,DR,REF822448,ANZ,Savings
22-09-2025 01:23,ANZ0F9C1F6B4AAD455DAD3E,012-345-678,11111111,RAILWAY STATION ANZ,9.41,0,1378928.78,DR,REF154271,ANZ,Savings
22-09-2025 01:46,ANZDC46D10F7474449F997A,012-345-678,11111111,WAGES CREDIT ANZ,0,6690.08,1385618.86,CR,REF956330,ANZ,Savings
22-09-2025 01:56,ANZ28FAC805F747427C9915,012-345-678,11111111,COLES ANZ,5.95,0,1385612.91,DR,REF236408,ANZ,Savings
22-09-2025 01:57,ANZE1F1C28B90104A3294AD,012-345-678,11111111,PAYPAL *NETFLIX ANZ,90.09,0,1385522.82,DR,REF605621,ANZ,Savings
22-09-2025 02:30,ANZ9CCF33176FEE429EB926,012-345-678,11111111,DOMINO'S PIZZA ANZ,34.65,0,1385488.17,DR,REF298802,ANZ,Savings
22-09-2025 02:39,ANZ3071A562874E4F3CA0EE,012-345-678,11111111,BIGW ANZ,75.18,0,1385412.99,DR,REF643173,ANZ,Savings
22-09-2025 02:58,INTF8E2E314FC654B2CA85D,012-345-678,11111111,TRANSFER FROM CBA 33333333,0,314.84,1385727.83,CR,INT-78863,ANZ,Savings
22-09-2025 03:11,ANZ5CE721E44D3F4167B5A3,012-345-678,11111111,CITYLINK ANZ,35.59,0,1385692.24,DR,REF895569,ANZ,Savings
22-09-2025 03:15,ANZB6455B83CA2F4474A71C,012-345-678,11111111,FLIXBUS ANZ,95.25,0,1385596.99,DR,REF229325,ANZ,Savings
22-09-2025 03:40,ANZ9E471C9B93A94DC4A0D1,012-345-678,11111111,BP ANZ,1.5,0,1385595.49,DR,REF447970,ANZ,Savings
22-09-2025 04:07,ANZC6AEF797F5E0411DAEE8,012-345-678,11111111,MENULOG ANZ,53.63,0,1385541.86,DR,REF615433,ANZ,Savings
22-09-2025 04:07,ANZE345A5E4AA3E472AB95B,012-345-678,11111111,BWS ANZ,81.23,0,1385460.63,DR,REF489216,ANZ,Savings
22-09-2025 04:41,ANZDB1C892146534ED78916,012-345-678,11111111,ZOOM ANZ,3.63,0,1385457,DR,REF559804,ANZ,Savings
22-09-2025 04:50,ANZ8F462F29D4594498AD6F,012-345-678,11111111,WOOLWORTHS ANZ,77.4,0,1385379.6,DR,REF588955,ANZ,Savings
22-09-2025 04:51,ANZ44F1F0F7CA7A489589E6,012-345-678,11111111,FLIXBUS ANZ,11.54,0,1385368.06,DR,REF692411,ANZ,Savings
22-09-2025 05:06,ANZDCEE0AF26DB3441A837D,012-345-678,11111111,BANK FEE ANZ,88.49,0,1385279.57,DR,REF127564,ANZ,Savings
22-09-2025 05:07,ANZ54717A837DB04A2E862D,012-345-678,11111111,TAFE BOOKSHOP ANZ,14.77,0,1385264.8,DR,REF200425,ANZ,Savings
22-09-2025 05:14,ANZD5EC800E61C9495AA10A,012-345-678,11111111,PAYMENT GATEWAY ANZ,61.82,0,1385202.98,DR,REF737106,ANZ,Savings
22-09-2025 05:14,INTBDA1618B5E6C4B3F88A7,012-345-678,11111111,TRANSFER TO CBA 22222222,1872.51,0,1383330.47,DR,INT-62691,ANZ,Savings
22-09-2025 05:30,INTA7CA986B8BB845589890,012-345-678,11111111,TRANSFER TO NAB 44444444,768.66,0,1382561.81,DR,INT-36755,ANZ,Savings
22-09-2025 05:58,ANZD9E3AFD1E3AE4602A04F,012-345-678,11111111,INTERNET TRANSFER ANZ,20.48,0,1382541.33,DR,REF408132,ANZ,Savings
22-09-2025 06:52,ANZ1B34690FCEA148AFBB90,012-345-678,11111111,JB HI-FI ANZ,51.64,0,1382489.69,DR,REF897094,ANZ,Savings
22-09-2025 07:04,ANZ6372C06A001D433AB1E0,012-345-678,11111111,ZOOM ANZ,99.03,0,1382390.66,DR,REF155880,ANZ,Savings
22-09-2025 07:37,INT75EF96633B974C66B1D8,012-345-678,11111111,TRANSFER FROM CBA 33333333,0,725.56,1383116.22,CR,INT-63696,ANZ,Savings
22-09-2025 07:52,ANZ365DFE943C33426ABB09,012-345-678,11111111,WOOLWORTHS ANZ,176.93,0,1382939.29,DR,REF850781,ANZ,Savings
22-09-2025 08:17,ANZ4B22280E19804BA8B4BF,012-345-678,11111111,SHELL ANZ,48.33,0,1382890.96,DR,REF914030,ANZ,Savings
22-09-2025 08:41,ANZCCB3C1C00A654CD0B090,012-345-678,11111111,MENULOG ANZ,95.31,0,1382795.65,DR,REF522240,ANZ,Savings
22-09-2025 09:31,INT46A86472DB6E4903B9DD,012-345-678,11111111,TRANSFER TO NAB 44444444,1217.07,0,1381578.58,DR,INT-44880,ANZ,Savings
22-09-2025 09:41,ANZ54FE7B3C74C14888A92F,012-345-678,11111111,INTERNET TRANSFER ANZ,17.76,0,1381560.82,DR,REF888201,ANZ,Savings
22-09-2025 09:51,ANZC0149FFE67594D05B2EA,012-345-678,11111111,UBER EATS ANZ,44.43,0,1381516.39,DR,REF255124,ANZ,Savings
22-09-2025 10:05,ANZ0B32E2361D42491EACDD,012-345-678,11111111,WOOLWORTHS ANZ,40.94,0,1381475.45,DR,REF231652,ANZ,Savings
22-09-2025 10:13,ANZ8C806B599CAF4D91A8FF,012-345-678,11111111,7-ELEVEN ANZ,38.93,0,1381436.52,DR,REF662203,ANZ,Savings
22-09-2025 10:21,ANZ725724ECFB4F448B8132,012-345-678,11111111,MENULOG ANZ,31.02,0,1381405.5,DR,REF417785,ANZ,Savings
22-09-2025 10:49,ANZ748113B93F6A4BA18856,012-345-678,11111111,7-ELEVEN ANZ,16.22,0,1381389.28,DR,REF749767,ANZ,Savings
22-09-2025 10:53,ANZ4E2D810BBE184203A716,012-345-678,11111111,CITYLINK ANZ,51.41,0,1381337.87,DR,REF393391,ANZ,Savings
22-09-2025 10:53,ANZ516922CDCAD640F2A751,012-345-678,11111111,PAYPAL *NETFLIX ANZ,4.86,0,1381333.01,DR,REF289145,ANZ,Savings
22-09-2025 11:04,ANZ98E0D29EED06476EBAB6,012-345-678,11111111,PAYROLL CREDIT ANZ,0,7934.9,1389267.91,CR,REF151540,ANZ,Savings
22-09-2025 11:04,ANZC973FD1FFDED48DD86E6,012-345-678,11111111,KFC ANZ,152.28,0,1389115.63,DR,REF114509,ANZ,Savings
22-09-2025 12:10,ANZ1B0B0568D4004CB3992D,012-345-678,11111111,JB HI-FI ANZ,50.69,0,1389064.94,DR,REF963254,ANZ,Savings
22-09-2025 13:12,ANZ7203C62877E14107AAB1,012-345-678,11111111,WOOLWORTHS ANZ,7.12,0,1389057.82,DR,REF953778,ANZ,Savings
22-09-2025 13:16,ANZF8B2529644A4486D8C34,012-345-678,11111111,7-ELEVEN ANZ,259.68,0,1388798.14,DR,REF433533,ANZ,Savings
22-09-2025 13:48,ANZ4A154442ECBF4362A2DE,012-345-678,11111111,RAILWAY STATION ANZ,20.4,0,1388777.74,DR,REF434946,ANZ,Savings
22-09-2025 15:35,INTB3E3855973DF4FA7B3C7,012-345-678,11111111,TRANSFER TO NAB 44444444,1741.48,0,1387036.26,DR,INT-16502,ANZ,Savings
22-09-2025 15:48,ANZ0DDE5D86DEAA44FFB554,012-345-678,11111111,MENULOG ANZ,9.49,0,1387026.77,DR,REF971297,ANZ,Savings
22-09-2025 16:40,ANZ86068FD0AB8D4C988FA4,012-345-678,11111111,7-ELEVEN ANZ,57.78,0,1386968.99,DR,REF219763,ANZ,Savings
22-09-2025 16:47,ANZ8B8B39C500114E24AC90,012-345-678,11111111,SPOTIFY ANZ,4.51,0,1386964.48,DR,REF745887,ANZ,Savings
22-09-2025 17:15,ANZ75B8364B28494AAD93B4,012-345-678,11111111,KFC ANZ,33.87,0,1386930.61,DR,REF926742,ANZ,Savings
22-09-2025 17:33,ANZ0AA634CE091A45F6A9CC,012-345-678,11111111,JB HI-FI ANZ,31.45,0,1386899.16,DR,REF292146,ANZ,Savings
22-09-2025 18:07,ANZ1017072310904415BB93,012-345-678,11111111,7-ELEVEN ANZ,14.44,0,1386884.72,DR,REF881844,ANZ,Savings
22-09-2025 18:12,ANZ7928F4445B764D2987C1,012-345-678,11111111,ZOOM ANZ,12.41,0,1386872.31,DR,REF327332,ANZ,Savings
22-09-2025 18:30,ANZ9CBFE8FC0F3D41D1B1D1,012-345-678,11111111,MENULOG ANZ,75.61,0,1386796.7,DR,REF663481,ANZ,Savings
22-09-2025 18:38,ANZCDB461A99BCC421BB580,012-345-678,11111111,BP ANZ,18.15,0,1386778.55,DR,REF250058,ANZ,Savings
22-09-2025 18:54,ANZ4C53BCC8A121416CAC37,012-345-678,11111111,FLIXBUS ANZ,17.8,0,1386760.75,DR,REF530999,ANZ,Savings
22-09-2025 19:06,ANZ80785E97CAEC4B0FADA7,012-345-678,11111111,TAFE BOOKSHOP ANZ,31.43,0,1386729.32,DR,REF241767,ANZ,Savings
22-09-2025 19:13,ANZ315BB054E66340BB8ED4,012-345-678,11111111,WOOLWORTHS ANZ,3.79,0,1386725.53,DR,REF896680,ANZ,Savings
22-09-2025 19:38,ANZB58E939F7EB94D0CA478,012-345-678,11111111,KFC ANZ,40.39,0,1386685.14,DR,REF181617,ANZ,Savings
22-09-2025 19:57,INT81FCAD4F7992466DA26C,012-345-678,11111111,TRANSFER TO NAB 44444444,86.57,0,1386598.57,DR,INT-12320,ANZ,Savings
22-09-2025 20:14,ANZ5ED02E42EF9F49CFAFF1,012-345-678,11111111,APPLE ANZ,41.09,0,1386557.48,DR,REF189266,ANZ,Savings
22-09-2025 20:19,ANZE1FB22E12A5C47F38BEF,012-345-678,11111111,STARBUCKS ANZ,49.67,0,1386507.81,DR,REF268322,ANZ,Savings
22-09-2025 20:44,ANZ899D6A2EE090441F8E0A,012-345-678,11111111,CITYLINK ANZ,106.72,0,1386401.09,DR,REF387528,ANZ,Savings
22-09-2025 21:17,ANZ807143E40EAD49629AA5,012-345-678,11111111,DOMINO'S PIZZA ANZ,52.32,0,1386348.77,DR,REF804373,ANZ,Savings
22-09-2025 21:57,ANZC4595F9E49E04F47BB69,012-345-678,11111111,WOOLWORTHS ANZ,144.39,0,1386204.38,DR,REF444154,ANZ,Savings
22-09-2025 22:05,ANZE2824AC935B64620B6A7,012-345-678,11111111,PAYMENT GATEWAY ANZ,55.54,0,1386148.84,DR,REF654119,ANZ,Savings
22-09-2025 22:13,ANZAB49B3917DA544EF8332,012-345-678,11111111,TAFE BOOKSHOP ANZ,16.62,0,1386132.22,DR,REF862324,ANZ,Savings
22-09-2025 22:24,ANZ26C1FCAF6AFB48689002,012-345-678,11111111,PAY - SALARY ANZ,0,2284.94,1388417.16,CR,REF777038,ANZ,Savings
22-09-2025 22:50,ANZBBF3BE2883B440659E1F,012-345-678,11111111,COMPANY PAYROLL ANZ,0,2449.91,1390867.07,CR,REF787794,ANZ,Savings
22-09-2025 23:03,ANZ9A744720FAE04E699080,012-345-678,11111111,AMAZON AU ANZ,33.4,0,1390833.67,DR,REF528583,ANZ,Savings
22-09-2025 23:13,ANZB6D69229CFBE4E5C8F68,012-345-678,11111111,BP ANZ,23.66,0,1390810.01,DR,REF140420,ANZ,Savings
22-09-2025 23:31,ANZ49CECB6BC480420791BC,012-345-678,11111111,HARVEY NORMAN ANZ,75.17,0,1390734.84,DR,REF870260,ANZ,Savings
22-09-2025 23:40,ANZ7B6EE549DFCF47FBB9CC,012-345-678,11111111,SHELL ANZ,8.94,0,1390725.9,DR,REF123263,ANZ,Savings
23-09-2025 00:00,INT034F9D62740F42A2AA83,012-345-678,11111111,TRANSFER TO NAB 44444444,776.69,0,1389949.21,DR,INT-78036,ANZ,Savings
23-09-2025 00:02,ANZ8BBBC67BAB3043C3AA0A,012-345-678,11111111,HARVEY NORMAN ANZ,135.43,0,1389813.78,DR,REF829546,ANZ,Savings
23-09-2025 00:32,ANZB93DE48DAC4244A6BC7D,012-345-678,11111111,PAYMENT GATEWAY ANZ,127.67,0,1389686.11,DR,REF146746,ANZ,Savings
23-09-2025 01:38,ANZ7637435D2E5843798BDD,012-345-678,11111111,WOOLWORTHS ANZ,7.67,0,1389678.44,DR,REF146307,ANZ,Savings
23-09-2025 01:41,ANZ824BB52C13ED4B85B8DD,012-345-678,11111111,WOOLWORTHS ANZ,73.8,0,1389604.64,DR,REF536458,ANZ,Savings
23-09-2025 01:45,ANZEA5B8ED88D89488E936B,012-345-678,11111111,PAYPAL *NETFLIX ANZ,86.83,0,1389517.81,DR,REF122043,ANZ,Savings
23-09-2025 02:14,ANZ6EED555932A046978A90,012-345-678,11111111,LIQUORLAND ANZ,24.09,0,1389493.72,DR,REF205693,ANZ,Savings
23-09-2025 03:06,ANZF1ABD8B67BA9466EBE96,012-345-678,11111111,BIGW ANZ,31.03,0,1389462.69,DR,REF319207,ANZ,Savings
23-09-2025 04:02,ANZ3F3FA8462FB14182B446,012-345-678,11111111,MCDONALDS ANZ,40.62,0,1389422.07,DR,REF537819,ANZ,Savings
23-09-2025 04:10,ANZC7E5F5E39E7243BB8EB0,012-345-678,11111111,DOMINO'S PIZZA ANZ,54.25,0,1389367.82,DR,REF781874,ANZ,Savings
23-09-2025 04:24,ANZ53B0A2276C3144C28702,012-345-678,11111111,PAYMENT GATEWAY ANZ,19.81,0,1389348.01,DR,REF724504,ANZ,Savings
23-09-2025 04:38,ANZCDA0D6970DF14A02A75B,012-345-678,11111111,KFC ANZ,71.35,0,1389276.66,DR,REF467052,ANZ,Savings
23-09-2025 04:40,ANZ0DDE5FD797F1476B8854,012-345-678,11111111,WOOLWORTHS ANZ,21.66,0,1389255,DR,REF588393,ANZ,Savings
23-09-2025 05:09,ANZCFC6972A756D456986A3,012-345-678,11111111,MCDONALDS ANZ,16.61,0,1389238.39,DR,REF875185,ANZ,Savings
23-09-2025 05:25,ANZ7C40522B7652466D8B03,012-345-678,11111111,KFC ANZ,15.37,0,1389223.02,DR,REF312925,ANZ,Savings
23-09-2025 06:16,ANZ0B0A65ED4BC54999A94C,012-345-678,11111111,PAY - SALARY ANZ,0,8.16,1389231.18,CR,REF692573,ANZ,Savings
23-09-2025 06:23,ANZADAB60092CEB427BBEEB,012-345-678,11111111,COMPANY PAYROLL ANZ,0,6619.28,1395850.46,CR,REF630171,ANZ,Savings
23-09-2025 07:53,ANZ9182EC2A3D6A4EF3907F,012-345-678,11111111,PAY - SALARY ANZ,0,3400.97,1399251.43,CR,REF425964,ANZ,Savings
23-09-2025 08:05,ANZ3830D5CE63A54C2FB5B5,012-345-678,11111111,SPOTIFY ANZ,8.46,0,1399242.97,DR,REF863610,ANZ,Savings
23-09-2025 08:05,ANZ73F5A1483D744DA183D5,012-345-678,11111111,TAFE BOOKSHOP ANZ,26.92,0,1399216.05,DR,REF958862,ANZ,Savings
23-09-2025 08:20,ANZA8AB9AEC202B4946A418,012-345-678,11111111,ZOOM ANZ,4.19,0,1399211.86,DR,REF121788,ANZ,Savings
23-09-2025 08:34,ANZ17AE710F5F1E488FA98F,012-345-678,11111111,MENULOG ANZ,161.99,0,1399049.87,DR,REF416419,ANZ,Savings
23-09-2025 08:40,ANZF57F44C223F544079E17,012-345-678,11111111,SHELL ANZ,7.43,0,1399042.44,DR,REF867114,ANZ,Savings
23-09-2025 09:00,ANZ1F773212B5854261A3FA,012-345-678,11111111,7-ELEVEN ANZ,11.47,0,1399030.97,DR,REF705765,ANZ,Savings
23-09-2025 09:13,ANZE40595EC6B184991838F,012-345-678,11111111,PAYMENT GATEWAY ANZ,68.61,0,1398962.36,DR,REF635184,ANZ,Savings
23-09-2025 09:31,ANZF24B3E890EE24001BF3C,012-345-678,11111111,BIGW ANZ,4.56,0,1398957.8,DR,REF599955,ANZ,Savings
23-09-2025 09:34,INT98C1C695850D499AB43C,012-345-678,11111111,TRANSFER TO CBA 33333333,508.11,0,1398449.69,DR,INT-56407,ANZ,Savings
23-09-2025 09:51,ANZ915443669BC8400A815D,012-345-678,11111111,TAFE BOOKSHOP ANZ,27.97,0,1398421.72,DR,REF984840,ANZ,Savings
23-09-2025 10:03,ANZAE68CF16BC9946FDAFC3,012-345-678,11111111,BANK FEE ANZ,30.57,0,1398391.15,DR,REF836525,ANZ,Savings
23-09-2025 10:06,ANZB27A04CAEE594354AAA7,012-345-678,11111111,SALARY PAYMENT ANZ,0,6393.86,1404785.01,CR,REF311405,ANZ,Savings
23-09-2025 10:14,ANZ63CC0DFAB0D9439E8D73,012-345-678,11111111,7-ELEVEN ANZ,103.64,0,1404681.37,DR,REF379556,ANZ,Savings
23-09-2025 10:21,ANZAA440C5CEB124BFA9C08,012-345-678,11111111,HARVEY NORMAN ANZ,18.39,0,1404662.98,DR,REF704590,ANZ,Savings
23-09-2025 10:54,ANZ02D03903242B484F934E,012-345-678,11111111,KFC ANZ,23.87,0,1404639.11,DR,REF612710,ANZ,Savings
23-09-2025 11:13,ANZFB36644F8182490CBF41,012-345-678,11111111,SALARY PAYMENT ANZ,0,484.36,1405123.47,CR,REF474363,ANZ,Savings
23-09-2025 11:23,ANZ25B92E42C5004F9987D8,012-345-678,11111111,UBER EATS ANZ,15.29,0,1405108.18,DR,REF707208,ANZ,Savings
23-09-2025 11:31,ANZ56620E799EBF4B40A590,012-345-678,11111111,HARVEY NORMAN ANZ,66.86,0,1405041.32,DR,REF604241,ANZ,Savings
23-09-2025 11:36,ANZ5FCCD319E8F34BE5BE1C,012-345-678,11111111,KFC ANZ,40.76,0,1405000.56,DR,REF229746,ANZ,Savings
23-09-2025 11:38,ANZ85E0CE17A03348649695,012-345-678,11111111,BP ANZ,24.77,0,1404975.79,DR,REF301634,ANZ,Savings
23-09-2025 11:46,ANZECD698714CA8465C9137,012-345-678,11111111,TAFE BOOKSHOP ANZ,6.05,0,1404969.74,DR,REF798891,ANZ,Savings
23-09-2025 11:57,ANZE865CB7EBF654BD4B66B,012-345-678,11111111,STARBUCKS ANZ,4.86,0,1404964.88,DR,REF778719,ANZ,Savings
23-09-2025 12:04,ANZ48C227976AB34D18B354,012-345-678,11111111,WAGES CREDIT ANZ,0,2651.69,1407616.57,CR,REF471482,ANZ,Savings
23-09-2025 12:09,INT09ECAE2B5C804E83A2A7,012-345-678,11111111,TRANSFER TO NAB 44444444,1246.95,0,1406369.62,DR,INT-52565,ANZ,Savings
23-09-2025 12:23,ANZ4495401B6EFB4B00BBDD,012-345-678,11111111,PAYMENT GATEWAY ANZ,45.88,0,1406323.74,DR,REF719685,ANZ,Savings
23-09-2025 12:30,ANZ7A2D6973B3474AA79064,012-345-678,11111111,COMPANY PAYROLL ANZ,0,1836.34,1408160.08,CR,REF647651,ANZ,Savings
23-09-2025 12:33,ANZ8D5E4F9C46584A0893FB,012-345-678,11111111,WOOLWORTHS ANZ,71.09,0,1408088.99,DR,REF689492,ANZ,Savings
23-09-2025 12:37,ANZ72C24E719DBC43B9AC5F,012-345-678,11111111,CITYLINK ANZ,21.96,0,1408067.03,DR,REF326715,ANZ,Savings
23-09-2025 13:20,ANZ9AD9CE7E71EE42FE9353,012-345-678,11111111,JB HI-FI ANZ,16.77,0,1408050.26,DR,REF899590,ANZ,Savings
23-09-2025 13:44,ANZ3FE0CBAD28714E52BF55,012-345-678,11111111,MCDONALDS ANZ,116.3,0,1407933.96,DR,REF629862,ANZ,Savings
23-09-2025 13:47,ANZ7C674266E3FC4923AA6A,012-345-678,11111111,WOOLWORTHS ANZ,58.25,0,1407875.71,DR,REF326637,ANZ,Savings
23-09-2025 13:58,ANZ63C3D876E39343AE8FF9,012-345-678,11111111,LIQUORLAND ANZ,76.75,0,1407798.96,DR,REF316881,ANZ,Savings
23-09-2025 14:04,ANZA5736CD4FF7B42B49ED0,012-345-678,11111111,PAYPAL *NETFLIX ANZ,41.64,0,1407757.32,DR,REF379726,ANZ,Savings
23-09-2025 14:11,ANZ64226105B4BA422C8389,012-345-678,11111111,CITYLINK ANZ,68.49,0,1407688.83,DR,REF721527,ANZ,Savings
23-09-2025 14:28,ANZ3E2B1A4762004DAA8662,012-345-678,11111111,WOOLWORTHS ANZ,46.75,0,1407642.08,DR,REF535019,ANZ,Savings
23-09-2025 14:35,ANZAC198695F12F48889B4B,012-345-678,11111111,MENULOG ANZ,14.79,0,1407627.29,DR,REF526645,ANZ,Savings
23-09-2025 15:15,ANZ6A200C1955C14633855B,012-345-678,11111111,BIGW ANZ,39.43,0,1407587.86,DR,REF482323,ANZ,Savings
23-09-2025 15:28,ANZA39D1B2D817149FFA989,012-345-678,11111111,BP ANZ,26.3,0,1407561.56,DR,REF440216,ANZ,Savings
23-09-2025 15:35,ANZEDA0F6BFEAA7450993C7,012-345-678,11111111,STARBUCKS ANZ,22.78,0,1407538.78,DR,REF502163,ANZ,Savings
23-09-2025 15:39,ANZEC1F55458FF6464D8B62,012-345-678,11111111,FLIXBUS ANZ,143.29,0,1407395.49,DR,REF288183,ANZ,Savings
23-09-2025 15:53,ANZF140745A8ACA49339BB4,012-345-678,11111111,UBER EATS ANZ,33.77,0,1407361.72,DR,REF974676,ANZ,Savings
23-09-2025 16:15,ANZ37CF72A745984D7B992A,012-345-678,11111111,KFC ANZ,49.03,0,1407312.69,DR,REF531455,ANZ,Savings
23-09-2025 16:17,ANZ9683D2155538459DAC35,012-345-678,11111111,JB HI-FI ANZ,27.83,0,1407284.86,DR,REF261431,ANZ,Savings
23-09-2025 16:46,ANZF52124622D7D4993B057,012-345-678,11111111,HARVEY NORMAN ANZ,52.32,0,1407232.54,DR,REF495662,ANZ,Savings
23-09-2025 17:55,ANZ34122E2354274310A287,012-345-678,11111111,INTERNET TRANSFER ANZ,150.29,0,1407082.25,DR,REF612436,ANZ,Savings
23-09-2025 17:56,ANZDE8C4F8265C847D0B639,012-345-678,11111111,ALDI ANZ,78,0,1407004.25,DR,REF278685,ANZ,Savings
23-09-2025 18:00,ANZBD2F4EB6147544508042,012-345-678,11111111,MENULOG ANZ,17.1,0,1406987.15,DR,REF184246,ANZ,Savings
23-09-2025 18:27,ANZC556B6517C8A45F09DBD,012-345-678,11111111,BWS ANZ,47.69,0,1406939.46,DR,REF119624,ANZ,Savings
23-09-2025 18:35,ANZ81A87D482A75411A96E2,012-345-678,11111111,FLIXBUS ANZ,46.8,0,1406892.66,DR,REF384617,ANZ,Savings
23-09-2025 18:57,ANZ5956CD065A924D759354,012-345-678,11111111,COLES ANZ,38.44,0,1406854.22,DR,REF775546,ANZ,Savings
23-09-2025 18:59,ANZ4D85A56B10FC4874B865,012-345-678,11111111,COMPANY PAYROLL ANZ,0,5006.56,1411860.78,CR,REF444162,ANZ,Savings
23-09-2025 19:09,ANZ7EFC0105085F49679E55,012-345-678,11111111,PAYMENT GATEWAY ANZ,54.78,0,1411806,DR,REF674852,ANZ,Savings
23-09-2025 19:10,ANZ7CA01C81A90341D28D09,012-345-678,11111111,SHELL ANZ,116.45,0,1411689.55,DR,REF610402,ANZ,Savings
23-09-2025 19:49,ANZ3233149726F14BBDB7C5,012-345-678,11111111,STARBUCKS ANZ,28.84,0,1411660.71,DR,REF309911,ANZ,Savings
23-09-2025 20:23,ANZ5A58ED69F55949D4A718,012-345-678,11111111,STARBUCKS ANZ,71.73,0,1411588.98,DR,REF401922,ANZ,Savings
23-09-2025 20:32,ANZ6336A915334B4F1CBB4C,012-345-678,11111111,COMPANY PAYROLL ANZ,0,3357.55,1414946.53,CR,REF970747,ANZ,Savings
23-09-2025 20:35,ANZ40F9AD79B08340ADA6E6,012-345-678,11111111,PAYROLL CREDIT ANZ,0,539.69,1415486.22,CR,REF902156,ANZ,Savings
23-09-2025 20:39,ANZ1FEBC0F9409E4EAEA607,012-345-678,11111111,FLIXBUS ANZ,103.48,0,1415382.74,DR,REF327166,ANZ,Savings
23-09-2025 20:43,ANZ5178D021209347FDB48B,012-345-678,11111111,BWS ANZ,5.02,0,1415377.72,DR,REF896945,ANZ,Savings
23-09-2025 21:33,ANZB85DF02990F24717BCFA,012-345-678,11111111,LIQUORLAND ANZ,44.18,0,1415333.54,DR,REF476849,ANZ,Savings
23-09-2025 21:37,ANZ833E3B3AE7E142BAAF04,012-345-678,11111111,JB HI-FI ANZ,71.6,0,1415261.94,DR,REF638178,ANZ,Savings
23-09-2025 21:38,ANZ3D8A60E7AD674B2BA220,012-345-678,11111111,APPLE ANZ,10.93,0,1415251.01,DR,REF674724,ANZ,Savings
23-09-2025 22:24,ANZ0C38633639264144AD1F,012-345-678,11111111,BIGW ANZ,88.56,0,1415162.45,DR,REF219247,ANZ,Savings
23-09-2025 22:51,ANZ1DDEEE02441845BC9145,012-345-678,11111111,CITYLINK ANZ,239.25,0,1414923.2,DR,REF229851,ANZ,Savings
23-09-2025 22:54,ANZ92667680A33D4BDE9988,012-345-678,11111111,MENULOG ANZ,47.4,0,1414875.8,DR,REF484648,ANZ,Savings
23-09-2025 23:14,ANZ813DA36CFB414150B715,012-345-678,11111111,APPLE ANZ,127.44,0,1414748.36,DR,REF312068,ANZ,Savings
24-09-2025 00:06,ANZC449C396E41943E6B93D,012-345-678,11111111,DOMINO'S PIZZA ANZ,114.01,0,1414634.35,DR,REF486289,ANZ,Savings
24-09-2025 00:08,ANZ27C14BF68EBD481F9476,012-345-678,11111111,RAILWAY STATION ANZ,58.22,0,1414576.13,DR,REF433410,ANZ,Savings
24-09-2025 00:35,INT00029515FF2444329C31,012-345-678,11111111,TRANSFER FROM NAB 44444444,0,1745.73,1416321.86,CR,INT-71876,ANZ,Savings
24-09-2025 00:36,ANZAA188723380E4CF59580,012-345-678,11111111,MENULOG ANZ,42.26,0,1416279.6,DR,REF946365,ANZ,Savings
24-09-2025 01:22,ANZ0251CAB414E947B99092,012-345-678,11111111,SPOTIFY ANZ,24.14,0,1416255.46,DR,REF516495,ANZ,Savings
24-09-2025 02:46,ANZAD4D3B5F27A04EF4AB14,012-345-678,11111111,APPLE ANZ,122.59,0,1416132.87,DR,REF139709,ANZ,Savings
24-09-2025 02:58,ANZ88ACFA624BE2426A9BD2,012-345-678,11111111,CITYLINK ANZ,43.9,0,1416088.97,DR,REF374628,ANZ,Savings
24-09-2025 03:03,ANZ3145C3C26BB34E90B91C,012-345-678,11111111,HARVEY NORMAN ANZ,20.86,0,1416068.11,DR,REF915154,ANZ,Savings
24-09-2025 03:13,ANZ148EF481765A423999B7,012-345-678,11111111,SHELL ANZ,65.75,0,1416002.36,DR,REF127411,ANZ,Savings
24-09-2025 03:47,ANZ4059D613BC4C4A92B037,012-345-678,11111111,BP ANZ,66.56,0,1415935.8,DR,REF174371,ANZ,Savings
24-09-2025 03:52,ANZ50CAF42B6232421B958F,012-345-678,11111111,SALARY PAYMENT ANZ,0,975.34,1416911.14,CR,REF781229,ANZ,Savings
24-09-2025 04:32,ANZA0123D68A9624807B6C5,012-345-678,11111111,WAGES CREDIT ANZ,0,7448.52,1424359.66,CR,REF569284,ANZ,Savings
24-09-2025 05:16,ANZB83810FC4A6F44B29195,012-345-678,11111111,MENULOG ANZ,10.7,0,1424348.96,DR,REF264155,ANZ,Savings
24-09-2025 05:34,ANZ682ACCB9EEE948EB8FF8,012-345-678,11111111,HARVEY NORMAN ANZ,46.55,0,1424302.41,DR,REF759275,ANZ,Savings
24-09-2025 05:37,INT69F2013EEDAD46508528,012-345-678,11111111,TRANSFER FROM CBA 22222222,0,286.41,1424588.82,CR,INT-68822,ANZ,Savings
24-09-2025 05:39,ANZ7B027870A3DD4B16B7A2,012-345-678,11111111,COMPANY PAYROLL ANZ,0,5516.79,1430105.61,CR,REF661617,ANZ,Savings
24-09-2025 06:18,INTAFE885987344411AAAC0,012-345-678,11111111,TRANSFER TO CBA 22222222,366.44,0,1429739.17,DR,INT-23984,ANZ,Savings
24-09-2025 07:19,ANZ0468EA79A64A42F0A89C,012-345-678,11111111,SALARY PAYMENT ANZ,0,931.8,1430670.97,CR,REF419358,ANZ,Savings
24-09-2025 07:42,ANZ5F011B4B5A554222A580,012-345-678,11111111,INTERNET TRANSFER ANZ,34.48,0,1430636.49,DR,REF698491,ANZ,Savings
24-09-2025 07:49,ANZEC0313BC17F34576BB87,012-345-678,11111111,7-ELEVEN ANZ,5.03,0,1430631.46,DR,REF961946,ANZ,Savings
24-09-2025 08:37,ANZD66D5E8DB9B3433CBB7D,012-345-678,11111111,WOOLWORTHS ANZ,47.05,0,1430584.41,DR,REF547581,ANZ,Savings
24-09-2025 08:51,ANZ0525AF34B00E4B43B5A1,012-345-678,11111111,PAYPAL *NETFLIX ANZ,46.13,0,1430538.28,DR,REF544755,ANZ,Savings
24-09-2025 09:27,ANZ82B690FEE1B44264AB58,012-345-678,11111111,CITYLINK ANZ,105.63,0,1430432.65,DR,REF706273,ANZ,Savings
24-09-2025 09:29,ANZ8907C5C69EA345D496ED,012-345-678,11111111,ZOOM ANZ,9.05,0,1430423.6,DR,REF162960,ANZ,Savings
24-09-2025 09:31,ANZ64B7CCC4067340CEAED1,012-345-678,11111111,WOOLWORTHS ANZ,21.99,0,1430401.61,DR,REF951332,ANZ,Savings
24-09-2025 09:39,ANZ47510C19FDD643E38BF7,012-345-678,11111111,RAILWAY STATION ANZ,53.91,0,1430347.7,DR,REF767154,ANZ,Savings
24-09-2025 09:46,ANZ007522E72A674581BCB7,012-345-678,11111111,DOMINO'S PIZZA ANZ,21.94,0,1430325.76,DR,REF103886,ANZ,Savings
24-09-2025 10:29,ANZ4179B30A543A49488AFE,012-345-678,11111111,LIQUORLAND ANZ,31.12,0,1430294.64,DR,REF944166,ANZ,Savings
24-09-2025 10:34,ANZBEAFA16EA9B74CED9347,012-345-678,11111111,CITYLINK ANZ,33.04,0,1430261.6,DR,REF258935,ANZ,Savings
24-09-2025 10:51,ANZ31E3A3F53AD84468AEAA,012-345-678,11111111,APPLE ANZ,15,0,1430246.6,DR,REF441060,ANZ,Savings
24-09-2025 10:51,ANZEF57441D9B92472499B3,012-345-678,11111111,TAFE BOOKSHOP ANZ,68.18,0,1430178.42,DR,REF853206,ANZ,Savings
24-09-2025 10:54,ANZE06001157EDF454581B0,012-345-678,11111111,ALDI ANZ,44.01,0,1430134.41,DR,REF535629,ANZ,Savings
24-09-2025 11:43,ANZD164EBA125DD45A68B03,012-345-678,11111111,PAYMENT GATEWAY ANZ,51.53,0,1430082.88,DR,REF482559,ANZ,Savings
24-09-2025 11:43,ANZ2DFF4B0A66684B408E7C,012-345-678,11111111,LIQUORLAND ANZ,208.74,0,1429874.14,DR,REF235598,ANZ,Savings
24-09-2025 11:47,ANZB015C55B33B047639312,012-345-678,11111111,PAYROLL CREDIT ANZ,0,37.89,1429912.03,CR,REF584166,ANZ,Savings
24-09-2025 12:12,ANZ7FD1E648B62542CCA1D8,012-345-678,11111111,BWS ANZ,25.45,0,1429886.58,DR,REF952280,ANZ,Savings
24-09-2025 12:32,ANZ6207EABDF96F4E3CAFC7,012-345-678,11111111,PAYMENT GATEWAY ANZ,12.75,0,1429873.83,DR,REF928414,ANZ,Savings
24-09-2025 13:08,ANZ14B6486D89A4406D85AB,012-345-678,11111111,SHELL ANZ,74.21,0,1429799.62,DR,REF258944,ANZ,Savings
24-09-2025 13:25,ANZF8F11635F6314474AF20,012-345-678,11111111,SHELL ANZ,35.66,0,1429763.96,DR,REF779074,ANZ,Savings
24-09-2025 13:27,ANZE04E37E5BFB34F5589E4,012-345-678,11111111,SPOTIFY ANZ,9.92,0,1429754.04,DR,REF837672,ANZ,Savings
24-09-2025 14:24,ANZA850E56F5D8742899B86,012-345-678,11111111,MCDONALDS ANZ,11.56,0,1429742.48,DR,REF207991,ANZ,Savings
24-09-2025 14:54,ANZFBFBAE424BA34BD591A3,012-345-678,11111111,BANK FEE ANZ,12.15,0,1429730.33,DR,REF124016,ANZ,Savings
24-09-2025 15:09,ANZC5BAB0BB70044E7AAA14,012-345-678,11111111,BANK FEE ANZ,23.1,0,1429707.23,DR,REF380408,ANZ,Savings
24-09-2025 15:13,INTC24A6F1A89344A33954C,012-345-678,11111111,TRANSFER TO CBA 22222222,1518.69,0,1428188.54,DR,INT-72691,ANZ,Savings
24-09-2025 15:34,ANZ23E71A53292348BFBB1E,012-345-678,11111111,MENULOG ANZ,42.77,0,1428145.77,DR,REF279446,ANZ,Savings
24-09-2025 15:44,ANZ1DAB13B6BA5D4E07939D,012-345-678,11111111,FLIXBUS ANZ,50.8,0,1428094.97,DR,REF668421,ANZ,Savings
24-09-2025 16:00,ANZ2CF5091C61A049608230,012-345-678,11111111,UBER EATS ANZ,24.34,0,1428070.63,DR,REF319965,ANZ,Savings
24-09-2025 16:11,ANZ561A9AA904E94E84B0A4,012-345-678,11111111,KFC ANZ,29.81,0,1428040.82,DR,REF524395,ANZ,Savings
24-09-2025 16:37,ANZ241C201C65CB4326B871,012-345-678,11111111,7-ELEVEN ANZ,96.38,0,1427944.44,DR,REF582431,ANZ,Savings
24-09-2025 16:42,ANZ1A884B683A4145F5A6D5,012-345-678,11111111,COMPANY PAYROLL ANZ,0,5092.02,1433036.46,CR,REF399164,ANZ,Savings
24-09-2025 16:55,ANZ7AD69B9BB4704E7BBA6A,012-345-678,11111111,BANK FEE ANZ,12.01,0,1433024.45,DR,REF877454,ANZ,Savings
24-09-2025 17:11,ANZD7FEEC15F8EB453F95AE,012-345-678,11111111,COLES ANZ,40.41,0,1432984.04,DR,REF536667,ANZ,Savings
24-09-2025 17:35,ANZFEB2661BA9244512ADD8,012-345-678,11111111,CITYLINK ANZ,37.77,0,1432946.27,DR,REF953279,ANZ,Savings
24-09-2025 17:47,ANZ1ADB51DB734E4DB5A5B3,012-345-678,11111111,SHELL ANZ,66.22,0,1432880.05,DR,REF853124,ANZ,Savings
24-09-2025 17:57,ANZC151B356F16D41B8B9AA,012-345-678,11111111,AMAZON AU ANZ,31.24,0,1432848.81,DR,REF406348,ANZ,Savings
24-09-2025 18:52,ANZ90CF446C4D944AAD99B5,012-345-678,11111111,HARVEY NORMAN ANZ,41.61,0,1432807.2,DR,REF168001,ANZ,Savings
24-09-2025 19:14,ANZ7D3B81771B0F4140B322,012-345-678,11111111,BWS ANZ,37.73,0,1432769.47,DR,REF624112,ANZ,Savings
24-09-2025 19:20,ANZ86C07A67275147B690B7,012-345-678,11111111,SPOTIFY ANZ,22.88,0,1432746.59,DR,REF983773,ANZ,Savings
24-09-2025 19:53,ANZCCCB4C6C1A034FBBBD31,012-345-678,11111111,FLIXBUS ANZ,49.32,0,1432697.27,DR,REF436541,ANZ,Savings
24-09-2025 19:56,ANZDA64252C7CF14E2E924E,012-345-678,11111111,INTERNET TRANSFER ANZ,16.68,0,1432680.59,DR,REF162086,ANZ,Savings
24-09-2025 20:21,ANZ9ED21896BD2345DA90B9,012-345-678,11111111,ALDI ANZ,116.62,0,1432563.97,DR,REF228268,ANZ,Savings
24-09-2025 20:33,ANZ4A41D4A67D234CFB902D,012-345-678,11111111,7-ELEVEN ANZ,38.27,0,1432525.7,DR,REF650520,ANZ,Savings
24-09-2025 21:12,ANZDAEA3DBC7F424D18A15F,012-345-678,11111111,BP ANZ,62.91,0,1432462.79,DR,REF702158,ANZ,Savings
24-09-2025 21:33,INT2120DF0FBAEF43AFA443,012-345-678,11111111,TRANSFER FROM CBA 22222222,0,499.04,1432961.83,CR,INT-86309,ANZ,Savings
24-09-2025 22:35,ANZ4B0947C894204ADCA788,012-345-678,11111111,SHELL ANZ,45.47,0,1432916.36,DR,REF319736,ANZ,Savings
24-09-2025 22:41,ANZ8665CD7BE7104410907C,012-345-678,11111111,STARBUCKS ANZ,14.45,0,1432901.91,DR,REF374541,ANZ,Savings
24-09-2025 23:12,ANZ035C1FEA2BC549679922,012-345-678,11111111,MENULOG ANZ,5.24,0,1432896.67,DR,REF762275,ANZ,Savings
24-09-2025 23:30,ANZFFF165CA7C0846E19A6A,012-345-678,11111111,INTERNET TRANSFER ANZ,66.62,0,1432830.05,DR,REF610557,ANZ,Savings
24-09-2025 23:41,ANZ0A87672A64D94D0FA52E,012-345-678,11111111,7-ELEVEN ANZ,56.7,0,1432773.35,DR,REF909064,ANZ,Savings
24-09-2025 23:48,ANZECE5362613374F9EB2C7,012-345-678,11111111,MENULOG ANZ,17.56,0,1432755.79,DR,REF549375,ANZ,Savings
25-09-2025 00:12,ANZ14DAC3D7282649798199,012-345-678,11111111,PAY - SALARY ANZ,0,5011.58,1437767.37,CR,REF331599,ANZ,Savings
25-09-2025 00:22,ANZ3175006C4866498FB431,012-345-678,11111111,HARVEY NORMAN ANZ,6.36,0,1437761.01,DR,REF800617,ANZ,Savings
25-09-2025 00:46,ANZ3F6A9FA7B44D48C1A3AC,012-345-678,11111111,TAFE BOOKSHOP ANZ,18.79,0,1437742.22,DR,REF750068,ANZ,Savings
25-09-2025 01:01,INT26BB5600C0584285817B,012-345-678,11111111,TRANSFER FROM CBA 22222222,0,1290.18,1439032.4,CR,INT-40527,ANZ,Savings
25-09-2025 01:33,ANZC436F543C003404C9DF1,012-345-678,11111111,STARBUCKS ANZ,48.01,0,1438984.39,DR,REF212029,ANZ,Savings
25-09-2025 02:07,ANZ1CA9C9B21306426E821C,012-345-678,11111111,AMAZON AU ANZ,4.33,0,1438980.06,DR,REF768995,ANZ,Savings
25-09-2025 02:10,INT65C87FD40C044EF88F7A,012-345-678,11111111,TRANSFER FROM NAB 44444444,0,735.62,1439715.68,CR,INT-12189,ANZ,Savings
25-09-2025 02:16,ANZ7A1AA28A595A42E0AF38,012-345-678,11111111,7-ELEVEN ANZ,42.16,0,1439673.52,DR,REF283456,ANZ,Savings
25-09-2025 02:22,ANZ5B32225245D74EB18385,012-345-678,11111111,KFC ANZ,119.71,0,1439553.81,DR,REF570283,ANZ,Savings
25-09-2025 02:33,ANZ25EAF15979954EDA81A5,012-345-678,11111111,CITYLINK ANZ,14.24,0,1439539.57,DR,REF243256,ANZ,Savings
25-09-2025 02:40,ANZ455DF7D208BE49B8A2D9,012-345-678,11111111,SPOTIFY ANZ,21.9,0,1439517.67,DR,REF173477,ANZ,Savings
25-09-2025 03:37,ANZ2E8FA15FCB43490B96CE,012-345-678,11111111,SHELL ANZ,4.5,0,1439513.17,DR,REF544743,ANZ,Savings
25-09-2025 04:03,INT4B41813DB60943209C28,012-345-678,11111111,TRANSFER TO CBA 22222222,580.52,0,1438932.65,DR,INT-35856,ANZ,Savings
25-09-2025 04:06,ANZ3C4BAB96A1A84F7AB9DC,012-345-678,11111111,APPLE ANZ,2.16,0,1438930.49,DR,REF872281,ANZ,Savings
25-09-2025 04:43,ANZ61D3400542E44B1E808E,012-345-678,11111111,BP ANZ,276.62,0,1438653.87,DR,REF913988,ANZ,Savings
25-09-2025 05:06,ANZ5042F73FBDEE4D0F85E5,012-345-678,11111111,BWS ANZ,45.94,0,1438607.93,DR,REF951206,ANZ,Savings
25-09-2025 05:15,ANZ1D6ABA594E8C4B23A40E,012-345-678,11111111,SALARY PAYMENT ANZ,0,386.65,1438994.58,CR,REF400650,ANZ,Savings
25-09-2025 05:36,ANZB301FBFE6CD34C0B8CDA,012-345-678,11111111,COLES ANZ,48.17,0,1438946.41,DR,REF969572,ANZ,Savings
25-09-2025 06:17,ANZCFE04C30236E45F38253,012-345-678,11111111,WAGES CREDIT ANZ,0,5893.75,1444840.16,CR,REF881071,ANZ,Savings
25-09-2025 06:25,ANZ468FC4349B894A8EBF88,012-345-678,11111111,COLES ANZ,43.52,0,1444796.64,DR,REF475478,ANZ,Savings
25-09-2025 07:00,ANZ4C8B188B371647109FB3,012-345-678,11111111,MCDONALDS ANZ,46.88,0,1444749.76,DR,REF135182,ANZ,Savings
25-09-2025 07:52,ANZ36B36FB0BE0548D3A823,012-345-678,11111111,WAGES CREDIT ANZ,0,843.06,1445592.82,CR,REF318347,ANZ,Savings
25-09-2025 08:10,ANZBCA3E17AA0D549A4B542,012-345-678,11111111,BANK FEE ANZ,8.05,0,1445584.77,DR,REF418313,ANZ,Savings
25-09-2025 08:22,ANZCCA7E44ABD6A4DB890B8,012-345-678,11111111,PAYMENT GATEWAY ANZ,5.22,0,1445579.55,DR,REF244619,ANZ,Savings
25-09-2025 09:04,ANZF24EC3A6353D4B1FA44C,012-345-678,11111111,SPOTIFY ANZ,31.97,0,1445547.58,DR,REF605291,ANZ,Savings
25-09-2025 09:04,ANZCC7AD479A6DD43C79558,012-345-678,11111111,LIQUORLAND ANZ,194.34,0,1445353.24,DR,REF931140,ANZ,Savings
25-09-2025 09:10,INTAF62321D199E40AB972D,012-345-678,11111111,TRANSFER FROM CBA 22222222,0,1883.7,1447236.94,CR,INT-27600,ANZ,Savings
25-09-2025 09:14,ANZ7D477D7DE2B9407F98DF,012-345-678,11111111,ALDI ANZ,107.2,0,1447129.74,DR,REF557850,ANZ,Savings
25-09-2025 09:40,ANZFEE6A367F1B847D6882D,012-345-678,11111111,JB HI-FI ANZ,4.84,0,1447124.9,DR,REF346401,ANZ,Savings
25-09-2025 10:25,ANZ1D6A22D4704D455389FC,012-345-678,11111111,BP ANZ,50.11,0,1447074.79,DR,REF422889,ANZ,Savings
25-09-2025 10:35,ANZD37F5139C6064764A1F0,012-345-678,11111111,PAYPAL *NETFLIX ANZ,172.96,0,1446901.83,DR,REF636324,ANZ,Savings
25-09-2025 10:35,ANZF6B33ED1F5C04D0683F0,012-345-678,11111111,INTERNET TRANSFER ANZ,14.17,0,1446887.66,DR,REF295358,ANZ,Savings
25-09-2025 10:37,ANZBF3F81EDC87D492BB966,012-345-678,11111111,AMAZON AU ANZ,6.2,0,1446881.46,DR,REF421407,ANZ,Savings
25-09-2025 10:56,ANZ007C12B268D1489F9656,012-345-678,11111111,SHELL ANZ,126.48,0,1446754.98,DR,REF523323,ANZ,Savings
25-09-2025 10:58,ANZ9B3A79CBB43C46CB9125,012-345-678,11111111,MCDONALDS ANZ,19.16,0,1446735.82,DR,REF967761,ANZ,Savings
25-09-2025 11:27,ANZA1673FBE9D204B08AF52,012-345-678,11111111,LIQUORLAND ANZ,16.78,0,1446719.04,DR,REF877480,ANZ,Savings
25-09-2025 11:29,ANZ9C3C9615D6934544964C,012-345-678,11111111,SPOTIFY ANZ,19.34,0,1446699.7,DR,REF103046,ANZ,Savings
25-09-2025 11:37,ANZ59DF8904FD104C4B808C,012-345-678,11111111,COLES ANZ,112.16,0,1446587.54,DR,REF457481,ANZ,Savings
25-09-2025 11:46,ANZ74D28C1F71074B31A464,012-345-678,11111111,CITYLINK ANZ,15.5,0,1446572.04,DR,REF871185,ANZ,Savings
25-09-2025 12:01,ANZED2C2B5D07574E63AA85,012-345-678,11111111,ZOOM ANZ,4.79,0,1446567.25,DR,REF810289,ANZ,Savings
25-09-2025 12:22,ANZ637E5EE82DDC4AC0A05A,012-345-678,11111111,INTERNET TRANSFER ANZ,83.79,0,1446483.46,DR,REF411856,ANZ,Savings
25-09-2025 12:32,ANZDD51C77F4AFE4FA798EF,012-345-678,11111111,SPOTIFY ANZ,124.81,0,1446358.65,DR,REF279393,ANZ,Savings
25-09-2025 12:34,ANZBAA7CA2D4E144109A8A2,012-345-678,11111111,WOOLWORTHS ANZ,64.55,0,1446294.1,DR,REF319084,ANZ,Savings
25-09-2025 12:42,INT667AAAA7FE724BD6A029,012-345-678,11111111,TRANSFER TO CBA 33333333,1299.83,0,1444994.27,DR,INT-17023,ANZ,Savings
25-09-2025 12:44,ANZ29AA32BFC1524517A425,012-345-678,11111111,STARBUCKS ANZ,181.25,0,1444813.02,DR,REF843999,ANZ,Savings
25-09-2025 13:28,INT2762F473B1EC48A9A093,012-345-678,11111111,TRANSFER TO NAB 44444444,1235.14,0,1443577.88,DR,INT-77393,ANZ,Savings
25-09-2025 13:29,ANZ858FABCA11464FB692B2,012-345-678,11111111,LIQUORLAND ANZ,122.55,0,1443455.33,DR,REF683745,ANZ,Savings
25-09-2025 13:59,ANZD826AACF16144D03A5A1,012-345-678,11111111,BIGW ANZ,24.73,0,1443430.6,DR,REF581782,ANZ,Savings
25-09-2025 15:09,INT6CB911EF92B342A797C1,012-345-678,11111111,TRANSFER TO CBA 33333333,1205.68,0,1442224.92,DR,INT-28455,ANZ,Savings
25-09-2025 17:07,ANZ0BF4EFF0429943EE91BE,012-345-678,11111111,BWS ANZ,8.54,0,1442216.38,DR,REF436328,ANZ,Savings
25-09-2025 17:52,ANZ46C8EE0926494D7BAF32,012-345-678,11111111,STARBUCKS ANZ,27.19,0,1442189.19,DR,REF445307,ANZ,Savings
25-09-2025 18:08,ANZF9D4282BAD1A49FF864A,012-345-678,11111111,SHELL ANZ,160.73,0,1442028.46,DR,REF402508,ANZ,Savings
25-09-2025 18:35,ANZBFE0F82095F245E589FD,012-345-678,11111111,PAYPAL *NETFLIX ANZ,58.14,0,1441970.32,DR,REF203994,ANZ,Savings
25-09-2025 18:43,ANZEB7778F494A440509F8D,012-345-678,11111111,MCDONALDS ANZ,12.87,0,1441957.45,DR,REF158868,ANZ,Savings
25-09-2025 18:51,ANZ0DE31B52C8084487B3AA,012-345-678,11111111,PAYPAL *NETFLIX ANZ,20.48,0,1441936.97,DR,REF952246,ANZ,Savings
25-09-2025 19:29,ANZ4B981527048D4D49A9A5,012-345-678,11111111,ZOOM ANZ,36.18,0,1441900.79,DR,REF838070,ANZ,Savings
25-09-2025 19:43,ANZ482C3F9F1EA147B2A09B,012-345-678,11111111,PAYPAL *NETFLIX ANZ,35.28,0,1441865.51,DR,REF357384,ANZ,Savings
25-09-2025 19:49,ANZC0B7DA4132844953A3F7,012-345-678,11111111,MCDONALDS ANZ,43.15,0,1441822.36,DR,REF712248,ANZ,Savings
25-09-2025 19:54,ANZ71EBC74D88B24CA28C23,012-345-678,11111111,HARVEY NORMAN ANZ,135.46,0,1441686.9,DR,REF165675,ANZ,Savings
25-09-2025 20:22,ANZ6DEA6379462A4598B60D,012-345-678,11111111,KFC ANZ,63.87,0,1441623.03,DR,REF901785,ANZ,Savings
25-09-2025 20:44,ANZF6CB546B053A498EA34C,012-345-678,11111111,APPLE ANZ,19.23,0,1441603.8,DR,REF717674,ANZ,Savings
25-09-2025 20:52,ANZ4973A42DC353459EB5FF,012-345-678,11111111,ALDI ANZ,12.33,0,1441591.47,DR,REF727345,ANZ,Savings
25-09-2025 20:56,ANZE85237FCA94B44A28205,012-345-678,11111111,SHELL ANZ,29.54,0,1441561.93,DR,REF335119,ANZ,Savings
25-09-2025 21:26,INT6894615858F14C3A8309,012-345-678,11111111,TRANSFER FROM CBA 22222222,0,557.86,1442119.79,CR,INT-97521,ANZ,Savings
25-09-2025 21:36,ANZ235A32A6D10243DA83ED,012-345-678,11111111,JB HI-FI ANZ,51.7,0,1442068.09,DR,REF819737,ANZ,Savings
25-09-2025 22:57,ANZ1F037B85FD054627ACEE,012-345-678,11111111,PAYMENT GATEWAY ANZ,20.1,0,1442047.99,DR,REF230714,ANZ,Savings
25-09-2025 22:58,ANZEFB8978EB5C845CBAE6E,012-345-678,11111111,ZOOM ANZ,154.46,0,1441893.53,DR,REF964304,ANZ,Savings
25-09-2025 23:05,ANZC5BE4E5773454359A02C,012-345-678,11111111,PAYMENT GATEWAY ANZ,14.38,0,1441879.15,DR,REF586013,ANZ,Savings
25-09-2025 23:05,ANZAAB48EA929DB4B8BBD6D,012-345-678,11111111,ALDI ANZ,14.94,0,1441864.21,DR,REF373694,ANZ,Savings
25-09-2025 23:06,ANZ18DB9C232CBE4D45B330,012-345-678,11111111,CITYLINK ANZ,17.94,0,1441846.27,DR,REF480321,ANZ,Savings
25-09-2025 23:34,ANZ5EFE79344BB74E4E98C2,012-345-678,11111111,SPOTIFY ANZ,51.13,0,1441795.14,DR,REF737928,ANZ,Savings
25-09-2025 23:42,ANZ94EC22636A594A958383,012-345-678,11111111,BIGW ANZ,18.3,0,1441776.84,DR,REF723599,ANZ,Savings
26-09-2025 00:20,ANZF4F7021F694D436AAE91,012-345-678,11111111,BANK FEE ANZ,96.42,0,1441680.42,DR,REF567238,ANZ,Savings
26-09-2025 00:29,ANZ091B2EB0F5454DDCAAE6,012-345-678,11111111,APPLE ANZ,11.46,0,1441668.96,DR,REF962818,ANZ,Savings
26-09-2025 00:29,ANZ8D433562AE404127BF2F,012-345-678,11111111,KFC ANZ,77.44,0,1441591.52,DR,REF992094,ANZ,Savings
26-09-2025 00:54,INT2A300B2869DC4B03A011,012-345-678,11111111,TRANSFER FROM CBA 33333333,0,1475.33,1443066.85,CR,INT-72153,ANZ,Savings
26-09-2025 02:08,ANZ7696BEAEA8674227AF33,012-345-678,11111111,COMPANY PAYROLL ANZ,0,1928.93,1444995.78,CR,REF608797,ANZ,Savings
26-09-2025 02:23,ANZ5A135F5C6FF249B8AE20,012-345-678,11111111,RAILWAY STATION ANZ,25.88,0,1444969.9,DR,REF978670,ANZ,Savings
26-09-2025 02:43,ANZ410EB4D80FC64AFAB744,012-345-678,11111111,FLIXBUS ANZ,86.23,0,1444883.67,DR,REF472955,ANZ,Savings
26-09-2025 03:06,ANZ413AA213E2AB49719BFB,012-345-678,11111111,DOMINO'S PIZZA ANZ,40.01,0,1444843.66,DR,REF965889,ANZ,Savings
26-09-2025 03:16,ANZF505CF5F776944BF9D83,012-345-678,11111111,STARBUCKS ANZ,86.13,0,1444757.53,DR,REF909014,ANZ,Savings
26-09-2025 04:58,ANZ59E05733CDCE4AC5A9ED,012-345-678,11111111,TAFE BOOKSHOP ANZ,36.9,0,1444720.63,DR,REF750137,ANZ,Savings
26-09-2025 05:24,ANZD495C9FFDFDE4F87A9C6,012-345-678,11111111,DOMINO'S PIZZA ANZ,137.49,0,1444583.14,DR,REF747376,ANZ,Savings
26-09-2025 05:29,ANZ791CD456D4754E36B222,012-345-678,11111111,PAYPAL *NETFLIX ANZ,118.78,0,1444464.36,DR,REF940900,ANZ,Savings
26-09-2025 06:19,ANZE028076A2C854E9C9B98,012-345-678,11111111,MENULOG ANZ,131.85,0,1444332.51,DR,REF410071,ANZ,Savings
26-09-2025 06:41,ANZ80D8E0C6265549CCA30A,012-345-678,11111111,LIQUORLAND ANZ,42.31,0,1444290.2,DR,REF602378,ANZ,Savings
26-09-2025 06:43,ANZD3273076B831443AA348,012-345-678,11111111,BIGW ANZ,15.69,0,1444274.51,DR,REF295704,ANZ,Savings
26-09-2025 06:52,ANZA18A28C36C9743878909,012-345-678,11111111,HARVEY NORMAN ANZ,37.35,0,1444237.16,DR,REF900383,ANZ,Savings
26-09-2025 07:00,ANZAABDF7C1D79144258FC2,012-345-678,11111111,WOOLWORTHS ANZ,102.46,0,1444134.7,DR,REF387933,ANZ,Savings
26-09-2025 07:01,INT2C99B59498484DA28AE7,012-345-678,11111111,TRANSFER TO NAB 44444444,1189.43,0,1442945.27,DR,INT-61889,ANZ,Savings
26-09-2025 07:16,ANZ94F910DACF4E46149903,012-345-678,11111111,STARBUCKS ANZ,73.07,0,1442872.2,DR,REF168851,ANZ,Savings
26-09-2025 07:22,ANZ99AE83107E494E289A1D,012-345-678,11111111,JB HI-FI ANZ,93.64,0,1442778.56,DR,REF259776,ANZ,Savings
26-09-2025 07:27,ANZ3118FEDC44E74648B5FF,012-345-678,11111111,RAILWAY STATION ANZ,34.26,0,1442744.3,DR,REF411685,ANZ,Savings
26-09-2025 07:58,ANZ31C63FA4E63249AC945B,012-345-678,11111111,RAILWAY STATION ANZ,86.2,0,1442658.1,DR,REF405914,ANZ,Savings
26-09-2025 08:04,ANZ3F288720FE084D149629,012-345-678,11111111,BP ANZ,27.24,0,1442630.86,DR,REF473434,ANZ,Savings
26-09-2025 08:12,ANZ5E94CD2092684AA59BB3,012-345-678,11111111,HARVEY NORMAN ANZ,28.09,0,1442602.77,DR,REF587988,ANZ,Savings
26-09-2025 08:25,ANZ7471240494914A8889D2,012-345-678,11111111,APPLE ANZ,54.82,0,1442547.95,DR,REF768966,ANZ,Savings
26-09-2025 09:09,ANZAD864D2AF38D4BF693BE,012-345-678,11111111,RAILWAY STATION ANZ,45.28,0,1442502.67,DR,REF265859,ANZ,Savings
26-09-2025 09:21,ANZ746D18670F6E41DC91FB,012-345-678,11111111,PAY - SALARY ANZ,0,4180.38,1446683.05,CR,REF222076,ANZ,Savings
26-09-2025 09:41,ANZ4858E0D8C0854FEC98A6,012-345-678,11111111,KFC ANZ,15.92,0,1446667.13,DR,REF481708,ANZ,Savings
26-09-2025 09:50,ANZFAC121711399440090DE,012-345-678,11111111,WOOLWORTHS ANZ,129.45,0,1446537.68,DR,REF989508,ANZ,Savings
26-09-2025 10:09,ANZ707AA9F57643469F9DD0,012-345-678,11111111,7-ELEVEN ANZ,25.22,0,1446512.46,DR,REF806253,ANZ,Savings
26-09-2025 10:21,ANZ0FF8C34418E44C29B562,012-345-678,11111111,RAILWAY STATION ANZ,14.19,0,1446498.27,DR,REF447145,ANZ,Savings
26-09-2025 11:02,ANZ967989B042444556B6D8,012-345-678,11111111,JB HI-FI ANZ,37.78,0,1446460.49,DR,REF768315,ANZ,Savings
26-09-2025 11:25,ANZ54AD79EA03A9423FA232,012-345-678,11111111,TAFE BOOKSHOP ANZ,24.32,0,1446436.17,DR,REF862019,ANZ,Savings
26-09-2025 11:28,ANZ2534A5C8471145699A4F,012-345-678,11111111,SHELL ANZ,127.13,0,1446309.04,DR,REF279748,ANZ,Savings
26-09-2025 11:44,ANZ10C942331ECB45CBA498,012-345-678,11111111,UBER EATS ANZ,108.28,0,1446200.76,DR,REF981419,ANZ,Savings
26-09-2025 11:47,ANZ96E4DBE7C677492094F9,012-345-678,11111111,ZOOM ANZ,19.93,0,1446180.83,DR,REF884947,ANZ,Savings
26-09-2025 11:54,ANZ6D14DFBAD8664C29BE78,012-345-678,11111111,DOMINO'S PIZZA ANZ,1.65,0,1446179.18,DR,REF446764,ANZ,Savings
26-09-2025 12:03,INT3AD5411F575D46E19508,012-345-678,11111111,TRANSFER TO CBA 22222222,620.53,0,1445558.65,DR,INT-53173,ANZ,Savings
26-09-2025 12:13,ANZ3F382DDCB8FF416694E8,012-345-678,11111111,BIGW ANZ,3.93,0,1445554.72,DR,REF338058,ANZ,Savings
26-09-2025 12:13,ANZDCB5DAAE82B74AB68374,012-345-678,11111111,HARVEY NORMAN ANZ,56.1,0,1445498.62,DR,REF685424,ANZ,Savings
26-09-2025 12:38,ANZ223F679DA4E347D29B33,012-345-678,11111111,INTERNET TRANSFER ANZ,132.03,0,1445366.59,DR,REF427034,ANZ,Savings
26-09-2025 13:19,ANZC7482328A36E42CA97FF,012-345-678,11111111,TAFE BOOKSHOP ANZ,15.66,0,1445350.93,DR,REF776816,ANZ,Savings
26-09-2025 13:54,ANZB6B2AAF9BC9643D18AD2,012-345-678,11111111,COMPANY PAYROLL ANZ,0,4040.83,1449391.76,CR,REF851628,ANZ,Savings
26-09-2025 14:12,ANZ539F9CFF612D432AA5F9,012-345-678,11111111,ALDI ANZ,29.89,0,1449361.87,DR,REF227942,ANZ,Savings
26-09-2025 14:33,ANZ4188F647472F4012907C,012-345-678,11111111,BWS ANZ,25.54,0,1449336.33,DR,REF988663,ANZ,Savings
26-09-2025 14:46,ANZ6EE16A9D1D724B15B2B1,012-345-678,11111111,COMPANY PAYROLL ANZ,0,5238.89,1454575.22,CR,REF918087,ANZ,Savings
26-09-2025 15:15,ANZ8B458B4D993C45A4A631,012-345-678,11111111,PAYROLL CREDIT ANZ,0,3027.26,1457602.48,CR,REF182183,ANZ,Savings
26-09-2025 15:22,ANZ37113C1252BA40C380F6,012-345-678,11111111,AMAZON AU ANZ,42.25,0,1457560.23,DR,REF532865,ANZ,Savings
26-09-2025 15:24,ANZDC271224F79942739A87,012-345-678,11111111,RAILWAY STATION ANZ,6.09,0,1457554.14,DR,REF702268,ANZ,Savings
26-09-2025 15:27,ANZ7840F06F4C1C4A3C86C3,012-345-678,11111111,BIGW ANZ,103.15,0,1457450.99,DR,REF760213,ANZ,Savings
26-09-2025 15:28,ANZ314CA9D26BA3444EA33C,012-345-678,11111111,PAYMENT GATEWAY ANZ,48.45,0,1457402.54,DR,REF538166,ANZ,Savings
26-09-2025 15:37,ANZ87F3CE0F2BAF4F0BA569,012-345-678,11111111,CITYLINK ANZ,53.53,0,1457349.01,DR,REF985349,ANZ,Savings
26-09-2025 15:57,ANZE8E13EDE640E4218ABCB,012-345-678,11111111,TAFE BOOKSHOP ANZ,6.07,0,1457342.94,DR,REF215323,ANZ,Savings
26-09-2025 16:07,ANZ0FB0027DE6474E358A5D,012-345-678,11111111,PAYROLL CREDIT ANZ,0,819.59,1458162.53,CR,REF436287,ANZ,Savings
26-09-2025 16:07,ANZ3BF60C1851284428A70B,012-345-678,11111111,FLIXBUS ANZ,32.7,0,1458129.83,DR,REF118599,ANZ,Savings
26-09-2025 16:38,ANZ431911CC50D04445BA91,012-345-678,11111111,COLES ANZ,51.75,0,1458078.08,DR,REF287535,ANZ,Savings
26-09-2025 16:45,ANZ66E9F1A81C054217B0A5,012-345-678,11111111,SALARY PAYMENT ANZ,0,5609.2,1463687.28,CR,REF533627,ANZ,Savings
26-09-2025 17:10,ANZ30108DEBA07A454BB189,012-345-678,11111111,PAYMENT GATEWAY ANZ,2.09,0,1463685.19,DR,REF565721,ANZ,Savings
26-09-2025 17:34,ANZ3FB3AAC19CA343F78304,012-345-678,11111111,WOOLWORTHS ANZ,86.97,0,1463598.22,DR,REF688215,ANZ,Savings
26-09-2025 17:41,ANZEE31DF799CA34DD69E2D,012-345-678,11111111,HARVEY NORMAN ANZ,124.29,0,1463473.93,DR,REF243549,ANZ,Savings
26-09-2025 17:59,ANZBBF4A9D58D0C446FABA8,012-345-678,11111111,SPOTIFY ANZ,87.92,0,1463386.01,DR,REF910720,ANZ,Savings
26-09-2025 18:21,ANZ45F9357CFEF6478A9C46,012-345-678,11111111,SHELL ANZ,13.15,0,1463372.86,DR,REF543497,ANZ,Savings
26-09-2025 18:29,ANZ511F611F54D148A1AD74,012-345-678,11111111,LIQUORLAND ANZ,45.13,0,1463327.73,DR,REF802895,ANZ,Savings
26-09-2025 18:31,ANZ6ED1124327D9486DAB59,012-345-678,11111111,SALARY PAYMENT ANZ,0,5722.4,1469050.13,CR,REF575335,ANZ,Savings
26-09-2025 18:42,ANZA754AADB53BB451C804E,012-345-678,11111111,STARBUCKS ANZ,62.59,0,1468987.54,DR,REF330282,ANZ,Savings
26-09-2025 18:59,ANZF15274D7DFF946D4B368,012-345-678,11111111,BANK FEE ANZ,85.78,0,1468901.76,DR,REF726785,ANZ,Savings
26-09-2025 19:05,INT8D8AE85025BB4C23BD6C,012-345-678,11111111,TRANSFER TO CBA 22222222,304.5,0,1468597.26,DR,INT-48246,ANZ,Savings
26-09-2025 19:22,ANZ9FD2D9140B2A449C82B7,012-345-678,11111111,HARVEY NORMAN ANZ,15.19,0,1468582.07,DR,REF298906,ANZ,Savings
26-09-2025 19:40,ANZFDA6A50653C5470D9EE6,012-345-678,11111111,KFC ANZ,202.82,0,1468379.25,DR,REF241595,ANZ,Savings
26-09-2025 19:41,ANZ31524771E7AE44BBB0DF,012-345-678,11111111,WOOLWORTHS ANZ,47.36,0,1468331.89,DR,REF195811,ANZ,Savings
26-09-2025 20:10,ANZ110858E9998B44229A39,012-345-678,11111111,KFC ANZ,73.47,0,1468258.42,DR,REF944482,ANZ,Savings
26-09-2025 20:18,ANZA0C91853A15D4C138C37,012-345-678,11111111,KFC ANZ,32.54,0,1468225.88,DR,REF948399,ANZ,Savings
26-09-2025 20:45,ANZFDD1572545054FE8A277,012-345-678,11111111,JB HI-FI ANZ,47.34,0,1468178.54,DR,REF692052,ANZ,Savings
26-09-2025 21:35,ANZ673B902CC2404CF8ABB2,012-345-678,11111111,COLES ANZ,31.38,0,1468147.16,DR,REF327681,ANZ,Savings
26-09-2025 22:00,ANZE9AA39E1A82D4313BC23,012-345-678,11111111,DOMINO'S PIZZA ANZ,89.66,0,1468057.5,DR,REF254317,ANZ,Savings
26-09-2025 22:40,ANZ4242C62525F24C37B517,012-345-678,11111111,SALARY PAYMENT ANZ,0,583.81,1468641.31,CR,REF334193,ANZ,Savings
26-09-2025 22:54,ANZ0A72AAF350C9416391CB,012-345-678,11111111,SALARY PAYMENT ANZ,0,6555.14,1475196.45,CR,REF635259,ANZ,Savings
26-09-2025 23:12,ANZ374D16E4AA66442EA1DF,012-345-678,11111111,BP ANZ,103.2,0,1475093.25,DR,REF877580,ANZ,Savings
27-09-2025 00:14,ANZ434699A2EE3146358045,012-345-678,11111111,JB HI-FI ANZ,126.03,0,1474967.22,DR,REF129926,ANZ,Savings
27-09-2025 00:18,ANZ0488B758923743319EA2,012-345-678,11111111,PAYPAL *NETFLIX ANZ,51.6,0,1474915.62,DR,REF827927,ANZ,Savings
27-09-2025 00:27,ANZDB19F7F8642D4B4A8E49,012-345-678,11111111,SPOTIFY ANZ,19.91,0,1474895.71,DR,REF324022,ANZ,Savings
27-09-2025 00:37,ANZD2D1D90178F048D0B768,012-345-678,11111111,LIQUORLAND ANZ,19.31,0,1474876.4,DR,REF729252,ANZ,Savings
27-09-2025 00:45,ANZ1E13C0FC3F82449392EC,012-345-678,11111111,COMPANY PAYROLL ANZ,0,935.08,1475811.48,CR,REF106698,ANZ,Savings
27-09-2025 00:47,ANZ12B4AC98FB3244F4B806,012-345-678,11111111,BWS ANZ,28.28,0,1475783.2,DR,REF510073,ANZ,Savings
27-09-2025 00:59,INT6669F479584A429BB89C,012-345-678,11111111,TRANSFER TO CBA 33333333,723.14,0,1475060.06,DR,INT-98210,ANZ,Savings
27-09-2025 01:05,ANZ7C11D75EE5EC4601B7F4,012-345-678,11111111,DOMINO'S PIZZA ANZ,65.79,0,1474994.27,DR,REF203089,ANZ,Savings
27-09-2025 01:07,ANZ2A7A9A3525FF41E09C26,012-345-678,11111111,DOMINO'S PIZZA ANZ,1.75,0,1474992.52,DR,REF633030,ANZ,Savings
27-09-2025 02:09,ANZ9E67632405AD444A8833,012-345-678,11111111,DOMINO'S PIZZA ANZ,4.02,0,1474988.5,DR,REF498906,ANZ,Savings
27-09-2025 02:36,ANZA0397518A55B45408A66,012-345-678,11111111,STARBUCKS ANZ,34.58,0,1474953.92,DR,REF663520,ANZ,Savings
27-09-2025 02:40,ANZA803FFA663224D9C8E92,012-345-678,11111111,HARVEY NORMAN ANZ,42.86,0,1474911.06,DR,REF364316,ANZ,Savings
27-09-2025 02:43,ANZ35BF79CF4EA043288B0F,012-345-678,11111111,FLIXBUS ANZ,44.3,0,1474866.76,DR,REF953130,ANZ,Savings
27-09-2025 03:04,ANZEEBE50FD1E08422C8C2B,012-345-678,11111111,BWS ANZ,28.55,0,1474838.21,DR,REF821318,ANZ,Savings
27-09-2025 03:16,ANZDCABD55546BD4151A3E4,012-345-678,11111111,PAY - SALARY ANZ,0,319.58,1475157.79,CR,REF468536,ANZ,Savings
27-09-2025 03:22,ANZ6CAC61DC6CB64C41AEC7,012-345-678,11111111,WAGES CREDIT ANZ,0,1002.44,1476160.23,CR,REF881193,ANZ,Savings
27-09-2025 03:35,ANZB607DD76FFDF4FCB82A0,012-345-678,11111111,7-ELEVEN ANZ,36.61,0,1476123.62,DR,REF808342,ANZ,Savings
27-09-2025 03:35,ANZF918D813682449B8A63C,012-345-678,11111111,BP ANZ,4.28,0,1476119.34,DR,REF466236,ANZ,Savings
27-09-2025 03:52,ANZ5626F62B9E4348DD8C3F,012-345-678,11111111,PAYROLL CREDIT ANZ,0,5184.81,1481304.15,CR,REF168863,ANZ,Savings
27-09-2025 04:04,ANZ42843907D2E14955927F,012-345-678,11111111,7-ELEVEN ANZ,29.88,0,1481274.27,DR,REF310907,ANZ,Savings
27-09-2025 04:12,ANZDE015C224FE6424B988C,012-345-678,11111111,APPLE ANZ,22.81,0,1481251.46,DR,REF860301,ANZ,Savings
27-09-2025 05:01,ANZ26AA945647524D88983D,012-345-678,11111111,BANK FEE ANZ,80.93,0,1481170.53,DR,REF394702,ANZ,Savings
27-09-2025 05:05,ANZ580DDFA321104286BD40,012-345-678,11111111,COLES ANZ,79.7,0,1481090.83,DR,REF638412,ANZ,Savings
27-09-2025 05:17,ANZ3C9A661407A946ECA814,012-345-678,11111111,SHELL ANZ,5.51,0,1481085.32,DR,REF340755,ANZ,Savings
27-09-2025 05:33,ANZ94C3A1CEA780410F9336,012-345-678,11111111,ZOOM ANZ,64.6,0,1481020.72,DR,REF694597,ANZ,Savings
27-09-2025 05:37,ANZ29F6BC285A72405D8315,012-345-678,11111111,RAILWAY STATION ANZ,39.81,0,1480980.91,DR,REF646697,ANZ,Savings
27-09-2025 05:52,ANZ49BD13DD1ABF4F819B87,012-345-678,11111111,TAFE BOOKSHOP ANZ,19.06,0,1480961.85,DR,REF479296,ANZ,Savings
27-09-2025 06:19,ANZ612B67EE65C44AAA8B25,012-345-678,11111111,CITYLINK ANZ,66.8,0,1480895.05,DR,REF982559,ANZ,Savings
27-09-2025 06:43,ANZ5AB34F2D9C9347D38188,012-345-678,11111111,PAYROLL CREDIT ANZ,0,3652.84,1484547.89,CR,REF463736,ANZ,Savings
27-09-2025 07:06,ANZ9B6AADB99FD046E390E0,012-345-678,11111111,APPLE ANZ,9.17,0,1484538.72,DR,REF429800,ANZ,Savings
27-09-2025 07:30,ANZE443D1DDD7F9489086BB,012-345-678,11111111,SHELL ANZ,5.81,0,1484532.91,DR,REF389811,ANZ,Savings
27-09-2025 08:35,ANZDBF80E76403944C0978D,012-345-678,11111111,UBER EATS ANZ,79.66,0,1484453.25,DR,REF215164,ANZ,Savings
27-09-2025 08:59,ANZ96C26ADC6A8A4C69A6B5,012-345-678,11111111,PAYMENT GATEWAY ANZ,6.57,0,1484446.68,DR,REF639454,ANZ,Savings
27-09-2025 09:45,ANZ03678D10853E493E8F65,012-345-678,11111111,PAYPAL *NETFLIX ANZ,11.11,0,1484435.57,DR,REF168726,ANZ,Savings
27-09-2025 10:00,ANZ2297FA733DF644C8A87C,012-345-678,11111111,COLES ANZ,20.81,0,1484414.76,DR,REF120879,ANZ,Savings
27-09-2025 10:03,ANZ4F4EDE5AF57546549A02,012-345-678,11111111,CITYLINK ANZ,197.87,0,1484216.89,DR,REF160730,ANZ,Savings
27-09-2025 10:04,ANZ9BDF1FDADF024443B207,012-345-678,11111111,BP ANZ,68.1,0,1484148.79,DR,REF378948,ANZ,Savings
27-09-2025 10:15,ANZDE574876816647A298FC,012-345-678,11111111,BWS ANZ,27.15,0,1484121.64,DR,REF506571,ANZ,Savings
27-09-2025 10:19,ANZ44C64F0A22504AD690B9,012-345-678,11111111,STARBUCKS ANZ,44.74,0,1484076.9,DR,REF264944,ANZ,Savings
27-09-2025 10:22,ANZ859EDE25BE6D4D739AC2,012-345-678,11111111,DOMINO'S PIZZA ANZ,1.69,0,1484075.21,DR,REF194083,ANZ,Savings
27-09-2025 10:23,ANZA867486B34354BFE9AE4,012-345-678,11111111,BIGW ANZ,50.7,0,1484024.51,DR,REF924634,ANZ,Savings
27-09-2025 11:00,ANZ17B3D43CD1704F31956A,012-345-678,11111111,SHELL ANZ,35.85,0,1483988.66,DR,REF710974,ANZ,Savings
27-09-2025 11:22,ANZ506CD0275C2B46C1A1D4,012-345-678,11111111,ZOOM ANZ,16.24,0,1483972.42,DR,REF858075,ANZ,Savings
27-09-2025 11:38,ANZ63A925523C424BB68027,012-345-678,11111111,SPOTIFY ANZ,16.24,0,1483956.18,DR,REF598088,ANZ,Savings
27-09-2025 11:48,ANZ3A31683DD02F4555B378,012-345-678,11111111,TAFE BOOKSHOP ANZ,32.27,0,1483923.91,DR,REF896669,ANZ,Savings
27-09-2025 11:52,ANZE699F03202D34E85BECB,012-345-678,11111111,LIQUORLAND ANZ,48.71,0,1483875.2,DR,REF805545,ANZ,Savings
27-09-2025 12:52,ANZC76FF1A2162B4E159ED0,012-345-678,11111111,WAGES CREDIT ANZ,0,663.62,1484538.82,CR,REF222827,ANZ,Savings
27-09-2025 12:58,ANZF528096CCFB24AA99C2F,012-345-678,11111111,ZOOM ANZ,8.73,0,1484530.09,DR,REF114929,ANZ,Savings
27-09-2025 13:01,ANZCC0ED5E0E5784A31A500,012-345-678,11111111,BANK FEE ANZ,35.43,0,1484494.66,DR,REF137840,ANZ,Savings
27-09-2025 13:16,ANZECBF0254D85446DA87CA,012-345-678,11111111,COMPANY PAYROLL ANZ,0,207.89,1484702.55,CR,REF640229,ANZ,Savings
27-09-2025 13:18,ANZE0831DD74B8341CB8769,012-345-678,11111111,COMPANY PAYROLL ANZ,0,7350.48,1492053.03,CR,REF781022,ANZ,Savings
27-09-2025 14:05,ANZCDB27EBBBFC24782A43C,012-345-678,11111111,COLES ANZ,133.65,0,1491919.38,DR,REF579200,ANZ,Savings
27-09-2025 14:06,INT698822C76B4944608512,012-345-678,11111111,TRANSFER FROM CBA 33333333,0,1940.58,1493859.96,CR,INT-48109,ANZ,Savings
27-09-2025 14:08,ANZC631383EC1654F0C8A5F,012-345-678,11111111,COLES ANZ,25.66,0,1493834.3,DR,REF388224,ANZ,Savings
27-09-2025 14:09,ANZDEB7B8655B4D4825997F,012-345-678,11111111,SPOTIFY ANZ,195.66,0,1493638.64,DR,REF185590,ANZ,Savings
27-09-2025 14:51,ANZ5DC576E2E2FC4C28AACC,012-345-678,11111111,BANK FEE ANZ,6.29,0,1493632.35,DR,REF945148,ANZ,Savings
27-09-2025 14:58,ANZB7394008EABD4DD88511,012-345-678,11111111,7-ELEVEN ANZ,16.15,0,1493616.2,DR,REF445289,ANZ,Savings
27-09-2025 15:53,ANZA4D68C3F58774491A2A3,012-345-678,11111111,BANK FEE ANZ,43.46,0,1493572.74,DR,REF173271,ANZ,Savings
27-09-2025 15:56,ANZC5AE27DC9E654E98B5B9,012-345-678,11111111,ZOOM ANZ,156.2,0,1493416.54,DR,REF338848,ANZ,Savings
27-09-2025 16:43,ANZC56BE6D42AAC4B2C931F,012-345-678,11111111,ALDI ANZ,2.86,0,1493413.68,DR,REF609414,ANZ,Savings
27-09-2025 16:49,ANZ6381B705FE1D49C58F52,012-345-678,11111111,DOMINO'S PIZZA ANZ,16.44,0,1493397.24,DR,REF263232,ANZ,Savings
27-09-2025 17:14,ANZ8699A38CEE7A42B4B884,012-345-678,11111111,BIGW ANZ,16.3,0,1493380.94,DR,REF455644,ANZ,Savings
27-09-2025 18:15,ANZB64FACD760694E5D86EA,012-345-678,11111111,AMAZON AU ANZ,97.6,0,1493283.34,DR,REF718417,ANZ,Savings
27-09-2025 18:19,ANZ4FBC1F145E1241708D5F,012-345-678,11111111,7-ELEVEN ANZ,71.36,0,1493211.98,DR,REF731886,ANZ,Savings
27-09-2025 18:20,ANZEBF0AAA4D95E4A29BDA7,012-345-678,11111111,RAILWAY STATION ANZ,31.68,0,1493180.3,DR,REF685686,ANZ,Savings
27-09-2025 18:29,ANZ1F0B08CF8DCB43A8B057,012-345-678,11111111,KFC ANZ,114.52,0,1493065.78,DR,REF412159,ANZ,Savings
27-09-2025 18:34,ANZEDB154283FB243AFB144,012-345-678,11111111,BP ANZ,9.33,0,1493056.45,DR,REF647175,ANZ,Savings
27-09-2025 19:00,ANZ8E8A71254F4147F396F0,012-345-678,11111111,WOOLWORTHS ANZ,76.14,0,1492980.31,DR,REF776347,ANZ,Savings
27-09-2025 19:21,ANZ77DBA0FD7AA940CCA988,012-345-678,11111111,ZOOM ANZ,45.66,0,1492934.65,DR,REF897206,ANZ,Savings
27-09-2025 19:32,ANZ92DBBE53AF8146218840,012-345-678,11111111,PAY - SALARY ANZ,0,3854.1,1496788.75,CR,REF201864,ANZ,Savings
27-09-2025 20:04,ANZ8C11A72AD6884C4ABD7C,012-345-678,11111111,STARBUCKS ANZ,44.48,0,1496744.27,DR,REF689470,ANZ,Savings
27-09-2025 20:34,ANZ002EC42017974EDBAB4F,012-345-678,11111111,7-ELEVEN ANZ,103.71,0,1496640.56,DR,REF748963,ANZ,Savings
27-09-2025 20:40,ANZFD15B217E76D42BAB9F3,012-345-678,11111111,PAYROLL CREDIT ANZ,0,782.75,1497423.31,CR,REF757908,ANZ,Savings
27-09-2025 20:55,ANZD7D3BB11E69B42588340,012-345-678,11111111,AMAZON AU ANZ,10.6,0,1497412.71,DR,REF680391,ANZ,Savings
27-09-2025 20:56,ANZD246589B11A649538F93,012-345-678,11111111,HARVEY NORMAN ANZ,66.94,0,1497345.77,DR,REF274708,ANZ,Savings
27-09-2025 20:58,ANZE8F8A5765E04445BA2E7,012-345-678,11111111,SHELL ANZ,39.62,0,1497306.15,DR,REF953956,ANZ,Savings
27-09-2025 21:15,ANZF0245523023D497C90EB,012-345-678,11111111,STARBUCKS ANZ,111.11,0,1497195.04,DR,REF285197,ANZ,Savings
27-09-2025 21:18,ANZ21F8574D586D4F11BE5A,012-345-678,11111111,PAYPAL *NETFLIX ANZ,28.53,0,1497166.51,DR,REF402491,ANZ,Savings
27-09-2025 21:25,ANZ87A948B35AC24F3B82FF,012-345-678,11111111,FLIXBUS ANZ,86.08,0,1497080.43,DR,REF191860,ANZ,Savings
27-09-2025 21:39,ANZE8484768F25F4F109861,012-345-678,11111111,7-ELEVEN ANZ,17.34,0,1497063.09,DR,REF874918,ANZ,Savings
27-09-2025 21:55,ANZ7B2FB1E6E30E46D2A660,012-345-678,11111111,DOMINO'S PIZZA ANZ,30.76,0,1497032.33,DR,REF882489,ANZ,Savings
27-09-2025 22:34,ANZCD27605715664101BD88,012-345-678,11111111,BANK FEE ANZ,114.39,0,1496917.94,DR,REF435856,ANZ,Savings
27-09-2025 22:43,INT676A7AD0CDBF42E09337,012-345-678,11111111,TRANSFER TO CBA 33333333,1993.29,0,1494924.65,DR,INT-64581,ANZ,Savings
27-09-2025 22:55,ANZ5E221A0A1AE4473A984D,012-345-678,11111111,MENULOG ANZ,37.35,0,1494887.3,DR,REF676669,ANZ,Savings
27-09-2025 22:57,ANZ0F78524032A34078BAA2,012-345-678,11111111,WOOLWORTHS ANZ,24.89,0,1494862.41,DR,REF821025,ANZ,Savings
27-09-2025 23:11,ANZD769C94CFCA34DEF82DC,012-345-678,11111111,PAYROLL CREDIT ANZ,0,6620.88,1501483.29,CR,REF459217,ANZ,Savings
27-09-2025 23:19,ANZA1EBC271F3AE46538384,012-345-678,11111111,PAYMENT GATEWAY ANZ,52.51,0,1501430.78,DR,REF541316,ANZ,Savings
27-09-2025 23:43,ANZB1894295B50D41AA8EC2,012-345-678,11111111,HARVEY NORMAN ANZ,38.81,0,1501391.97,DR,REF921555,ANZ,Savings
27-09-2025 23:56,ANZ15F1D9F00FAA425F95E6,012-345-678,11111111,LIQUORLAND ANZ,5.22,0,1501386.75,DR,REF704174,ANZ,Savings
28-09-2025 00:25,ANZC9D86400A5284FDDA57C,012-345-678,11111111,AMAZON AU ANZ,18.59,0,1501368.16,DR,REF478124,ANZ,Savings
28-09-2025 00:27,ANZ41A60801CBFE4FF68CC3,012-345-678,11111111,SPOTIFY ANZ,28.16,0,1501340,DR,REF291028,ANZ,Savings
28-09-2025 01:14,ANZ598AA561DD974FCE80D7,012-345-678,11111111,SALARY PAYMENT ANZ,0,7703.46,1509043.46,CR,REF530164,ANZ,Savings
28-09-2025 01:26,ANZE477A4CEC52B4F0B8DB8,012-345-678,11111111,SPOTIFY ANZ,52.42,0,1508991.04,DR,REF389756,ANZ,Savings
28-09-2025 01:26,ANZ2776E77419F34204A9FB,012-345-678,11111111,BWS ANZ,8.18,0,1508982.86,DR,REF875466,ANZ,Savings
28-09-2025 02:13,ANZ9F6CD9F52EEC4383A4A7,012-345-678,11111111,PAY - SALARY ANZ,0,1031.5,1510014.36,CR,REF622028,ANZ,Savings
28-09-2025 02:15,ANZ2EFF0363086944C0AACB,012-345-678,11111111,CITYLINK ANZ,112,0,1509902.36,DR,REF703730,ANZ,Savings
28-09-2025 02:43,ANZ55DDA070C1BD488CA563,012-345-678,11111111,7-ELEVEN ANZ,79.32,0,1509823.04,DR,REF189774,ANZ,Savings
28-09-2025 02:52,ANZDA7F29A4EC094C21B02E,012-345-678,11111111,PAY - SALARY ANZ,0,3135.02,1512958.06,CR,REF407564,ANZ,Savings
28-09-2025 03:24,ANZA6C48706675E4737A60E,012-345-678,11111111,MCDONALDS ANZ,52,0,1512906.06,DR,REF771612,ANZ,Savings
28-09-2025 03:32,ANZB913568EE5A0467F8FD1,012-345-678,11111111,COMPANY PAYROLL ANZ,0,7437.58,1520343.64,CR,REF435824,ANZ,Savings
28-09-2025 03:32,ANZB3A8FB67E7914866836A,012-345-678,11111111,MENULOG ANZ,18.41,0,1520325.23,DR,REF144897,ANZ,Savings
28-09-2025 03:32,ANZEDCB9214F2BC47459B2B,012-345-678,11111111,DOMINO'S PIZZA ANZ,13.77,0,1520311.46,DR,REF596803,ANZ,Savings
28-09-2025 03:46,ANZEF36B74F092B4A60951F,012-345-678,11111111,UBER EATS ANZ,23.51,0,1520287.95,DR,REF170951,ANZ,Savings
28-09-2025 03:52,ANZEF0ED680FA0249949604,012-345-678,11111111,RAILWAY STATION ANZ,124.9,0,1520163.05,DR,REF269891,ANZ,Savings
28-09-2025 03:55,ANZB5C0DE3E570A433197AF,012-345-678,11111111,KFC ANZ,18.2,0,1520144.85,DR,REF733242,ANZ,Savings
28-09-2025 04:01,ANZ5D7B01B48D0641AF91D4,012-345-678,11111111,FLIXBUS ANZ,45.52,0,1520099.33,DR,REF204847,ANZ,Savings
28-09-2025 04:29,ANZA6E97BC8D591482D8DE4,012-345-678,11111111,SHELL ANZ,146.37,0,1519952.96,DR,REF204225,ANZ,Savings
28-09-2025 04:31,ANZDA7B5219D88F4D388A62,012-345-678,11111111,BP ANZ,18.64,0,1519934.32,DR,REF187287,ANZ,Savings
28-09-2025 04:51,ANZ2438005590C94711A1B8,012-345-678,11111111,WOOLWORTHS ANZ,13.94,0,1519920.38,DR,REF148836,ANZ,Savings
28-09-2025 04:58,ANZE0D85620946F4D28993A,012-345-678,11111111,AMAZON AU ANZ,97.44,0,1519822.94,DR,REF195400,ANZ,Savings
28-09-2025 05:38,ANZEAFBFAF697144E31B806,012-345-678,11111111,HARVEY NORMAN ANZ,37.08,0,1519785.86,DR,REF821298,ANZ,Savings
28-09-2025 05:49,ANZ088A3524CF6C4721A131,012-345-678,11111111,PAYMENT GATEWAY ANZ,46.63,0,1519739.23,DR,REF453871,ANZ,Savings
28-09-2025 05:56,ANZC5982AD6A1134B63A269,012-345-678,11111111,SPOTIFY ANZ,97.05,0,1519642.18,DR,REF676587,ANZ,Savings
28-09-2025 06:13,ANZ0576BA157A4E4EDAB60D,012-345-678,11111111,APPLE ANZ,7.81,0,1519634.37,DR,REF437792,ANZ,Savings
28-09-2025 06:19,ANZE8261EDEFAA94C5B826C,012-345-678,11111111,ALDI ANZ,14.48,0,1519619.89,DR,REF279862,ANZ,Savings
28-09-2025 06:21,ANZ804FF20F3EFF4A12986E,012-345-678,11111111,SHELL ANZ,19.54,0,1519600.35,DR,REF555041,ANZ,Savings
28-09-2025 06:24,ANZ4B706C2E58154FD2AF9B,012-345-678,11111111,COLES ANZ,84.4,0,1519515.95,DR,REF855014,ANZ,Savings
28-09-2025 06:59,ANZ5F4CBDD0733A48A898B5,012-345-678,11111111,TAFE BOOKSHOP ANZ,119.01,0,1519396.94,DR,REF966764,ANZ,Savings
28-09-2025 07:12,ANZ69CFBEB505484300B0EE,012-345-678,11111111,BWS ANZ,87.48,0,1519309.46,DR,REF386582,ANZ,Savings
28-09-2025 07:25,ANZB57B09783EA447F6802A,012-345-678,11111111,COMPANY PAYROLL ANZ,0,4951,1524260.46,CR,REF498247,ANZ,Savings
28-09-2025 08:40,ANZ85EA8C968CF14C5FB467,012-345-678,11111111,BWS ANZ,119.46,0,1524141,DR,REF131163,ANZ,Savings
28-09-2025 09:39,ANZ624EA79C8AA54F66B993,012-345-678,11111111,BIGW ANZ,146.55,0,1523994.45,DR,REF499072,ANZ,Savings
28-09-2025 10:12,ANZFB615C2DF0FF4905A68B,012-345-678,11111111,BWS ANZ,115.92,0,1523878.53,DR,REF451495,ANZ,Savings
28-09-2025 11:18,ANZ8406A2B7DCC04FCB8167,012-345-678,11111111,SALARY PAYMENT ANZ,0,4587.84,1528466.37,CR,REF618208,ANZ,Savings
28-09-2025 11:20,ANZ972395323E2B487AA43C,012-345-678,11111111,WOOLWORTHS ANZ,48.88,0,1528417.49,DR,REF794410,ANZ,Savings
28-09-2025 11:25,ANZCEEC628C45E04C239220,012-345-678,11111111,UBER EATS ANZ,27.32,0,1528390.17,DR,REF133861,ANZ,Savings
28-09-2025 11:42,ANZ7FEF69D85EC040308377,012-345-678,11111111,WOOLWORTHS ANZ,53.53,0,1528336.64,DR,REF867445,ANZ,Savings
28-09-2025 11:42,ANZD47CC1C909E940DBA169,012-345-678,11111111,WOOLWORTHS ANZ,4.35,0,1528332.29,DR,REF910329,ANZ,Savings
28-09-2025 12:01,ANZ540A7C1E3EA944CD9A16,012-345-678,11111111,APPLE ANZ,52.9,0,1528279.39,DR,REF159843,ANZ,Savings
28-09-2025 12:36,ANZ0DB577816E0C4EA08BA7,012-345-678,11111111,BIGW ANZ,47.96,0,1528231.43,DR,REF993929,ANZ,Savings
28-09-2025 12:38,ANZ7A471F58113C4268826E,012-345-678,11111111,APPLE ANZ,29.94,0,1528201.49,DR,REF371314,ANZ,Savings
28-09-2025 13:06,ANZ24B620A843904D06892D,012-345-678,11111111,MCDONALDS ANZ,4.87,0,1528196.62,DR,REF631722,ANZ,Savings
28-09-2025 13:17,INT308E2013F57A427797AE,012-345-678,11111111,TRANSFER TO CBA 33333333,1987.78,0,1526208.84,DR,INT-60037,ANZ,Savings
28-09-2025 13:42,ANZAFB8642DC8704D75A9C1,012-345-678,11111111,UBER EATS ANZ,68.26,0,1526140.58,DR,REF333884,ANZ,Savings
28-09-2025 14:43,ANZE05C35DC9E974C86BF9D,012-345-678,11111111,PAYMENT GATEWAY ANZ,39.3,0,1526101.28,DR,REF966322,ANZ,Savings
28-09-2025 14:46,ANZ487FC5EDA4E946879A83,012-345-678,11111111,INTERNET TRANSFER ANZ,65.42,0,1526035.86,DR,REF475937,ANZ,Savings
28-09-2025 14:56,ANZ22D6D8E592C94DE7A46B,012-345-678,11111111,STARBUCKS ANZ,23.92,0,1526011.94,DR,REF729058,ANZ,Savings
28-09-2025 15:12,ANZA49B40FAE2434CDC8243,012-345-678,11111111,SALARY PAYMENT ANZ,0,3450.64,1529462.58,CR,REF238625,ANZ,Savings
28-09-2025 15:31,ANZB7E0D3DBF38D44EC949C,012-345-678,11111111,PAY - SALARY ANZ,0,25.46,1529488.04,CR,REF599643,ANZ,Savings
28-09-2025 15:43,ANZ94A913D8DC4A41C3BA30,012-345-678,11111111,MENULOG ANZ,82.01,0,1529406.03,DR,REF869552,ANZ,Savings
28-09-2025 15:45,ANZ17E524E8AA2044998B80,012-345-678,11111111,BIGW ANZ,3.68,0,1529402.35,DR,REF751157,ANZ,Savings
28-09-2025 16:00,ANZ40581F13A25C49F0B920,012-345-678,11111111,PAYROLL CREDIT ANZ,0,3504.31,1532906.66,CR,REF151110,ANZ,Savings
28-09-2025 16:34,ANZA2948083B7C046618EDB,012-345-678,11111111,DOMINO'S PIZZA ANZ,16.55,0,1532890.11,DR,REF519234,ANZ,Savings
28-09-2025 16:39,ANZ9259CBB7648146CCA5C8,012-345-678,11111111,AMAZON AU ANZ,14.47,0,1532875.64,DR,REF534248,ANZ,Savings
28-09-2025 16:51,INT341A4C64B05646019A7C,012-345-678,11111111,TRANSFER TO CBA 33333333,683.29,0,1532192.35,DR,INT-82405,ANZ,Savings
28-09-2025 17:07,ANZE7D273814B6849489772,012-345-678,11111111,PAYROLL CREDIT ANZ,0,2767.98,1534960.33,CR,REF771062,ANZ,Savings
28-09-2025 17:29,ANZDA6A789FAA2E4A41B476,012-345-678,11111111,BANK FEE ANZ,58.31,0,1534902.02,DR,REF300884,ANZ,Savings
28-09-2025 18:08,ANZD08F69F8B5F249FDA422,012-345-678,11111111,7-ELEVEN ANZ,36.68,0,1534865.34,DR,REF834498,ANZ,Savings
28-09-2025 18:11,ANZ6BB4CCBC53014C78AD4B,012-345-678,11111111,COMPANY PAYROLL ANZ,0,4487.7,1539353.04,CR,REF264318,ANZ,Savings
28-09-2025 18:42,ANZ38FFAB5025634B49BDC3,012-345-678,11111111,SHELL ANZ,28.46,0,1539324.58,DR,REF987477,ANZ,Savings
28-09-2025 18:56,ANZA07769ACD1814C4DA68B,012-345-678,11111111,ZOOM ANZ,14.11,0,1539310.47,DR,REF872271,ANZ,Savings
28-09-2025 19:06,ANZF2BD2DBBAFBB47C0919D,012-345-678,11111111,PAYMENT GATEWAY ANZ,46.67,0,1539263.8,DR,REF426469,ANZ,Savings
28-09-2025 19:30,ANZ33B50D2FBDBD4264B916,012-345-678,11111111,PAYPAL *NETFLIX ANZ,6.23,0,1539257.57,DR,REF775832,ANZ,Savings
28-09-2025 19:52,ANZ92C57332B5C042579A68,012-345-678,11111111,BWS ANZ,19.84,0,1539237.73,DR,REF113576,ANZ,Savings
28-09-2025 20:12,ANZF6A9F9943BEC4CEF92F5,012-345-678,11111111,APPLE ANZ,161.35,0,1539076.38,DR,REF538027,ANZ,Savings
28-09-2025 20:43,ANZD09C58734652424F86F7,012-345-678,11111111,FLIXBUS ANZ,58.5,0,1539017.88,DR,REF447228,ANZ,Savings
28-09-2025 20:44,ANZF4DA0CE3F4F44D5E9373,012-345-678,11111111,APPLE ANZ,4.69,0,1539013.19,DR,REF804668,ANZ,Savings
28-09-2025 21:27,ANZ87681875D0554D08BE7C,012-345-678,11111111,PAYROLL CREDIT ANZ,0,7012.62,1546025.81,CR,REF199283,ANZ,Savings
28-09-2025 21:27,ANZ0D5C5082B13C47FE957A,012-345-678,11111111,PAYPAL *NETFLIX ANZ,5.31,0,1546020.5,DR,REF502980,ANZ,Savings
28-09-2025 21:48,ANZ4C18525DD0064CE3A071,012-345-678,11111111,HARVEY NORMAN ANZ,26.64,0,1545993.86,DR,REF698887,ANZ,Savings
28-09-2025 21:49,INT6D82098937DF4F2F9710,012-345-678,11111111,TRANSFER FROM CBA 33333333,0,349.13,1546342.99,CR,INT-62391,ANZ,Savings
28-09-2025 21:50,ANZ9C13A4FE0F9C4EA3BC31,012-345-678,11111111,PAYMENT GATEWAY ANZ,28.26,0,1546314.73,DR,REF781656,ANZ,Savings
28-09-2025 21:54,ANZ36677D0262814A70813F,012-345-678,11111111,TAFE BOOKSHOP ANZ,19.73,0,1546295,DR,REF854019,ANZ,Savings
28-09-2025 22:18,ANZA66986CDA9E943A68C86,012-345-678,11111111,INTERNET TRANSFER ANZ,36.06,0,1546258.94,DR,REF446732,ANZ,Savings
28-09-2025 22:24,ANZ965B28436ACD4CE281CD,012-345-678,11111111,PAYROLL CREDIT ANZ,0,4599.79,1550858.73,CR,REF693496,ANZ,Savings
28-09-2025 22:28,ANZED59A3F208DC448491F8,012-345-678,11111111,FLIXBUS ANZ,69.44,0,1550789.29,DR,REF141966,ANZ,Savings
28-09-2025 22:36,ANZ961D82E5CD0547FDAE5F,012-345-678,11111111,INTERNET TRANSFER ANZ,16.33,0,1550772.96,DR,REF538499,ANZ,Savings
28-09-2025 22:46,ANZ56F78AC9C6C64BAEA1A7,012-345-678,11111111,CITYLINK ANZ,20.96,0,1550752,DR,REF292940,ANZ,Savings
28-09-2025 23:06,ANZ18A2712C3EAC4E178CC0,012-345-678,11111111,AMAZON AU ANZ,31.25,0,1550720.75,DR,REF123637,ANZ,Savings
28-09-2025 23:32,ANZ0926EF62ADCE487D9DF6,012-345-678,11111111,APPLE ANZ,253.16,0,1550467.59,DR,REF206146,ANZ,Savings
28-09-2025 23:43,ANZEFED64EA875745DEBD89,012-345-678,11111111,ALDI ANZ,4.93,0,1550462.66,DR,REF220287,ANZ,Savings
29-09-2025 00:10,ANZ2FEFC5865E544BAB8787,012-345-678,11111111,BP ANZ,30.31,0,1550432.35,DR,REF735781,ANZ,Savings
29-09-2025 00:17,ANZDECC02602CE34F0690F6,012-345-678,11111111,WAGES CREDIT ANZ,0,2393.53,1552825.88,CR,REF514019,ANZ,Savings
29-09-2025 00:22,ANZ13C4630667B24AFB8B33,012-345-678,11111111,RAILWAY STATION ANZ,9.76,0,1552816.12,DR,REF591004,ANZ,Savings
29-09-2025 00:26,ANZAEFFFDE8FB414CA28F0F,012-345-678,11111111,SHELL ANZ,31.43,0,1552784.69,DR,REF489584,ANZ,Savings
29-09-2025 00:45,ANZ644B264157574EFEB4B7,012-345-678,11111111,BIGW ANZ,69.43,0,1552715.26,DR,REF643908,ANZ,Savings
29-09-2025 00:49,ANZ44168EDBB903423DA4AF,012-345-678,11111111,KFC ANZ,55.27,0,1552659.99,DR,REF304529,ANZ,Savings
29-09-2025 01:36,ANZ0046C9FFA9F146979BC4,012-345-678,11111111,COLES ANZ,53.76,0,1552606.23,DR,REF572973,ANZ,Savings
29-09-2025 01:43,ANZAF4CB4CA31FE4AFCB4E7,012-345-678,11111111,SALARY PAYMENT ANZ,0,3611.62,1556217.85,CR,REF186791,ANZ,Savings
29-09-2025 01:57,ANZ0A707DE2FBCD48269A00,012-345-678,11111111,TAFE BOOKSHOP ANZ,35.93,0,1556181.92,DR,REF812980,ANZ,Savings
29-09-2025 03:33,ANZE9396CCF478F43308F41,012-345-678,11111111,COLES ANZ,17.44,0,1556164.48,DR,REF825367,ANZ,Savings
29-09-2025 04:03,ANZE71A28F777604619A545,012-345-678,11111111,BANK FEE ANZ,6.71,0,1556157.77,DR,REF980168,ANZ,Savings
29-09-2025 04:23,ANZ5CDD1BD5369548FEB6A1,012-345-678,11111111,BIGW ANZ,7.39,0,1556150.38,DR,REF248523,ANZ,Savings
29-09-2025 04:23,ANZ46ADF224E4764742ACE6,012-345-678,11111111,PAYPAL *NETFLIX ANZ,50.43,0,1556099.95,DR,REF619203,ANZ,Savings
29-09-2025 04:50,ANZ0B48CEF0CD944341B914,012-345-678,11111111,BIGW ANZ,3.93,0,1556096.02,DR,REF302788,ANZ,Savings
29-09-2025 06:12,ANZ345FCE4C7873434086A0,012-345-678,11111111,ALDI ANZ,147.21,0,1555948.81,DR,REF388259,ANZ,Savings
29-09-2025 06:36,ANZA1BD415DD5314F0BB767,012-345-678,11111111,UBER EATS ANZ,21.52,0,1555927.29,DR,REF770961,ANZ,Savings
29-09-2025 06:48,ANZ52224C8E050048028236,012-345-678,11111111,ZOOM ANZ,46.23,0,1555881.06,DR,REF814634,ANZ,Savings
29-09-2025 06:53,ANZ5E721BADB77F4DF5B5F8,012-345-678,11111111,LIQUORLAND ANZ,71.55,0,1555809.51,DR,REF236965,ANZ,Savings
29-09-2025 06:53,ANZ3D2832C60B21432583FF,012-345-678,11111111,MCDONALDS ANZ,26.53,0,1555782.98,DR,REF442159,ANZ,Savings
29-09-2025 06:57,ANZ48D2C677CEC44380B739,012-345-678,11111111,WOOLWORTHS ANZ,124.99,0,1555657.99,DR,REF960094,ANZ,Savings
29-09-2025 07:04,INT973C97F1CFCD4B1F8B78,012-345-678,11111111,TRANSFER TO CBA 22222222,1990.35,0,1553667.64,DR,INT-34910,ANZ,Savings
29-09-2025 07:07,INT7A4A704CAFE047A68936,012-345-678,11111111,TRANSFER TO CBA 33333333,173.5,0,1553494.14,DR,INT-45539,ANZ,Savings
29-09-2025 07:08,ANZA3C4AA53D2D44DD28F90,012-345-678,11111111,SALARY PAYMENT ANZ,0,2143.38,1555637.52,CR,REF341359,ANZ,Savings
29-09-2025 07:53,ANZF7CDD6B528C7497D8175,012-345-678,11111111,ALDI ANZ,10.92,0,1555626.6,DR,REF615798,ANZ,Savings
29-09-2025 08:14,ANZ99848446A40343D89F3D,012-345-678,11111111,SPOTIFY ANZ,57.12,0,1555569.48,DR,REF546684,ANZ,Savings
29-09-2025 08:19,ANZ2EEC85D91A984CD9AAC6,012-345-678,11111111,MENULOG ANZ,136.69,0,1555432.79,DR,REF481282,ANZ,Savings
29-09-2025 08:20,ANZ5C58D43B4FD943D8AE63,012-345-678,11111111,MCDONALDS ANZ,79.4,0,1555353.39,DR,REF886529,ANZ,Savings
29-09-2025 08:20,ANZ9FD44FF61BE34B6798B6,012-345-678,11111111,7-ELEVEN ANZ,29.25,0,1555324.14,DR,REF619932,ANZ,Savings
29-09-2025 08:26,ANZ504414B82F2A4959BBF9,012-345-678,11111111,STARBUCKS ANZ,62.14,0,1555262,DR,REF465127,ANZ,Savings
29-09-2025 08:44,ANZ78EF3FABB6C64071BAE6,012-345-678,11111111,KFC ANZ,28.03,0,1555233.97,DR,REF724217,ANZ,Savings
29-09-2025 09:29,ANZ3BFCF91D68024485ACAC,012-345-678,11111111,INTERNET TRANSFER ANZ,3.23,0,1555230.74,DR,REF754428,ANZ,Savings
29-09-2025 09:51,ANZ7769BFA0D317481BA66A,012-345-678,11111111,MENULOG ANZ,86.34,0,1555144.4,DR,REF366708,ANZ,Savings
29-09-2025 10:06,ANZ41EAE304DA8A4A04AA04,012-345-678,11111111,BIGW ANZ,29.5,0,1555114.9,DR,REF292795,ANZ,Savings
29-09-2025 10:12,ANZ69678529D169409DAF1B,012-345-678,11111111,INTERNET TRANSFER ANZ,18.34,0,1555096.56,DR,REF338824,ANZ,Savings
29-09-2025 10:19,ANZ8707DE0D32EA48FF93B8,012-345-678,11111111,APPLE ANZ,35.31,0,1555061.25,DR,REF202895,ANZ,Savings
29-09-2025 10:22,ANZ3E33FF6118FA4D4AABDF,012-345-678,11111111,COLES ANZ,39.41,0,1555021.84,DR,REF487206,ANZ,Savings
29-09-2025 10:42,ANZ2C3137F8102E46EA956A,012-345-678,11111111,AMAZON AU ANZ,54.37,0,1554967.47,DR,REF304753,ANZ,Savings
29-09-2025 12:04,ANZ3D1193297F1E4C65AAF6,012-345-678,11111111,KFC ANZ,99.35,0,1554868.12,DR,REF318031,ANZ,Savings
29-09-2025 12:06,ANZ4C034D1281D04C0BA836,012-345-678,11111111,SALARY PAYMENT ANZ,0,4086.39,1558954.51,CR,REF242641,ANZ,Savings
29-09-2025 12:11,INT389BC5F9F17E4AB78BC6,012-345-678,11111111,TRANSFER FROM CBA 22222222,0,319.49,1559274,CR,INT-23332,ANZ,Savings
29-09-2025 12:12,ANZ82148F19D0814A368620,012-345-678,11111111,TAFE BOOKSHOP ANZ,32.49,0,1559241.51,DR,REF930924,ANZ,Savings
29-09-2025 12:31,ANZFC486EAB011A4F5DA150,012-345-678,11111111,PAYPAL *NETFLIX ANZ,53.17,0,1559188.34,DR,REF199831,ANZ,Savings
29-09-2025 12:34,ANZ38DA1893E7D749B2B0A3,012-345-678,11111111,BWS ANZ,9.96,0,1559178.38,DR,REF718375,ANZ,Savings
29-09-2025 12:51,ANZE6AA0903D46644D38A78,012-345-678,11111111,BIGW ANZ,9.63,0,1559168.75,DR,REF487374,ANZ,Savings
29-09-2025 13:05,ANZ745829DCD4A54960828A,012-345-678,11111111,DOMINO'S PIZZA ANZ,38.49,0,1559130.26,DR,REF614004,ANZ,Savings
29-09-2025 13:20,ANZBBF1E2A377504FE19C4C,012-345-678,11111111,SALARY PAYMENT ANZ,0,242.3,1559372.56,CR,REF253648,ANZ,Savings
29-09-2025 13:29,ANZFC189303D1A44B4CB943,012-345-678,11111111,PAYMENT GATEWAY ANZ,54.43,0,1559318.13,DR,REF390877,ANZ,Savings
29-09-2025 14:05,ANZ6B4AD0CFC772423A9096,012-345-678,11111111,BANK FEE ANZ,53.54,0,1559264.59,DR,REF839174,ANZ,Savings
29-09-2025 14:36,ANZ61DD5E6B3FED428C961E,012-345-678,11111111,COMPANY PAYROLL ANZ,0,7748.1,1567012.69,CR,REF289386,ANZ,Savings
29-09-2025 14:49,ANZEDDC35630B014577BF41,012-345-678,11111111,SHELL ANZ,16.99,0,1566995.7,DR,REF493424,ANZ,Savings
29-09-2025 14:52,ANZC8DB76E0907F4950BE8C,012-345-678,11111111,LIQUORLAND ANZ,10.43,0,1566985.27,DR,REF647836,ANZ,Savings
29-09-2025 14:58,ANZ1C7D593EBD7549D3AC0F,012-345-678,11111111,ZOOM ANZ,3.59,0,1566981.68,DR,REF646702,ANZ,Savings
29-09-2025 15:12,ANZ2972C44297E84272A660,012-345-678,11111111,PAYROLL CREDIT ANZ,0,6179.09,1573160.77,CR,REF161905,ANZ,Savings
29-09-2025 15:35,ANZ94B4E2691AE344F0AC01,012-345-678,11111111,PAYMENT GATEWAY ANZ,161.99,0,1572998.78,DR,REF631363,ANZ,Savings
29-09-2025 15:54,ANZ42C679318FC94D38812E,012-345-678,11111111,ZOOM ANZ,206.78,0,1572792,DR,REF154052,ANZ,Savings
29-09-2025 16:56,ANZ5AA40F3C03094B369637,012-345-678,11111111,BANK FEE ANZ,21.6,0,1572770.4,DR,REF599867,ANZ,Savings
29-09-2025 17:09,ANZ857E18F23FDF4A848D37,012-345-678,11111111,UBER EATS ANZ,47.25,0,1572723.15,DR,REF892654,ANZ,Savings
29-09-2025 17:15,ANZEB069C29E21D43D9B793,012-345-678,11111111,SALARY PAYMENT ANZ,0,7256.4,1579979.55,CR,REF712975,ANZ,Savings
29-09-2025 17:17,ANZ41FDAAF025A94AC29E5A,012-345-678,11111111,KFC ANZ,10.63,0,1579968.92,DR,REF820446,ANZ,Savings
29-09-2025 17:28,ANZC4BE43C0A5B3449EB882,012-345-678,11111111,TAFE BOOKSHOP ANZ,10.59,0,1579958.33,DR,REF648994,ANZ,Savings
29-09-2025 17:30,ANZA39490B48C3546D7B2C7,012-345-678,11111111,PAYROLL CREDIT ANZ,0,1166.87,1581125.2,CR,REF875011,ANZ,Savings
29-09-2025 17:51,ANZE467C80B50354361BCF2,012-345-678,11111111,AMAZON AU ANZ,6.05,0,1581119.15,DR,REF299473,ANZ,Savings
29-09-2025 17:56,ANZ5117CFEFB57045F1BA45,012-345-678,11111111,PAYMENT GATEWAY ANZ,25.68,0,1581093.47,DR,REF564577,ANZ,Savings
29-09-2025 18:05,ANZD0007006BE324EEEB652,012-345-678,11111111,SPOTIFY ANZ,42.12,0,1581051.35,DR,REF181627,ANZ,Savings
29-09-2025 18:35,ANZFA633303571D44B3AA3B,012-345-678,11111111,TAFE BOOKSHOP ANZ,31.45,0,1581019.9,DR,REF925296,ANZ,Savings
29-09-2025 18:41,ANZ43C8C5E670784B3E844C,012-345-678,11111111,PAYMENT GATEWAY ANZ,64.5,0,1580955.4,DR,REF924236,ANZ,Savings
29-09-2025 19:26,ANZEAAE07ED091E4CEB979D,012-345-678,11111111,BANK FEE ANZ,7.77,0,1580947.63,DR,REF866048,ANZ,Savings
29-09-2025 19:41,ANZ91487109C54040CE97F8,012-345-678,11111111,INTERNET TRANSFER ANZ,30.2,0,1580917.43,DR,REF776732,ANZ,Savings
29-09-2025 19:48,INTB636FE46834A4A0FA361,012-345-678,11111111,TRANSFER FROM CBA 33333333,0,846.58,1581764.01,CR,INT-72941,ANZ,Savings
29-09-2025 20:00,ANZ788D918F40F441159AD7,012-345-678,11111111,SALARY PAYMENT ANZ,0,726.67,1582490.68,CR,REF251022,ANZ,Savings
29-09-2025 20:29,ANZ934254F8489340ECB31C,012-345-678,11111111,ALDI ANZ,44.98,0,1582445.7,DR,REF384134,ANZ,Savings
29-09-2025 20:42,ANZ554E9125BFB64F5CA415,012-345-678,11111111,CITYLINK ANZ,40.6,0,1582405.1,DR,REF994049,ANZ,Savings
29-09-2025 20:46,ANZDE3BA6B938904FA789AA,012-345-678,11111111,BP ANZ,14.42,0,1582390.68,DR,REF973050,ANZ,Savings
29-09-2025 21:06,ANZC76E19F92CD54915AA3C,012-345-678,11111111,SHELL ANZ,65.67,0,1582325.01,DR,REF185393,ANZ,Savings
29-09-2025 21:57,ANZC5157E459C8A474E94B5,012-345-678,11111111,ALDI ANZ,36.28,0,1582288.73,DR,REF295667,ANZ,Savings
29-09-2025 22:16,ANZ11701AE55C1246309E7D,012-345-678,11111111,PAYPAL *NETFLIX ANZ,37.7,0,1582251.03,DR,REF239027,ANZ,Savings
29-09-2025 22:43,ANZ948EB70762E24BA5A75A,012-345-678,11111111,BIGW ANZ,23.74,0,1582227.29,DR,REF652549,ANZ,Savings
29-09-2025 22:48,ANZB3B9472C21D24B779339,012-345-678,11111111,APPLE ANZ,7.42,0,1582219.87,DR,REF784144,ANZ,Savings
29-09-2025 22:54,ANZ4CE42B474C4F4E2D92B1,012-345-678,11111111,APPLE ANZ,37.64,0,1582182.23,DR,REF870410,ANZ,Savings
30-09-2025 00:18,ANZ33988FA242BA40558DFF,012-345-678,11111111,ZOOM ANZ,4.89,0,1582177.34,DR,REF460457,ANZ,Savings
30-09-2025 00:53,ANZ50630CF5B3A34E5EA8B9,012-345-678,11111111,UBER EATS ANZ,141.39,0,1582035.95,DR,REF907083,ANZ,Savings
30-09-2025 01:05,ANZ5B1C1B57A3BC4774B25F,012-345-678,11111111,JB HI-FI ANZ,32.21,0,1582003.74,DR,REF417887,ANZ,Savings
30-09-2025 01:06,ANZAB4B54C7FDE0469D8901,012-345-678,11111111,KFC ANZ,50.72,0,1581953.02,DR,REF479573,ANZ,Savings
30-09-2025 01:33,ANZD95FD715389547869F12,012-345-678,11111111,UBER EATS ANZ,54.78,0,1581898.24,DR,REF453245,ANZ,Savings
30-09-2025 01:34,ANZA570BCE62071464B915A,012-345-678,11111111,FLIXBUS ANZ,53.58,0,1581844.66,DR,REF916199,ANZ,Savings
30-09-2025 01:59,ANZCC95EF2C72144319A755,012-345-678,11111111,TAFE BOOKSHOP ANZ,147.83,0,1581696.83,DR,REF295728,ANZ,Savings
30-09-2025 02:04,ANZ6AD2A82F9C654A2F95A1,012-345-678,11111111,BP ANZ,12.04,0,1581684.79,DR,REF774821,ANZ,Savings
30-09-2025 02:07,ANZ35145061DDA64C0FB10A,012-345-678,11111111,DOMINO'S PIZZA ANZ,24.32,0,1581660.47,DR,REF783207,ANZ,Savings
30-09-2025 02:10,ANZ8552C55F37DB47B0849B,012-345-678,11111111,PAYMENT GATEWAY ANZ,34.74,0,1581625.73,DR,REF786470,ANZ,Savings
30-09-2025 02:21,ANZ8BF34B6DF59541A9A7FD,012-345-678,11111111,BANK FEE ANZ,14.91,0,1581610.82,DR,REF682204,ANZ,Savings
30-09-2025 02:47,ANZ507177CD0B2D4DC8A9F4,012-345-678,11111111,JB HI-FI ANZ,5.4,0,1581605.42,DR,REF316137,ANZ,Savings
30-09-2025 04:23,ANZFA1E534C3F2D40F3A256,012-345-678,11111111,BWS ANZ,72.05,0,1581533.37,DR,REF409417,ANZ,Savings
30-09-2025 04:28,INT7B794ECE3AFD42E08B37,012-345-678,11111111,TRANSFER FROM CBA 33333333,0,1069.53,1582602.9,CR,INT-45708,ANZ,Savings
30-09-2025 04:43,ANZ644C21C0E0914BE78EF2,012-345-678,11111111,BANK FEE ANZ,207.49,0,1582395.41,DR,REF821095,ANZ,Savings
30-09-2025 06:17,ANZ8294D7959BF6439089D6,012-345-678,11111111,ALDI ANZ,38.22,0,1582357.19,DR,REF360794,ANZ,Savings
30-09-2025 06:32,ANZ638A0F4CA0964808AD7D,012-345-678,11111111,COLES ANZ,50.17,0,1582307.02,DR,REF644752,ANZ,Savings
30-09-2025 06:33,ANZ9D9E5D7703E449B785F1,012-345-678,11111111,BP ANZ,24.66,0,1582282.36,DR,REF535535,ANZ,Savings
30-09-2025 06:51,INTA3A9D8A803924B33A90E,012-345-678,11111111,TRANSFER TO CBA 22222222,623.26,0,1581659.1,DR,INT-68271,ANZ,Savings
30-09-2025 07:00,ANZ11E8951592D64A92AADF,012-345-678,11111111,PAY - SALARY ANZ,0,7808.93,1589468.03,CR,REF973836,ANZ,Savings
30-09-2025 07:10,ANZ1AAED735FB734283B1FA,012-345-678,11111111,PAYROLL CREDIT ANZ,0,6099.69,1595567.72,CR,REF908753,ANZ,Savings
30-09-2025 07:29,INT529C36E5CF184054A0C3,012-345-678,11111111,TRANSFER TO NAB 44444444,1057.84,0,1594509.88,DR,INT-63145,ANZ,Savings
30-09-2025 07:32,ANZ90435BFD94D6446C906E,012-345-678,11111111,LIQUORLAND ANZ,12.66,0,1594497.22,DR,REF665583,ANZ,Savings
30-09-2025 07:33,ANZ8730566DBBC6411FADCD,012-345-678,11111111,ALDI ANZ,2.68,0,1594494.54,DR,REF493774,ANZ,Savings
30-09-2025 08:15,ANZ56DFB726ABF64D95A247,012-345-678,11111111,7-ELEVEN ANZ,6.29,0,1594488.25,DR,REF161777,ANZ,Savings
30-09-2025 08:36,ANZ29611E7DAF144D18B2C2,012-345-678,11111111,PAYROLL CREDIT ANZ,0,7445.58,1601933.83,CR,REF696043,ANZ,Savings
30-09-2025 08:44,ANZ9C366761C0C64C71AF4E,012-345-678,11111111,PAYMENT GATEWAY ANZ,71.37,0,1601862.46,DR,REF783177,ANZ,Savings
30-09-2025 09:10,ANZBF2B53F225B542A2A54D,012-345-678,11111111,COMPANY PAYROLL ANZ,0,6945.73,1608808.19,CR,REF683419,ANZ,Savings
30-09-2025 10:20,ANZE122FDFFD6E940BDAB4A,012-345-678,11111111,ALDI ANZ,24.95,0,1608783.24,DR,REF892882,ANZ,Savings
30-09-2025 10:38,ANZ566F4EA0298E41328963,012-345-678,11111111,APPLE ANZ,64.94,0,1608718.3,DR,REF593452,ANZ,Savings
30-09-2025 10:56,ANZ2CD4312BA93E4F66A7EC,012-345-678,11111111,COLES ANZ,60.45,0,1608657.85,DR,REF182772,ANZ,Savings
30-09-2025 11:00,ANZ18A76382AFF04DDC980A,012-345-678,11111111,STARBUCKS ANZ,63.67,0,1608594.18,DR,REF401176,ANZ,Savings
30-09-2025 11:11,ANZD797487942144E36BC59,012-345-678,11111111,SPOTIFY ANZ,75.88,0,1608518.3,DR,REF686947,ANZ,Savings
30-09-2025 11:13,INTC3BB970325354C0B8932,012-345-678,11111111,TRANSFER FROM CBA 22222222,0,1814.27,1610332.57,CR,INT-87450,ANZ,Savings
30-09-2025 11:28,INTA31DBFA7C68241E792C0,012-345-678,11111111,TRANSFER TO CBA 33333333,1976.37,0,1608356.2,DR,INT-94252,ANZ,Savings
30-09-2025 11:43,ANZF33922CE174E4E268A01,012-345-678,11111111,RAILWAY STATION ANZ,64.68,0,1608291.52,DR,REF280550,ANZ,Savings
30-09-2025 12:05,ANZ8CB2700BE8FD40E8A3DB,012-345-678,11111111,LIQUORLAND ANZ,11.54,0,1608279.98,DR,REF369491,ANZ,Savings
30-09-2025 12:07,ANZF315D1318D7D4BA4B55B,012-345-678,11111111,MCDONALDS ANZ,17.55,0,1608262.43,DR,REF423283,ANZ,Savings
30-09-2025 12:11,ANZCF7EDDFC18AE4442B0DC,012-345-678,11111111,COLES ANZ,136.05,0,1608126.38,DR,REF442092,ANZ,Savings
30-09-2025 12:12,ANZAA796D03C01147FAAA27,012-345-678,11111111,7-ELEVEN ANZ,29.56,0,1608096.82,DR,REF382382,ANZ,Savings
30-09-2025 12:16,ANZAC7D9BDA4EAA4E03BA7C,012-345-678,11111111,WOOLWORTHS ANZ,12.48,0,1608084.34,DR,REF324301,ANZ,Savings
30-09-2025 12:48,ANZ468839E2D93C4773923A,012-345-678,11111111,PAYPAL *NETFLIX ANZ,73.42,0,1608010.92,DR,REF762157,ANZ,Savings
30-09-2025 13:10,INT8EAB0EDACAF542388BBD,012-345-678,11111111,TRANSFER FROM CBA 22222222,0,607.67,1608618.59,CR,INT-92167,ANZ,Savings
30-09-2025 13:14,ANZ03AA2F795A624FFDA663,012-345-678,11111111,ALDI ANZ,45.05,0,1608573.54,DR,REF870249,ANZ,Savings
30-09-2025 13:15,ANZ966E46607B6841A48A74,012-345-678,11111111,WOOLWORTHS ANZ,72.58,0,1608500.96,DR,REF702086,ANZ,Savings
30-09-2025 13:20,ANZ9B81025C983F457CAF24,012-345-678,11111111,DOMINO'S PIZZA ANZ,61.67,0,1608439.29,DR,REF395433,ANZ,Savings
30-09-2025 14:00,ANZ334E756C379446A09233,012-345-678,11111111,BANK FEE ANZ,68.55,0,1608370.74,DR,REF725669,ANZ,Savings
30-09-2025 14:04,ANZB54019059B3F4A4FA69E,012-345-678,11111111,HARVEY NORMAN ANZ,16.08,0,1608354.66,DR,REF814785,ANZ,Savings
30-09-2025 14:08,INTBE5A885E111741599E47,012-345-678,11111111,TRANSFER FROM NAB 44444444,0,634.24,1608988.9,CR,INT-77620,ANZ,Savings
30-09-2025 14:29,ANZ5E7DEF38720D41BEA94E,012-345-678,11111111,PAY - SALARY ANZ,0,7590.89,1616579.79,CR,REF563122,ANZ,Savings
30-09-2025 15:31,ANZ6661B2E822564859BA36,012-345-678,11111111,TAFE BOOKSHOP ANZ,86.96,0,1616492.83,DR,REF896930,ANZ,Savings
30-09-2025 16:19,ANZ3DF34AADACCA410193E3,012-345-678,11111111,MENULOG ANZ,41.04,0,1616451.79,DR,REF528242,ANZ,Savings
30-09-2025 16:22,ANZCBC0205F7CEA4722A324,012-345-678,11111111,PAYROLL CREDIT ANZ,0,4822.81,1621274.6,CR,REF105487,ANZ,Savings
30-09-2025 16:29,INT07F9358DCA644F13A92D,012-345-678,11111111,TRANSFER FROM CBA 22222222,0,533.69,1621808.29,CR,INT-86775,ANZ,Savings
30-09-2025 17:13,ANZDC0CAD01BE174F179515,012-345-678,11111111,BIGW ANZ,30.8,0,1621777.49,DR,REF290075,ANZ,Savings
30-09-2025 17:32,ANZF235DD1150F44A0A9247,012-345-678,11111111,STARBUCKS ANZ,8.41,0,1621769.08,DR,REF632140,ANZ,Savings
30-09-2025 17:45,ANZAB26EDAA1D7549F79907,012-345-678,11111111,SPOTIFY ANZ,117.78,0,1621651.3,DR,REF111186,ANZ,Savings
30-09-2025 18:15,INT44A5E2638CC74DA3B357,012-345-678,11111111,TRANSFER TO CBA 22222222,1473.34,0,1620177.96,DR,INT-64674,ANZ,Savings
30-09-2025 18:42,ANZE2ABF007E6FE4212A48F,012-345-678,11111111,JB HI-FI ANZ,11.17,0,1620166.79,DR,REF456069,ANZ,Savings
30-09-2025 18:48,ANZCF6B903CE5784A098FAF,012-345-678,11111111,WOOLWORTHS ANZ,63.97,0,1620102.82,DR,REF488151,ANZ,Savings
30-09-2025 18:48,ANZ4D028AF53D1F4D50B454,012-345-678,11111111,SHELL ANZ,8.12,0,1620094.7,DR,REF513176,ANZ,Savings
30-09-2025 19:04,ANZ955B7C2AB7564F3896AF,012-345-678,11111111,WOOLWORTHS ANZ,35.57,0,1620059.13,DR,REF844484,ANZ,Savings
30-09-2025 19:16,ANZCE0739C627A34857A2FD,012-345-678,11111111,BWS ANZ,30.01,0,1620029.12,DR,REF271928,ANZ,Savings
30-09-2025 19:44,ANZA0E8832DED98430DAAEB,012-345-678,11111111,WAGES CREDIT ANZ,0,1111.75,1621140.87,CR,REF495138,ANZ,Savings
30-09-2025 19:55,ANZ04BBA0A1DA42402C8F6C,012-345-678,11111111,CITYLINK ANZ,23.97,0,1621116.9,DR,REF454655,ANZ,Savings
30-09-2025 20:25,ANZ725E7483CC2446418391,012-345-678,11111111,BIGW ANZ,36.7,0,1621080.2,DR,REF187561,ANZ,Savings
30-09-2025 20:25,ANZA88C33B7596D48DEA29A,012-345-678,11111111,STARBUCKS ANZ,35.81,0,1621044.39,DR,REF842470,ANZ,Savings
30-09-2025 21:03,INT5F681E9150A84EAC98F3,012-345-678,11111111,TRANSFER TO CBA 22222222,239.03,0,1620805.36,DR,INT-16648,ANZ,Savings
30-09-2025 21:10,ANZ39988E6D7946493AA8AA,012-345-678,11111111,FLIXBUS ANZ,33.15,0,1620772.21,DR,REF316357,ANZ,Savings
30-09-2025 21:14,ANZD2FF1924E54A48B8875F,012-345-678,11111111,RAILWAY STATION ANZ,36.45,0,1620735.76,DR,REF314762,ANZ,Savings
30-09-2025 21:35,ANZ18AC57B867F24065931E,012-345-678,11111111,APPLE ANZ,21.12,0,1620714.64,DR,REF913605,ANZ,Savings
30-09-2025 22:38,ANZ35F56165F0CF4B34839D,012-345-678,11111111,HARVEY NORMAN ANZ,9.41,0,1620705.23,DR,REF511252,ANZ,Savings
30-09-2025 22:59,ANZ57B3C94E236E4F919094,012-345-678,11111111,COMPANY PAYROLL ANZ,0,5744.82,1626450.05,CR,REF400937,ANZ,Savings
30-09-2025 23:00,ANZ8394C55B2A794435A72E,012-345-678,11111111,RAILWAY STATION ANZ,33.96,0,1626416.09,DR,REF234474,ANZ,Savings
30-09-2025 23:13,ANZ6E92BA4E625F47FC8673,012-345-678,11111111,RAILWAY STATION ANZ,25.94,0,1626390.15,DR,REF615151,ANZ,Savings
30-09-2025 23:13,ANZ43365D8135C9433D8EC4,012-345-678,11111111,ALDI ANZ,57.61,0,1626332.54,DR,REF886455,ANZ,Savings
30-09-2025 23:15,ANZ87B3F22E5767459AA633,012-345-678,11111111,BP ANZ,146.35,0,1626186.19,DR,REF357557,ANZ,Savings
30-09-2025 23:17,ANZ8068C66D17584ACB8875,012-345-678,11111111,FLIXBUS ANZ,6.96,0,1626179.23,DR,REF646423,ANZ,Savings
30-09-2025 23:24,ANZ34A76D22F40D473BB801,012-345-678,11111111,CITYLINK ANZ,97.98,0,1626081.25,DR,REF911008,ANZ,Savings
30-09-2025 23:32,ANZD63C5D54FF2C4339BA4A,012-345-678,11111111,JB HI-FI ANZ,3.8,0,1626077.45,DR,REF528475,ANZ,Savings
30-09-2025 23:36,ANZ8A1D28B7FD304F74AAC2,012-345-678,11111111,FLIXBUS ANZ,24.75,0,1626052.7,DR,REF879848,ANZ,Savings
