Date,TransactionID,BSB,AccountNumber,Description,Debit,Credit,Balance,Type,Reference,Bank,AccountType
01-08-2025 00:10,CBAE682529DEF214F0CA133,063-000-001,22222222,SHELL CBA,7.05,0,2814.08,DR,REF960576,CBA,Savings
01-08-2025 00:52,CBAA42429731D2D4CE19967,063-000-001,22222222,BANK FEE CBA,29.48,0,2784.6,DR,REF718943,CBA,Savings
01-08-2025 01:00,CBACDC6EA8D8C3F4870B625,063-000-001,22222222,CITYLINK CBA,107.49,0,2677.11,DR,REF765248,CBA,Savings
01-08-2025 01:06,CBABD2644B65EC9471FB637,063-000-001,22222222,BANK FEE CBA,12.25,0,2664.86,DR,REF715328,CBA,Savings
01-08-2025 01:13,CBAD60C6E6BF0554C3F88AB,063-000-001,22222222,PAYMENT GATEWAY CBA,13.48,0,2651.38,DR,REF475813,CBA,Savings
01-08-2025 01:51,CBA80895AD98B8741BDAA59,063-000-001,22222222,PAYROLL CREDIT CBA,0,3624.36,6275.74,CR,REF282276,CBA,Savings
01-08-2025 02:02,CBA05DF6F19A06C4B618ABF,063-000-001,22222222,COLES CBA,15.12,0,6260.62,DR,REF754003,CBA,Savings
01-08-2025 02:25,CBA5B8F341AA5FF4E85A8E1,063-000-001,22222222,DOMINO'S PIZZA CBA,58.38,0,6202.24,DR,REF279365,CBA,Savings
01-08-2025 02:36,CBA7DD4ED6C58B94B499170,063-000-001,22222222,COMPANY PAYROLL CBA,0,475.1,6677.34,CR,REF730744,CBA,Savings
01-08-2025 03:16,CBAC366A3CFC16A406AB430,063-000-001,22222222,MCDONALDS CBA,54.53,0,6622.81,DR,REF219877,CBA,Savings
01-08-2025 03:37,CBAA6267E58CD8A4FD78F35,063-000-001,22222222,ALDI CBA,115.98,0,6506.83,DR,REF542065,CBA,Savings
01-08-2025 03:41,CBA3C16F9323AED40129993,063-000-001,22222222,BWS CBA,20.87,0,6485.96,DR,REF436939,CBA,Savings
01-08-2025 04:06,CBA3F1E73A25F1F4CF5B7E1,063-000-001,22222222,SALARY PAYMENT CBA,0,2233.69,8719.65,CR,REF742706,CBA,Savings
01-08-2025 04:21,CBAD4C244F4AE8741C39382,063-000-001,22222222,COMPANY PAYROLL CBA,0,1616.22,10335.87,CR,REF120719,CBA,Savings
01-08-2025 04:34,CBA7FE25D4F9F734895BFD1,063-000-001,22222222,KFC CBA,71.21,0,10264.66,DR,REF780710,CBA,Savings
01-08-2025 04:55,CBA554E0C79B4B543178948,063-000-001,22222222,AMAZON AU CBA,11.6,0,10253.06,DR,REF524871,CBA,Savings
01-08-2025 05:04,CBA3A3077DF34D340938CF7,063-000-001,22222222,LIQUORLAND CBA,29.81,0,10223.25,DR,REF757287,CBA,Savings
01-08-2025 05:05,CBA64CF2F3F28E14F288999,063-000-001,22222222,BWS CBA,15.22,0,10208.03,DR,REF626899,CBA,Savings
01-08-2025 05:06,CBAD25E845638A24368A359,063-000-001,22222222,SPOTIFY CBA,19.06,0,10188.97,DR,REF384627,CBA,Savings
01-08-2025 05:25,CBA52A6DB7035374E09A43C,063-000-001,22222222,CITYLINK CBA,75.51,0,10113.46,DR,REF100372,CBA,Savings
01-08-2025 05:39,CBA8E796CAC7834491192B9,063-000-001,22222222,MENULOG CBA,71.71,0,10041.75,DR,REF322138,CBA,Savings
01-08-2025 05:45,CBA80835AD75AB8428483F2,063-000-001,22222222,ALDI CBA,60.91,0,9980.84,DR,REF493256,CBA,Savings
01-08-2025 05:51,CBACB9984312F404CF08410,063-000-001,22222222,APPLE CBA,70.28,0,9910.56,DR,REF226032,CBA,Savings
01-08-2025 05:54,CBAAF8B4E7D20A24222964D,063-000-001,22222222,CITYLINK CBA,2.88,0,9907.68,DR,REF818615,CBA,Savings
01-08-2025 06:42,CBA0E4B60B1C58F4FB18CDE,063-000-001,22222222,FLIXBUS CBA,42.65,0,9865.03,DR,REF360081,CBA,Savings
01-08-2025 06:49,CBAD5291591A56A49C58745,063-000-001,22222222,ZOOM CBA,93.77,0,9771.26,DR,REF461025,CBA,Savings
01-08-2025 07:04,CBA7E13B01A2CE1414D98AE,063-000-001,22222222,PAYMENT GATEWAY CBA,22.44,0,9748.82,DR,REF566462,CBA,Savings
01-08-2025 07:37,CBA6D047A691A4F45AB902E,063-000-001,22222222,STARBUCKS CBA,89.3,0,9659.52,DR,REF510958,CBA,Savings
01-08-2025 08:31,CBAF745057D5CF4459CB86D,063-000-001,22222222,PAYPAL *NETFLIX CBA,45.44,0,9614.08,DR,REF960979,CBA,Savings
01-08-2025 09:00,CBA9409595FD06D42B1A814,063-000-001,22222222,HARVEY NORMAN CBA,71.44,0,9542.64,DR,REF550704,CBA,Savings
01-08-2025 09:22,CBA798E4D799DA0444892BE,063-000-001,22222222,PAYPAL *NETFLIX CBA,88.75,0,9453.89,DR,REF720960,CBA,Savings
01-08-2025 09:40,CBAF1F93C27FFE0404096A3,063-000-001,22222222,BANK FEE CBA,12.18,0,9441.71,DR,REF162493,CBA,Savings
01-08-2025 09:46,CBAF5A0C0B0380D4394A214,063-000-001,22222222,PAYMENT GATEWAY CBA,90.03,0,9351.68,DR,REF128937,CBA,Savings
01-08-2025 09:54,CBA45A4A27F25D0450DBE78,063-000-001,22222222,BWS CBA,9.68,0,9342,DR,REF396181,CBA,Savings
01-08-2025 10:26,CBA0B5CAEE1998441A8AF05,063-000-001,22222222,KFC CBA,152.17,0,9189.83,DR,REF130643,CBA,Savings
01-08-2025 10:33,CBA3C337F1731884CB79049,063-000-001,22222222,APPLE CBA,7.73,0,9182.1,DR,REF784054,CBA,Savings
01-08-2025 10:35,INT7D5D09D28BA7438BB1EF,063-000-001,22222222,TRANSFER FROM NAB 44444444,0,1225.3,10407.4,CR,INT-51084,CBA,Savings
01-08-2025 10:49,CBA51831435C0214E3F8BA6,063-000-001,22222222,PAYPAL *NETFLIX CBA,91.36,0,10316.04,DR,REF772158,CBA,Savings
01-08-2025 10:55,CBA9E625891E6FD4130A5E8,063-000-001,22222222,SHELL CBA,9.19,0,10306.85,DR,REF549200,CBA,Savings
01-08-2025 11:41,CBA35D2D02ED62440F8B3DE,063-000-001,22222222,MENULOG CBA,28.36,0,10278.49,DR,REF718403,CBA,Savings
01-08-2025 11:57,CBA3130C2B5A8BD48439BED,063-000-001,22222222,7-ELEVEN CBA,104.91,0,10173.58,DR,REF351405,CBA,Savings
01-08-2025 12:08,CBA05FFC9CD8BAD495F8A77,063-000-001,22222222,PAYPAL *NETFLIX CBA,9.66,0,10163.92,DR,REF802101,CBA,Savings
01-08-2025 12:09,CBA73309C4D5B184A2A815B,063-000-001,22222222,PAYROLL CREDIT CBA,0,2488.41,12652.33,CR,REF528569,CBA,Savings
01-08-2025 12:11,CBA84F429ABD68043B7B1EA,063-000-001,22222222,SHELL CBA,19.35,0,12632.98,DR,REF943777,CBA,Savings
01-08-2025 12:33,CBA5006C60A0692457D82E5,063-000-001,22222222,COLES CBA,54.51,0,12578.47,DR,REF776381,CBA,Savings
01-08-2025 12:47,CBA75538A07297A46158111,063-000-001,22222222,BANK FEE CBA,73.19,0,12505.28,DR,REF102423,CBA,Savings
01-08-2025 13:27,CBAD943BA0E46AE48D2941B,063-000-001,22222222,CITYLINK CBA,44.34,0,12460.94,DR,REF761259,CBA,Savings
01-08-2025 13:46,CBA04FD2EBD55054682AE9B,063-000-001,22222222,RAILWAY STATION CBA,128.92,0,12332.02,DR,REF653671,CBA,Savings
01-08-2025 13:51,CBAA5527F9FCB9740849B75,063-000-001,22222222,RAILWAY STATION CBA,8.02,0,12324,DR,REF888533,CBA,Savings
01-08-2025 14:21,CBAEE5E82D9448F46D08CE6,063-000-001,22222222,DOMINO'S PIZZA CBA,244.93,0,12079.07,DR,REF986708,CBA,Savings
01-08-2025 14:30,CBA987AA5E362D94C35BF77,063-000-001,22222222,SALARY PAYMENT CBA,0,251.68,12330.75,CR,REF556408,CBA,Savings
01-08-2025 14:30,CBA9EC65FF8FA544601A908,063-000-001,22222222,HARVEY NORMAN CBA,21.97,0,12308.78,DR,REF958572,CBA,Savings
01-08-2025 14:33,CBAEDFAEFFF28B241F1B13B,063-000-001,22222222,BANK FEE CBA,23.2,0,12285.58,DR,REF102360,CBA,Savings
01-08-2025 15:13,CBA2EFE3CCBD6824CD0AF5C,063-000-001,22222222,BANK FEE CBA,24.75,0,12260.83,DR,REF217794,CBA,Savings
01-08-2025 15:30,CBABF90A81BAE5D43EAA3B3,063-000-001,22222222,LIQUORLAND CBA,7.71,0,12253.12,DR,REF258686,CBA,Savings
01-08-2025 15:42,CBA2D9527A8423641C9BF3C,063-000-001,22222222,7-ELEVEN CBA,70.35,0,12182.77,DR,REF882938,CBA,Savings
01-08-2025 15:48,CBAD6925416D0BB4A129BC4,063-000-001,22222222,WOOLWORTHS CBA,56.79,0,12125.98,DR,REF812500,CBA,Savings
01-08-2025 15:52,CBAA963A3BA13034FD091A5,063-000-001,22222222,WOOLWORTHS CBA,18.31,0,12107.67,DR,REF123151,CBA,Savings
01-08-2025 15:56,CBA2314F60E10574ADB8A78,063-000-001,22222222,INTERNET TRANSFER CBA,20.22,0,12087.45,DR,REF963550,CBA,Savings
01-08-2025 16:12,CBAF9FA7B5736F14434AB0A,063-000-001,22222222,RAILWAY STATION CBA,130.61,0,11956.84,DR,REF944119,CBA,Savings
01-08-2025 16:15,CBAE4E02C0975E84C3F8851,063-000-001,22222222,SHELL CBA,26.21,0,11930.63,DR,REF402790,CBA,Savings
01-08-2025 16:18,CBA408C8A4C5CA04B5294A2,063-000-001,22222222,PAYROLL CREDIT CBA,0,953.71,12884.34,CR,REF761415,CBA,Savings
01-08-2025 16:20,CBAC6AD206AA34B430C9C8B,063-000-001,22222222,BP CBA,3.75,0,12880.59,DR,REF454657,CBA,Savings
01-08-2025 16:21,CBABD4EDC9F2DC743FB9E53,063-000-001,22222222,MENULOG CBA,10.31,0,12870.28,DR,REF283340,CBA,Savings
01-08-2025 16:34,CBA2E255A10849B4464B1A7,063-000-001,22222222,SALARY PAYMENT CBA,0,807.74,13678.02,CR,REF962515,CBA,Savings
01-08-2025 16:56,INT3AFD639CA9DB45BBAD82,063-000-001,22222222,TRANSFER TO NAB 44444444,995.36,0,12682.66,DR,INT-43672,CBA,Savings
01-08-2025 17:09,CBABCBE21D4506A4AB99F78,063-000-001,22222222,LIQUORLAND CBA,45.82,0,12636.84,DR,REF921296,CBA,Savings
01-08-2025 17:16,CBAD3C3431E55564ED986FA,063-000-001,22222222,BANK FEE CBA,54.46,0,12582.38,DR,REF391370,CBA,Savings
01-08-2025 17:37,CBA2B51D75F254B4D05961A,063-000-001,22222222,RAILWAY STATION CBA,79.56,0,12502.82,DR,REF253689,CBA,Savings
01-08-2025 17:49,CBAD1334D6A49BC47B69A06,063-000-001,22222222,BANK FEE CBA,29.2,0,12473.62,DR,REF582526,CBA,Savings
01-08-2025 17:53,CBA77162640675240AFB55D,063-000-001,22222222,SALARY PAYMENT CBA,0,1191.51,13665.13,CR,REF794324,CBA,Savings
01-08-2025 18:12,CBA8BA91797E47542609718,063-000-001,22222222,WAGES CREDIT CBA,0,231.61,13896.74,CR,REF832402,CBA,Savings
01-08-2025 18:51,INTCF598E343C444A8A9B00,063-000-001,22222222,TRANSFER TO CBA 33333333,349.13,0,13547.61,DR,INT-77206,CBA,Savings
01-08-2025 19:04,CBAE8CE999F4FFC40278A73,063-000-001,22222222,HARVEY NORMAN CBA,36.92,0,13510.69,DR,REF666232,CBA,Savings
01-08-2025 19:31,CBAA61BA8BFB75F46C7993A,063-000-001,22222222,SHELL CBA,61.06,0,13449.63,DR,REF519709,CBA,Savings
01-08-2025 19:48,CBADA376D8038B4420E8EB6,063-000-001,22222222,RAILWAY STATION CBA,46.16,0,13403.47,DR,REF942594,CBA,Savings
01-08-2025 20:14,CBA510B6A0110A44BF6841C,063-000-001,22222222,WOOLWORTHS CBA,51.96,0,13351.51,DR,REF731834,CBA,Savings
01-08-2025 20:26,CBA1750517ACBF34D899010,063-000-001,22222222,BWS CBA,25.46,0,13326.05,DR,REF185154,CBA,Savings
01-08-2025 20:40,CBA5C7E42E254F44CBB902C,063-000-001,22222222,SPOTIFY CBA,25.15,0,13300.9,DR,REF746665,CBA,Savings
01-08-2025 21:12,CBA0F67B73AB1EB4AE78822,063-000-001,22222222,BIGW CBA,101.42,0,13199.48,DR,REF988058,CBA,Savings
01-08-2025 21:32,CBA8ECC6C5880364D29869D,063-000-001,22222222,BP CBA,95.57,0,13103.91,DR,REF851844,CBA,Savings
01-08-2025 21:34,CBA9B0A853808344AF6B069,063-000-001,22222222,WOOLWORTHS CBA,28.22,0,13075.69,DR,REF865213,CBA,Savings
01-08-2025 21:35,CBA1FA6AA1C43D2431F940B,063-000-001,22222222,PAYPAL *NETFLIX CBA,85.62,0,12990.07,DR,REF847325,CBA,Savings
01-08-2025 22:11,CBA2CE9441C9A0543128689,063-000-001,22222222,SALARY PAYMENT CBA,0,6753.13,19743.2,CR,REF431851,CBA,Savings
01-08-2025 22:21,CBAE4CBD46496934D7D979B,063-000-001,22222222,CITYLINK CBA,29.47,0,19713.73,DR,REF827120,CBA,Savings
01-08-2025 22:22,CBA4A574D12330F40FF8CFB,063-000-001,22222222,BWS CBA,13.73,0,19700,DR,REF161776,CBA,Savings
01-08-2025 22:26,CBAF21335160B324EEAAFB8,063-000-001,22222222,BP CBA,9.89,0,19690.11,DR,REF455124,CBA,Savings
01-08-2025 22:26,CBA5A9F9481C0284B3898F2,063-000-001,22222222,BANK FEE CBA,47.41,0,19642.7,DR,REF478931,CBA,Savings
01-08-2025 22:29,CBAF13EFB7DF66F4AC8B0EE,063-000-001,22222222,7-ELEVEN CBA,19.39,0,19623.31,DR,REF682153,CBA,Savings
01-08-2025 22:35,CBAA7368CD106B640FD99C9,063-000-001,22222222,UBER EATS CBA,16.45,0,19606.86,DR,REF322817,CBA,Savings
01-08-2025 22:37,CBA975771F9E4084798857C,063-000-001,22222222,WAGES CREDIT CBA,0,4529.21,24136.07,CR,REF584860,CBA,Savings
01-08-2025 22:39,CBA87412D61CF5F47E4A91B,063-000-001,22222222,PAYMENT GATEWAY CBA,18.44,0,24117.63,DR,REF701721,CBA,Savings
01-08-2025 22:56,CBA295B40A7CD734732921B,063-000-001,22222222,SALARY PAYMENT CBA,0,7970.95,32088.58,CR,REF131371,CBA,Savings
01-08-2025 23:10,CBAACB85FDAA65247829704,063-000-001,22222222,UBER EATS CBA,39.11,0,32049.47,DR,REF700344,CBA,Savings
01-08-2025 23:21,CBAECD1A682E862493BB1DD,063-000-001,22222222,BANK FEE CBA,46.51,0,32002.96,DR,REF940693,CBA,Savings
01-08-2025 23:29,CBA9E6BAEC0F4864678A594,063-000-001,22222222,INTERNET TRANSFER CBA,57.88,0,31945.08,DR,REF259482,CBA,Savings
02-08-2025 00:06,CBA14F779F242844E6D8315,063-000-001,22222222,PAYMENT GATEWAY CBA,33.16,0,31911.92,DR,REF409246,CBA,Savings
02-08-2025 00:11,CBADAA165950F12481F8AC2,063-000-001,22222222,BWS CBA,168.36,0,31743.56,DR,REF727318,CBA,Savings
02-08-2025 01:04,CBA3B7EF195CB06468AA88E,063-000-001,22222222,CITYLINK CBA,119.3,0,31624.26,DR,REF265348,CBA,Savings
02-08-2025 01:05,CBA2B1F3D7D5799442B9D3A,063-000-001,22222222,WAGES CREDIT CBA,0,4756.5,36380.76,CR,REF900688,CBA,Savings
02-08-2025 02:07,CBA60F9CBACAD564F688DDF,063-000-001,22222222,INTERNET TRANSFER CBA,19.33,0,36361.43,DR,REF487363,CBA,Savings
02-08-2025 02:57,CBAD5DCCCF644094F95BE43,063-000-001,22222222,ALDI CBA,4.3,0,36357.13,DR,REF406781,CBA,Savings
02-08-2025 03:20,CBA0CCF430B2952474F9512,063-000-001,22222222,MENULOG CBA,12.54,0,36344.59,DR,REF900091,CBA,Savings
02-08-2025 03:35,CBA6F13A17E25594EE98CA9,063-000-001,22222222,LIQUORLAND CBA,27.69,0,36316.9,DR,REF655067,CBA,Savings
02-08-2025 03:35,CBA4A41D8AECA7B44EE9D87,063-000-001,22222222,SHELL CBA,35.46,0,36281.44,DR,REF711592,CBA,Savings
02-08-2025 03:55,CBAFFAD76D543EE4B0BBB5A,063-000-001,22222222,TAFE BOOKSHOP CBA,40.73,0,36240.71,DR,REF616580,CBA,Savings
02-08-2025 04:07,CBA58F6EFF0B8474C96AA5B,063-000-001,22222222,PAYROLL CREDIT CBA,0,977.43,37218.14,CR,REF678978,CBA,Savings
02-08-2025 04:18,CBACE6725FA94A343DBB693,063-000-001,22222222,LIQUORLAND CBA,65.23,0,37152.91,DR,REF324861,CBA,Savings
02-08-2025 04:24,CBA02F69AB082334825BE64,063-000-001,22222222,COLES CBA,12.24,0,37140.67,DR,REF216105,CBA,Savings
02-08-2025 04:34,CBA4406163547114545A51C,063-000-001,22222222,BP CBA,14.65,0,37126.02,DR,REF141563,CBA,Savings
02-08-2025 04:51,CBA725597F3302C4CCAB8E0,063-000-001,22222222,BP CBA,27.97,0,37098.05,DR,REF300723,CBA,Savings
02-08-2025 05:14,CBAC7DC4EEDB4B14D07ACB4,063-000-001,22222222,MENULOG CBA,27.79,0,37070.26,DR,REF576264,CBA,Savings
02-08-2025 05:25,CBAF067F999393F4C9D808F,063-000-001,22222222,INTERNET TRANSFER CBA,8.08,0,37062.18,DR,REF273712,CBA,Savings
02-08-2025 05:48,CBAF11B30ECA2324F68A0CB,063-000-001,22222222,WAGES CREDIT CBA,0,7591.68,44653.86,CR,REF919806,CBA,Savings
02-08-2025 05:54,CBAF2FBF4E18E174A628990,063-000-001,22222222,SALARY PAYMENT CBA,0,1670.09,46323.95,CR,REF901983,CBA,Savings
02-08-2025 06:06,CBA107ED0D3C4204657B12C,063-000-001,22222222,PAYPAL *NETFLIX CBA,30.61,0,46293.34,DR,REF283290,CBA,Savings
02-08-2025 06:40,CBAC069512AD780482EBBBA,063-000-001,22222222,UBER EATS CBA,99.71,0,46193.63,DR,REF264506,CBA,Savings
02-08-2025 06:52,CBAE3414288FC444BEEAF40,063-000-001,22222222,BANK FEE CBA,55.01,0,46138.62,DR,REF340869,CBA,Savings
02-08-2025 07:12,CBA43E9F3F5549740CAA3E1,063-000-001,22222222,JB HI-FI CBA,7.79,0,46130.83,DR,REF391547,CBA,Savings
02-08-2025 07:17,CBA251DB7CF8766412FA2EA,063-000-001,22222222,UBER EATS CBA,54.51,0,46076.32,DR,REF489816,CBA,Savings
02-08-2025 07:37,CBA335D5935069E41D3BA3C,063-000-001,22222222,7-ELEVEN CBA,115.38,0,45960.94,DR,REF104522,CBA,Savings
02-08-2025 09:55,CBAF24B203275F7436E8479,063-000-001,22222222,WOOLWORTHS CBA,63.49,0,45897.45,DR,REF455443,CBA,Savings
02-08-2025 10:05,CBA7C2D0D26F042481CA5A2,063-000-001,22222222,AMAZON AU CBA,10.44,0,45887.01,DR,REF682878,CBA,Savings
02-08-2025 10:26,CBA106EB1961A9840C0910C,063-000-001,22222222,KFC CBA,133.32,0,45753.69,DR,REF100342,CBA,Savings
02-08-2025 10:35,CBABD57370B3EFE4158B400,063-000-001,22222222,FLIXBUS CBA,17.8,0,45735.89,DR,REF145679,CBA,Savings
02-08-2025 10:50,CBA420AD1D59485497281C9,063-000-001,22222222,DOMINO'S PIZZA CBA,8.56,0,45727.33,DR,REF745135,CBA,Savings
02-08-2025 10:51,CBA688F1841DCEA4D73BD93,063-000-001,22222222,SHELL CBA,60.01,0,45667.32,DR,REF776942,CBA,Savings
02-08-2025 10:52,CBA11217CB15C97421D900F,063-000-001,22222222,ZOOM CBA,93.83,0,45573.49,DR,REF651504,CBA,Savings
02-08-2025 11:40,CBA58C06F8A33AE4FFE81D2,063-000-001,22222222,AMAZON AU CBA,71.89,0,45501.6,DR,REF636039,CBA,Savings
02-08-2025 11:42,CBAF98A9901344C414882BE,063-000-001,22222222,BIGW CBA,50,0,45451.6,DR,REF106878,CBA,Savings
02-08-2025 11:54,CBA5AC3FEC5601D49A58B78,063-000-001,22222222,RAILWAY STATION CBA,1.97,0,45449.63,DR,REF562915,CBA,Savings
02-08-2025 12:00,CBA283E5B81FDC84E8788F9,063-000-001,22222222,LIQUORLAND CBA,9.66,0,45439.97,DR,REF947288,CBA,Savings
02-08-2025 12:12,CBAD3E1BEC532904B26BE5A,063-000-001,22222222,BIGW CBA,12.69,0,45427.28,DR,REF371810,CBA,Savings
02-08-2025 12:29,CBA35F02D668E6943CDAFF9,063-000-001,22222222,PAY - SALARY CBA,0,3501.57,48928.85,CR,REF561144,CBA,Savings
02-08-2025 12:40,CBA36FCE0B3DC554438A99D,063-000-001,22222222,AMAZON AU CBA,56.85,0,48872,DR,REF102043,CBA,Savings
02-08-2025 12:56,CBA2E0FC584471144F18724,063-000-001,22222222,DOMINO'S PIZZA CBA,84.28,0,48787.72,DR,REF726637,CBA,Savings
02-08-2025 12:59,CBA58534CE5C4334FE9A05C,063-000-001,22222222,COMPANY PAYROLL CBA,0,3102.53,51890.25,CR,REF696963,CBA,Savings
02-08-2025 13:16,CBAF4727E354AEB49ADAFE5,063-000-001,22222222,STARBUCKS CBA,88.88,0,51801.37,DR,REF914547,CBA,Savings
02-08-2025 13:19,CBA5F2D3F9D636346FFBA15,063-000-001,22222222,MENULOG CBA,12.29,0,51789.08,DR,REF134913,CBA,Savings
02-08-2025 13:20,CBA1CAA4E2E352145B086C7,063-000-001,22222222,ALDI CBA,99.48,0,51689.6,DR,REF487049,CBA,Savings
02-08-2025 13:35,CBA3590E6CAA784470CBFA5,063-000-001,22222222,WAGES CREDIT CBA,0,4021.16,55710.76,CR,REF929459,CBA,Savings
02-08-2025 13:35,CBA32BA14FF3A1D4331BFFF,063-000-001,22222222,DOMINO'S PIZZA CBA,28.95,0,55681.81,DR,REF806434,CBA,Savings
02-08-2025 13:35,CBA9C049529FE5040B5973A,063-000-001,22222222,WOOLWORTHS CBA,62.92,0,55618.89,DR,REF263288,CBA,Savings
02-08-2025 14:23,CBA1CF50FB559FB4394900A,063-000-001,22222222,UBER EATS CBA,4.69,0,55614.2,DR,REF728087,CBA,Savings
02-08-2025 14:31,CBAD3812775D1EB49F8BF7C,063-000-001,22222222,JB HI-FI CBA,12.29,0,55601.91,DR,REF194852,CBA,Savings
02-08-2025 14:33,CBA120F32DCE8554FB6B4C1,063-000-001,22222222,SALARY PAYMENT CBA,0,4483.58,60085.49,CR,REF484363,CBA,Savings
02-08-2025 15:14,CBA828CB4E5AC794E52A380,063-000-001,22222222,WOOLWORTHS CBA,38.16,0,60047.33,DR,REF143586,CBA,Savings
02-08-2025 15:22,CBA4352A3CD468342B2885D,063-000-001,22222222,AMAZON AU CBA,60.13,0,59987.2,DR,REF751583,CBA,Savings
02-08-2025 16:00,INTFF1E926961A440F493CF,063-000-001,22222222,TRANSFER FROM CBA 33333333,0,316.56,60303.76,CR,INT-10533,CBA,Savings
02-08-2025 16:18,CBADCAADA25982C4D838BCE,063-000-001,22222222,PAYMENT GATEWAY CBA,14.13,0,60289.63,DR,REF349201,CBA,Savings
02-08-2025 16:19,CBAA0DDFF5C8F9846BE9DF8,063-000-001,22222222,ZOOM CBA,46.71,0,60242.92,DR,REF278893,CBA,Savings
02-08-2025 16:28,CBA7B071F0E570C4C268ABB,063-000-001,22222222,PAYROLL CREDIT CBA,0,3560.92,63803.84,CR,REF585516,CBA,Savings
02-08-2025 16:36,CBA43B0F2D6459F4166ADB8,063-000-001,22222222,WOOLWORTHS CBA,78.4,0,63725.44,DR,REF593978,CBA,Savings
02-08-2025 16:38,CBAA83B20D3C2794A819BD9,063-000-001,22222222,DOMINO'S PIZZA CBA,167.12,0,63558.32,DR,REF218513,CBA,Savings
02-08-2025 17:11,INTD7D4195820DD4544A8D1,063-000-001,22222222,TRANSFER TO CBA 33333333,1033.94,0,62524.38,DR,INT-23330,CBA,Savings
02-08-2025 17:12,CBA6360AFAABAA04F669195,063-000-001,22222222,CITYLINK CBA,72.25,0,62452.13,DR,REF226459,CBA,Savings
02-08-2025 17:27,CBA8E1538253E8043B3905E,063-000-001,22222222,STARBUCKS CBA,46.16,0,62405.97,DR,REF471977,CBA,Savings
02-08-2025 18:05,CBA9728E0C898BA4A1C8D56,063-000-001,22222222,LIQUORLAND CBA,29.27,0,62376.7,DR,REF401965,CBA,Savings
02-08-2025 18:13,CBA3CC4012FCFEB461B9661,063-000-001,22222222,MCDONALDS CBA,46.23,0,62330.47,DR,REF716990,CBA,Savings
02-08-2025 18:16,CBA7CE7F037C15C49DA9997,063-000-001,22222222,SHELL CBA,167.3,0,62163.17,DR,REF240021,CBA,Savings
02-08-2025 18:38,CBA22E88336F1FC47C489C2,063-000-001,22222222,TAFE BOOKSHOP CBA,50.88,0,62112.29,DR,REF332383,CBA,Savings
02-08-2025 18:43,CBA77D525BF8D6E463A8F8E,063-000-001,22222222,RAILWAY STATION CBA,117.28,0,61995.01,DR,REF860927,CBA,Savings
02-08-2025 18:44,CBAD2280B12B6B2463BB763,063-000-001,22222222,KFC CBA,50.3,0,61944.71,DR,REF959851,CBA,Savings
02-08-2025 19:15,CBA6A22B8E2F99549B5A63F,063-000-001,22222222,BIGW CBA,41.06,0,61903.65,DR,REF651327,CBA,Savings
02-08-2025 19:31,INT6226C454E1B54F8B957B,063-000-001,22222222,TRANSFER FROM NAB 44444444,0,1772.91,63676.56,CR,INT-61712,CBA,Savings
02-08-2025 19:58,CBA84FAA1A181794AD7AC17,063-000-001,22222222,7-ELEVEN CBA,44.73,0,63631.83,DR,REF969762,CBA,Savings
02-08-2025 20:16,CBAFFE9A0D01DE84CBF8550,063-000-001,22222222,TAFE BOOKSHOP CBA,127.21,0,63504.62,DR,REF825668,CBA,Savings
02-08-2025 20:52,CBAEC16EC973C5F4F1CA7C8,063-000-001,22222222,MCDONALDS CBA,5.72,0,63498.9,DR,REF868297,CBA,Savings
02-08-2025 21:06,CBAE04B82A05E10495A9701,063-000-001,22222222,KFC CBA,53.71,0,63445.19,DR,REF249187,CBA,Savings
02-08-2025 21:21,CBAAA5944E4398248E6BD05,063-000-001,22222222,SHELL CBA,6.2,0,63438.99,DR,REF779562,CBA,Savings
02-08-2025 21:54,CBA2E4DF3D0325F4E75A5CA,063-000-001,22222222,WAGES CREDIT CBA,0,6124.05,69563.04,CR,REF525902,CBA,Savings
02-08-2025 21:54,CBA2A5F9694661A4C68816D,063-000-001,22222222,ZOOM CBA,28.24,0,69534.8,DR,REF605720,CBA,Savings
02-08-2025 22:10,CBA048A497D31D54622A4CE,063-000-001,22222222,RAILWAY STATION CBA,10.76,0,69524.04,DR,REF439824,CBA,Savings
02-08-2025 23:00,CBAAB66AF42BCE645D68F5E,063-000-001,22222222,PAYPAL *NETFLIX CBA,32.02,0,69492.02,DR,REF612571,CBA,Savings
02-08-2025 23:07,CBA89F84808B9FD42098319,063-000-001,22222222,PAY - SALARY CBA,0,667.57,70159.59,CR,REF664040,CBA,Savings
02-08-2025 23:08,CBAAC1F7A2059874A7C80D7,063-000-001,22222222,HARVEY NORMAN CBA,27.9,0,70131.69,DR,REF536462,CBA,Savings
02-08-2025 23:17,CBAAFFC87B070664722B70C,063-000-001,22222222,WAGES CREDIT CBA,0,6211.91,76343.6,CR,REF876654,CBA,Savings
03-08-2025 00:21,CBA56BF759C9386447FB5B0,063-000-001,22222222,CITYLINK CBA,12.77,0,76330.83,DR,REF882758,CBA,Savings
03-08-2025 00:26,CBA9B8AF81C3D864F7D80EB,063-000-001,22222222,SHELL CBA,36.08,0,76294.75,DR,REF726066,CBA,Savings
03-08-2025 00:47,CBAA9608C2F63614FA09772,063-000-001,22222222,PAYPAL *NETFLIX CBA,40.87,0,76253.88,DR,REF195134,CBA,Savings
03-08-2025 01:06,CBA0A5CA611EF7C47979098,063-000-001,22222222,JB HI-FI CBA,115.91,0,76137.97,DR,REF299596,CBA,Savings
03-08-2025 01:36,CBA57A08F96DC094E95AE4E,063-000-001,22222222,DOMINO'S PIZZA CBA,97.81,0,76040.16,DR,REF955775,CBA,Savings
03-08-2025 01:38,CBA9D9342455EE74332B587,063-000-001,22222222,LIQUORLAND CBA,108.1,0,75932.06,DR,REF986180,CBA,Savings
03-08-2025 01:59,CBA12E470AD38DA41EB9255,063-000-001,22222222,COLES CBA,150.32,0,75781.74,DR,REF409282,CBA,Savings
03-08-2025 02:14,CBA60E541CE09F34F029B1E,063-000-001,22222222,7-ELEVEN CBA,85.85,0,75695.89,DR,REF340051,CBA,Savings
03-08-2025 02:46,CBA4C20C3EDAD2F4E188DC6,063-000-001,22222222,WOOLWORTHS CBA,25.21,0,75670.68,DR,REF937201,CBA,Savings
03-08-2025 03:01,CBAE6C5D81AD55446B38D73,063-000-001,22222222,KFC CBA,240.35,0,75430.33,DR,REF912289,CBA,Savings
03-08-2025 03:20,CBA54EF93C3779744F484F5,063-000-001,22222222,DOMINO'S PIZZA CBA,80.7,0,75349.63,DR,REF117847,CBA,Savings
03-08-2025 03:26,CBA6D58EAB94A42491CA91C,063-000-001,22222222,PAYPAL *NETFLIX CBA,31.06,0,75318.57,DR,REF735352,CBA,Savings
03-08-2025 03:30,CBA93162A66D25045EF8374,063-000-001,22222222,BIGW CBA,2.63,0,75315.94,DR,REF365083,CBA,Savings
03-08-2025 03:48,CBA709721D912FF44C5830D,063-000-001,22222222,ALDI CBA,78.36,0,75237.58,DR,REF237729,CBA,Savings
03-08-2025 04:08,CBAA64D960B5382478EB9AF,063-000-001,22222222,TAFE BOOKSHOP CBA,11.96,0,75225.62,DR,REF938465,CBA,Savings
03-08-2025 04:10,CBA3C89F03A79854FFFA657,063-000-001,22222222,UBER EATS CBA,13.35,0,75212.27,DR,REF668282,CBA,Savings
03-08-2025 04:10,CBA6837A723F12E43AA9FBD,063-000-001,22222222,SPOTIFY CBA,75.58,0,75136.69,DR,REF115207,CBA,Savings
03-08-2025 04:44,CBAF85538C0C2594106B601,063-000-001,22222222,LIQUORLAND CBA,67.54,0,75069.15,DR,REF635403,CBA,Savings
03-08-2025 05:10,CBA30D78D9A6480404D80E5,063-000-001,22222222,WOOLWORTHS CBA,11.84,0,75057.31,DR,REF760338,CBA,Savings
03-08-2025 05:29,CBA07CEB4ABAD8B49A186B2,063-000-001,22222222,TAFE BOOKSHOP CBA,7.32,0,75049.99,DR,REF475265,CBA,Savings
03-08-2025 05:30,CBA5032B31A7FA547C08570,063-000-001,22222222,JB HI-FI CBA,159.93,0,74890.06,DR,REF799526,CBA,Savings
03-08-2025 05:53,CBA9C22399E606040C3AA37,063-000-001,22222222,LIQUORLAND CBA,98.31,0,74791.75,DR,REF939524,CBA,Savings
03-08-2025 06:17,CBAC62FD1C970DB4026ACE3,063-000-001,22222222,HARVEY NORMAN CBA,78.21,0,74713.54,DR,REF464448,CBA,Savings
03-08-2025 06:35,CBACC8B8725AC26499997AD,063-000-001,22222222,DOMINO'S PIZZA CBA,13.73,0,74699.81,DR,REF975276,CBA,Savings
03-08-2025 06:47,CBA601AAA6CC9D24E4492DF,063-000-001,22222222,DOMINO'S PIZZA CBA,6.79,0,74693.02,DR,REF831970,CBA,Savings
03-08-2025 06:58,CBAA0A967B7962642E082CB,063-000-001,22222222,MCDONALDS CBA,183.52,0,74509.5,DR,REF260795,CBA,Savings
03-08-2025 06:59,CBA23A03C734E134B7ABE4C,063-000-001,22222222,PAYPAL *NETFLIX CBA,11.3,0,74498.2,DR,REF813870,CBA,Savings
03-08-2025 07:09,CBA951AB1624DE442FB924A,063-000-001,22222222,BANK FEE CBA,7.13,0,74491.07,DR,REF846888,CBA,Savings
03-08-2025 07:45,CBAD2D0B8B9FF54438A819B,063-000-001,22222222,LIQUORLAND CBA,36.57,0,74454.5,DR,REF889330,CBA,Savings
03-08-2025 07:57,CBA11667AF4E7EC4BBA93FD,063-000-001,22222222,KFC CBA,11.13,0,74443.37,DR,REF680944,CBA,Savings
03-08-2025 07:58,CBA043AF01971CC4403B504,063-000-001,22222222,MCDONALDS CBA,62.97,0,74380.4,DR,REF687361,CBA,Savings
03-08-2025 08:07,CBA353EFEB48AAE4E928E84,063-000-001,22222222,SHELL CBA,11.47,0,74368.93,DR,REF387321,CBA,Savings
03-08-2025 08:20,CBAC7EDB70CF06244B5A120,063-000-001,22222222,PAYMENT GATEWAY CBA,53.8,0,74315.13,DR,REF728429,CBA,Savings
03-08-2025 08:44,CBAF459056B71FD4EA0865E,063-000-001,22222222,COMPANY PAYROLL CBA,0,1554.65,75869.78,CR,REF152991,CBA,Savings
03-08-2025 08:50,CBA3D3C09F21F1441248D6E,063-000-001,22222222,BP CBA,17.28,0,75852.5,DR,REF702263,CBA,Savings
03-08-2025 08:51,CBACFD6C022A6344158B504,063-000-001,22222222,BANK FEE CBA,112.32,0,75740.18,DR,REF240631,CBA,Savings
03-08-2025 09:05,CBA5BC06534CB73418EA784,063-000-001,22222222,PAY - SALARY CBA,0,6869.78,82609.96,CR,REF541055,CBA,Savings
03-08-2025 09:09,CBADC8EACFD9C9141AC84C1,063-000-001,22222222,RAILWAY STATION CBA,79.85,0,82530.11,DR,REF500602,CBA,Savings
03-08-2025 09:20,CBA311D719D291B4DED9B35,063-000-001,22222222,BIGW CBA,48.75,0,82481.36,DR,REF821807,CBA,Savings
03-08-2025 09:22,CBA5D2C2611951643129D22,063-000-001,22222222,SHELL CBA,15.31,0,82466.05,DR,REF917584,CBA,Savings
03-08-2025 09:30,CBA57F6171C60F046C3B7FF,063-000-001,22222222,CITYLINK CBA,36.59,0,82429.46,DR,REF245878,CBA,Savings
03-08-2025 09:39,CBA8A257552D40B45619CEA,063-000-001,22222222,PAYMENT GATEWAY CBA,43.12,0,82386.34,DR,REF691756,CBA,Savings
03-08-2025 09:48,CBA80BA63BA0861413A80AC,063-000-001,22222222,KFC CBA,30.76,0,82355.58,DR,REF609008,CBA,Savings
03-08-2025 10:01,CBA89192E4952854F25A5C6,063-000-001,22222222,RAILWAY STATION CBA,76.34,0,82279.24,DR,REF346102,CBA,Savings
03-08-2025 10:42,CBA9E596E7932C34A109E5B,063-000-001,22222222,CITYLINK CBA,17.84,0,82261.4,DR,REF910719,CBA,Savings
03-08-2025 11:07,CBA8EED00B2D30544829C62,063-000-001,22222222,COMPANY PAYROLL CBA,0,6831.93,89093.33,CR,REF320091,CBA,Savings
03-08-2025 11:40,CBAF8A31CB881B24D9DA32F,063-000-001,22222222,BP CBA,11.81,0,89081.52,DR,REF196372,CBA,Savings
03-08-2025 11:41,CBACA62E5C40A364784B597,063-000-001,22222222,TAFE BOOKSHOP CBA,14.31,0,89067.21,DR,REF844873,CBA,Savings
03-08-2025 12:07,CBA7DBA5FB938B94263B738,063-000-001,22222222,DOMINO'S PIZZA CBA,24.19,0,89043.02,DR,REF863373,CBA,Savings
03-08-2025 12:41,CBA0711BA1BAEE84B77A42C,063-000-001,22222222,7-ELEVEN CBA,34.69,0,89008.33,DR,REF666046,CBA,Savings
03-08-2025 13:41,CBA3CF0EA2105B34C7E8902,063-000-001,22222222,MENULOG CBA,229.55,0,88778.78,DR,REF409246,CBA,Savings
03-08-2025 13:50,CBAE07C1B18F95540259C60,063-000-001,22222222,WOOLWORTHS CBA,203.81,0,88574.97,DR,REF575842,CBA,Savings
03-08-2025 13:58,CBA28B40DD7D7904C9CA545,063-000-001,22222222,MCDONALDS CBA,73.32,0,88501.65,DR,REF297309,CBA,Savings
03-08-2025 13:59,CBA4021AFD7037E4EF99D5F,063-000-001,22222222,CITYLINK CBA,66.21,0,88435.44,DR,REF534247,CBA,Savings
03-08-2025 14:10,CBAD3C16FF926354C13B890,063-000-001,22222222,LIQUORLAND CBA,3.27,0,88432.17,DR,REF360556,CBA,Savings
03-08-2025 14:20,CBA09B62F1F1C4E4D6583FF,063-000-001,22222222,PAYPAL *NETFLIX CBA,25.67,0,88406.5,DR,REF677677,CBA,Savings
03-08-2025 14:27,CBA5DA2E278858446948AD1,063-000-001,22222222,WAGES CREDIT CBA,0,5201.4,93607.9,CR,REF332941,CBA,Savings
03-08-2025 14:56,CBAE45C6938620E455CBB6B,063-000-001,22222222,BWS CBA,10.84,0,93597.06,DR,REF718469,CBA,Savings
03-08-2025 15:11,CBA08670C4514EC48EEAC69,063-000-001,22222222,PAYROLL CREDIT CBA,0,298.84,93895.9,CR,REF936114,CBA,Savings
03-08-2025 15:12,CBA585D3267DDF24EC7A106,063-000-001,22222222,BIGW CBA,17.08,0,93878.82,DR,REF303659,CBA,Savings
03-08-2025 15:32,CBA66110691317547EE869C,063-000-001,22222222,SHELL CBA,36.25,0,93842.57,DR,REF255940,CBA,Savings
03-08-2025 16:44,CBA8CD000D9FA3A496AA39F,063-000-001,22222222,BANK FEE CBA,9.97,0,93832.6,DR,REF954970,CBA,Savings
03-08-2025 17:00,CBAEE9B9804AE07449CAC5B,063-000-001,22222222,ZOOM CBA,20.75,0,93811.85,DR,REF271171,CBA,Savings
03-08-2025 17:33,CBA790CEBC1C7144BE98C05,063-000-001,22222222,LIQUORLAND CBA,30.43,0,93781.42,DR,REF366592,CBA,Savings
03-08-2025 17:44,CBA4246BB4FD6064BC89A8C,063-000-001,22222222,UBER EATS CBA,3.12,0,93778.3,DR,REF651781,CBA,Savings
03-08-2025 18:35,CBAF01E6B39DAEA43F1B7E9,063-000-001,22222222,LIQUORLAND CBA,50.27,0,93728.03,DR,REF415530,CBA,Savings
03-08-2025 19:07,INT78DEC73E4AC14AA8A876,063-000-001,22222222,TRANSFER FROM ANZ 11111111,0,725.61,94453.64,CR,INT-28104,CBA,Savings
03-08-2025 19:16,CBAEABA1108017145788DCA,063-000-001,22222222,MCDONALDS CBA,9.82,0,94443.82,DR,REF904045,CBA,Savings
03-08-2025 19:59,CBA8214B78B8FC74BAABB54,063-000-001,22222222,MCDONALDS CBA,76.27,0,94367.55,DR,REF424824,CBA,Savings
03-08-2025 20:01,CBAFB9E46389A804D909AE5,063-000-001,22222222,MENULOG CBA,16.51,0,94351.04,DR,REF126560,CBA,Savings
03-08-2025 20:02,CBA921E9BC115EE40959CC4,063-000-001,22222222,MCDONALDS CBA,61.39,0,94289.65,DR,REF725206,CBA,Savings
03-08-2025 20:04,CBA5F00D1A5CA3548BEBA10,063-000-001,22222222,DOMINO'S PIZZA CBA,55.61,0,94234.04,DR,REF319608,CBA,Savings
03-08-2025 20:06,CBADF256AB54241462E840E,063-000-001,22222222,SHELL CBA,101.65,0,94132.39,DR,REF520239,CBA,Savings
03-08-2025 20:25,INTA6B7E53E01DA444EB0DE,063-000-001,22222222,TRANSFER TO NAB 44444444,1481.97,0,92650.42,DR,INT-35605,CBA,Savings
03-08-2025 20:40,CBABAC31708F83949E8A7E0,063-000-001,22222222,CITYLINK CBA,109.51,0,92540.91,DR,REF394549,CBA,Savings
03-08-2025 20:47,CBA5B579EBC883346B4916A,063-000-001,22222222,PAYMENT GATEWAY CBA,94.29,0,92446.62,DR,REF351624,CBA,Savings
03-08-2025 21:08,CBA5E760818293146EE9E0D,063-000-001,22222222,DOMINO'S PIZZA CBA,127.02,0,92319.6,DR,REF256653,CBA,Savings
03-08-2025 21:24,CBAAF704F5EFA8341CAB195,063-000-001,22222222,UBER EATS CBA,104.15,0,92215.45,DR,REF839306,CBA,Savings
03-08-2025 21:56,CBA84F95418BF2F44BF832B,063-000-001,22222222,PAYPAL *NETFLIX CBA,45.35,0,92170.1,DR,REF569701,CBA,Savings
03-08-2025 22:11,CBA12E07F7918BA4632A764,063-000-001,22222222,SALARY PAYMENT CBA,0,1803.07,93973.17,CR,REF795727,CBA,Savings
03-08-2025 22:25,CBA265E778E4FF7443AB0F5,063-000-001,22222222,STARBUCKS CBA,5.41,0,93967.76,DR,REF966401,CBA,Savings
03-08-2025 22:42,CBABC98EEE83B6042F2A09B,063-000-001,22222222,7-ELEVEN CBA,13.27,0,93954.49,DR,REF854969,CBA,Savings
03-08-2025 22:54,CBA5DF33A2F9E6843398B25,063-000-001,22222222,COMPANY PAYROLL CBA,0,1152.33,95106.82,CR,REF550052,CBA,Savings
03-08-2025 22:56,CBAE5AA947BB96240809FC4,063-000-001,22222222,7-ELEVEN CBA,15.86,0,95090.96,DR,REF597502,CBA,Savings
03-08-2025 23:14,CBA69E7101C605F4C6B8F1E,063-000-001,22222222,RAILWAY STATION CBA,12.91,0,95078.05,DR,REF225425,CBA,Savings
03-08-2025 23:57,CBA3676F469783A4A95BD08,063-000-001,22222222,CITYLINK CBA,220.21,0,94857.84,DR,REF520753,CBA,Savings
04-08-2025 00:11,CBA73F5854699054B72A4D1,063-000-001,22222222,LIQUORLAND CBA,181.32,0,94676.52,DR,REF957035,CBA,Savings
04-08-2025 00:42,CBA40B7B1BA771C4847A45F,063-000-001,22222222,SALARY PAYMENT CBA,0,5971.2,100647.72,CR,REF513738,CBA,Savings
04-08-2025 00:42,CBA7947B0EE913E464CBD35,063-000-001,22222222,KFC CBA,32.04,0,100615.68,DR,REF456485,CBA,Savings
04-08-2025 01:33,CBA5E4C3C48B4284F4EBDFE,063-000-001,22222222,JB HI-FI CBA,48.19,0,100567.49,DR,REF663982,CBA,Savings
04-08-2025 01:41,CBAA0FA58112CD1441B97B0,063-000-001,22222222,SPOTIFY CBA,10.37,0,100557.12,DR,REF489167,CBA,Savings
04-08-2025 01:42,CBAF4AAA668158B4AB3958B,063-000-001,22222222,PAYPAL *NETFLIX CBA,157.17,0,100399.95,DR,REF622646,CBA,Savings
04-08-2025 01:59,CBAF7AFB24909AF4CD99DEA,063-000-001,22222222,MENULOG CBA,83.78,0,100316.17,DR,REF704052,CBA,Savings
04-08-2025 01:59,CBAE48BC3087B0F470BA6A8,063-000-001,22222222,SHELL CBA,12.8,0,100303.37,DR,REF381543,CBA,Savings
04-08-2025 02:10,INT2DD18F5C734549CABFE6,063-000-001,22222222,TRANSFER FROM ANZ 11111111,0,249.84,100553.21,CR,INT-36945,CBA,Savings
04-08-2025 02:31,CBA8BB3C68602DE481F993F,063-000-001,22222222,PAY - SALARY CBA,0,2154.26,102707.47,CR,REF404332,CBA,Savings
04-08-2025 02:36,CBA598AD45C363A45DFAAAB,063-000-001,22222222,DOMINO'S PIZZA CBA,12.47,0,102695,DR,REF275286,CBA,Savings
04-08-2025 02:54,CBA147A4271025B4DC391B4,063-000-001,22222222,BANK FEE CBA,110.57,0,102584.43,DR,REF833066,CBA,Savings
04-08-2025 02:57,INT081A362DDF9C42D9BFED,063-000-001,22222222,TRANSFER TO CBA 33333333,561.62,0,102022.81,DR,INT-97968,CBA,Savings
04-08-2025 03:07,CBAAA17A5E61F51463F8BC3,063-000-001,22222222,SHELL CBA,7.02,0,102015.79,DR,REF367830,CBA,Savings
04-08-2025 03:48,CBAE308F15733584EB1A647,063-000-001,22222222,LIQUORLAND CBA,14.86,0,102000.93,DR,REF573723,CBA,Savings
04-08-2025 04:23,CBA12D89E68E14042E4A8DA,063-000-001,22222222,PAYROLL CREDIT CBA,0,3447.65,105448.58,CR,REF754434,CBA,Savings
04-08-2025 04:43,CBACBC4662D632548A19230,063-000-001,22222222,BP CBA,69.43,0,105379.15,DR,REF731354,CBA,Savings
04-08-2025 04:59,CBAFB1BA232F30E4F89822E,063-000-001,22222222,INTERNET TRANSFER CBA,65.3,0,105313.85,DR,REF572691,CBA,Savings
04-08-2025 05:13,CBA144B65F4F0D34D1D819C,063-000-001,22222222,SHELL CBA,140.94,0,105172.91,DR,REF433693,CBA,Savings
04-08-2025 05:18,CBA46256675B8914F4C935C,063-000-001,22222222,AMAZON AU CBA,33.62,0,105139.29,DR,REF598215,CBA,Savings
04-08-2025 05:19,CBA0D4F0D0FEB3446279FB5,063-000-001,22222222,SPOTIFY CBA,131.17,0,105008.12,DR,REF743912,CBA,Savings
04-08-2025 05:20,CBA1ED6974D0DE949AEAA49,063-000-001,22222222,PAYMENT GATEWAY CBA,181.35,0,104826.77,DR,REF270594,CBA,Savings
04-08-2025 05:30,INT07E5F8E8118C46BE8B24,063-000-001,22222222,TRANSFER TO ANZ 11111111,1584.95,0,103241.82,DR,INT-69923,CBA,Savings
04-08-2025 05:32,CBA400E3053AFB04BD89787,063-000-001,22222222,ALDI CBA,48,0,103193.82,DR,REF402018,CBA,Savings
04-08-2025 06:07,CBAC5F5856279B74BEC8D9F,063-000-001,22222222,BP CBA,31.97,0,103161.85,DR,REF176549,CBA,Savings
04-08-2025 06:07,CBACE3A97BA52F7402FB0DF,063-000-001,22222222,FLIXBUS CBA,35,0,103126.85,DR,REF685315,CBA,Savings
04-08-2025 06:11,CBA8ABA54EE157041AAA2FB,063-000-001,22222222,COMPANY PAYROLL CBA,0,3349,106475.85,CR,REF268925,CBA,Savings
04-08-2025 06:50,CBA5EE50070D3DC46BF9E81,063-000-001,22222222,PAYROLL CREDIT CBA,0,5100.15,111576,CR,REF356727,CBA,Savings
04-08-2025 07:36,CBAFF2B9C0E5C0B4543A2C9,063-000-001,22222222,BANK FEE CBA,47.23,0,111528.77,DR,REF846748,CBA,Savings
04-08-2025 07:49,CBA5198D21F72E7474BB05E,063-000-001,22222222,INTERNET TRANSFER CBA,25.95,0,111502.82,DR,REF248523,CBA,Savings
04-08-2025 07:53,CBA422E9DE2FBAD45139EE4,063-000-001,22222222,SPOTIFY CBA,142.24,0,111360.58,DR,REF899637,CBA,Savings
04-08-2025 08:02,CBA4EBF13620ED14BA183B1,063-000-001,22222222,STARBUCKS CBA,45.34,0,111315.24,DR,REF729165,CBA,Savings
04-08-2025 08:05,CBA76A65B8EF55C45D2A18D,063-000-001,22222222,ALDI CBA,2.57,0,111312.67,DR,REF873433,CBA,Savings
04-08-2025 08:40,CBA3B1FB7815114401A9140,063-000-001,22222222,JB HI-FI CBA,7.34,0,111305.33,DR,REF796101,CBA,Savings
04-08-2025 09:42,CBA41F4553C577744039BCA,063-000-001,22222222,UBER EATS CBA,61.99,0,111243.34,DR,REF350540,CBA,Savings
04-08-2025 10:02,CBA03FB8D6C716A4572A6AE,063-000-001,22222222,7-ELEVEN CBA,25.93,0,111217.41,DR,REF797119,CBA,Savings
04-08-2025 10:08,CBA4124126491744D20A0BB,063-000-001,22222222,TAFE BOOKSHOP CBA,192.37,0,111025.04,DR,REF962119,CBA,Savings
04-08-2025 10:24,CBAB107ED955E0E472D9F56,063-000-001,22222222,PAYROLL CREDIT CBA,0,6661.52,117686.56,CR,REF470972,CBA,Savings
04-08-2025 10:37,CBA14CD7257EF0F434F840D,063-000-001,22222222,DOMINO'S PIZZA CBA,182.95,0,117503.61,DR,REF998343,CBA,Savings
04-08-2025 10:37,CBA96939FA86DE14DBC8C6A,063-000-001,22222222,INTERNET TRANSFER CBA,8.91,0,117494.7,DR,REF591725,CBA,Savings
04-08-2025 10:45,CBAADE20D373C62495CB32F,063-000-001,22222222,WAGES CREDIT CBA,0,2053.99,119548.69,CR,REF655922,CBA,Savings
04-08-2025 10:53,CBA0CD5F087EFA54F4FAF29,063-000-001,22222222,PAYMENT GATEWAY CBA,9.37,0,119539.32,DR,REF555643,CBA,Savings
04-08-2025 11:06,CBAE20368C017284B1DA3C7,063-000-001,22222222,BIGW CBA,24.53,0,119514.79,DR,REF324824,CBA,Savings
04-08-2025 11:07,CBA40857F95A2884F0EA6E1,063-000-001,22222222,COMPANY PAYROLL CBA,0,101.94,119616.73,CR,REF549528,CBA,Savings
04-08-2025 11:19,CBA4799E9EF6045451799DC,063-000-001,22222222,HARVEY NORMAN CBA,51.74,0,119564.99,DR,REF217113,CBA,Savings
04-08-2025 11:25,CBA7E4450F0ABE44AF6A177,063-000-001,22222222,HARVEY NORMAN CBA,102.93,0,119462.06,DR,REF986282,CBA,Savings
04-08-2025 11:29,CBA915E56519B704E10A5AF,063-000-001,22222222,SPOTIFY CBA,16.68,0,119445.38,DR,REF371483,CBA,Savings
04-08-2025 11:38,CBA2100BCAA5C3C439292D6,063-000-001,22222222,PAYMENT GATEWAY CBA,106.21,0,119339.17,DR,REF675080,CBA,Savings
04-08-2025 11:51,CBAAB37ACCFF1A04D979594,063-000-001,22222222,WAGES CREDIT CBA,0,270.5,119609.67,CR,REF917587,CBA,Savings
04-08-2025 12:00,CBA9B2F12DD1FAE44F487C1,063-000-001,22222222,RAILWAY STATION CBA,89.33,0,119520.34,DR,REF590870,CBA,Savings
04-08-2025 12:13,INT92078F582C104A6F92AF,063-000-001,22222222,TRANSFER FROM NAB 44444444,0,527.79,120048.13,CR,INT-98000,CBA,Savings
04-08-2025 13:13,CBA14B76FDB1408412BACFA,063-000-001,22222222,BIGW CBA,37.31,0,120010.82,DR,REF514707,CBA,Savings
04-08-2025 14:30,INT2B4FF85221FA425F84E6,063-000-001,22222222,TRANSFER TO CBA 33333333,1328.6,0,118682.22,DR,INT-22855,CBA,Savings
04-08-2025 14:38,CBA306DD61E7D9D4D48AC2C,063-000-001,22222222,HARVEY NORMAN CBA,30.75,0,118651.47,DR,REF122966,CBA,Savings
04-08-2025 15:30,CBA79EEA8794AB9456A880E,063-000-001,22222222,SALARY PAYMENT CBA,0,6662.8,125314.27,CR,REF966150,CBA,Savings
04-08-2025 15:32,CBA573D6E17F0914A46A726,063-000-001,22222222,FLIXBUS CBA,55.64,0,125258.63,DR,REF378947,CBA,Savings
04-08-2025 15:43,CBAB8285280E58E4081A4D1,063-000-001,22222222,SALARY PAYMENT CBA,0,5778.49,131037.12,CR,REF996500,CBA,Savings
04-08-2025 15:48,CBA977ABF509CCF4AFDAAB8,063-000-001,22222222,RAILWAY STATION CBA,34.82,0,131002.3,DR,REF406374,CBA,Savings
04-08-2025 16:00,CBA799A7DC3EDB9416CA662,063-000-001,22222222,BWS CBA,84.7,0,130917.6,DR,REF668716,CBA,Savings
04-08-2025 16:08,CBA2D54ED61507349349C94,063-000-001,22222222,TAFE BOOKSHOP CBA,103.5,0,130814.1,DR,REF236535,CBA,Savings
04-08-2025 16:17,INTF2D4EA88864E408C8160,063-000-001,22222222,TRANSFER TO NAB 44444444,1174.16,0,129639.94,DR,INT-44504,CBA,Savings
04-08-2025 16:53,CBA9B40BC77F0114CEE8D7F,063-000-001,22222222,LIQUORLAND CBA,158.36,0,129481.58,DR,REF835016,CBA,Savings
04-08-2025 16:55,CBA7E98E24C40A5439A8491,063-000-001,22222222,ALDI CBA,10.24,0,129471.34,DR,REF208667,CBA,Savings
04-08-2025 17:06,CBA4D2470B2CFB94C39B354,063-000-001,22222222,KFC CBA,20.64,0,129450.7,DR,REF769132,CBA,Savings
04-08-2025 17:13,CBA894D824FB4844683B679,063-000-001,22222222,7-ELEVEN CBA,23.47,0,129427.23,DR,REF192447,CBA,Savings
04-08-2025 17:45,CBAAFB3C48AA3B640339104,063-000-001,22222222,BIGW CBA,45.72,0,129381.51,DR,REF474248,CBA,Savings
04-08-2025 17:46,CBAE0E9CEB795294EE6BD08,063-000-001,22222222,WAGES CREDIT CBA,0,1174.46,130555.97,CR,REF593338,CBA,Savings
04-08-2025 17:57,CBAB91588C77D3440F28459,063-000-001,22222222,MENULOG CBA,12.13,0,130543.84,DR,REF630840,CBA,Savings
04-08-2025 18:19,CBAB2C5B3C2ED414F75B174,063-000-001,22222222,HARVEY NORMAN CBA,192.17,0,130351.67,DR,REF195399,CBA,Savings
04-08-2025 19:19,CBA163C03655EA14472B5B1,063-000-001,22222222,KFC CBA,52.18,0,130299.49,DR,REF404816,CBA,Savings
04-08-2025 19:37,CBA086F168019E5486F84AD,063-000-001,22222222,MENULOG CBA,5.84,0,130293.65,DR,REF642598,CBA,Savings
04-08-2025 20:15,CBA53B1831535C941D1BAEA,063-000-001,22222222,INTERNET TRANSFER CBA,47.12,0,130246.53,DR,REF947774,CBA,Savings
04-08-2025 20:31,CBA23569F704AA14442A34E,063-000-001,22222222,SHELL CBA,150.27,0,130096.26,DR,REF937915,CBA,Savings
04-08-2025 20:53,CBAC630A6404B574205B38D,063-000-001,22222222,TAFE BOOKSHOP CBA,20.19,0,130076.07,DR,REF416026,CBA,Savings
04-08-2025 20:53,CBA0ACB9902F1934EC988C4,063-000-001,22222222,BP CBA,38.13,0,130037.94,DR,REF156482,CBA,Savings
04-08-2025 20:54,CBA2A967AC0B16E4C0FB713,063-000-001,22222222,DOMINO'S PIZZA CBA,82.86,0,129955.08,DR,REF395922,CBA,Savings
04-08-2025 21:04,CBA6BFF9C6664454B6E80BA,063-000-001,22222222,BANK FEE CBA,33.13,0,129921.95,DR,REF244320,CBA,Savings
04-08-2025 21:14,CBA788964577671465698DA,063-000-001,22222222,BWS CBA,80.92,0,129841.03,DR,REF368307,CBA,Savings
04-08-2025 23:24,CBA8DFFA39F0298401FB48C,063-000-001,22222222,TAFE BOOKSHOP CBA,26.24,0,129814.79,DR,REF429967,CBA,Savings
05-08-2025 00:12,CBA63B235D8083441C1BF85,063-000-001,22222222,7-ELEVEN CBA,18.26,0,129796.53,DR,REF130750,CBA,Savings
05-08-2025 00:15,CBAB59FD781C61E466C8BA5,063-000-001,22222222,APPLE CBA,71.56,0,129724.97,DR,REF597110,CBA,Savings
05-08-2025 00:18,INT079AF0C0E4014416A2BD,063-000-001,22222222,TRANSFER TO ANZ 11111111,1278.6,0,128446.37,DR,INT-72216,CBA,Savings
05-08-2025 00:43,CBA39DD186964314B7ABC92,063-000-001,22222222,WOOLWORTHS CBA,35.72,0,128410.65,DR,REF615836,CBA,Savings
05-08-2025 01:12,CBA9D243570BCB4451B9BD6,063-000-001,22222222,STARBUCKS CBA,29.3,0,128381.35,DR,REF983904,CBA,Savings
05-08-2025 01:30,CBAE5BF131EBB5E4CC6A588,063-000-001,22222222,7-ELEVEN CBA,7.53,0,128373.82,DR,REF226239,CBA,Savings
05-08-2025 02:18,CBAB38C53E0C03D40AF9C90,063-000-001,22222222,BIGW CBA,22.1,0,128351.72,DR,REF844678,CBA,Savings
05-08-2025 02:28,CBADEFFED95DD134001BB75,063-000-001,22222222,AMAZON AU CBA,26.39,0,128325.33,DR,REF868987,CBA,Savings
05-08-2025 02:28,CBA4870ADF63C764D638418,063-000-001,22222222,WOOLWORTHS CBA,67.65,0,128257.68,DR,REF661037,CBA,Savings
05-08-2025 03:18,CBACB10E0753C37416B8CAC,063-000-001,22222222,LIQUORLAND CBA,105.97,0,128151.71,DR,REF439663,CBA,Savings
05-08-2025 03:21,CBA3C05925D94884400AEA4,063-000-001,22222222,SHELL CBA,10.84,0,128140.87,DR,REF874863,CBA,Savings
05-08-2025 03:32,CBA7FE60682B7F846F8A1E0,063-000-001,22222222,BWS CBA,121.14,0,128019.73,DR,REF192259,CBA,Savings
05-08-2025 04:00,CBA1E7BFFF89DBE44B8BB93,063-000-001,22222222,MENULOG CBA,32.77,0,127986.96,DR,REF244030,CBA,Savings
05-08-2025 04:15,CBA5AE06ABA7C944114A1F9,063-000-001,22222222,SHELL CBA,15.99,0,127970.97,DR,REF299121,CBA,Savings
05-08-2025 04:22,CBAA9F94C34BB414DB9A617,063-000-001,22222222,TAFE BOOKSHOP CBA,42.79,0,127928.18,DR,REF178730,CBA,Savings
05-08-2025 04:51,CBA485AE69A567C4EC5AE82,063-000-001,22222222,ALDI CBA,28.82,0,127899.36,DR,REF665161,CBA,Savings
05-08-2025 05:07,CBA751CB7AA90124183B812,063-000-001,22222222,MCDONALDS CBA,15.06,0,127884.3,DR,REF414056,CBA,Savings
05-08-2025 05:41,CBABE318599A3EF47AEB13B,063-000-001,22222222,MCDONALDS CBA,136.12,0,127748.18,DR,REF245425,CBA,Savings
05-08-2025 06:06,CBAA5299DBB9ADF423480F5,063-000-001,22222222,STARBUCKS CBA,51.01,0,127697.17,DR,REF518450,CBA,Savings
05-08-2025 06:08,CBAEC72E3C805A642EBAB82,063-000-001,22222222,MENULOG CBA,3.43,0,127693.74,DR,REF793042,CBA,Savings
05-08-2025 06:09,CBA513F8B06486A45628D8A,063-000-001,22222222,HARVEY NORMAN CBA,100.06,0,127593.68,DR,REF212579,CBA,Savings
05-08-2025 06:14,CBA1B2785868BF14F96800B,063-000-001,22222222,INTERNET TRANSFER CBA,8.98,0,127584.7,DR,REF800608,CBA,Savings
05-08-2025 06:16,CBA80F663F92B6D4EA481B3,063-000-001,22222222,KFC CBA,51.79,0,127532.91,DR,REF606106,CBA,Savings
05-08-2025 06:25,INTF2336ABADDD3439A81E8,063-000-001,22222222,TRANSFER TO ANZ 11111111,103.58,0,127429.33,DR,INT-45724,CBA,Savings
05-08-2025 06:26,CBA12A5A2CB92D34962B005,063-000-001,22222222,BANK FEE CBA,161.2,0,127268.13,DR,REF866563,CBA,Savings
05-08-2025 06:46,CBAC61AC5BDA8784325BE60,063-000-001,22222222,ZOOM CBA,31.39,0,127236.74,DR,REF108820,CBA,Savings
05-08-2025 08:05,CBA314688B9886A4D42A29D,063-000-001,22222222,PAYPAL *NETFLIX CBA,12.12,0,127224.62,DR,REF527548,CBA,Savings
05-08-2025 08:24,INT04CD2B16FA0547F1B119,063-000-001,22222222,TRANSFER TO NAB 44444444,497.26,0,126727.36,DR,INT-20674,CBA,Savings
05-08-2025 08:42,CBA489DF040F6154960A57D,063-000-001,22222222,CITYLINK CBA,10.81,0,126716.55,DR,REF977104,CBA,Savings
05-08-2025 09:23,CBA769CC71419F6427AA5A6,063-000-001,22222222,ALDI CBA,53.61,0,126662.94,DR,REF165819,CBA,Savings
05-08-2025 09:33,CBAA1910A9BB3BC4F7A8C31,063-000-001,22222222,AMAZON AU CBA,130.32,0,126532.62,DR,REF638940,CBA,Savings
05-08-2025 09:51,CBAB2AF57E70BF649E9833D,063-000-001,22222222,SHELL CBA,12.92,0,126519.7,DR,REF448180,CBA,Savings
05-08-2025 09:57,CBA0E1F19C4940E48439028,063-000-001,22222222,FLIXBUS CBA,35.43,0,126484.27,DR,REF658806,CBA,Savings
05-08-2025 10:04,CBA46865E63A1F544B9A0F5,063-000-001,22222222,MCDONALDS CBA,14.81,0,126469.46,DR,REF180796,CBA,Savings
05-08-2025 10:36,CBA0B7A46CC85BD485B8055,063-000-001,22222222,BANK FEE CBA,27.55,0,126441.91,DR,REF154504,CBA,Savings
05-08-2025 10:45,CBA9140365622304FC4B9C9,063-000-001,22222222,SALARY PAYMENT CBA,0,5417.06,131858.97,CR,REF845077,CBA,Savings
05-08-2025 10:47,INTF1436EA26C3B498FB75C,063-000-001,22222222,TRANSFER FROM ANZ 11111111,0,220.47,132079.44,CR,INT-71457,CBA,Savings
05-08-2025 10:50,CBA4D65408720C64D6BB928,063-000-001,22222222,MENULOG CBA,4.54,0,132074.9,DR,REF764280,CBA,Savings
05-08-2025 10:56,CBAEB9440E486CC4FC89B40,063-000-001,22222222,PAYMENT GATEWAY CBA,28.76,0,132046.14,DR,REF870286,CBA,Savings
05-08-2025 11:15,CBA02304BE4266740A0BD9F,063-000-001,22222222,KFC CBA,50.98,0,131995.16,DR,REF648837,CBA,Savings
05-08-2025 12:00,CBA0891D356555949368FE6,063-000-001,22222222,LIQUORLAND CBA,8.09,0,131987.07,DR,REF736525,CBA,Savings
05-08-2025 12:25,INTB2522812C73C4F188EA4,063-000-001,22222222,TRANSFER FROM CBA 33333333,0,1689.09,133676.16,CR,INT-81507,CBA,Savings
05-08-2025 12:57,CBA3D589247FC6C41ADAA34,063-000-001,22222222,BIGW CBA,59.16,0,133617,DR,REF107291,CBA,Savings
05-08-2025 13:18,CBA75469C23EDA545C48A13,063-000-001,22222222,CITYLINK CBA,13.14,0,133603.86,DR,REF189164,CBA,Savings
05-08-2025 13:37,CBA817DFAB383DB4CBEA331,063-000-001,22222222,ZOOM CBA,21.44,0,133582.42,DR,REF879026,CBA,Savings
05-08-2025 14:08,CBA881F92C9C69848B58EC9,063-000-001,22222222,PAYMENT GATEWAY CBA,5.23,0,133577.19,DR,REF554128,CBA,Savings
05-08-2025 14:08,CBA6B39EBB8C73645CCBEDB,063-000-001,22222222,ALDI CBA,104.72,0,133472.47,DR,REF665136,CBA,Savings
05-08-2025 14:10,CBA36D31B6C85F34232A4C7,063-000-001,22222222,TAFE BOOKSHOP CBA,11.35,0,133461.12,DR,REF245019,CBA,Savings
05-08-2025 14:16,CBA23D55C96C284486DAB07,063-000-001,22222222,COLES CBA,4.77,0,133456.35,DR,REF447019,CBA,Savings
05-08-2025 14:23,CBA4CBDB465865F4F22A922,063-000-001,22222222,APPLE CBA,50.81,0,133405.54,DR,REF869284,CBA,Savings
05-08-2025 15:08,CBA2AA33621E28249559401,063-000-001,22222222,PAYROLL CREDIT CBA,0,2973.31,136378.85,CR,REF177936,CBA,Savings
05-08-2025 15:37,CBAA3812E2241DC44FBA0A4,063-000-001,22222222,BIGW CBA,13.09,0,136365.76,DR,REF991587,CBA,Savings
05-08-2025 16:27,CBAAD7744FD211542CDA15D,063-000-001,22222222,AMAZON AU CBA,140.56,0,136225.2,DR,REF561958,CBA,Savings
05-08-2025 16:50,CBA6F617082F4454731B87D,063-000-001,22222222,RAILWAY STATION CBA,10.43,0,136214.77,DR,REF879996,CBA,Savings
05-08-2025 17:17,CBA800F600A220A47469C81,063-000-001,22222222,MENULOG CBA,19.46,0,136195.31,DR,REF277532,CBA,Savings
05-08-2025 17:24,CBAFE0F6C274A114FA796A8,063-000-001,22222222,UBER EATS CBA,29.8,0,136165.51,DR,REF900287,CBA,Savings
05-08-2025 17:26,CBA1E9B05B938ED4AE2A8A1,063-000-001,22222222,COLES CBA,59.61,0,136105.9,DR,REF805152,CBA,Savings
05-08-2025 17:30,CBA0458A96542DD4E38B128,063-000-001,22222222,PAYPAL *NETFLIX CBA,84.9,0,136021,DR,REF690559,CBA,Savings
05-08-2025 18:03,CBA554891ACC74241C294CE,063-000-001,22222222,BWS CBA,10.45,0,136010.55,DR,REF391294,CBA,Savings
05-08-2025 18:11,CBA12580A3766314522B475,063-000-001,22222222,TAFE BOOKSHOP CBA,65.2,0,135945.35,DR,REF912456,CBA,Savings
05-08-2025 18:17,CBAF690B5291E8E49A78700,063-000-001,22222222,DOMINO'S PIZZA CBA,11.98,0,135933.37,DR,REF633680,CBA,Savings
05-08-2025 18:46,CBAB990981F696649F18F59,063-000-001,22222222,APPLE CBA,9.34,0,135924.03,DR,REF814273,CBA,Savings
05-08-2025 18:58,CBA109B3887FA9448649F94,063-000-001,22222222,HARVEY NORMAN CBA,17.31,0,135906.72,DR,REF547122,CBA,Savings
05-08-2025 19:03,CBA0C29235D675942489F7C,063-000-001,22222222,COLES CBA,115.23,0,135791.49,DR,REF816506,CBA,Savings
05-08-2025 19:04,CBA7B739348703F4234AF13,063-000-001,22222222,DOMINO'S PIZZA CBA,53.92,0,135737.57,DR,REF701497,CBA,Savings
05-08-2025 19:18,INTCE0899769E404E41AD2A,063-000-001,22222222,TRANSFER FROM CBA 33333333,0,1568.23,137305.8,CR,INT-80383,CBA,Savings
05-08-2025 19:25,CBA28FB10EBC0A0478E9BE0,063-000-001,22222222,SALARY PAYMENT CBA,0,2315.19,139620.99,CR,REF172905,CBA,Savings
05-08-2025 19:31,CBAF87A5919C47F4C969DB3,063-000-001,22222222,SHELL CBA,106.64,0,139514.35,DR,REF419510,CBA,Savings
05-08-2025 19:31,CBA6A28956F89004EB8A785,063-000-001,22222222,SHELL CBA,10.89,0,139503.46,DR,REF204587,CBA,Savings
05-08-2025 19:49,CBA155F226219654201B68B,063-000-001,22222222,MENULOG CBA,30.91,0,139472.55,DR,REF243628,CBA,Savings
05-08-2025 20:11,INTF6F4D3886E2C4AFD81A2,063-000-001,22222222,TRANSFER FROM ANZ 11111111,0,1447.18,140919.73,CR,INT-68168,CBA,Savings
05-08-2025 20:47,INT30F6C40EED534C448CD1,063-000-001,22222222,TRANSFER TO CBA 33333333,474.2,0,140445.53,DR,INT-59790,CBA,Savings
05-08-2025 21:08,CBADE69FBD1F6B8456CBF34,063-000-001,22222222,UBER EATS CBA,66.95,0,140378.58,DR,REF810572,CBA,Savings
05-08-2025 21:13,INTF3E7E0AE7DE848768855,063-000-001,22222222,TRANSFER TO ANZ 11111111,784.88,0,139593.7,DR,INT-93020,CBA,Savings
05-08-2025 21:30,CBA4B3912C184074A18AB33,063-000-001,22222222,MENULOG CBA,67.77,0,139525.93,DR,REF798955,CBA,Savings
05-08-2025 21:31,CBA201A7CDDB63345FF974F,063-000-001,22222222,COMPANY PAYROLL CBA,0,3830.98,143356.91,CR,REF274361,CBA,Savings
05-08-2025 21:52,CBA83C1AB46FA15458F9E71,063-000-001,22222222,BWS CBA,55.49,0,143301.42,DR,REF824398,CBA,Savings
05-08-2025 21:56,CBA555F86427EC34692BD60,063-000-001,22222222,FLIXBUS CBA,41.96,0,143259.46,DR,REF508882,CBA,Savings
05-08-2025 21:57,CBAEE7A8EF669524F729983,063-000-001,22222222,APPLE CBA,4.28,0,143255.18,DR,REF396393,CBA,Savings
05-08-2025 22:05,CBA22974080740D49CAB85B,063-000-001,22222222,RAILWAY STATION CBA,18.13,0,143237.05,DR,REF170075,CBA,Savings
05-08-2025 22:42,CBA1033EBA26809430CAD3A,063-000-001,22222222,BWS CBA,48.41,0,143188.64,DR,REF126423,CBA,Savings
05-08-2025 22:48,CBA90636D4E754D4CD58E7F,063-000-001,22222222,BWS CBA,11.32,0,143177.32,DR,REF259395,CBA,Savings
05-08-2025 22:52,CBA27DC905A600E4FA3890D,063-000-001,22222222,APPLE CBA,191.97,0,142985.35,DR,REF957946,CBA,Savings
05-08-2025 23:09,CBA4250AF1BD1574FE69DA1,063-000-001,22222222,ZOOM CBA,3.12,0,142982.23,DR,REF870967,CBA,Savings
05-08-2025 23:51,CBA7D3030D096F246EA8511,063-000-001,22222222,WOOLWORTHS CBA,142.82,0,142839.41,DR,REF521378,CBA,Savings
06-08-2025 00:32,CBA3228CD2FF89A4250BAC2,063-000-001,22222222,STARBUCKS CBA,13.13,0,142826.28,DR,REF263171,CBA,Savings
06-08-2025 00:41,CBA00149B8732A64E969E42,063-000-001,22222222,KFC CBA,79.54,0,142746.74,DR,REF394041,CBA,Savings
06-08-2025 00:43,CBA84E8F0208ED94E1E99BF,063-000-001,22222222,ZOOM CBA,133.52,0,142613.22,DR,REF127325,CBA,Savings
06-08-2025 00:52,CBA0334CBE379614E5AAE5B,063-000-001,22222222,MCDONALDS CBA,55.75,0,142557.47,DR,REF963808,CBA,Savings
06-08-2025 01:20,CBAAF4D8B303BCE440A965F,063-000-001,22222222,HARVEY NORMAN CBA,39.51,0,142517.96,DR,REF452616,CBA,Savings
06-08-2025 01:48,CBAD2B360AE923543D694E3,063-000-001,22222222,JB HI-FI CBA,136.86,0,142381.1,DR,REF339835,CBA,Savings
06-08-2025 01:52,CBACD5FAF803F1D4CB79C1D,063-000-001,22222222,APPLE CBA,76.24,0,142304.86,DR,REF643999,CBA,Savings
06-08-2025 02:15,CBA1E2ED962EAA2498DA53C,063-000-001,22222222,CITYLINK CBA,33.83,0,142271.03,DR,REF798496,CBA,Savings
06-08-2025 02:40,CBAC9BC006187CA49E080D3,063-000-001,22222222,INTERNET TRANSFER CBA,26.08,0,142244.95,DR,REF695473,CBA,Savings
06-08-2025 02:50,CBA67E9773AE64C478093B9,063-000-001,22222222,TAFE BOOKSHOP CBA,69.67,0,142175.28,DR,REF348371,CBA,Savings
06-08-2025 03:00,CBA82E684ACEE474173B207,063-000-001,22222222,ALDI CBA,90.76,0,142084.52,DR,REF635808,CBA,Savings
06-08-2025 03:14,CBA8F17A6E1CC6244DE89E0,063-000-001,22222222,CITYLINK CBA,23.48,0,142061.04,DR,REF334649,CBA,Savings
06-08-2025 03:29,CBA97913CE276FB45B4A066,063-000-001,22222222,BWS CBA,95.56,0,141965.48,DR,REF655372,CBA,Savings
06-08-2025 03:30,CBAB6B17B59F4404F20984D,063-000-001,22222222,MENULOG CBA,11.95,0,141953.53,DR,REF270811,CBA,Savings
06-08-2025 03:33,CBA55962B8565B64D158018,063-000-001,22222222,MENULOG CBA,15.61,0,141937.92,DR,REF280977,CBA,Savings
06-08-2025 04:43,INT8487972F086845E39C3C,063-000-001,22222222,TRANSFER TO CBA 33333333,333.21,0,141604.71,DR,INT-20256,CBA,Savings
06-08-2025 04:52,CBAA85A54A1361042798C9A,063-000-001,22222222,SALARY PAYMENT CBA,0,2974.06,144578.77,CR,REF957327,CBA,Savings
06-08-2025 05:18,CBAEFFF8BCBA52849AEB8CF,063-000-001,22222222,KFC CBA,6.03,0,144572.74,DR,REF298398,CBA,Savings
06-08-2025 05:41,CBA07ED4C8CE2A040EA8B3C,063-000-001,22222222,7-ELEVEN CBA,119.6,0,144453.14,DR,REF796802,CBA,Savings
06-08-2025 05:43,CBA768BB7E63B574AB2A6A0,063-000-001,22222222,ZOOM CBA,39.83,0,144413.31,DR,REF893887,CBA,Savings
06-08-2025 05:47,CBA23C0B6A95DD24408A180,063-000-001,22222222,APPLE CBA,37.45,0,144375.86,DR,REF548280,CBA,Savings
06-08-2025 05:52,CBAE5EFDDE4C3A748D1A777,063-000-001,22222222,KFC CBA,14.38,0,144361.48,DR,REF548211,CBA,Savings
06-08-2025 06:09,CBA0532752879584BFC85A0,063-000-001,22222222,PAY - SALARY CBA,0,4593.79,148955.27,CR,REF383043,CBA,Savings
06-08-2025 06:17,CBA2894EE753D99498C9951,063-000-001,22222222,COLES CBA,64.77,0,148890.5,DR,REF872869,CBA,Savings
06-08-2025 06:17,CBA5351D708C8BF47F79217,063-000-001,22222222,FLIXBUS CBA,74.61,0,148815.89,DR,REF309959,CBA,Savings
06-08-2025 07:24,CBAE391E2B5D91B4B44B104,063-000-001,22222222,CITYLINK CBA,80.67,0,148735.22,DR,REF848920,CBA,Savings
06-08-2025 08:43,CBABD85F84D8C5D4D76A312,063-000-001,22222222,PAYROLL CREDIT CBA,0,3372.56,152107.78,CR,REF342130,CBA,Savings
06-08-2025 09:06,CBAC45BF3259D404EE7B465,063-000-001,22222222,PAYMENT GATEWAY CBA,77.96,0,152029.82,DR,REF690817,CBA,Savings
06-08-2025 09:29,CBA4D0E6144B8C34E628C55,063-000-001,22222222,INTERNET TRANSFER CBA,4.81,0,152025.01,DR,REF328744,CBA,Savings
06-08-2025 09:35,CBAC0D13BBE3DCF453998FB,063-000-001,22222222,BIGW CBA,114.14,0,151910.87,DR,REF864990,CBA,Savings
06-08-2025 09:41,CBA621D8E3BED534767B720,063-000-001,22222222,7-ELEVEN CBA,32.37,0,151878.5,DR,REF648254,CBA,Savings
06-08-2025 09:59,CBAA9C6C1FAEFBA4E1C9F8F,063-000-001,22222222,MCDONALDS CBA,42.67,0,151835.83,DR,REF648561,CBA,Savings
06-08-2025 10:07,CBA5C4B571CD6C244A1A7EC,063-000-001,22222222,AMAZON AU CBA,14.08,0,151821.75,DR,REF168593,CBA,Savings
06-08-2025 10:12,INT28089430BA804361B2FE,063-000-001,22222222,TRANSFER FROM ANZ 11111111,0,1727.71,153549.46,CR,INT-87904,CBA,Savings
06-08-2025 10:36,CBA9B7CD0B9712D4CB3A560,063-000-001,22222222,CITYLINK CBA,11.97,0,153537.49,DR,REF118161,CBA,Savings
06-08-2025 10:39,CBA046574B3A9934225BEF2,063-000-001,22222222,CITYLINK CBA,27.12,0,153510.37,DR,REF991472,CBA,Savings
06-08-2025 10:49,CBA546D532D8FC4410ABB59,063-000-001,22222222,HARVEY NORMAN CBA,85.94,0,153424.43,DR,REF478519,CBA,Savings
06-08-2025 10:52,INT9F242CD681E043DBA4B2,063-000-001,22222222,TRANSFER TO NAB 44444444,1216.58,0,152207.85,DR,INT-70052,CBA,Savings
06-08-2025 11:16,CBA2D2627FAE7A04ADDACC3,063-000-001,22222222,JB HI-FI CBA,46.73,0,152161.12,DR,REF918359,CBA,Savings
06-08-2025 11:28,CBAD60D7EF08D7741CEBCF1,063-000-001,22222222,PAYROLL CREDIT CBA,0,6268.35,158429.47,CR,REF192789,CBA,Savings
06-08-2025 11:35,CBA809EA7C38ED24EE9B4D1,063-000-001,22222222,7-ELEVEN CBA,54.47,0,158375,DR,REF533022,CBA,Savings
06-08-2025 12:39,CBAD499C83B725E4EF496B4,063-000-001,22222222,STARBUCKS CBA,51.99,0,158323.01,DR,REF576308,CBA,Savings
06-08-2025 12:58,CBAC2E50F438340418596D1,063-000-001,22222222,BP CBA,11.91,0,158311.1,DR,REF963285,CBA,Savings
06-08-2025 13:30,CBAA7F3FA73E63E48E8A9E2,063-000-001,22222222,SHELL CBA,76.87,0,158234.23,DR,REF568070,CBA,Savings
06-08-2025 13:41,CBA7ED8A9F1A4E04E7F8831,063-000-001,22222222,SPOTIFY CBA,38.53,0,158195.7,DR,REF571384,CBA,Savings
06-08-2025 13:46,CBA8488762855E345B2903E,063-000-001,22222222,CITYLINK CBA,115.9,0,158079.8,DR,REF612797,CBA,Savings
06-08-2025 13:48,CBABAEC2AA4EAA74534A326,063-000-001,22222222,LIQUORLAND CBA,31.07,0,158048.73,DR,REF452114,CBA,Savings
06-08-2025 13:50,CBAD58F67CE5AFE420BA29A,063-000-001,22222222,SHELL CBA,118.51,0,157930.22,DR,REF381249,CBA,Savings
06-08-2025 14:43,CBA74DF28242AA94247BCD8,063-000-001,22222222,CITYLINK CBA,16.13,0,157914.09,DR,REF424467,CBA,Savings
06-08-2025 14:44,CBAF27419316DB14C6D8341,063-000-001,22222222,PAYPAL *NETFLIX CBA,40.68,0,157873.41,DR,REF427983,CBA,Savings
06-08-2025 14:49,CBA4627334260D54F19ADFB,063-000-001,22222222,WOOLWORTHS CBA,7.64,0,157865.77,DR,REF174159,CBA,Savings
06-08-2025 15:40,CBA7F563E8FDD754493B644,063-000-001,22222222,COLES CBA,17.27,0,157848.5,DR,REF673051,CBA,Savings
06-08-2025 15:57,CBA5B9653205AA147589831,063-000-001,22222222,FLIXBUS CBA,16.89,0,157831.61,DR,REF537583,CBA,Savings
06-08-2025 16:47,CBA87B50E310BE54FDF8281,063-000-001,22222222,KFC CBA,9.77,0,157821.84,DR,REF518991,CBA,Savings
06-08-2025 17:19,CBA9DBC33086F2D4FEB8677,063-000-001,22222222,BANK FEE CBA,77.63,0,157744.21,DR,REF198164,CBA,Savings
06-08-2025 17:57,CBABFA7AD1FC5FD45CBB63B,063-000-001,22222222,DOMINO'S PIZZA CBA,159.16,0,157585.05,DR,REF485407,CBA,Savings
06-08-2025 18:25,CBAC49CEA4F3A874D02A74A,063-000-001,22222222,BANK FEE CBA,63.08,0,157521.97,DR,REF304016,CBA,Savings
06-08-2025 19:14,CBA37E51D7DAB61491083A3,063-000-001,22222222,HARVEY NORMAN CBA,103.58,0,157418.39,DR,REF264222,CBA,Savings
06-08-2025 19:44,CBA0B90EE49BC2B4ED48B6D,063-000-001,22222222,PAYPAL *NETFLIX CBA,42.03,0,157376.36,DR,REF858669,CBA,Savings
06-08-2025 20:04,CBACF6BB18849084EEF9591,063-000-001,22222222,PAYPAL *NETFLIX CBA,12.82,0,157363.54,DR,REF625411,CBA,Savings
06-08-2025 20:11,CBAC39A8963482F435193A1,063-000-001,22222222,RAILWAY STATION CBA,18.14,0,157345.4,DR,REF618041,CBA,Savings
06-08-2025 20:33,CBA0808E20C8681437FAAAE,063-000-001,22222222,WAGES CREDIT CBA,0,4636.01,161981.41,CR,REF352423,CBA,Savings
06-08-2025 20:40,CBADA82F64DF2CF4B53AF53,063-000-001,22222222,UBER EATS CBA,99.23,0,161882.18,DR,REF414259,CBA,Savings
06-08-2025 20:43,CBA97C808DFE4B7449F8B36,063-000-001,22222222,CITYLINK CBA,15.6,0,161866.58,DR,REF920705,CBA,Savings
06-08-2025 21:16,CBAD0890E2214D54CABA559,063-000-001,22222222,PAY - SALARY CBA,0,1968.71,163835.29,CR,REF463726,CBA,Savings
06-08-2025 21:19,INT66EBCBCDAAD34B269B67,063-000-001,22222222,TRANSFER FROM NAB 44444444,0,425.75,164261.04,CR,INT-26378,CBA,Savings
06-08-2025 21:24,CBA83858B8D551546AE9B65,063-000-001,22222222,ZOOM CBA,23.64,0,164237.4,DR,REF615186,CBA,Savings
06-08-2025 21:45,CBAB77D1E9A359846F28B7A,063-000-001,22222222,TAFE BOOKSHOP CBA,3.57,0,164233.83,DR,REF285657,CBA,Savings
06-08-2025 22:27,CBA130A8220D5B24EFD88BC,063-000-001,22222222,UBER EATS CBA,51.03,0,164182.8,DR,REF262185,CBA,Savings
06-08-2025 22:33,CBAE4A5AF9D2F704840A46E,063-000-001,22222222,JB HI-FI CBA,15.38,0,164167.42,DR,REF215011,CBA,Savings
06-08-2025 22:35,CBAFBAF0AE33D3744BD80CC,063-000-001,22222222,TAFE BOOKSHOP CBA,58.19,0,164109.23,DR,REF536070,CBA,Savings
06-08-2025 22:38,CBAD08E9D332C904004ACF9,063-000-001,22222222,MCDONALDS CBA,9.85,0,164099.38,DR,REF135652,CBA,Savings
06-08-2025 22:55,CBA7D7D86D42C2C4F5FB2F5,063-000-001,22222222,MCDONALDS CBA,75.91,0,164023.47,DR,REF927086,CBA,Savings
06-08-2025 23:32,CBAFD478524CCDC4281B3AA,063-000-001,22222222,SALARY PAYMENT CBA,0,489.76,164513.23,CR,REF250679,CBA,Savings
06-08-2025 23:36,CBA14FD38DD98CB49D89506,063-000-001,22222222,MENULOG CBA,56.07,0,164457.16,DR,REF631984,CBA,Savings
07-08-2025 00:24,CBA4F851F04E6DB403C9597,063-000-001,22222222,COMPANY PAYROLL CBA,0,104.83,164561.99,CR,REF522574,CBA,Savings
07-08-2025 00:28,CBA0E70D5380A83441092F8,063-000-001,22222222,TAFE BOOKSHOP CBA,84.72,0,164477.27,DR,REF255753,CBA,Savings
07-08-2025 00:36,CBA8B00CAA9193D41EEB8CD,063-000-001,22222222,BIGW CBA,83.29,0,164393.98,DR,REF958510,CBA,Savings
07-08-2025 00:59,CBA2A9FE451BD564C5AB6FB,063-000-001,22222222,ALDI CBA,39.74,0,164354.24,DR,REF629234,CBA,Savings
07-08-2025 01:04,CBAD925902AFD4B49219779,063-000-001,22222222,PAYPAL *NETFLIX CBA,21.43,0,164332.81,DR,REF260538,CBA,Savings
07-08-2025 01:24,CBA1F30D84B46014AE08179,063-000-001,22222222,SPOTIFY CBA,18.41,0,164314.4,DR,REF712420,CBA,Savings
07-08-2025 01:39,CBAA840DB473D6D4C8DB560,063-000-001,22222222,WOOLWORTHS CBA,8.24,0,164306.16,DR,REF631460,CBA,Savings
07-08-2025 02:03,CBA083FC9F5A97A4DB2B59D,063-000-001,22222222,BANK FEE CBA,9.93,0,164296.23,DR,REF516928,CBA,Savings
07-08-2025 02:12,CBA61DE246471FA4BEC97D7,063-000-001,22222222,JB HI-FI CBA,25.95,0,164270.28,DR,REF330168,CBA,Savings
07-08-2025 02:47,CBA2E9109A836CB4B738285,063-000-001,22222222,BP CBA,12.37,0,164257.91,DR,REF249022,CBA,Savings
07-08-2025 02:48,CBA0859591010EC4B5986A8,063-000-001,22222222,PAYPAL *NETFLIX CBA,49.81,0,164208.1,DR,REF794836,CBA,Savings
07-08-2025 02:55,CBA04030E09DDF44867B354,063-000-001,22222222,RAILWAY STATION CBA,60.07,0,164148.03,DR,REF329426,CBA,Savings
07-08-2025 03:35,CBA516812EC96984ABDA23D,063-000-001,22222222,COMPANY PAYROLL CBA,0,1886.96,166034.99,CR,REF806460,CBA,Savings
07-08-2025 03:37,CBA101127F52DE4494196B8,063-000-001,22222222,RAILWAY STATION CBA,24.04,0,166010.95,DR,REF696943,CBA,Savings
07-08-2025 03:58,CBA5C413F7D100E48B88CA6,063-000-001,22222222,DOMINO'S PIZZA CBA,13.47,0,165997.48,DR,REF548021,CBA,Savings
07-08-2025 04:14,CBA2B2DD528028D44EAB1D9,063-000-001,22222222,JB HI-FI CBA,70.85,0,165926.63,DR,REF555921,CBA,Savings
07-08-2025 04:32,CBA64C0A4ADD5FA4DF88721,063-000-001,22222222,PAY - SALARY CBA,0,7409.32,173335.95,CR,REF156418,CBA,Savings
07-08-2025 04:40,CBA7C82F451EB774748B622,063-000-001,22222222,ZOOM CBA,30.34,0,173305.61,DR,REF161303,CBA,Savings
07-08-2025 06:13,CBA9B1548E811C8449585DE,063-000-001,22222222,RAILWAY STATION CBA,15.4,0,173290.21,DR,REF443136,CBA,Savings
07-08-2025 06:22,CBA5B546CA2864541B5A876,063-000-001,22222222,BANK FEE CBA,13.39,0,173276.82,DR,REF184796,CBA,Savings
07-08-2025 06:46,CBAB869F9F5F6AB491B96B1,063-000-001,22222222,BANK FEE CBA,14.15,0,173262.67,DR,REF701281,CBA,Savings
07-08-2025 07:00,CBA89ABC204F0E54A0193D9,063-000-001,22222222,UBER EATS CBA,36.91,0,173225.76,DR,REF776077,CBA,Savings
07-08-2025 07:11,CBA4273A1B04D7442FEB19B,063-000-001,22222222,UBER EATS CBA,164.53,0,173061.23,DR,REF954298,CBA,Savings
07-08-2025 07:40,CBAACB7492429AD4837923E,063-000-001,22222222,APPLE CBA,24.99,0,173036.24,DR,REF847721,CBA,Savings
07-08-2025 08:08,CBA7383D903119A4878B251,063-000-001,22222222,BP CBA,91.03,0,172945.21,DR,REF994400,CBA,Savings
07-08-2025 09:22,CBA43B5956EE93D4A5995AA,063-000-001,22222222,APPLE CBA,8.31,0,172936.9,DR,REF437332,CBA,Savings
07-08-2025 09:28,CBA488B795757A9454E89D5,063-000-001,22222222,7-ELEVEN CBA,64.91,0,172871.99,DR,REF127738,CBA,Savings
07-08-2025 09:47,CBAD7C1F726C34748CEAAA5,063-000-001,22222222,STARBUCKS CBA,3.84,0,172868.15,DR,REF602543,CBA,Savings
07-08-2025 09:49,CBA311CA489EE0549F09679,063-000-001,22222222,COLES CBA,37.44,0,172830.71,DR,REF490457,CBA,Savings
07-08-2025 10:01,CBAC13D958AB76B4AFE948A,063-000-001,22222222,INTERNET TRANSFER CBA,59.71,0,172771,DR,REF431243,CBA,Savings
07-08-2025 10:08,CBA000F2BEBBFD7411D866A,063-000-001,22222222,7-ELEVEN CBA,74.63,0,172696.37,DR,REF806807,CBA,Savings
07-08-2025 10:11,CBAF86A4A3C376D4906B0DD,063-000-001,22222222,JB HI-FI CBA,9.45,0,172686.92,DR,REF986676,CBA,Savings
07-08-2025 10:16,CBAC2DB696C72224A3BA4B3,063-000-001,22222222,SALARY PAYMENT CBA,0,5629.75,178316.67,CR,REF441033,CBA,Savings
07-08-2025 10:16,CBA2456778F5B8242BA91CC,063-000-001,22222222,MENULOG CBA,17.75,0,178298.92,DR,REF625781,CBA,Savings
07-08-2025 10:18,CBA8A77615115784A87ADD9,063-000-001,22222222,HARVEY NORMAN CBA,38.91,0,178260.01,DR,REF263693,CBA,Savings
07-08-2025 10:41,CBA54557B7D0C9B40E187B3,063-000-001,22222222,ZOOM CBA,65.2,0,178194.81,DR,REF282280,CBA,Savings
07-08-2025 10:43,CBA15DD3EF9D3F04DA48E41,063-000-001,22222222,ALDI CBA,45.62,0,178149.19,DR,REF441791,CBA,Savings
07-08-2025 10:58,CBA45CF16DABFFE490592D4,063-000-001,22222222,PAYMENT GATEWAY CBA,7.32,0,178141.87,DR,REF602311,CBA,Savings
07-08-2025 11:17,CBADCEAD9EA2B7142B78E7A,063-000-001,22222222,APPLE CBA,91.7,0,178050.17,DR,REF506591,CBA,Savings
07-08-2025 11:44,INT992C77419DC1445E9DCF,063-000-001,22222222,TRANSFER FROM ANZ 11111111,0,434.2,178484.37,CR,INT-68592,CBA,Savings
07-08-2025 11:53,CBAF8ECC22CCB0A4125904D,063-000-001,22222222,BP CBA,16.57,0,178467.8,DR,REF459304,CBA,Savings
07-08-2025 12:09,CBA8EE702FC8827430CAC4D,063-000-001,22222222,INTERNET TRANSFER CBA,39.56,0,178428.24,DR,REF427301,CBA,Savings
07-08-2025 12:29,CBAD307446A03B04F278C12,063-000-001,22222222,MCDONALDS CBA,113.95,0,178314.29,DR,REF910047,CBA,Savings
07-08-2025 13:21,CBA4037992297EE42A09620,063-000-001,22222222,COLES CBA,219.83,0,178094.46,DR,REF783141,CBA,Savings
07-08-2025 13:37,CBAA2984E2D66C74939AB09,063-000-001,22222222,DOMINO'S PIZZA CBA,40.42,0,178054.04,DR,REF696536,CBA,Savings
07-08-2025 13:42,CBA185CD9EC94664257B09C,063-000-001,22222222,ALDI CBA,49.14,0,178004.9,DR,REF167704,CBA,Savings
07-08-2025 13:45,CBAC615D2DCB95F4DFC8E6E,063-000-001,22222222,APPLE CBA,17.18,0,177987.72,DR,REF189967,CBA,Savings
07-08-2025 13:53,CBA2ACA3B26BF3D40719B51,063-000-001,22222222,WOOLWORTHS CBA,26.65,0,177961.07,DR,REF785930,CBA,Savings
07-08-2025 14:49,CBACC32329F06F64FE8BAAA,063-000-001,22222222,AMAZON AU CBA,62.13,0,177898.94,DR,REF929053,CBA,Savings
07-08-2025 15:59,CBA8742FCB8AC0E441DBA40,063-000-001,22222222,JB HI-FI CBA,22.44,0,177876.5,DR,REF216172,CBA,Savings
07-08-2025 16:37,CBAE9A4F8767BDA481FA656,063-000-001,22222222,SPOTIFY CBA,6.72,0,177869.78,DR,REF703778,CBA,Savings
07-08-2025 16:46,CBAE16B827FDC734375838A,063-000-001,22222222,STARBUCKS CBA,68.11,0,177801.67,DR,REF709179,CBA,Savings
07-08-2025 16:53,CBAD5D26FC2231448119CB6,063-000-001,22222222,SHELL CBA,50.44,0,177751.23,DR,REF370534,CBA,Savings
07-08-2025 17:15,CBAB466071CD1F6461B85FF,063-000-001,22222222,COMPANY PAYROLL CBA,0,5461.88,183213.11,CR,REF603358,CBA,Savings
07-08-2025 17:44,INTD8221E658EC84AFA829E,063-000-001,22222222,TRANSFER TO NAB 44444444,776.41,0,182436.7,DR,INT-23534,CBA,Savings
07-08-2025 17:58,CBA7412DA2A9A184D988597,063-000-001,22222222,BIGW CBA,115.07,0,182321.63,DR,REF433625,CBA,Savings
07-08-2025 18:07,CBADB0475B2A1DA411E8C27,063-000-001,22222222,BIGW CBA,7.73,0,182313.9,DR,REF538264,CBA,Savings
07-08-2025 18:13,CBA882C5C1E9888464B81BF,063-000-001,22222222,AMAZON AU CBA,70.43,0,182243.47,DR,REF332449,CBA,Savings
07-08-2025 18:17,INTC891F37DCC9E45F1B5BE,063-000-001,22222222,TRANSFER TO CBA 33333333,480.94,0,181762.53,DR,INT-14239,CBA,Savings
07-08-2025 18:51,CBA41B3E028F5B6493BA3CE,063-000-001,22222222,SHELL CBA,8.3,0,181754.23,DR,REF139501,CBA,Savings
07-08-2025 19:03,CBAD81F3D218BE947489310,063-000-001,22222222,HARVEY NORMAN CBA,4.42,0,181749.81,DR,REF498271,CBA,Savings
07-08-2025 19:14,CBA027B3BBAF9F245208E07,063-000-001,22222222,PAYMENT GATEWAY CBA,68.36,0,181681.45,DR,REF598878,CBA,Savings
07-08-2025 19:36,CBA8F6D6DBB0A774F5FB4E0,063-000-001,22222222,UBER EATS CBA,47.77,0,181633.68,DR,REF420626,CBA,Savings
07-08-2025 19:38,CBA3BBF6C6F29CF49FEB077,063-000-001,22222222,AMAZON AU CBA,5.06,0,181628.62,DR,REF237371,CBA,Savings
07-08-2025 19:38,CBA971DABCD0E6344938D42,063-000-001,22222222,WAGES CREDIT CBA,0,1684.66,183313.28,CR,REF318540,CBA,Savings
07-08-2025 20:14,CBA892799FBB4C7445B8E94,063-000-001,22222222,WOOLWORTHS CBA,41.06,0,183272.22,DR,REF106323,CBA,Savings
07-08-2025 20:17,CBAD948C9EFB30743BFBFCE,063-000-001,22222222,PAYMENT GATEWAY CBA,6.94,0,183265.28,DR,REF713800,CBA,Savings
07-08-2025 20:41,CBAA9DF6135E8F94715A0BB,063-000-001,22222222,BIGW CBA,12.07,0,183253.21,DR,REF389383,CBA,Savings
07-08-2025 21:37,INT117B399BFA7A4D4E86FF,063-000-001,22222222,TRANSFER FROM NAB 44444444,0,1689.4,184942.61,CR,INT-92793,CBA,Savings
07-08-2025 22:36,CBADB74A15C21A144E08054,063-000-001,22222222,DOMINO'S PIZZA CBA,21.31,0,184921.3,DR,REF347330,CBA,Savings
07-08-2025 22:36,CBAE8BEE0F1D2D442C6A8C6,063-000-001,22222222,ALDI CBA,87.27,0,184834.03,DR,REF298498,CBA,Savings
07-08-2025 22:37,CBABB3C1B8F89C3408EB8EA,063-000-001,22222222,KFC CBA,10.65,0,184823.38,DR,REF405722,CBA,Savings
07-08-2025 22:39,CBA87192C5D96AA4B20BA74,063-000-001,22222222,ZOOM CBA,46.53,0,184776.85,DR,REF474343,CBA,Savings
07-08-2025 22:52,CBA136C8124C7F94B23BB66,063-000-001,22222222,WAGES CREDIT CBA,0,2877.09,187653.94,CR,REF636731,CBA,Savings
07-08-2025 23:47,CBA873492AA3DD141F19E3F,063-000-001,22222222,PAY - SALARY CBA,0,2473.87,190127.81,CR,REF788277,CBA,Savings
08-08-2025 00:33,CBA38648324CB6F48808965,063-000-001,22222222,JB HI-FI CBA,37.13,0,190090.68,DR,REF602764,CBA,Savings
08-08-2025 00:42,CBAAD0C07726077499EB981,063-000-001,22222222,STARBUCKS CBA,12.4,0,190078.28,DR,REF586256,CBA,Savings
08-08-2025 00:58,CBA110BAF22CF6147B8AF4F,063-000-001,22222222,MENULOG CBA,30.78,0,190047.5,DR,REF236532,CBA,Savings
08-08-2025 01:04,INT99C76ABEBE2C4C9E8BB3,063-000-001,22222222,TRANSFER FROM NAB 44444444,0,1577.28,191624.78,CR,INT-93770,CBA,Savings
08-08-2025 01:09,CBAC507749E9A2746B78629,063-000-001,22222222,7-ELEVEN CBA,80.84,0,191543.94,DR,REF933514,CBA,Savings
08-08-2025 01:15,CBAD7956A6C047D4112887F,063-000-001,22222222,ZOOM CBA,42.61,0,191501.33,DR,REF744762,CBA,Savings
08-08-2025 01:24,CBA221CABD89AF043F8936E,063-000-001,22222222,DOMINO'S PIZZA CBA,31.95,0,191469.38,DR,REF143308,CBA,Savings
08-08-2025 02:15,CBAE5BDFFCF9A1042699AE3,063-000-001,22222222,ALDI CBA,67.1,0,191402.28,DR,REF462832,CBA,Savings
08-08-2025 02:28,CBAC404CA7113E94DCD82EB,063-000-001,22222222,HARVEY NORMAN CBA,11.11,0,191391.17,DR,REF702036,CBA,Savings
08-08-2025 02:31,CBA1711F95DAEAD4EA49FC3,063-000-001,22222222,TAFE BOOKSHOP CBA,86.36,0,191304.81,DR,REF479245,CBA,Savings
08-08-2025 03:00,CBAFA8E48E5F362458FA379,063-000-001,22222222,MCDONALDS CBA,86.03,0,191218.78,DR,REF700038,CBA,Savings
08-08-2025 03:22,CBAC24F57111CEA41ADBD10,063-000-001,22222222,STARBUCKS CBA,27.3,0,191191.48,DR,REF309631,CBA,Savings
08-08-2025 03:32,CBA191D44DAF2D04BB4A768,063-000-001,22222222,ZOOM CBA,51,0,191140.48,DR,REF699055,CBA,Savings
08-08-2025 04:57,CBAC8773102BEFD460B8759,063-000-001,22222222,INTERNET TRANSFER CBA,20.97,0,191119.51,DR,REF494955,CBA,Savings
08-08-2025 05:00,CBA2383272DB6824E668E40,063-000-001,22222222,CITYLINK CBA,15.03,0,191104.48,DR,REF451517,CBA,Savings
08-08-2025 05:13,CBABB7162DA2D5A480F85C5,063-000-001,22222222,CITYLINK CBA,1.91,0,191102.57,DR,REF401015,CBA,Savings
08-08-2025 05:25,CBA6F3642E757A742AEBBF3,063-000-001,22222222,LIQUORLAND CBA,12.34,0,191090.23,DR,REF643060,CBA,Savings
08-08-2025 06:25,CBA473AAE3B43CF44CA92C8,063-000-001,22222222,COMPANY PAYROLL CBA,0,686.16,191776.39,CR,REF586456,CBA,Savings
08-08-2025 06:56,INT7854791E211E425C856F,063-000-001,22222222,TRANSFER TO CBA 33333333,988.67,0,190787.72,DR,INT-26013,CBA,Savings
08-08-2025 07:09,CBA0928E4A2B1284FDEB795,063-000-001,22222222,BWS CBA,49.73,0,190737.99,DR,REF434147,CBA,Savings
08-08-2025 07:24,CBA0A63A8B6DA844A6BB6B4,063-000-001,22222222,LIQUORLAND CBA,71.52,0,190666.47,DR,REF432679,CBA,Savings
08-08-2025 07:42,CBA2BB1F9F374224F41B644,063-000-001,22222222,SALARY PAYMENT CBA,0,6840.72,197507.19,CR,REF253660,CBA,Savings
08-08-2025 08:54,CBA2CD7325D3B0348C8BC61,063-000-001,22222222,WOOLWORTHS CBA,15.36,0,197491.83,DR,REF137779,CBA,Savings
08-08-2025 09:14,INT61EA49A5C03B471F86F5,063-000-001,22222222,TRANSFER TO CBA 33333333,1736.28,0,195755.55,DR,INT-41250,CBA,Savings
08-08-2025 09:30,CBA1F349571CCFC462F93CD,063-000-001,22222222,LIQUORLAND CBA,5.17,0,195750.38,DR,REF441034,CBA,Savings
08-08-2025 09:51,CBAD56BE0A3120A4394BCA2,063-000-001,22222222,PAYPAL *NETFLIX CBA,9.75,0,195740.63,DR,REF410342,CBA,Savings
08-08-2025 09:55,CBAF4D31FAFA05D459A88B5,063-000-001,22222222,ZOOM CBA,30.07,0,195710.56,DR,REF500226,CBA,Savings
08-08-2025 10:03,CBAFD4E5B5E31C2465395F0,063-000-001,22222222,STARBUCKS CBA,50.42,0,195660.14,DR,REF800493,CBA,Savings
08-08-2025 10:14,CBAC55A357C63A64EA78364,063-000-001,22222222,PAYMENT GATEWAY CBA,120.34,0,195539.8,DR,REF696077,CBA,Savings
08-08-2025 10:26,CBAD2180111C94A4AB4AF69,063-000-001,22222222,COLES CBA,116.41,0,195423.39,DR,REF385893,CBA,Savings
08-08-2025 10:29,CBA1D6167268E4947278A0C,063-000-001,22222222,KFC CBA,36.49,0,195386.9,DR,REF738836,CBA,Savings
08-08-2025 11:30,CBA6B07B59866BA4222BF5F,063-000-001,22222222,7-ELEVEN CBA,15.47,0,195371.43,DR,REF820098,CBA,Savings
08-08-2025 11:31,CBAE9EF092D3E3447768FD3,063-000-001,22222222,ALDI CBA,3.26,0,195368.17,DR,REF292221,CBA,Savings
08-08-2025 11:43,CBADCC662A1724C4F8089A0,063-000-001,22222222,PAY - SALARY CBA,0,7529.69,202897.86,CR,REF455954,CBA,Savings
08-08-2025 11:44,CBABE523C6AFE244FF1B8EA,063-000-001,22222222,ZOOM CBA,149.24,0,202748.62,DR,REF778904,CBA,Savings
08-08-2025 12:33,CBAD959544B72AC40ABBC62,063-000-001,22222222,LIQUORLAND CBA,267.38,0,202481.24,DR,REF228082,CBA,Savings
08-08-2025 12:41,CBA3784AB366CDB42AB804A,063-000-001,22222222,COLES CBA,4.9,0,202476.34,DR,REF640405,CBA,Savings
08-08-2025 13:28,CBA77BAD976633647B1802A,063-000-001,22222222,PAYPAL *NETFLIX CBA,93.4,0,202382.94,DR,REF710833,CBA,Savings
08-08-2025 13:42,CBAC1318D5C710B4022B498,063-000-001,22222222,WOOLWORTHS CBA,76.76,0,202306.18,DR,REF703166,CBA,Savings
08-08-2025 13:47,CBA8D092D05AEA0434F98B0,063-000-001,22222222,FLIXBUS CBA,30.81,0,202275.37,DR,REF544621,CBA,Savings
08-08-2025 14:24,CBAA468ABC8D82F40CBA2A7,063-000-001,22222222,SALARY PAYMENT CBA,0,7556.12,209831.49,CR,REF971071,CBA,Savings
08-08-2025 14:44,CBA80DA3E4B656E42269BAB,063-000-001,22222222,WAGES CREDIT CBA,0,419.14,210250.63,CR,REF397414,CBA,Savings
08-08-2025 15:13,CBAAC891103FFBF498C8CCD,063-000-001,22222222,PAY - SALARY CBA,0,690.26,210940.89,CR,REF430232,CBA,Savings
08-08-2025 15:17,CBAC81CAB6DFC8F4A5F97A5,063-000-001,22222222,RAILWAY STATION CBA,347,0,210593.89,DR,REF189818,CBA,Savings
08-08-2025 15:19,INTA3FFB053FD9C496C86FB,063-000-001,22222222,TRANSFER TO CBA 33333333,1339.3,0,209254.59,DR,INT-51249,CBA,Savings
08-08-2025 15:25,CBA5DC2D2B7643C4581956E,063-000-001,22222222,MENULOG CBA,21.45,0,209233.14,DR,REF959615,CBA,Savings
08-08-2025 15:38,CBA668D46DCE1D44A78A6B8,063-000-001,22222222,LIQUORLAND CBA,71.08,0,209162.06,DR,REF883236,CBA,Savings
08-08-2025 15:57,CBA2A3A378545E042A7BE52,063-000-001,22222222,SALARY PAYMENT CBA,0,6212.9,215374.96,CR,REF361723,CBA,Savings
08-08-2025 15:58,CBAB5C00259708B44D6AC16,063-000-001,22222222,BWS CBA,53.78,0,215321.18,DR,REF317872,CBA,Savings
08-08-2025 16:17,INTE5CB74EF74D746B8A1DE,063-000-001,22222222,TRANSFER FROM CBA 33333333,0,866.64,216187.82,CR,INT-84190,CBA,Savings
08-08-2025 16:46,CBA47EC6F02B0614328A534,063-000-001,22222222,7-ELEVEN CBA,15.98,0,216171.84,DR,REF836136,CBA,Savings
08-08-2025 17:10,INT2564BB42CEA24B958486,063-000-001,22222222,TRANSFER FROM NAB 44444444,0,301.17,216473.01,CR,INT-61792,CBA,Savings
08-08-2025 17:16,CBA95E222AE1D1C4E27A63F,063-000-001,22222222,RAILWAY STATION CBA,6.67,0,216466.34,DR,REF280098,CBA,Savings
08-08-2025 17:21,CBAAA1C512332734886A1C9,063-000-001,22222222,BWS CBA,14.48,0,216451.86,DR,REF666150,CBA,Savings
08-08-2025 17:36,CBA0584D12BC38042D7932E,063-000-001,22222222,ZOOM CBA,147.72,0,216304.14,DR,REF914721,CBA,Savings
08-08-2025 17:39,CBAB4537DFE014A4E178A54,063-000-001,22222222,BANK FEE CBA,1.45,0,216302.69,DR,REF678563,CBA,Savings
08-08-2025 18:02,CBAFBC30DD165B947C2A91F,063-000-001,22222222,JB HI-FI CBA,83.91,0,216218.78,DR,REF992204,CBA,Savings
08-08-2025 18:15,CBAEE6881A1A8F4445BACCD,063-000-001,22222222,STARBUCKS CBA,94.05,0,216124.73,DR,REF134685,CBA,Savings
08-08-2025 18:23,CBA578934B6EF0D425E8976,063-000-001,22222222,WOOLWORTHS CBA,56.66,0,216068.07,DR,REF941920,CBA,Savings
08-08-2025 18:47,CBAE5A2B633FE6041E8A2C0,063-000-001,22222222,SPOTIFY CBA,85.37,0,215982.7,DR,REF923596,CBA,Savings
08-08-2025 19:47,CBA6B4E9DBA24924D438E5B,063-000-001,22222222,DOMINO'S PIZZA CBA,64.73,0,215917.97,DR,REF538370,CBA,Savings
08-08-2025 19:50,CBAFD5DE4F07B2648B5A816,063-000-001,22222222,KFC CBA,10.97,0,215907,DR,REF670557,CBA,Savings
08-08-2025 19:53,CBA8DA3CBC9F87645B79167,063-000-001,22222222,UBER EATS CBA,218.79,0,215688.21,DR,REF711485,CBA,Savings
08-08-2025 21:15,CBAB888994C570C4454A0BC,063-000-001,22222222,SPOTIFY CBA,42.53,0,215645.68,DR,REF384955,CBA,Savings
08-08-2025 21:45,CBA50915CE66B854D99B243,063-000-001,22222222,SHELL CBA,5.19,0,215640.49,DR,REF936686,CBA,Savings
08-08-2025 22:05,CBA1E83B200B5574BF98D8C,063-000-001,22222222,BANK FEE CBA,243.82,0,215396.67,DR,REF902614,CBA,Savings
08-08-2025 22:18,CBA7122932C938344A18ABB,063-000-001,22222222,SALARY PAYMENT CBA,0,590.46,215987.13,CR,REF227112,CBA,Savings
08-08-2025 22:38,CBA46CD331FC72E4C3D86C1,063-000-001,22222222,APPLE CBA,149.46,0,215837.67,DR,REF802613,CBA,Savings
08-08-2025 23:44,CBA16CECC8F0AA5456580F4,063-000-001,22222222,ZOOM CBA,15.99,0,215821.68,DR,REF839386,CBA,Savings
09-08-2025 00:37,CBAF6044469E87644FDA4CF,063-000-001,22222222,LIQUORLAND CBA,309.29,0,215512.39,DR,REF467307,CBA,Savings
09-08-2025 00:44,CBAA08581931AD54DE69B06,063-000-001,22222222,BP CBA,52.36,0,215460.03,DR,REF340066,CBA,Savings
09-08-2025 00:45,CBAE332942366CD47399333,063-000-001,22222222,BWS CBA,38.75,0,215421.28,DR,REF137852,CBA,Savings
09-08-2025 01:06,CBAE9FCE6895F7A46BE96C4,063-000-001,22222222,PAYMENT GATEWAY CBA,83.3,0,215337.98,DR,REF652877,CBA,Savings
09-08-2025 01:36,CBAD1337841040A4ECEAF1A,063-000-001,22222222,SALARY PAYMENT CBA,0,533.84,215871.82,CR,REF695221,CBA,Savings
09-08-2025 02:28,CBA1084A5180600478BB930,063-000-001,22222222,JB HI-FI CBA,45.87,0,215825.95,DR,REF773105,CBA,Savings
09-08-2025 02:30,CBAF4321362923D41CAA89D,063-000-001,22222222,ALDI CBA,57.15,0,215768.8,DR,REF179765,CBA,Savings
09-08-2025 03:06,CBA7821B42F191B43DB9B7A,063-000-001,22222222,SALARY PAYMENT CBA,0,5632.27,221401.07,CR,REF554930,CBA,Savings
09-08-2025 03:06,CBAAD6CBCB5162E42ED92FD,063-000-001,22222222,APPLE CBA,6.45,0,221394.62,DR,REF381822,CBA,Savings
09-08-2025 03:59,CBA3E057DB5B3B741269C15,063-000-001,22222222,UBER EATS CBA,24.19,0,221370.43,DR,REF586850,CBA,Savings
09-08-2025 04:13,CBAB80077B3C0E745E3A79E,063-000-001,22222222,CITYLINK CBA,59.48,0,221310.95,DR,REF382917,CBA,Savings
09-08-2025 04:15,CBA9146657A7280469D9590,063-000-001,22222222,WOOLWORTHS CBA,7.95,0,221303,DR,REF963550,CBA,Savings
09-08-2025 04:15,CBAE16B63CB33E4463FB122,063-000-001,22222222,COLES CBA,146.69,0,221156.31,DR,REF821320,CBA,Savings
09-08-2025 04:20,CBA40CF9E7356A74B5585C7,063-000-001,22222222,PAYPAL *NETFLIX CBA,47.95,0,221108.36,DR,REF754118,CBA,Savings
09-08-2025 04:27,CBA5BF2B72910904E679B0C,063-000-001,22222222,LIQUORLAND CBA,149.04,0,220959.32,DR,REF370272,CBA,Savings
09-08-2025 04:27,CBA4D5DEEF4A5C547DA98FE,063-000-001,22222222,PAYPAL *NETFLIX CBA,10.86,0,220948.46,DR,REF676414,CBA,Savings
09-08-2025 04:29,CBA51F5C961E2014E9CBF5B,063-000-001,22222222,BWS CBA,114.78,0,220833.68,DR,REF397488,CBA,Savings
09-08-2025 04:50,CBA50D843A7B5304BED950A,063-000-001,22222222,RAILWAY STATION CBA,16.03,0,220817.65,DR,REF144062,CBA,Savings
09-08-2025 04:54,CBA04CFFFB739D44763B7C3,063-000-001,22222222,BP CBA,68.75,0,220748.9,DR,REF944774,CBA,Savings
09-08-2025 05:33,CBAA410A64427834A26B37B,063-000-001,22222222,7-ELEVEN CBA,64.49,0,220684.41,DR,REF100941,CBA,Savings
09-08-2025 06:05,INTE144D21460224D608190,063-000-001,22222222,TRANSFER TO ANZ 11111111,912.15,0,219772.26,DR,INT-56045,CBA,Savings
09-08-2025 06:14,CBAED76526CAEC64C76991A,063-000-001,22222222,JB HI-FI CBA,40.74,0,219731.52,DR,REF688427,CBA,Savings
09-08-2025 06:35,CBAF6A5EAE6CD6A48C681B3,063-000-001,22222222,INTERNET TRANSFER CBA,16.42,0,219715.1,DR,REF699588,CBA,Savings
09-08-2025 07:05,CBA0DD9FBD986D843F98961,063-000-001,22222222,PAYROLL CREDIT CBA,0,3315.45,223030.55,CR,REF285045,CBA,Savings
09-08-2025 07:43,INTB16C6BCC86AD4E8FA005,063-000-001,22222222,TRANSFER FROM NAB 44444444,0,1545.24,224575.79,CR,INT-84857,CBA,Savings
09-08-2025 08:54,CBA1C5666FF1BE94A8EBD3F,063-000-001,22222222,APPLE CBA,40.66,0,224535.13,DR,REF834893,CBA,Savings
09-08-2025 08:55,CBAD9F257DF3E294E0BAD6E,063-000-001,22222222,MENULOG CBA,26.66,0,224508.47,DR,REF792193,CBA,Savings
09-08-2025 08:58,CBAE34DB0A5C65B461E8227,063-000-001,22222222,BWS CBA,11.6,0,224496.87,DR,REF887592,CBA,Savings
09-08-2025 09:05,CBADAB6BDDAAB424A0DA88C,063-000-001,22222222,SPOTIFY CBA,22.46,0,224474.41,DR,REF924059,CBA,Savings
09-08-2025 09:11,CBADF084318871040188D2D,063-000-001,22222222,LIQUORLAND CBA,16.9,0,224457.51,DR,REF281547,CBA,Savings
09-08-2025 09:13,CBA62AA267731FC4B9CB870,063-000-001,22222222,CITYLINK CBA,70.98,0,224386.53,DR,REF632933,CBA,Savings
09-08-2025 09:18,CBA2708392F6B7146BB82D7,063-000-001,22222222,COMPANY PAYROLL CBA,0,2938.92,227325.45,CR,REF342070,CBA,Savings
09-08-2025 09:48,CBA88F64912721C49C29371,063-000-001,22222222,CITYLINK CBA,11.09,0,227314.36,DR,REF562559,CBA,Savings
09-08-2025 09:54,CBA63044FA8ED15447C90B5,063-000-001,22222222,7-ELEVEN CBA,19.78,0,227294.58,DR,REF868461,CBA,Savings
09-08-2025 10:12,CBAB8302F6E909344EB8A01,063-000-001,22222222,ZOOM CBA,4.63,0,227289.95,DR,REF938933,CBA,Savings
09-08-2025 11:04,CBA9E09030AA4344929BE93,063-000-001,22222222,KFC CBA,43.74,0,227246.21,DR,REF460433,CBA,Savings
09-08-2025 11:10,CBADB1CA6DE5E5742D290F0,063-000-001,22222222,BANK FEE CBA,25.75,0,227220.46,DR,REF352128,CBA,Savings
09-08-2025 11:12,CBA7717F80E574045B683BF,063-000-001,22222222,AMAZON AU CBA,16.74,0,227203.72,DR,REF537296,CBA,Savings
09-08-2025 11:17,CBAB03381397E9B4AADBC4A,063-000-001,22222222,APPLE CBA,4.79,0,227198.93,DR,REF687217,CBA,Savings
09-08-2025 11:18,CBA2169FF6561934D26BD1E,063-000-001,22222222,FLIXBUS CBA,22.64,0,227176.29,DR,REF185612,CBA,Savings
09-08-2025 11:49,CBAD6B1FDCD6C0A4A908E17,063-000-001,22222222,MENULOG CBA,50.45,0,227125.84,DR,REF919906,CBA,Savings
09-08-2025 11:56,CBAE98DBAFD2B9D4D0BA502,063-000-001,22222222,CITYLINK CBA,13.91,0,227111.93,DR,REF570819,CBA,Savings
09-08-2025 12:46,CBA4FB016C0A3BA45D89E06,063-000-001,22222222,UBER EATS CBA,11.59,0,227100.34,DR,REF934470,CBA,Savings
09-08-2025 13:14,CBAFA34AB847C2841B29C0F,063-000-001,22222222,DOMINO'S PIZZA CBA,6.99,0,227093.35,DR,REF413793,CBA,Savings
09-08-2025 14:11,INTFBDEDB94AACF4C4995CF,063-000-001,22222222,TRANSFER TO NAB 44444444,909.78,0,226183.57,DR,INT-52062,CBA,Savings
09-08-2025 14:18,CBA44502ED7541F4A55856E,063-000-001,22222222,PAYMENT GATEWAY CBA,11.52,0,226172.05,DR,REF263484,CBA,Savings
09-08-2025 14:34,CBA0A3631E0D0A04F08AECA,063-000-001,22222222,BWS CBA,20.73,0,226151.32,DR,REF837173,CBA,Savings
09-08-2025 15:01,CBA7C9F973BF6724EE9B0BD,063-000-001,22222222,7-ELEVEN CBA,30.58,0,226120.74,DR,REF982151,CBA,Savings
09-08-2025 15:07,CBA0EA04409F76546E49A32,063-000-001,22222222,TAFE BOOKSHOP CBA,92.05,0,226028.69,DR,REF772411,CBA,Savings
09-08-2025 15:16,CBA224C161E84504FF2BD0D,063-000-001,22222222,PAYPAL *NETFLIX CBA,33.54,0,225995.15,DR,REF470661,CBA,Savings
09-08-2025 15:18,CBA7037A7545746443B91FD,063-000-001,22222222,APPLE CBA,64.95,0,225930.2,DR,REF468927,CBA,Savings
09-08-2025 15:27,CBAAB5A99F2949C46C08A22,063-000-001,22222222,APPLE CBA,33.97,0,225896.23,DR,REF811749,CBA,Savings
09-08-2025 15:29,CBA88190D5E37B9480DB76C,063-000-001,22222222,STARBUCKS CBA,5.94,0,225890.29,DR,REF900181,CBA,Savings
09-08-2025 16:08,CBAA2857C033E6944759F3C,063-000-001,22222222,COMPANY PAYROLL CBA,0,3635.76,229526.05,CR,REF101427,CBA,Savings
09-08-2025 16:22,CBA2E2ABDDAC8FA4E5B8301,063-000-001,22222222,SALARY PAYMENT CBA,0,405.15,229931.2,CR,REF173457,CBA,Savings
09-08-2025 16:23,CBAC82483F4745F48BA865C,063-000-001,22222222,APPLE CBA,42.29,0,229888.91,DR,REF765547,CBA,Savings
09-08-2025 16:24,CBA37E2F8E385A940AF8033,063-000-001,22222222,MENULOG CBA,29.09,0,229859.82,DR,REF470425,CBA,Savings
09-08-2025 16:56,CBA9798B48DF9754581894A,063-000-001,22222222,BP CBA,27.52,0,229832.3,DR,REF807048,CBA,Savings
09-08-2025 17:00,CBA35CC67B000F84512B4F3,063-000-001,22222222,PAYMENT GATEWAY CBA,40.84,0,229791.46,DR,REF429775,CBA,Savings
09-08-2025 17:01,CBAC941951C7A014B139E6E,063-000-001,22222222,UBER EATS CBA,130.73,0,229660.73,DR,REF401045,CBA,Savings
09-08-2025 17:11,CBAABE1F223129643308E72,063-000-001,22222222,CITYLINK CBA,36.45,0,229624.28,DR,REF386488,CBA,Savings
09-08-2025 17:13,CBAAAE10E20926649619ADF,063-000-001,22222222,FLIXBUS CBA,70.31,0,229553.97,DR,REF810877,CBA,Savings
09-08-2025 17:45,CBA0461DA2E99E649908E75,063-000-001,22222222,PAY - SALARY CBA,0,3226.23,232780.2,CR,REF621550,CBA,Savings
09-08-2025 17:47,CBA2205A2ED587640BB8D6B,063-000-001,22222222,HARVEY NORMAN CBA,31.97,0,232748.23,DR,REF811819,CBA,Savings
09-08-2025 18:30,CBA57A0DE26D9C54DE0A570,063-000-001,22222222,SPOTIFY CBA,107.48,0,232640.75,DR,REF690633,CBA,Savings
09-08-2025 18:43,CBADCD736F71D3B4082B09E,063-000-001,22222222,CITYLINK CBA,13.86,0,232626.89,DR,REF279027,CBA,Savings
09-08-2025 18:47,CBAE639A8214D784803AED5,063-000-001,22222222,KFC CBA,10.75,0,232616.14,DR,REF416088,CBA,Savings
09-08-2025 19:26,CBA8F90A216C7474E5BBFC2,063-000-001,22222222,PAYPAL *NETFLIX CBA,47.99,0,232568.15,DR,REF687022,CBA,Savings
09-08-2025 19:31,CBA384DA14ECA3048D29552,063-000-001,22222222,DOMINO'S PIZZA CBA,252.56,0,232315.59,DR,REF983997,CBA,Savings
09-08-2025 19:47,CBA1BE107DE453C401AB283,063-000-001,22222222,PAYPAL *NETFLIX CBA,8.35,0,232307.24,DR,REF789338,CBA,Savings
09-08-2025 19:55,CBAAF11E89B96B441F7B6D1,063-000-001,22222222,BP CBA,41.33,0,232265.91,DR,REF972722,CBA,Savings
09-08-2025 20:12,CBAE952D0BD34D84BDDAFA6,063-000-001,22222222,SHELL CBA,89.59,0,232176.32,DR,REF394747,CBA,Savings
09-08-2025 20:58,CBAF7DCEDE26E874010B5A0,063-000-001,22222222,WOOLWORTHS CBA,9.41,0,232166.91,DR,REF568423,CBA,Savings
09-08-2025 20:59,INTDBA3A20308E848DFB230,063-000-001,22222222,TRANSFER FROM CBA 33333333,0,276.27,232443.18,CR,INT-31679,CBA,Savings
09-08-2025 21:11,CBA16B6E4072E7B4647A337,063-000-001,22222222,DOMINO'S PIZZA CBA,86.96,0,232356.22,DR,REF544206,CBA,Savings
09-08-2025 21:32,CBA4994AB5D3CCD4F9E9FDD,063-000-001,22222222,PAYROLL CREDIT CBA,0,3557.32,235913.54,CR,REF263753,CBA,Savings
09-08-2025 21:33,INT7B9EACDEAD5A468B90A9,063-000-001,22222222,TRANSFER TO NAB 44444444,1245.56,0,234667.98,DR,INT-35510,CBA,Savings
09-08-2025 21:37,CBA8BC9AC7C495540BFBAAC,063-000-001,22222222,DOMINO'S PIZZA CBA,65.11,0,234602.87,DR,REF788473,CBA,Savings
09-08-2025 21:49,CBA12F15A23D7684EABB5CE,063-000-001,22222222,ZOOM CBA,50.54,0,234552.33,DR,REF567987,CBA,Savings
09-08-2025 22:19,CBAA77F870AA07242EC8E66,063-000-001,22222222,HARVEY NORMAN CBA,33.13,0,234519.2,DR,REF452637,CBA,Savings
09-08-2025 22:49,CBAA7CB8509C86944F09BC3,063-000-001,22222222,PAYROLL CREDIT CBA,0,531.45,235050.65,CR,REF608544,CBA,Savings
09-08-2025 23:04,CBABA6B6455BB724951A1DB,063-000-001,22222222,BP CBA,24.32,0,235026.33,DR,REF431054,CBA,Savings
09-08-2025 23:23,CBA19C3BA38EFEC4385BBD3,063-000-001,22222222,INTERNET TRANSFER CBA,18.73,0,235007.6,DR,REF233966,CBA,Savings
09-08-2025 23:26,CBABB54E57C3FA94090847A,063-000-001,22222222,ALDI CBA,55.34,0,234952.26,DR,REF439652,CBA,Savings
09-08-2025 23:35,CBA5809AF3C99D14D9488FF,063-000-001,22222222,JB HI-FI CBA,13.51,0,234938.75,DR,REF134951,CBA,Savings
10-08-2025 00:59,CBA42108F803A8449A9A989,063-000-001,22222222,SPOTIFY CBA,6.97,0,234931.78,DR,REF478993,CBA,Savings
10-08-2025 01:19,CBAB38B15DCA5AF4359BB93,063-000-001,22222222,CITYLINK CBA,13.06,0,234918.72,DR,REF770068,CBA,Savings
10-08-2025 01:40,CBAB391C5C9F0504B769338,063-000-001,22222222,PAY - SALARY CBA,0,2779.08,237697.8,CR,REF243241,CBA,Savings
10-08-2025 02:06,CBA61655135DA554678B335,063-000-001,22222222,RAILWAY STATION CBA,28.86,0,237668.94,DR,REF791148,CBA,Savings
10-08-2025 02:08,CBAB33E114D3EB44D7B9C95,063-000-001,22222222,BANK FEE CBA,127.72,0,237541.22,DR,REF341520,CBA,Savings
10-08-2025 02:31,CBA90584E92F4104D78AE4E,063-000-001,22222222,ZOOM CBA,53.3,0,237487.92,DR,REF631251,CBA,Savings
10-08-2025 02:57,CBA470066BD5904403EB37D,063-000-001,22222222,WOOLWORTHS CBA,10.03,0,237477.89,DR,REF618841,CBA,Savings
10-08-2025 03:01,CBAAAFB79FA2AF440BF96B0,063-000-001,22222222,WOOLWORTHS CBA,20.55,0,237457.34,DR,REF359611,CBA,Savings
10-08-2025 03:03,CBA9FED39027A3247A8B393,063-000-001,22222222,TAFE BOOKSHOP CBA,75.03,0,237382.31,DR,REF567488,CBA,Savings
10-08-2025 03:06,CBA4BAE5C69A7F4458E861D,063-000-001,22222222,COMPANY PAYROLL CBA,0,7940.88,245323.19,CR,REF848240,CBA,Savings
10-08-2025 04:11,CBACC9D54F5DF784E66A58F,063-000-001,22222222,7-ELEVEN CBA,25.84,0,245297.35,DR,REF324984,CBA,Savings
10-08-2025 04:22,CBA73911A47826440DBACE0,063-000-001,22222222,INTERNET TRANSFER CBA,7.07,0,245290.28,DR,REF188393,CBA,Savings
10-08-2025 04:30,CBAF6060C1EC6994B09926F,063-000-001,22222222,SHELL CBA,22.2,0,245268.08,DR,REF117394,CBA,Savings
10-08-2025 04:37,CBA7ADAB3A943DC4C12AEE7,063-000-001,22222222,PAYMENT GATEWAY CBA,33.31,0,245234.77,DR,REF449965,CBA,Savings
10-08-2025 04:38,CBA242152E335F14C24BD1C,063-000-001,22222222,JB HI-FI CBA,45.44,0,245189.33,DR,REF306210,CBA,Savings
10-08-2025 05:41,CBA956F2183CFBB48D9A838,063-000-001,22222222,KFC CBA,7.85,0,245181.48,DR,REF643025,CBA,Savings
10-08-2025 05:42,CBA068A8F2FEF75499DBAFD,063-000-001,22222222,ALDI CBA,56.07,0,245125.41,DR,REF137405,CBA,Savings
10-08-2025 05:44,CBA2F16047026284FF8A427,063-000-001,22222222,LIQUORLAND CBA,39.65,0,245085.76,DR,REF883637,CBA,Savings
10-08-2025 05:44,CBA3947F52011D448D996D0,063-000-001,22222222,SALARY PAYMENT CBA,0,2772.23,247857.99,CR,REF639138,CBA,Savings
10-08-2025 05:58,CBA12A7753B2677486FB18C,063-000-001,22222222,SPOTIFY CBA,3.92,0,247854.07,DR,REF201481,CBA,Savings
10-08-2025 06:22,CBAB78A4AAFD97346658CB2,063-000-001,22222222,PAYMENT GATEWAY CBA,9.62,0,247844.45,DR,REF739273,CBA,Savings
10-08-2025 08:06,CBA480F311095044A98B8FE,063-000-001,22222222,SHELL CBA,11.15,0,247833.3,DR,REF247810,CBA,Savings
10-08-2025 08:07,CBAD205C984C0174E4C922A,063-000-001,22222222,BANK FEE CBA,67.81,0,247765.49,DR,REF878178,CBA,Savings
10-08-2025 08:39,CBA05B1A685FF9D4726A908,063-000-001,22222222,STARBUCKS CBA,55.84,0,247709.65,DR,REF559197,CBA,Savings
10-08-2025 08:43,CBAE1D9BB47B34F48ACB606,063-000-001,22222222,COLES CBA,145.44,0,247564.21,DR,REF759507,CBA,Savings
10-08-2025 08:45,CBA9C50E3B83D004BD698D7,063-000-001,22222222,RAILWAY STATION CBA,71.22,0,247492.99,DR,REF318687,CBA,Savings
10-08-2025 09:15,CBAE172B1B137F544B0A1D5,063-000-001,22222222,FLIXBUS CBA,90.76,0,247402.23,DR,REF927860,CBA,Savings
10-08-2025 09:17,INTE5643DA767FF4E6DB6B0,063-000-001,22222222,TRANSFER FROM NAB 44444444,0,832.17,248234.4,CR,INT-43757,CBA,Savings
10-08-2025 10:07,CBA0CD76F5C093C4E0FA4C4,063-000-001,22222222,COLES CBA,40.9,0,248193.5,DR,REF802305,CBA,Savings
10-08-2025 10:28,CBA0AD84BD536C64AAAAAEA,063-000-001,22222222,AMAZON AU CBA,9.62,0,248183.88,DR,REF890323,CBA,Savings
10-08-2025 10:35,CBAA9A2B76325144F609637,063-000-001,22222222,HARVEY NORMAN CBA,39.53,0,248144.35,DR,REF411634,CBA,Savings
10-08-2025 10:53,CBAC975F46E723B4BE0AD95,063-000-001,22222222,CITYLINK CBA,17.51,0,248126.84,DR,REF293222,CBA,Savings
10-08-2025 11:18,CBAC47EE85B4E1246C69CD8,063-000-001,22222222,HARVEY NORMAN CBA,195.14,0,247931.7,DR,REF365056,CBA,Savings
10-08-2025 12:18,CBAB46B09C5DA7B40DCA8DD,063-000-001,22222222,AMAZON AU CBA,7.91,0,247923.79,DR,REF888216,CBA,Savings
10-08-2025 12:59,CBA1100492FE6D941E4866C,063-000-001,22222222,STARBUCKS CBA,10.31,0,247913.48,DR,REF560679,CBA,Savings
10-08-2025 13:01,CBA091AD0357F8647BEB392,063-000-001,22222222,STARBUCKS CBA,19.07,0,247894.41,DR,REF830848,CBA,Savings
10-08-2025 13:33,CBAC71D4214F925469DB7FD,063-000-001,22222222,HARVEY NORMAN CBA,33.54,0,247860.87,DR,REF256747,CBA,Savings
10-08-2025 14:38,CBAF01BAF1DD6C84FD99AB7,063-000-001,22222222,BP CBA,147.39,0,247713.48,DR,REF345293,CBA,Savings
10-08-2025 15:03,CBA91FB9A724C4841F38058,063-000-001,22222222,APPLE CBA,41.43,0,247672.05,DR,REF645544,CBA,Savings
10-08-2025 15:11,CBA7ECD97FFB2EF440880DD,063-000-001,22222222,TAFE BOOKSHOP CBA,15.57,0,247656.48,DR,REF536479,CBA,Savings
10-08-2025 15:19,CBAFCB3FD865220408EA82B,063-000-001,22222222,SALARY PAYMENT CBA,0,4690.21,252346.69,CR,REF800864,CBA,Savings
10-08-2025 16:18,CBA369E0C4E0A404EECA5E1,063-000-001,22222222,UBER EATS CBA,29.89,0,252316.8,DR,REF712048,CBA,Savings
10-08-2025 16:33,CBA5CDCAD024B52479E90B3,063-000-001,22222222,SPOTIFY CBA,33.84,0,252282.96,DR,REF421503,CBA,Savings
10-08-2025 17:08,CBAF3139CA71A4E42CDA3E5,063-000-001,22222222,ALDI CBA,26.1,0,252256.86,DR,REF969831,CBA,Savings
10-08-2025 17:14,CBA6B251BADEDA94C8A9FEC,063-000-001,22222222,PAYPAL *NETFLIX CBA,34.95,0,252221.91,DR,REF868766,CBA,Savings
10-08-2025 17:16,CBA6DDE43EAB5F248EFAE25,063-000-001,22222222,AMAZON AU CBA,230.12,0,251991.79,DR,REF859266,CBA,Savings
10-08-2025 18:01,CBA1095CD8650CD4E7FA076,063-000-001,22222222,JB HI-FI CBA,127.61,0,251864.18,DR,REF188331,CBA,Savings
10-08-2025 18:28,CBA6D8E02E4816D4981AF2E,063-000-001,22222222,PAYROLL CREDIT CBA,0,983.01,252847.19,CR,REF576143,CBA,Savings
10-08-2025 18:35,CBA793D86C463F7416D9408,063-000-001,22222222,LIQUORLAND CBA,28.27,0,252818.92,DR,REF950596,CBA,Savings
10-08-2025 19:56,CBA8483801A16CA42D29387,063-000-001,22222222,WAGES CREDIT CBA,0,3924.6,256743.52,CR,REF136686,CBA,Savings
10-08-2025 21:06,CBAA9A02A42A6BA4DE3B6B4,063-000-001,22222222,MCDONALDS CBA,29.72,0,256713.8,DR,REF746334,CBA,Savings
10-08-2025 21:09,CBAA03649C86CAE4A6EBD06,063-000-001,22222222,ALDI CBA,51.95,0,256661.85,DR,REF299338,CBA,Savings
10-08-2025 21:24,CBA6F0A1C7A7774400FAA09,063-000-001,22222222,PAYMENT GATEWAY CBA,129.96,0,256531.89,DR,REF468829,CBA,Savings
10-08-2025 21:27,CBA055C6921ACE5410AAAA0,063-000-001,22222222,MCDONALDS CBA,7.57,0,256524.32,DR,REF933610,CBA,Savings
10-08-2025 21:53,CBAA3BC12D24E774115B0B1,063-000-001,22222222,RAILWAY STATION CBA,12.3,0,256512.02,DR,REF208307,CBA,Savings
10-08-2025 21:54,CBA51727B62670E4632BC7D,063-000-001,22222222,PAYROLL CREDIT CBA,0,5692.66,262204.68,CR,REF516733,CBA,Savings
10-08-2025 22:12,CBA891F8B2123C848EABDF8,063-000-001,22222222,SPOTIFY CBA,14.24,0,262190.44,DR,REF855186,CBA,Savings
10-08-2025 22:18,CBAC0AE3BE9014B4E12B078,063-000-001,22222222,SHELL CBA,25.61,0,262164.83,DR,REF754347,CBA,Savings
10-08-2025 23:03,CBAD6721E8E06FA410BAE0A,063-000-001,22222222,WAGES CREDIT CBA,0,459.25,262624.08,CR,REF485087,CBA,Savings
10-08-2025 23:10,CBA3470567FF461452AB80D,063-000-001,22222222,FLIXBUS CBA,3.11,0,262620.97,DR,REF791802,CBA,Savings
10-08-2025 23:23,CBAD5BA64FCB6284AA78668,063-000-001,22222222,BWS CBA,86.07,0,262534.9,DR,REF936886,CBA,Savings
10-08-2025 23:24,CBA25DCD3F5C68C4907ACAC,063-000-001,22222222,AMAZON AU CBA,62.01,0,262472.89,DR,REF677129,CBA,Savings
10-08-2025 23:29,CBA5E97FDF7C8BD41EDA78A,063-000-001,22222222,UBER EATS CBA,64.78,0,262408.11,DR,REF274362,CBA,Savings
10-08-2025 23:31,CBAD0DA23EED70E418E9846,063-000-001,22222222,PAYMENT GATEWAY CBA,11.24,0,262396.87,DR,REF103073,CBA,Savings
10-08-2025 23:44,CBA1406FFD55CE242B08793,063-000-001,22222222,STARBUCKS CBA,51.1,0,262345.77,DR,REF770370,CBA,Savings
11-08-2025 00:32,CBA5F563F9A8489481681C7,063-000-001,22222222,ALDI CBA,109.94,0,262235.83,DR,REF601171,CBA,Savings
11-08-2025 00:53,CBA02C2FED32A2E4BC3BBCF,063-000-001,22222222,ALDI CBA,11.51,0,262224.32,DR,REF966206,CBA,Savings
11-08-2025 01:04,INT4434D9141E0F428F9FFD,063-000-001,22222222,TRANSFER TO CBA 33333333,615.68,0,261608.64,DR,INT-36991,CBA,Savings
11-08-2025 01:08,CBA335DC413E67543F1BA31,063-000-001,22222222,KFC CBA,8.52,0,261600.12,DR,REF331281,CBA,Savings
11-08-2025 01:09,CBAF6FFEE87D53E40FBB03A,063-000-001,22222222,WAGES CREDIT CBA,0,7333.82,268933.94,CR,REF733410,CBA,Savings
11-08-2025 01:34,CBA845DD0F3CBEB478CBE76,063-000-001,22222222,LIQUORLAND CBA,153.85,0,268780.09,DR,REF984168,CBA,Savings
11-08-2025 01:57,CBAD4D2F99230D1429DBE8B,063-000-001,22222222,7-ELEVEN CBA,88.03,0,268692.06,DR,REF811777,CBA,Savings
11-08-2025 02:05,CBA24D7B6DA52AF42F0B711,063-000-001,22222222,APPLE CBA,56.25,0,268635.81,DR,REF690196,CBA,Savings
11-08-2025 02:13,CBA408053EA319E447F8BD0,063-000-001,22222222,PAYROLL CREDIT CBA,0,401.41,269037.22,CR,REF477791,CBA,Savings
11-08-2025 03:04,CBA09373D7BB04541DD942B,063-000-001,22222222,TAFE BOOKSHOP CBA,38.85,0,268998.37,DR,REF822915,CBA,Savings
11-08-2025 03:21,CBA9A31C58990A24FBCAC0F,063-000-001,22222222,SPOTIFY CBA,119.66,0,268878.71,DR,REF210365,CBA,Savings
11-08-2025 03:38,CBAEFF6DF743EB9411DA7C3,063-000-001,22222222,SPOTIFY CBA,24.94,0,268853.77,DR,REF860662,CBA,Savings
11-08-2025 03:38,CBAF3451A04FE784F9695BF,063-000-001,22222222,ZOOM CBA,8.6,0,268845.17,DR,REF948111,CBA,Savings
11-08-2025 04:04,CBA382A654CBF8F4C5BAE78,063-000-001,22222222,ALDI CBA,55.01,0,268790.16,DR,REF587975,CBA,Savings
11-08-2025 04:04,CBA8C633BEF2F9D453CAF0F,063-000-001,22222222,KFC CBA,22.89,0,268767.27,DR,REF183857,CBA,Savings
11-08-2025 04:17,CBA95DF7FD263894EAA8011,063-000-001,22222222,LIQUORLAND CBA,96.96,0,268670.31,DR,REF198912,CBA,Savings
11-08-2025 04:54,CBAE69FDB09A4344086A0DC,063-000-001,22222222,BANK FEE CBA,60.83,0,268609.48,DR,REF785415,CBA,Savings
11-08-2025 04:54,CBAAAAD95C794B240379FC3,063-000-001,22222222,MCDONALDS CBA,36.3,0,268573.18,DR,REF126073,CBA,Savings
11-08-2025 05:02,CBA873CD9B8EE104D8FAF98,063-000-001,22222222,AMAZON AU CBA,32.71,0,268540.47,DR,REF754919,CBA,Savings
11-08-2025 05:28,CBA05E85DEA158A4E6A8097,063-000-001,22222222,JB HI-FI CBA,104.06,0,268436.41,DR,REF261300,CBA,Savings
11-08-2025 05:49,CBA19F4F182C3A54D5A9693,063-000-001,22222222,PAY - SALARY CBA,0,2433.88,270870.29,CR,REF377907,CBA,Savings
11-08-2025 06:14,CBA8D015A88A1444453A4CF,063-000-001,22222222,JB HI-FI CBA,84.69,0,270785.6,DR,REF407604,CBA,Savings
11-08-2025 06:37,CBACD7F628EF2594A4EA46E,063-000-001,22222222,LIQUORLAND CBA,11.41,0,270774.19,DR,REF691396,CBA,Savings
11-08-2025 06:38,CBA335B85D0FE4548CFAA12,063-000-001,22222222,MENULOG CBA,57.8,0,270716.39,DR,REF642047,CBA,Savings
11-08-2025 06:43,CBAA792ABDF67A34F9E910A,063-000-001,22222222,KFC CBA,116.53,0,270599.86,DR,REF572370,CBA,Savings
11-08-2025 07:05,CBAE84071DA4FF54EF39DF8,063-000-001,22222222,FLIXBUS CBA,99.35,0,270500.51,DR,REF807915,CBA,Savings
11-08-2025 07:49,CBAC7080C7189B946FFBA1A,063-000-001,22222222,BP CBA,37,0,270463.51,DR,REF808269,CBA,Savings
11-08-2025 07:58,CBAB21D4F4E2778441AB2F3,063-000-001,22222222,UBER EATS CBA,4.99,0,270458.52,DR,REF276674,CBA,Savings
11-08-2025 08:00,CBA6BE50D81C68B4A9098EC,063-000-001,22222222,UBER EATS CBA,13.36,0,270445.16,DR,REF260161,CBA,Savings
11-08-2025 08:05,CBA2614A1459FE149E0B700,063-000-001,22222222,PAYMENT GATEWAY CBA,70.89,0,270374.27,DR,REF419974,CBA,Savings
11-08-2025 09:01,CBA2EB1C266B53541289E6F,063-000-001,22222222,PAYMENT GATEWAY CBA,73.01,0,270301.26,DR,REF688025,CBA,Savings
11-08-2025 09:43,CBAD5AB78686FD84C2F8EA0,063-000-001,22222222,ZOOM CBA,18.66,0,270282.6,DR,REF305928,CBA,Savings
11-08-2025 09:47,CBADB5B09558CD646268A3D,063-000-001,22222222,BP CBA,92,0,270190.6,DR,REF866031,CBA,Savings
11-08-2025 09:47,CBACD2D9D84D5C146D39FB4,063-000-001,22222222,JB HI-FI CBA,16.72,0,270173.88,DR,REF294164,CBA,Savings
11-08-2025 10:17,CBA57A9CC28AF93438684E9,063-000-001,22222222,WOOLWORTHS CBA,37.2,0,270136.68,DR,REF570198,CBA,Savings
11-08-2025 10:31,CBA7EDFBD2982AE4720839C,063-000-001,22222222,FLIXBUS CBA,50.22,0,270086.46,DR,REF261332,CBA,Savings
11-08-2025 10:42,CBA38FB459922FB4108B558,063-000-001,22222222,FLIXBUS CBA,22.37,0,270064.09,DR,REF878088,CBA,Savings
11-08-2025 11:08,CBABCA5C303E0B54A9DBF3D,063-000-001,22222222,STARBUCKS CBA,24.43,0,270039.66,DR,REF126109,CBA,Savings
11-08-2025 11:24,CBA042838450F914D0BA8E1,063-000-001,22222222,JB HI-FI CBA,68.22,0,269971.44,DR,REF905869,CBA,Savings
11-08-2025 11:27,CBA659C3FAF76784EB4B10A,063-000-001,22222222,BP CBA,14.1,0,269957.34,DR,REF729545,CBA,Savings
11-08-2025 12:15,CBA2C9E3ABEA7B4421D9683,063-000-001,22222222,PAY - SALARY CBA,0,1009.34,270966.68,CR,REF914970,CBA,Savings
11-08-2025 12:21,CBAA1A4C65A48AC48D1963F,063-000-001,22222222,7-ELEVEN CBA,127.81,0,270838.87,DR,REF374971,CBA,Savings
11-08-2025 12:40,CBA746605C652E74E859538,063-000-001,22222222,APPLE CBA,45.56,0,270793.31,DR,REF283649,CBA,Savings
11-08-2025 12:41,CBA49FE0CE6C8D745D08673,063-000-001,22222222,WAGES CREDIT CBA,0,7365.39,278158.7,CR,REF555791,CBA,Savings
11-08-2025 12:43,CBAABD4A20F2BEA4F72B019,063-000-001,22222222,COMPANY PAYROLL CBA,0,4247.93,282406.63,CR,REF107066,CBA,Savings
11-08-2025 13:20,CBA08971A15F0DB4E21BD62,063-000-001,22222222,PAYPAL *NETFLIX CBA,54.46,0,282352.17,DR,REF186105,CBA,Savings
11-08-2025 14:08,CBA095E31B18D3E46E99C38,063-000-001,22222222,LIQUORLAND CBA,126.08,0,282226.09,DR,REF958986,CBA,Savings
11-08-2025 14:17,CBA2F963799378A4925AB2B,063-000-001,22222222,LIQUORLAND CBA,20.18,0,282205.91,DR,REF226954,CBA,Savings
11-08-2025 14:32,CBA69E92752E91C4792B25A,063-000-001,22222222,LIQUORLAND CBA,89.16,0,282116.75,DR,REF346341,CBA,Savings
11-08-2025 14:49,INT0A721C1CCC63402AA9AB,063-000-001,22222222,TRANSFER FROM ANZ 11111111,0,1237.19,283353.94,CR,INT-86308,CBA,Savings
11-08-2025 14:53,CBAF79B66F35E444B5EAF53,063-000-001,22222222,SPOTIFY CBA,39.92,0,283314.02,DR,REF120445,CBA,Savings
11-08-2025 15:22,CBAE5B03CA5DB4E416394C0,063-000-001,22222222,LIQUORLAND CBA,11.29,0,283302.73,DR,REF688032,CBA,Savings
11-08-2025 16:02,CBA8D5F2479BF8F474EBD3A,063-000-001,22222222,UBER EATS CBA,120.19,0,283182.54,DR,REF385986,CBA,Savings
11-08-2025 16:24,CBABCCC5F152FB8493182CF,063-000-001,22222222,BP CBA,7.51,0,283175.03,DR,REF995765,CBA,Savings
11-08-2025 16:32,CBA718C324DFD0E4EB89309,063-000-001,22222222,WAGES CREDIT CBA,0,7554.17,290729.2,CR,REF374635,CBA,Savings
11-08-2025 16:39,CBAE97B868D13C0461CAE48,063-000-001,22222222,COLES CBA,14.19,0,290715.01,DR,REF918047,CBA,Savings
11-08-2025 16:45,CBAC6C3E91294ED4F42902D,063-000-001,22222222,BWS CBA,12.29,0,290702.72,DR,REF612683,CBA,Savings
11-08-2025 17:00,CBAAB9D19831475408FA9B1,063-000-001,22222222,RAILWAY STATION CBA,5.65,0,290697.07,DR,REF667406,CBA,Savings
11-08-2025 17:20,CBA7734E105D3204AFEBC74,063-000-001,22222222,DOMINO'S PIZZA CBA,67.15,0,290629.92,DR,REF184842,CBA,Savings
11-08-2025 17:31,CBABDDAF45AF304495EA910,063-000-001,22222222,AMAZON AU CBA,18.81,0,290611.11,DR,REF142526,CBA,Savings
11-08-2025 17:33,CBA4DD9DEC3EEB646BD8367,063-000-001,22222222,BIGW CBA,37.56,0,290573.55,DR,REF470301,CBA,Savings
11-08-2025 17:41,CBA54F9FE160F7E4521A9B7,063-000-001,22222222,PAYPAL *NETFLIX CBA,8.44,0,290565.11,DR,REF675614,CBA,Savings
11-08-2025 17:54,CBAC0A4D95DBF624AC698DA,063-000-001,22222222,STARBUCKS CBA,58.97,0,290506.14,DR,REF594135,CBA,Savings
11-08-2025 18:11,CBAD32C21A110EB4C9AB515,063-000-001,22222222,JB HI-FI CBA,60.8,0,290445.34,DR,REF163731,CBA,Savings
11-08-2025 18:29,CBA37337C5465F74CC4899B,063-000-001,22222222,BWS CBA,36.59,0,290408.75,DR,REF268572,CBA,Savings
11-08-2025 18:47,CBA0198B01C49BA435780D5,063-000-001,22222222,RAILWAY STATION CBA,11.44,0,290397.31,DR,REF762901,CBA,Savings
11-08-2025 20:26,CBA045CA9D2CFF3433494E3,063-000-001,22222222,CITYLINK CBA,37.75,0,290359.56,DR,REF296171,CBA,Savings
11-08-2025 20:29,CBA3EC06D2EE372478483DB,063-000-001,22222222,HARVEY NORMAN CBA,29.1,0,290330.46,DR,REF167535,CBA,Savings
11-08-2025 20:35,CBAF9DD494D782F4FC5972D,063-000-001,22222222,JB HI-FI CBA,4.66,0,290325.8,DR,REF896789,CBA,Savings
11-08-2025 21:11,CBA725B657F715044558F4D,063-000-001,22222222,ZOOM CBA,38.88,0,290286.92,DR,REF560104,CBA,Savings
11-08-2025 21:18,INT2F760ABC05754B81BE5D,063-000-001,22222222,TRANSFER TO CBA 33333333,1327.35,0,288959.57,DR,INT-69087,CBA,Savings
11-08-2025 21:30,CBA1DDA4BF626DE48808932,063-000-001,22222222,PAY - SALARY CBA,0,592.72,289552.29,CR,REF100885,CBA,Savings
11-08-2025 21:44,CBAD4C1F26A11F647BA8B14,063-000-001,22222222,UBER EATS CBA,14.38,0,289537.91,DR,REF594952,CBA,Savings
11-08-2025 21:49,CBA9A9F33C526E547FD9A38,063-000-001,22222222,LIQUORLAND CBA,7.84,0,289530.07,DR,REF512916,CBA,Savings
11-08-2025 22:02,CBA8FA091C5A25D492880BF,063-000-001,22222222,PAYMENT GATEWAY CBA,32.42,0,289497.65,DR,REF318680,CBA,Savings
11-08-2025 22:16,CBA92C9D28AC89343C28CAD,063-000-001,22222222,PAYROLL CREDIT CBA,0,789.61,290287.26,CR,REF575726,CBA,Savings
11-08-2025 22:27,CBAE666F842462144D89FF3,063-000-001,22222222,SHELL CBA,23.86,0,290263.4,DR,REF889006,CBA,Savings
11-08-2025 22:35,CBA0A75774D98FE42039B61,063-000-001,22222222,APPLE CBA,4.18,0,290259.22,DR,REF276094,CBA,Savings
11-08-2025 23:01,CBAEA29AA1D761340FABEB5,063-000-001,22222222,DOMINO'S PIZZA CBA,19.55,0,290239.67,DR,REF475376,CBA,Savings
11-08-2025 23:15,CBA8F18D8784F004D80A0AB,063-000-001,22222222,BWS CBA,3.02,0,290236.65,DR,REF767170,CBA,Savings
11-08-2025 23:24,CBA1F43BF211C534431BD26,063-000-001,22222222,SPOTIFY CBA,46.25,0,290190.4,DR,REF612043,CBA,Savings
12-08-2025 00:07,CBAE3E25DFDE53940B8BE4A,063-000-001,22222222,BIGW CBA,7.5,0,290182.9,DR,REF121857,CBA,Savings
12-08-2025 00:36,CBA08D77155416A467DA896,063-000-001,22222222,ZOOM CBA,18.71,0,290164.19,DR,REF721269,CBA,Savings
12-08-2025 00:40,CBA970D073C3C1D42F6BA96,063-000-001,22222222,ZOOM CBA,40.13,0,290124.06,DR,REF940364,CBA,Savings
12-08-2025 00:51,CBA4866999F46A940C9BE78,063-000-001,22222222,APPLE CBA,42.06,0,290082,DR,REF786673,CBA,Savings
12-08-2025 01:05,CBA83F805FF6BE2462D84AB,063-000-001,22222222,PAYROLL CREDIT CBA,0,859.28,290941.28,CR,REF178075,CBA,Savings
12-08-2025 01:42,CBA8F8B3FEBC5F44E2C8165,063-000-001,22222222,INTERNET TRANSFER CBA,12.52,0,290928.76,DR,REF194067,CBA,Savings
12-08-2025 02:02,CBABEC441DA8CFD420AA7E3,063-000-001,22222222,COLES CBA,28.09,0,290900.67,DR,REF353695,CBA,Savings
12-08-2025 03:14,CBA84F078B04ADC43C6BF69,063-000-001,22222222,CITYLINK CBA,25.57,0,290875.1,DR,REF164252,CBA,Savings
12-08-2025 03:20,CBA5BFFA1B421B24513BF89,063-000-001,22222222,BWS CBA,51.03,0,290824.07,DR,REF443142,CBA,Savings
12-08-2025 03:32,CBAFAC81BE4726942628EBF,063-000-001,22222222,SPOTIFY CBA,22.73,0,290801.34,DR,REF336009,CBA,Savings
12-08-2025 03:51,CBAC3CED9151FEE47FDA247,063-000-001,22222222,SPOTIFY CBA,94.4,0,290706.94,DR,REF676546,CBA,Savings
12-08-2025 04:10,CBA0D0AA6F364814B01990E,063-000-001,22222222,LIQUORLAND CBA,26.98,0,290679.96,DR,REF730646,CBA,Savings
12-08-2025 04:23,INT4ABF82E369F74BA494FE,063-000-001,22222222,TRANSFER TO NAB 44444444,436.09,0,290243.87,DR,INT-62407,CBA,Savings
12-08-2025 04:38,CBA799ED1E2516E47BEB335,063-000-001,22222222,SHELL CBA,30.87,0,290213,DR,REF384360,CBA,Savings
12-08-2025 04:56,CBA47ED430E944741F1A3B6,063-000-001,22222222,AMAZON AU CBA,38.4,0,290174.6,DR,REF642976,CBA,Savings
12-08-2025 05:12,CBA099FE763056B4FB78D56,063-000-001,22222222,FLIXBUS CBA,3.4,0,290171.2,DR,REF534538,CBA,Savings
12-08-2025 05:19,CBAEB019ABC8C964EE4A003,063-000-001,22222222,DOMINO'S PIZZA CBA,4.44,0,290166.76,DR,REF140021,CBA,Savings
12-08-2025 05:29,CBAE41E4D4D1EDA4B24B392,063-000-001,22222222,MCDONALDS CBA,99.45,0,290067.31,DR,REF147611,CBA,Savings
12-08-2025 05:29,CBADE446424C52643AEADE0,063-000-001,22222222,WOOLWORTHS CBA,33.15,0,290034.16,DR,REF154144,CBA,Savings
12-08-2025 05:47,CBADC406144D68448EDB288,063-000-001,22222222,PAYROLL CREDIT CBA,0,2472.53,292506.69,CR,REF941584,CBA,Savings
12-08-2025 05:52,CBA9396C4C902724A60A2CD,063-000-001,22222222,CITYLINK CBA,35.58,0,292471.11,DR,REF933524,CBA,Savings
12-08-2025 06:03,CBA3BC59DDC683D4D36AA20,063-000-001,22222222,AMAZON AU CBA,109.92,0,292361.19,DR,REF693463,CBA,Savings
12-08-2025 06:24,CBAC97AF45BB22B45BC8A60,063-000-001,22222222,DOMINO'S PIZZA CBA,187.18,0,292174.01,DR,REF514082,CBA,Savings
12-08-2025 06:32,CBA56B8A3D1BE8B47D0A7DB,063-000-001,22222222,STARBUCKS CBA,36.02,0,292137.99,DR,REF265148,CBA,Savings
12-08-2025 07:03,CBAD4A16F319DBB4F159B59,063-000-001,22222222,MCDONALDS CBA,72.06,0,292065.93,DR,REF696155,CBA,Savings
12-08-2025 07:09,CBAA3FE9ABC1E1D460787E9,063-000-001,22222222,SHELL CBA,118.54,0,291947.39,DR,REF639166,CBA,Savings
12-08-2025 08:41,CBA6DD0A11148AD477CA539,063-000-001,22222222,INTERNET TRANSFER CBA,9.06,0,291938.33,DR,REF390544,CBA,Savings
12-08-2025 08:59,CBADBDD0641F7F4408A9439,063-000-001,22222222,PAYMENT GATEWAY CBA,14.03,0,291924.3,DR,REF945156,CBA,Savings
12-08-2025 09:01,CBA5826EEA15D5441CA93C0,063-000-001,22222222,SALARY PAYMENT CBA,0,327.16,292251.46,CR,REF600561,CBA,Savings
12-08-2025 09:11,CBA04736219170D4C0F8B4A,063-000-001,22222222,HARVEY NORMAN CBA,10.48,0,292240.98,DR,REF666587,CBA,Savings
12-08-2025 09:36,CBA97C57DA991AD45DABADD,063-000-001,22222222,HARVEY NORMAN CBA,14.49,0,292226.49,DR,REF930806,CBA,Savings
12-08-2025 09:38,CBA7FD75485099B455DACDE,063-000-001,22222222,AMAZON AU CBA,170.28,0,292056.21,DR,REF154678,CBA,Savings
12-08-2025 09:51,INT845632A39FAC4EC492A4,063-000-001,22222222,TRANSFER FROM ANZ 11111111,0,1523.01,293579.22,CR,INT-42529,CBA,Savings
12-08-2025 09:56,CBA65004BD7792B4AF49225,063-000-001,22222222,PAYPAL *NETFLIX CBA,11.34,0,293567.88,DR,REF656967,CBA,Savings
12-08-2025 09:56,CBA1D70FF8A7ED24AAEAA71,063-000-001,22222222,CITYLINK CBA,29.84,0,293538.04,DR,REF703360,CBA,Savings
12-08-2025 10:02,CBA4B211B357A28438AACEC,063-000-001,22222222,BP CBA,9.06,0,293528.98,DR,REF543019,CBA,Savings
12-08-2025 10:04,CBA72F9CDEE6B904D009702,063-000-001,22222222,BIGW CBA,28.76,0,293500.22,DR,REF570040,CBA,Savings
12-08-2025 10:17,CBA264D7ABDF8D24B23AFDB,063-000-001,22222222,WAGES CREDIT CBA,0,286.88,293787.1,CR,REF294858,CBA,Savings
12-08-2025 10:17,CBAEF8395858E6E43CC8992,063-000-001,22222222,CITYLINK CBA,22.79,0,293764.31,DR,REF158799,CBA,Savings
12-08-2025 10:17,CBAC5FCB200476449B3BA79,063-000-001,22222222,COLES CBA,61.38,0,293702.93,DR,REF203676,CBA,Savings
12-08-2025 10:39,CBA7FB988FB649A472BA954,063-000-001,22222222,UBER EATS CBA,6.46,0,293696.47,DR,REF466439,CBA,Savings
12-08-2025 10:40,CBA13E49A74809140F8A7BA,063-000-001,22222222,BIGW CBA,23.54,0,293672.93,DR,REF906829,CBA,Savings
12-08-2025 10:43,CBAFFE2547E4A6948148C80,063-000-001,22222222,BIGW CBA,46.05,0,293626.88,DR,REF526598,CBA,Savings
12-08-2025 10:59,CBA32941E8C1EAF4EDF87D4,063-000-001,22222222,HARVEY NORMAN CBA,34.5,0,293592.38,DR,REF589843,CBA,Savings
12-08-2025 11:00,CBAFB9A4CD074F84353AE4B,063-000-001,22222222,APPLE CBA,50.25,0,293542.13,DR,REF475424,CBA,Savings
12-08-2025 11:10,CBA763F0A6A4F1A4ADFBB3D,063-000-001,22222222,CITYLINK CBA,14.38,0,293527.75,DR,REF565299,CBA,Savings
12-08-2025 11:14,CBA3BCDA8350AC142F5843E,063-000-001,22222222,SHELL CBA,95.9,0,293431.85,DR,REF120156,CBA,Savings
12-08-2025 11:32,CBAFC856F97B6EC431FBEEE,063-000-001,22222222,7-ELEVEN CBA,82.12,0,293349.73,DR,REF879655,CBA,Savings
12-08-2025 11:36,CBA90E504DA37B84810B616,063-000-001,22222222,BP CBA,76.63,0,293273.1,DR,REF861801,CBA,Savings
12-08-2025 11:58,CBA899379FF0BC04C56A87D,063-000-001,22222222,JB HI-FI CBA,160.42,0,293112.68,DR,REF942657,CBA,Savings
12-08-2025 12:19,CBA03069BA4C39B44B6ABCC,063-000-001,22222222,ZOOM CBA,90.99,0,293021.69,DR,REF248682,CBA,Savings
12-08-2025 12:51,CBA4F90C1511B34458F9CEC,063-000-001,22222222,PAYROLL CREDIT CBA,0,5180.55,298202.24,CR,REF973096,CBA,Savings
12-08-2025 13:06,CBA111BE6FAC47C4C388E4D,063-000-001,22222222,ALDI CBA,6.23,0,298196.01,DR,REF135457,CBA,Savings
12-08-2025 13:07,CBA84ED9F1E73AF423A83AE,063-000-001,22222222,RAILWAY STATION CBA,150.59,0,298045.42,DR,REF836379,CBA,Savings
12-08-2025 13:26,CBA831AD305E05141129ABE,063-000-001,22222222,JB HI-FI CBA,50.74,0,297994.68,DR,REF396345,CBA,Savings
12-08-2025 13:26,CBAA36B6404E39546A89679,063-000-001,22222222,DOMINO'S PIZZA CBA,17.9,0,297976.78,DR,REF871532,CBA,Savings
12-08-2025 13:41,CBAEE2A50FFCA194448B816,063-000-001,22222222,SPOTIFY CBA,4.67,0,297972.11,DR,REF143085,CBA,Savings
12-08-2025 14:23,CBAE95704E1E7F644AFBE96,063-000-001,22222222,7-ELEVEN CBA,32.99,0,297939.12,DR,REF948900,CBA,Savings
12-08-2025 14:27,CBA2DCB47977F91443596FF,063-000-001,22222222,MCDONALDS CBA,42.72,0,297896.4,DR,REF854418,CBA,Savings
12-08-2025 14:31,CBA8E20EF6AD6E5422CA571,063-000-001,22222222,WAGES CREDIT CBA,0,6036.85,303933.25,CR,REF234471,CBA,Savings
12-08-2025 15:13,CBA4294C01323AC4A7CACE2,063-000-001,22222222,MENULOG CBA,16.01,0,303917.24,DR,REF406014,CBA,Savings
12-08-2025 15:25,CBA24843EEA26224A0AA862,063-000-001,22222222,BIGW CBA,53.84,0,303863.4,DR,REF810096,CBA,Savings
12-08-2025 15:31,CBA0FD5288EBC5847D9929F,063-000-001,22222222,LIQUORLAND CBA,46.27,0,303817.13,DR,REF201972,CBA,Savings
12-08-2025 15:47,CBAE48ACFDEE69644458ACF,063-000-001,22222222,AMAZON AU CBA,17.26,0,303799.87,DR,REF857550,CBA,Savings
12-08-2025 15:55,CBA6DB94AB788FC4CB29C27,063-000-001,22222222,STARBUCKS CBA,32.81,0,303767.06,DR,REF525186,CBA,Savings
12-08-2025 16:14,INT9D5CC90F11C04E3EB264,063-000-001,22222222,TRANSFER TO ANZ 11111111,1413.2,0,302353.86,DR,INT-66319,CBA,Savings
12-08-2025 16:19,CBA46BCDA4CF539480D8E6A,063-000-001,22222222,COLES CBA,81.39,0,302272.47,DR,REF876951,CBA,Savings
12-08-2025 16:33,CBAEBD885D3B8A041158F31,063-000-001,22222222,CITYLINK CBA,38.96,0,302233.51,DR,REF351185,CBA,Savings
12-08-2025 18:40,CBA8FB85154ACA84793942E,063-000-001,22222222,MENULOG CBA,8.75,0,302224.76,DR,REF158172,CBA,Savings
12-08-2025 19:01,CBA9E3952D8B2544C249FFE,063-000-001,22222222,BP CBA,156.66,0,302068.1,DR,REF860927,CBA,Savings
12-08-2025 19:42,CBA87130DE6329647C796EC,063-000-001,22222222,WAGES CREDIT CBA,0,2174.06,304242.16,CR,REF212736,CBA,Savings
12-08-2025 19:45,CBA7E091BD68A2846DFB9E1,063-000-001,22222222,PAY - SALARY CBA,0,7240.1,311482.26,CR,REF736015,CBA,Savings
12-08-2025 19:55,CBA4A722EF8E2BF48D5B6E7,063-000-001,22222222,UBER EATS CBA,22.2,0,311460.06,DR,REF428214,CBA,Savings
12-08-2025 19:59,CBA96DCCCA9518F42D9B193,063-000-001,22222222,MENULOG CBA,229.56,0,311230.5,DR,REF693061,CBA,Savings
12-08-2025 20:13,CBACCDA0EC358C64AC3812A,063-000-001,22222222,KFC CBA,108.99,0,311121.51,DR,REF732798,CBA,Savings
12-08-2025 20:43,CBA28BB6CFFF5A84E0FBD48,063-000-001,22222222,ZOOM CBA,51.08,0,311070.43,DR,REF438598,CBA,Savings
12-08-2025 20:50,CBA4F3CC38D92DE455F9DA3,063-000-001,22222222,BWS CBA,62.68,0,311007.75,DR,REF900777,CBA,Savings
12-08-2025 21:38,CBA05457FB70A86418F9969,063-000-001,22222222,PAYMENT GATEWAY CBA,33.69,0,310974.06,DR,REF155864,CBA,Savings
12-08-2025 21:39,CBA4B1E9A94655047B8827B,063-000-001,22222222,WAGES CREDIT CBA,0,5741.29,316715.35,CR,REF814214,CBA,Savings
12-08-2025 22:16,CBA8B70DCF4B6204539B19B,063-000-001,22222222,PAY - SALARY CBA,0,3404.32,320119.67,CR,REF700368,CBA,Savings
12-08-2025 22:17,CBAB05ECC440BA54F1096A6,063-000-001,22222222,SALARY PAYMENT CBA,0,1043.36,321163.03,CR,REF839168,CBA,Savings
12-08-2025 22:31,CBA6EDB3507851A486B876D,063-000-001,22222222,ZOOM CBA,2.31,0,321160.72,DR,REF295630,CBA,Savings
12-08-2025 23:37,CBAD20633DD31894DE7A9FB,063-000-001,22222222,BWS CBA,58.84,0,321101.88,DR,REF744722,CBA,Savings
12-08-2025 23:45,CBADF39F47349E844868591,063-000-001,22222222,MENULOG CBA,50.92,0,321050.96,DR,REF867619,CBA,Savings
12-08-2025 23:56,CBA20341F650A234663A9CB,063-000-001,22222222,LIQUORLAND CBA,14.82,0,321036.14,DR,REF226734,CBA,Savings
13-08-2025 00:01,CBAF183F7AE776D4FB68B0B,063-000-001,22222222,FLIXBUS CBA,15.42,0,321020.72,DR,REF856469,CBA,Savings
13-08-2025 00:43,CBA86F1A70330B042248694,063-000-001,22222222,PAYROLL CREDIT CBA,0,3526.53,324547.25,CR,REF865107,CBA,Savings
13-08-2025 00:46,INT03BEE6E7FBE64912811E,063-000-001,22222222,TRANSFER FROM ANZ 11111111,0,385.16,324932.41,CR,INT-34228,CBA,Savings
13-08-2025 01:08,CBA0F0CA75CD82C49A79B1D,063-000-001,22222222,RAILWAY STATION CBA,43.62,0,324888.79,DR,REF235994,CBA,Savings
13-08-2025 01:28,CBAE232C3B22B2643E89987,063-000-001,22222222,PAYROLL CREDIT CBA,0,46.94,324935.73,CR,REF866761,CBA,Savings
13-08-2025 01:58,CBA5B44E61B7D7C406AAA2B,063-000-001,22222222,PAYPAL *NETFLIX CBA,47.56,0,324888.17,DR,REF338715,CBA,Savings
13-08-2025 02:17,CBA55468CE8D8CA4A05AC2C,063-000-001,22222222,MCDONALDS CBA,39.74,0,324848.43,DR,REF650929,CBA,Savings
13-08-2025 02:29,CBA5AF768D8A907472A8CAC,063-000-001,22222222,PAYMENT GATEWAY CBA,61.84,0,324786.59,DR,REF797124,CBA,Savings
13-08-2025 02:34,CBA26ECE52151CD4A189B64,063-000-001,22222222,COMPANY PAYROLL CBA,0,1503.81,326290.4,CR,REF536412,CBA,Savings
13-08-2025 03:01,CBA279895BE28484BA99E3F,063-000-001,22222222,ZOOM CBA,12.06,0,326278.34,DR,REF483818,CBA,Savings
13-08-2025 03:22,CBA32337A5D4EC646E8B252,063-000-001,22222222,BWS CBA,112.46,0,326165.88,DR,REF225667,CBA,Savings
13-08-2025 03:56,CBA69133768BF874D378848,063-000-001,22222222,MENULOG CBA,37.38,0,326128.5,DR,REF749376,CBA,Savings
13-08-2025 04:13,CBAA65ADFD932F4407094C1,063-000-001,22222222,WAGES CREDIT CBA,0,1547.58,327676.08,CR,REF139843,CBA,Savings
13-08-2025 04:18,CBAA33BAB4578AC4D919DBD,063-000-001,22222222,SHELL CBA,8.13,0,327667.95,DR,REF749515,CBA,Savings
13-08-2025 06:32,CBAF60649863831413B8876,063-000-001,22222222,COMPANY PAYROLL CBA,0,4366.21,332034.16,CR,REF354558,CBA,Savings
13-08-2025 06:40,CBAD37749E588B7419C8D18,063-000-001,22222222,PAY - SALARY CBA,0,4066.23,336100.39,CR,REF900173,CBA,Savings
13-08-2025 07:12,CBA89035E4D0EC04EC390AE,063-000-001,22222222,FLIXBUS CBA,3.79,0,336096.6,DR,REF833835,CBA,Savings
13-08-2025 07:31,CBA4943C23918E243BB9EA9,063-000-001,22222222,WAGES CREDIT CBA,0,6408.86,342505.46,CR,REF917112,CBA,Savings
13-08-2025 09:08,CBAE48A733473D145A69141,063-000-001,22222222,KFC CBA,84.16,0,342421.3,DR,REF342437,CBA,Savings
13-08-2025 09:16,CBAB45A30EEB6C449908FB8,063-000-001,22222222,SHELL CBA,57.66,0,342363.64,DR,REF553080,CBA,Savings
13-08-2025 10:45,CBA10774328AFAB4F02BFE6,063-000-001,22222222,PAYROLL CREDIT CBA,0,5825.85,348189.49,CR,REF905764,CBA,Savings
13-08-2025 10:47,CBA3C605A753BA045FC952E,063-000-001,22222222,FLIXBUS CBA,31.87,0,348157.62,DR,REF357557,CBA,Savings
13-08-2025 10:49,CBA9368ED000B9D4B28B6BD,063-000-001,22222222,WAGES CREDIT CBA,0,5656.47,353814.09,CR,REF722419,CBA,Savings
13-08-2025 10:54,CBA5E2AF44C68F94BD3A328,063-000-001,22222222,PAYMENT GATEWAY CBA,68.76,0,353745.33,DR,REF428304,CBA,Savings
13-08-2025 11:16,CBA02DD18B12B354D019DAB,063-000-001,22222222,KFC CBA,16,0,353729.33,DR,REF347871,CBA,Savings
13-08-2025 12:01,CBA0EBF6693A44F4D659143,063-000-001,22222222,WOOLWORTHS CBA,49.58,0,353679.75,DR,REF844673,CBA,Savings
13-08-2025 12:38,CBA3DDE9F7CFE4A4D3B95DF,063-000-001,22222222,MCDONALDS CBA,23.14,0,353656.61,DR,REF988315,CBA,Savings
13-08-2025 12:51,CBACCEEF897E42D473792F3,063-000-001,22222222,COMPANY PAYROLL CBA,0,5114.43,358771.04,CR,REF318506,CBA,Savings
13-08-2025 13:17,CBA3FD8546A5C4E4A2CADF3,063-000-001,22222222,STARBUCKS CBA,27.33,0,358743.71,DR,REF702927,CBA,Savings
13-08-2025 13:50,CBA26F6B6B6A5A148D4BCCC,063-000-001,22222222,KFC CBA,3.91,0,358739.8,DR,REF896501,CBA,Savings
13-08-2025 14:42,CBA1788CC36A2044060A23A,063-000-001,22222222,LIQUORLAND CBA,11.28,0,358728.52,DR,REF238299,CBA,Savings
13-08-2025 14:44,CBA56B47D58E67B4E86B034,063-000-001,22222222,WAGES CREDIT CBA,0,415.95,359144.47,CR,REF271483,CBA,Savings
13-08-2025 14:46,CBA7B2EB2EC58D048EBB643,063-000-001,22222222,ZOOM CBA,142.94,0,359001.53,DR,REF614254,CBA,Savings
13-08-2025 15:37,CBA192FEE0160944DADB799,063-000-001,22222222,STARBUCKS CBA,106.15,0,358895.38,DR,REF333171,CBA,Savings
13-08-2025 16:11,CBAA1D7D1E005C34ABF900B,063-000-001,22222222,PAYROLL CREDIT CBA,0,7475.83,366371.21,CR,REF138993,CBA,Savings
13-08-2025 16:25,CBAC38F02F7E7C64731898A,063-000-001,22222222,PAY - SALARY CBA,0,5884.87,372256.08,CR,REF658036,CBA,Savings
13-08-2025 16:27,CBA6480D6A381554C769454,063-000-001,22222222,PAYPAL *NETFLIX CBA,14.8,0,372241.28,DR,REF689785,CBA,Savings
13-08-2025 16:29,CBA5388B2D9EE1E442BA62A,063-000-001,22222222,COLES CBA,52.04,0,372189.24,DR,REF131565,CBA,Savings
13-08-2025 17:35,CBA93591F6A0F3E4B6ABD30,063-000-001,22222222,AMAZON AU CBA,9.75,0,372179.49,DR,REF507448,CBA,Savings
13-08-2025 17:36,CBA64B097A2CA7046C58219,063-000-001,22222222,BANK FEE CBA,20.88,0,372158.61,DR,REF572544,CBA,Savings
13-08-2025 17:41,CBAEC09EDFCE86447FE95F0,063-000-001,22222222,MCDONALDS CBA,48.19,0,372110.42,DR,REF193037,CBA,Savings
13-08-2025 17:55,CBA19413383A3974418A87B,063-000-001,22222222,AMAZON AU CBA,7.85,0,372102.57,DR,REF618259,CBA,Savings
13-08-2025 17:59,CBAD576C06FF2724C7685C2,063-000-001,22222222,INTERNET TRANSFER CBA,89.06,0,372013.51,DR,REF830057,CBA,Savings
13-08-2025 18:03,CBA9F6C3CAE7CF44BB1BB3F,063-000-001,22222222,SPOTIFY CBA,5.53,0,372007.98,DR,REF312273,CBA,Savings
13-08-2025 18:46,CBA9D6C239B1EEC4D0C8824,063-000-001,22222222,HARVEY NORMAN CBA,67.63,0,371940.35,DR,REF555671,CBA,Savings
13-08-2025 19:32,INTFE04BDC616944B4F98D6,063-000-001,22222222,TRANSFER TO NAB 44444444,1808.58,0,370131.77,DR,INT-18026,CBA,Savings
13-08-2025 19:33,CBAF00687B561DB49ABA716,063-000-001,22222222,COLES CBA,8.11,0,370123.66,DR,REF450978,CBA,Savings
13-08-2025 19:43,CBAA2519B37B1474ECA96BF,063-000-001,22222222,LIQUORLAND CBA,13.14,0,370110.52,DR,REF316867,CBA,Savings
13-08-2025 20:05,CBA5A9B5BABED5C4F309887,063-000-001,22222222,ALDI CBA,6.29,0,370104.23,DR,REF590142,CBA,Savings
13-08-2025 20:55,CBAB4B731B19F454EC7A518,063-000-001,22222222,INTERNET TRANSFER CBA,7.9,0,370096.33,DR,REF558978,CBA,Savings
13-08-2025 21:00,CBAE778B40DBA2D48F2B17F,063-000-001,22222222,COMPANY PAYROLL CBA,0,6715.33,376811.66,CR,REF480697,CBA,Savings
13-08-2025 21:01,CBAE4014C6D8E2C45C9A929,063-000-001,22222222,COMPANY PAYROLL CBA,0,5195.05,382006.71,CR,REF426695,CBA,Savings
13-08-2025 21:05,CBAD40481F397264A308205,063-000-001,22222222,7-ELEVEN CBA,61.36,0,381945.35,DR,REF225176,CBA,Savings
13-08-2025 21:17,CBAEC533ABFF1844037B1B1,063-000-001,22222222,SHELL CBA,56.01,0,381889.34,DR,REF247424,CBA,Savings
13-08-2025 21:18,CBAE33E2C9F851240819411,063-000-001,22222222,STARBUCKS CBA,67.01,0,381822.33,DR,REF997847,CBA,Savings
13-08-2025 21:38,CBA6FC177D1F197474B9C95,063-000-001,22222222,TAFE BOOKSHOP CBA,116.73,0,381705.6,DR,REF904193,CBA,Savings
13-08-2025 22:32,INTAD64D1F7F4434A8794F6,063-000-001,22222222,TRANSFER TO CBA 33333333,1355.21,0,380350.39,DR,INT-51801,CBA,Savings
13-08-2025 22:32,CBA55F006AFE24B49678C83,063-000-001,22222222,BP CBA,5.84,0,380344.55,DR,REF611514,CBA,Savings
13-08-2025 22:46,CBADCDCA5C3BF3644B0AA35,063-000-001,22222222,DOMINO'S PIZZA CBA,61.17,0,380283.38,DR,REF305571,CBA,Savings
13-08-2025 23:37,CBAFF1BC407DB8844C3A73A,063-000-001,22222222,COMPANY PAYROLL CBA,0,7348.64,387632.02,CR,REF641575,CBA,Savings
13-08-2025 23:47,CBAEC4C431D6F1F4912B72B,063-000-001,22222222,BANK FEE CBA,19.69,0,387612.33,DR,REF252316,CBA,Savings
13-08-2025 23:58,CBADEAAC1EADF20476AABE7,063-000-001,22222222,WOOLWORTHS CBA,56.42,0,387555.91,DR,REF447587,CBA,Savings
14-08-2025 00:06,CBAE8F27E08A9CD4C8AB97D,063-000-001,22222222,BANK FEE CBA,204.33,0,387351.58,DR,REF745448,CBA,Savings
14-08-2025 00:19,CBA5EA1033FF93D4713BCDD,063-000-001,22222222,LIQUORLAND CBA,218.65,0,387132.93,DR,REF153443,CBA,Savings
14-08-2025 00:56,CBA7C08C0FE85FD45A09990,063-000-001,22222222,7-ELEVEN CBA,57.12,0,387075.81,DR,REF470102,CBA,Savings
14-08-2025 01:38,CBA9578603316A54D56AE91,063-000-001,22222222,TAFE BOOKSHOP CBA,57.12,0,387018.69,DR,REF644278,CBA,Savings
14-08-2025 02:00,CBA9F24A77F4BCB4D9FB55E,063-000-001,22222222,BIGW CBA,12.99,0,387005.7,DR,REF259894,CBA,Savings
14-08-2025 02:15,CBA43ADD04296194D458507,063-000-001,22222222,RAILWAY STATION CBA,110.32,0,386895.38,DR,REF308153,CBA,Savings
14-08-2025 03:04,CBA652EC14ED6DC444A8DAF,063-000-001,22222222,MENULOG CBA,23.77,0,386871.61,DR,REF405467,CBA,Savings
14-08-2025 03:22,CBABD2E79EE213B4711A6B8,063-000-001,22222222,CITYLINK CBA,39.29,0,386832.32,DR,REF257861,CBA,Savings
14-08-2025 03:45,CBA373C311493FB41BDB6AA,063-000-001,22222222,MENULOG CBA,44.86,0,386787.46,DR,REF993901,CBA,Savings
14-08-2025 04:00,CBA3C3E966C8D0341E08B90,063-000-001,22222222,BANK FEE CBA,12.29,0,386775.17,DR,REF863589,CBA,Savings
14-08-2025 04:30,CBA3D5FEE8ED424495A83F3,063-000-001,22222222,BP CBA,8.25,0,386766.92,DR,REF558910,CBA,Savings
14-08-2025 04:49,CBAD8B79861C805402980EB,063-000-001,22222222,WAGES CREDIT CBA,0,3921.74,390688.66,CR,REF460241,CBA,Savings
14-08-2025 05:23,CBA1195242DEEDF47B4804D,063-000-001,22222222,RAILWAY STATION CBA,46.76,0,390641.9,DR,REF537468,CBA,Savings
14-08-2025 05:35,CBAE03C709541F24996B802,063-000-001,22222222,MCDONALDS CBA,12.08,0,390629.82,DR,REF668610,CBA,Savings
14-08-2025 06:13,CBAA314440E54564DCCA614,063-000-001,22222222,AMAZON AU CBA,56.7,0,390573.12,DR,REF781508,CBA,Savings
14-08-2025 06:14,CBAD4998F84F80744B596A6,063-000-001,22222222,7-ELEVEN CBA,61.36,0,390511.76,DR,REF237899,CBA,Savings
14-08-2025 06:26,CBA27C8FF38592B4CCCAB0A,063-000-001,22222222,FLIXBUS CBA,22.46,0,390489.3,DR,REF572363,CBA,Savings
14-08-2025 06:35,CBA5B8D777CEA8B4B3AB6D5,063-000-001,22222222,ZOOM CBA,54.63,0,390434.67,DR,REF746834,CBA,Savings
14-08-2025 07:09,CBA7403767C12FA4B4FB32C,063-000-001,22222222,KFC CBA,18.52,0,390416.15,DR,REF392297,CBA,Savings
14-08-2025 07:23,CBAAE4DE07750044441B5C7,063-000-001,22222222,HARVEY NORMAN CBA,2.66,0,390413.49,DR,REF622822,CBA,Savings
14-08-2025 07:31,CBA31CADBDB3D1044288175,063-000-001,22222222,UBER EATS CBA,165.24,0,390248.25,DR,REF677436,CBA,Savings
14-08-2025 07:53,CBAB97617D781DD4C32B715,063-000-001,22222222,7-ELEVEN CBA,4.4,0,390243.85,DR,REF748594,CBA,Savings
14-08-2025 08:32,CBA7F19EDA59D1F4F8F825C,063-000-001,22222222,HARVEY NORMAN CBA,43.93,0,390199.92,DR,REF658320,CBA,Savings
14-08-2025 09:01,CBAB3AE2C9D44FD4423A53A,063-000-001,22222222,RAILWAY STATION CBA,108.69,0,390091.23,DR,REF759734,CBA,Savings
14-08-2025 09:08,CBA0BAAC00805CE4658817E,063-000-001,22222222,SPOTIFY CBA,50.11,0,390041.12,DR,REF845607,CBA,Savings
14-08-2025 09:16,CBA1CA8D6383DDD4D3A88A4,063-000-001,22222222,PAYPAL *NETFLIX CBA,48.61,0,389992.51,DR,REF140383,CBA,Savings
14-08-2025 09:28,CBAC57AF3E4E8634493BC6F,063-000-001,22222222,BIGW CBA,7.88,0,389984.63,DR,REF454490,CBA,Savings
14-08-2025 09:32,CBA61A5A1DD0F934384A07B,063-000-001,22222222,ALDI CBA,58.57,0,389926.06,DR,REF761126,CBA,Savings
14-08-2025 09:34,CBAB9713ED2288845629463,063-000-001,22222222,BWS CBA,132.76,0,389793.3,DR,REF499024,CBA,Savings
14-08-2025 10:01,CBA71AF4E2F9B1F4368BDA4,063-000-001,22222222,MCDONALDS CBA,100.6,0,389692.7,DR,REF176016,CBA,Savings
14-08-2025 10:02,CBA6310EABB0DEE46E78FBF,063-000-001,22222222,DOMINO'S PIZZA CBA,81.71,0,389610.99,DR,REF477725,CBA,Savings
14-08-2025 10:13,CBA3E5565ED285742D7A883,063-000-001,22222222,ZOOM CBA,108.1,0,389502.89,DR,REF516903,CBA,Savings
14-08-2025 10:18,CBACF0DAF661B0148E2A8F7,063-000-001,22222222,MCDONALDS CBA,69.46,0,389433.43,DR,REF136060,CBA,Savings
14-08-2025 10:45,CBA654597033E894A338895,063-000-001,22222222,CITYLINK CBA,59.98,0,389373.45,DR,REF456150,CBA,Savings
14-08-2025 10:48,CBA99A9A880544E468CA5A4,063-000-001,22222222,TAFE BOOKSHOP CBA,46.9,0,389326.55,DR,REF768023,CBA,Savings
14-08-2025 10:51,CBAF58B823C3DE24127A86C,063-000-001,22222222,COLES CBA,83.39,0,389243.16,DR,REF872585,CBA,Savings
14-08-2025 11:10,CBA53DD120068DF45D8A19C,063-000-001,22222222,STARBUCKS CBA,8.2,0,389234.96,DR,REF103599,CBA,Savings
14-08-2025 11:49,CBA84577884E68E4C10852A,063-000-001,22222222,DOMINO'S PIZZA CBA,64.69,0,389170.27,DR,REF293627,CBA,Savings
14-08-2025 12:02,CBA813D48F536F94E469E18,063-000-001,22222222,RAILWAY STATION CBA,4.16,0,389166.11,DR,REF528250,CBA,Savings
14-08-2025 12:19,CBA94D94DFF71D240BD9020,063-000-001,22222222,BIGW CBA,53.12,0,389112.99,DR,REF180932,CBA,Savings
14-08-2025 12:26,CBAED295F109E474908A309,063-000-001,22222222,COLES CBA,31.43,0,389081.56,DR,REF677430,CBA,Savings
14-08-2025 12:29,CBAD9AD82E5D7A54D7C85A7,063-000-001,22222222,SPOTIFY CBA,23.05,0,389058.51,DR,REF861895,CBA,Savings
14-08-2025 12:40,CBA4195F938783542BA9154,063-000-001,22222222,BWS CBA,4.52,0,389053.99,DR,REF360266,CBA,Savings
14-08-2025 13:07,CBA8610F3B5872F4D25B8EF,063-000-001,22222222,SPOTIFY CBA,115.42,0,388938.57,DR,REF670966,CBA,Savings
14-08-2025 13:13,CBAFC0EAB229E24412BA832,063-000-001,22222222,BP CBA,122.82,0,388815.75,DR,REF644826,CBA,Savings
14-08-2025 13:15,CBA8946D20966594778AD64,063-000-001,22222222,APPLE CBA,144.46,0,388671.29,DR,REF161277,CBA,Savings
14-08-2025 14:07,CBA629275C56B244E5193D4,063-000-001,22222222,INTERNET TRANSFER CBA,53.33,0,388617.96,DR,REF311265,CBA,Savings
14-08-2025 14:13,CBA4A6A279A9B944ACAAC85,063-000-001,22222222,BP CBA,81.96,0,388536,DR,REF423993,CBA,Savings
14-08-2025 14:25,CBA2F59C5D733514F609B3C,063-000-001,22222222,AMAZON AU CBA,88.03,0,388447.97,DR,REF381514,CBA,Savings
14-08-2025 14:42,CBA3995A6D3D95041119293,063-000-001,22222222,LIQUORLAND CBA,5.13,0,388442.84,DR,REF128333,CBA,Savings
14-08-2025 14:43,CBA452B88F619F44AA3BC47,063-000-001,22222222,DOMINO'S PIZZA CBA,127.77,0,388315.07,DR,REF227712,CBA,Savings
14-08-2025 14:53,CBA2EBF836E505E417E8E7C,063-000-001,22222222,ZOOM CBA,68.86,0,388246.21,DR,REF151676,CBA,Savings
14-08-2025 15:41,CBA471354A751894BF38C90,063-000-001,22222222,SPOTIFY CBA,15.68,0,388230.53,DR,REF188652,CBA,Savings
14-08-2025 15:46,CBA3998A97C82F341D3A433,063-000-001,22222222,DOMINO'S PIZZA CBA,25.85,0,388204.68,DR,REF969582,CBA,Savings
14-08-2025 16:07,CBAB4940D566DC74EAFA7FA,063-000-001,22222222,BIGW CBA,49.18,0,388155.5,DR,REF449842,CBA,Savings
14-08-2025 16:26,CBABE86EDA819774DD59136,063-000-001,22222222,WOOLWORTHS CBA,12.98,0,388142.52,DR,REF195086,CBA,Savings
14-08-2025 16:33,CBA3B52478A17424AB4A545,063-000-001,22222222,APPLE CBA,35.36,0,388107.16,DR,REF925536,CBA,Savings
14-08-2025 17:00,CBAD57CE04317354A418020,063-000-001,22222222,COMPANY PAYROLL CBA,0,3698.68,391805.84,CR,REF698485,CBA,Savings
14-08-2025 17:10,CBA0E260D42317849F9A709,063-000-001,22222222,DOMINO'S PIZZA CBA,98.21,0,391707.63,DR,REF939221,CBA,Savings
14-08-2025 17:20,CBA5141AB9CA03A458CB116,063-000-001,22222222,LIQUORLAND CBA,116.85,0,391590.78,DR,REF362815,CBA,Savings
14-08-2025 18:39,CBAFB8D263CE1094D65B8D9,063-000-001,22222222,LIQUORLAND CBA,29.6,0,391561.18,DR,REF479267,CBA,Savings
14-08-2025 18:45,CBAA5C90520A4AD422F942C,063-000-001,22222222,ZOOM CBA,34,0,391527.18,DR,REF192661,CBA,Savings
14-08-2025 18:46,INT73258B1CFE854C6283D3,063-000-001,22222222,TRANSFER FROM CBA 33333333,0,1812.89,393340.07,CR,INT-62141,CBA,Savings
14-08-2025 20:14,CBA01B0C7F3CB284B11B2CF,063-000-001,22222222,UBER EATS CBA,3.54,0,393336.53,DR,REF160735,CBA,Savings
14-08-2025 20:34,CBA0C5AB08E643F485AA941,063-000-001,22222222,APPLE CBA,243.15,0,393093.38,DR,REF607660,CBA,Savings
14-08-2025 21:32,CBA76F75CE970574CE394BF,063-000-001,22222222,PAY - SALARY CBA,0,6011.82,399105.2,CR,REF548344,CBA,Savings
14-08-2025 22:04,CBA3D5D014AB7F944AE9FE6,063-000-001,22222222,BANK FEE CBA,23.65,0,399081.55,DR,REF314381,CBA,Savings
14-08-2025 22:52,CBAF27AC02A4C034378BA99,063-000-001,22222222,TAFE BOOKSHOP CBA,8.87,0,399072.68,DR,REF369724,CBA,Savings
14-08-2025 23:00,CBA16B206C6A44E4B359196,063-000-001,22222222,ZOOM CBA,44.37,0,399028.31,DR,REF127373,CBA,Savings
14-08-2025 23:21,CBA11AB594372E24B629D5D,063-000-001,22222222,BIGW CBA,21.92,0,399006.39,DR,REF671055,CBA,Savings
14-08-2025 23:54,CBA4DB204AA159941369A5A,063-000-001,22222222,KFC CBA,50.14,0,398956.25,DR,REF407942,CBA,Savings
15-08-2025 00:00,CBA4E57B691BBEB46E6AD23,063-000-001,22222222,PAYROLL CREDIT CBA,0,135.28,399091.53,CR,REF802426,CBA,Savings
15-08-2025 00:10,INTCFF520AB42854A8797F5,063-000-001,22222222,TRANSFER FROM ANZ 11111111,0,131.74,399223.27,CR,INT-65690,CBA,Savings
15-08-2025 00:27,CBA3710ECA6FCCA40409A88,063-000-001,22222222,LIQUORLAND CBA,16.46,0,399206.81,DR,REF261146,CBA,Savings
15-08-2025 00:29,CBA3EE26982D8F04DA58FA9,063-000-001,22222222,BANK FEE CBA,24.07,0,399182.74,DR,REF103178,CBA,Savings
15-08-2025 00:31,CBABDDBCF32B96546898D50,063-000-001,22222222,SALARY PAYMENT CBA,0,6380.2,405562.94,CR,REF844487,CBA,Savings
15-08-2025 01:17,CBAD2EF410959AA42ECA384,063-000-001,22222222,HARVEY NORMAN CBA,23.58,0,405539.36,DR,REF365156,CBA,Savings
15-08-2025 01:22,CBA624E8A44F70C4FA88ACF,063-000-001,22222222,BP CBA,16.36,0,405523,DR,REF517174,CBA,Savings
15-08-2025 01:25,CBACF18D9A2BE2945DFA501,063-000-001,22222222,SALARY PAYMENT CBA,0,5303.15,410826.15,CR,REF973183,CBA,Savings
15-08-2025 02:07,CBA0B24B59C2E244FC6A8CD,063-000-001,22222222,ALDI CBA,82.84,0,410743.31,DR,REF808321,CBA,Savings
15-08-2025 02:24,CBA120F5EBFAE4D42A2A9C1,063-000-001,22222222,RAILWAY STATION CBA,9.83,0,410733.48,DR,REF430283,CBA,Savings
15-08-2025 02:45,CBA805D1A2DCA7E468B8124,063-000-001,22222222,BWS CBA,20.76,0,410712.72,DR,REF137277,CBA,Savings
15-08-2025 02:55,CBA36613A9A89274C669C64,063-000-001,22222222,ALDI CBA,149.23,0,410563.49,DR,REF231469,CBA,Savings
15-08-2025 03:45,CBAF660A76D80694A74B1DE,063-000-001,22222222,BP CBA,33.59,0,410529.9,DR,REF155096,CBA,Savings
15-08-2025 04:40,CBA3358C3EBD08A4D04B6F7,063-000-001,22222222,COLES CBA,37.96,0,410491.94,DR,REF547895,CBA,Savings
15-08-2025 05:36,CBA38CF38C497044CE8847D,063-000-001,22222222,KFC CBA,8.26,0,410483.68,DR,REF208266,CBA,Savings
15-08-2025 05:52,CBA203CB11FFDF4465483F4,063-000-001,22222222,INTERNET TRANSFER CBA,47.66,0,410436.02,DR,REF813334,CBA,Savings
15-08-2025 06:09,CBA7446BA5C88F846038C7F,063-000-001,22222222,BIGW CBA,21.66,0,410414.36,DR,REF833863,CBA,Savings
15-08-2025 06:11,CBAB3983FCA645E4C819F2B,063-000-001,22222222,HARVEY NORMAN CBA,30.66,0,410383.7,DR,REF566838,CBA,Savings
15-08-2025 06:18,CBA63CA3D2CBBBD40DB8657,063-000-001,22222222,SPOTIFY CBA,6.23,0,410377.47,DR,REF521043,CBA,Savings
15-08-2025 06:58,CBADDF44D4CC724438A94D0,063-000-001,22222222,WAGES CREDIT CBA,0,3865.42,414242.89,CR,REF538053,CBA,Savings
15-08-2025 07:54,CBA9C7747F2C2984162B9DD,063-000-001,22222222,WOOLWORTHS CBA,182.81,0,414060.08,DR,REF992614,CBA,Savings
15-08-2025 08:00,CBA4259727A6BDA4C23B3A0,063-000-001,22222222,PAYPAL *NETFLIX CBA,53.56,0,414006.52,DR,REF840905,CBA,Savings
15-08-2025 08:17,CBAA1168320D7AA4968BE0D,063-000-001,22222222,LIQUORLAND CBA,104.67,0,413901.85,DR,REF811607,CBA,Savings
15-08-2025 08:22,CBA86968177E63F4445A211,063-000-001,22222222,FLIXBUS CBA,131.31,0,413770.54,DR,REF817114,CBA,Savings
15-08-2025 08:33,CBA4AF11AE67AC4481AAF4F,063-000-001,22222222,AMAZON AU CBA,114.96,0,413655.58,DR,REF486357,CBA,Savings
15-08-2025 08:49,CBA0C5B0F4CC2864B3B8A33,063-000-001,22222222,7-ELEVEN CBA,24.08,0,413631.5,DR,REF260679,CBA,Savings
15-08-2025 09:55,CBA84F95C5C054E41049F2E,063-000-001,22222222,COLES CBA,7.83,0,413623.67,DR,REF700011,CBA,Savings
15-08-2025 10:04,CBAC1615B6C9EA64E86B7C6,063-000-001,22222222,SHELL CBA,37.08,0,413586.59,DR,REF229234,CBA,Savings
15-08-2025 10:53,CBAFB5E3A3BB562422DA5CE,063-000-001,22222222,JB HI-FI CBA,24.75,0,413561.84,DR,REF687401,CBA,Savings
15-08-2025 10:55,CBAD345880C99914777B9FC,063-000-001,22222222,COMPANY PAYROLL CBA,0,5557.91,419119.75,CR,REF882776,CBA,Savings
15-08-2025 11:08,CBADCB31549DA064B7CACED,063-000-001,22222222,KFC CBA,163.24,0,418956.51,DR,REF860244,CBA,Savings
15-08-2025 11:35,CBA456A802800304A9DAB9C,063-000-001,22222222,DOMINO'S PIZZA CBA,15.05,0,418941.46,DR,REF762601,CBA,Savings
15-08-2025 11:42,CBA7EE84DF6AB0A4BCF88DA,063-000-001,22222222,STARBUCKS CBA,143.11,0,418798.35,DR,REF155361,CBA,Savings
15-08-2025 11:45,CBA10CCC271F99E462B9D42,063-000-001,22222222,7-ELEVEN CBA,48.64,0,418749.71,DR,REF760678,CBA,Savings
15-08-2025 11:56,CBAAE41C77977E145E691B3,063-000-001,22222222,APPLE CBA,35.54,0,418714.17,DR,REF343822,CBA,Savings
15-08-2025 12:03,CBA3CB839971DB5404798AB,063-000-001,22222222,AMAZON AU CBA,30.6,0,418683.57,DR,REF950269,CBA,Savings
15-08-2025 13:02,CBA46D56B6996AD442BA54F,063-000-001,22222222,APPLE CBA,6.6,0,418676.97,DR,REF307724,CBA,Savings
15-08-2025 13:02,CBAF208DC2F945D4DD48A1F,063-000-001,22222222,SPOTIFY CBA,59.62,0,418617.35,DR,REF200819,CBA,Savings
15-08-2025 13:42,CBA2853BC4D7B8C479CA44F,063-000-001,22222222,BIGW CBA,20.69,0,418596.66,DR,REF181196,CBA,Savings
15-08-2025 13:47,CBACB54BE0C8E58424C8A1C,063-000-001,22222222,7-ELEVEN CBA,94.89,0,418501.77,DR,REF858262,CBA,Savings
15-08-2025 13:55,CBA30F89603DB6D44D29C7C,063-000-001,22222222,UBER EATS CBA,48.14,0,418453.63,DR,REF665898,CBA,Savings
15-08-2025 14:08,CBA7857AF82C32C44DA8229,063-000-001,22222222,TAFE BOOKSHOP CBA,4.86,0,418448.77,DR,REF439840,CBA,Savings
15-08-2025 14:38,CBA18CF421A609B49D1A1F8,063-000-001,22222222,KFC CBA,50.7,0,418398.07,DR,REF452882,CBA,Savings
15-08-2025 15:57,CBA86F12FDDE17D47D8853C,063-000-001,22222222,WOOLWORTHS CBA,58.46,0,418339.61,DR,REF769112,CBA,Savings
15-08-2025 16:08,INTB9DBAE3D50AF46DAB699,063-000-001,22222222,TRANSFER FROM NAB 44444444,0,234.99,418574.6,CR,INT-28638,CBA,Savings
15-08-2025 16:12,CBA854D50FE66D84BE996D7,063-000-001,22222222,SPOTIFY CBA,23.92,0,418550.68,DR,REF818480,CBA,Savings
15-08-2025 16:12,CBAA5F4C04F7AEB486FB02D,063-000-001,22222222,MENULOG CBA,41.31,0,418509.37,DR,REF153753,CBA,Savings
15-08-2025 16:43,CBA51B075B139C04CAD8A1F,063-000-001,22222222,SHELL CBA,48.03,0,418461.34,DR,REF284242,CBA,Savings
15-08-2025 17:57,CBAADDA68D648C041918D36,063-000-001,22222222,MENULOG CBA,9.93,0,418451.41,DR,REF262905,CBA,Savings
15-08-2025 17:57,CBA3536EC72A818480DBB22,063-000-001,22222222,FLIXBUS CBA,14.39,0,418437.02,DR,REF682430,CBA,Savings
15-08-2025 18:42,CBA815ED82C9C774C64BFD1,063-000-001,22222222,FLIXBUS CBA,42.36,0,418394.66,DR,REF151238,CBA,Savings
15-08-2025 19:22,CBA5E009E4A6A024B50A564,063-000-001,22222222,CITYLINK CBA,42.69,0,418351.97,DR,REF504909,CBA,Savings
15-08-2025 19:47,CBA91821C5908E34423BF67,063-000-001,22222222,WAGES CREDIT CBA,0,3567.33,421919.3,CR,REF495619,CBA,Savings
15-08-2025 20:14,CBA09B4813CCD3D41B0A85C,063-000-001,22222222,HARVEY NORMAN CBA,52.28,0,421867.02,DR,REF258393,CBA,Savings
15-08-2025 20:29,CBA09F9BE6B28F041D6945F,063-000-001,22222222,JB HI-FI CBA,257.64,0,421609.38,DR,REF822450,CBA,Savings
15-08-2025 20:59,CBAB636B21A2A5C411D99B1,063-000-001,22222222,WAGES CREDIT CBA,0,686.81,422296.19,CR,REF356504,CBA,Savings
15-08-2025 21:20,CBAEF8CDAB48FCA4F21AC82,063-000-001,22222222,DOMINO'S PIZZA CBA,43.09,0,422253.1,DR,REF371991,CBA,Savings
15-08-2025 21:45,CBAF7D4CA17FE534F5BABF4,063-000-001,22222222,MENULOG CBA,60.78,0,422192.32,DR,REF977623,CBA,Savings
15-08-2025 22:01,CBAA1C97359AB534DCD8FC6,063-000-001,22222222,7-ELEVEN CBA,71.87,0,422120.45,DR,REF472539,CBA,Savings
15-08-2025 22:34,CBA72477FA170A44BE5B925,063-000-001,22222222,ALDI CBA,4.15,0,422116.3,DR,REF232680,CBA,Savings
15-08-2025 22:38,CBA4D8AF2DD3C224019AE99,063-000-001,22222222,ALDI CBA,107.5,0,422008.8,DR,REF106171,CBA,Savings
15-08-2025 22:41,CBA1481A678F0B84BC592E4,063-000-001,22222222,ALDI CBA,41.75,0,421967.05,DR,REF963142,CBA,Savings
15-08-2025 22:46,CBAA9E1967F5AB54F9B8997,063-000-001,22222222,PAYROLL CREDIT CBA,0,476.71,422443.76,CR,REF225633,CBA,Savings
15-08-2025 22:55,CBA02F445EEF69A49DC99AD,063-000-001,22222222,COLES CBA,14.95,0,422428.81,DR,REF592035,CBA,Savings
15-08-2025 23:19,CBA55F8B520CBB54903B267,063-000-001,22222222,MENULOG CBA,18.7,0,422410.11,DR,REF764717,CBA,Savings
16-08-2025 00:36,CBA4EEFB31F0BA14605BCE7,063-000-001,22222222,LIQUORLAND CBA,23.66,0,422386.45,DR,REF420400,CBA,Savings
16-08-2025 00:38,INTAD3134D0844F4FA7B420,063-000-001,22222222,TRANSFER TO ANZ 11111111,1887.94,0,420498.51,DR,INT-13675,CBA,Savings
16-08-2025 00:51,CBA10BAB71E1542453F902B,063-000-001,22222222,TAFE BOOKSHOP CBA,19.83,0,420478.68,DR,REF578843,CBA,Savings
16-08-2025 01:13,CBA6B58206726584051B62A,063-000-001,22222222,BWS CBA,23.57,0,420455.11,DR,REF543294,CBA,Savings
16-08-2025 01:39,CBA988FA494A86D45EABB84,063-000-001,22222222,MCDONALDS CBA,57.23,0,420397.88,DR,REF698673,CBA,Savings
16-08-2025 01:40,CBA99C59F13CC6D4CC8A3CF,063-000-001,22222222,WOOLWORTHS CBA,34.83,0,420363.05,DR,REF497954,CBA,Savings
16-08-2025 01:52,CBA1FB7173DFC40465FA40B,063-000-001,22222222,COLES CBA,10.29,0,420352.76,DR,REF752661,CBA,Savings
16-08-2025 01:56,CBA0A96CF88B732427D97B3,063-000-001,22222222,MCDONALDS CBA,3.71,0,420349.05,DR,REF108714,CBA,Savings
16-08-2025 02:00,CBACB70494B99D048648325,063-000-001,22222222,SALARY PAYMENT CBA,0,4266.58,424615.63,CR,REF521534,CBA,Savings
16-08-2025 02:06,CBA8D9F9D25D4294F41B5BA,063-000-001,22222222,ZOOM CBA,65.64,0,424549.99,DR,REF598521,CBA,Savings
16-08-2025 02:12,CBAACD81C76040943D1BA52,063-000-001,22222222,ALDI CBA,35.87,0,424514.12,DR,REF276937,CBA,Savings
16-08-2025 02:17,CBAF8322675981844DC82F2,063-000-001,22222222,BIGW CBA,76.47,0,424437.65,DR,REF771007,CBA,Savings
16-08-2025 02:50,CBA9934A09F8F1C404289BB,063-000-001,22222222,KFC CBA,35.59,0,424402.06,DR,REF366555,CBA,Savings
16-08-2025 03:14,CBADD6D6749BEA04743B82C,063-000-001,22222222,BWS CBA,21.73,0,424380.33,DR,REF514651,CBA,Savings
16-08-2025 03:21,CBA7C26D9FD7D3C4810B60E,063-000-001,22222222,MENULOG CBA,42.87,0,424337.46,DR,REF114461,CBA,Savings
16-08-2025 03:50,CBA46964AF5B2DB4F348083,063-000-001,22222222,BANK FEE CBA,14.55,0,424322.91,DR,REF591655,CBA,Savings
16-08-2025 03:54,CBA4916519F09AC483DA1DA,063-000-001,22222222,SALARY PAYMENT CBA,0,612.27,424935.18,CR,REF109706,CBA,Savings
16-08-2025 03:55,CBA52D57ACAA7A74A799607,063-000-001,22222222,RAILWAY STATION CBA,4.01,0,424931.17,DR,REF697839,CBA,Savings
16-08-2025 04:05,CBA13D9C148AA83420B8868,063-000-001,22222222,UBER EATS CBA,10.45,0,424920.72,DR,REF668535,CBA,Savings
16-08-2025 04:40,CBA1EB0728A684441659562,063-000-001,22222222,WOOLWORTHS CBA,4.53,0,424916.19,DR,REF348791,CBA,Savings
16-08-2025 05:47,CBA0088CBA2E3334E3E8E51,063-000-001,22222222,BANK FEE CBA,113.69,0,424802.5,DR,REF660097,CBA,Savings
16-08-2025 06:09,CBAE1CAB3C5A79B47658CB4,063-000-001,22222222,SHELL CBA,38.52,0,424763.98,DR,REF859539,CBA,Savings
16-08-2025 06:35,INTE18FDEB66B9A4F20BD4D,063-000-001,22222222,TRANSFER FROM ANZ 11111111,0,1812.31,426576.29,CR,INT-89865,CBA,Savings
16-08-2025 06:41,CBA954FAAD474AD4969B347,063-000-001,22222222,ALDI CBA,57.6,0,426518.69,DR,REF913695,CBA,Savings
16-08-2025 07:44,CBA6BE02E1E4126499FB3DB,063-000-001,22222222,JB HI-FI CBA,116.17,0,426402.52,DR,REF958618,CBA,Savings
16-08-2025 08:06,INT72F01ED9497F48F6A3BE,063-000-001,22222222,TRANSFER FROM NAB 44444444,0,1085.18,427487.7,CR,INT-16541,CBA,Savings
16-08-2025 08:20,CBA3A4555B5656A45448D32,063-000-001,22222222,SPOTIFY CBA,10.81,0,427476.89,DR,REF963945,CBA,Savings
16-08-2025 08:44,CBAD092DCF8B2BD4BCA91A9,063-000-001,22222222,PAYMENT GATEWAY CBA,40.85,0,427436.04,DR,REF137449,CBA,Savings
16-08-2025 09:16,CBA5C127B79C63448A1A8C0,063-000-001,22222222,HARVEY NORMAN CBA,27.12,0,427408.92,DR,REF323758,CBA,Savings
16-08-2025 09:36,CBAA4053821543943459C28,063-000-001,22222222,MENULOG CBA,103.8,0,427305.12,DR,REF465202,CBA,Savings
16-08-2025 09:37,CBA0903FAA309294355A1F4,063-000-001,22222222,INTERNET TRANSFER CBA,42.18,0,427262.94,DR,REF494947,CBA,Savings
16-08-2025 10:04,CBA61BABB6242EA4CA2817E,063-000-001,22222222,AMAZON AU CBA,147.15,0,427115.79,DR,REF248017,CBA,Savings
16-08-2025 10:05,CBA164391E1CF13483DAC6A,063-000-001,22222222,FLIXBUS CBA,66.29,0,427049.5,DR,REF851451,CBA,Savings
16-08-2025 10:13,CBA364C7BF31F234CD48856,063-000-001,22222222,WOOLWORTHS CBA,7.8,0,427041.7,DR,REF525130,CBA,Savings
16-08-2025 10:35,CBADCABFB5E948F40E5B3A8,063-000-001,22222222,PAYROLL CREDIT CBA,0,7444.75,434486.45,CR,REF686456,CBA,Savings
16-08-2025 10:55,CBA5A8F95AA0A4541D2A155,063-000-001,22222222,SHELL CBA,10.99,0,434475.46,DR,REF626616,CBA,Savings
16-08-2025 11:15,CBA5C6F0F21411349C2A4C2,063-000-001,22222222,BWS CBA,63.98,0,434411.48,DR,REF644070,CBA,Savings
16-08-2025 11:48,CBAA89CDB1DD1AA4626A310,063-000-001,22222222,SHELL CBA,77.04,0,434334.44,DR,REF639831,CBA,Savings
16-08-2025 12:12,CBADB3AFF71F10F4940B9D4,063-000-001,22222222,BWS CBA,53.13,0,434281.31,DR,REF392111,CBA,Savings
16-08-2025 12:12,CBA7372E957F14242E8B077,063-000-001,22222222,JB HI-FI CBA,30.98,0,434250.33,DR,REF869860,CBA,Savings
16-08-2025 12:35,CBA75DECE1EA0864FB4AE0E,063-000-001,22222222,SHELL CBA,6.51,0,434243.82,DR,REF539255,CBA,Savings
16-08-2025 13:06,CBACF85E8DC35EA4A158A2E,063-000-001,22222222,ZOOM CBA,19.48,0,434224.34,DR,REF400444,CBA,Savings
16-08-2025 13:07,CBAE515DEE841CB4C8CB01C,063-000-001,22222222,WAGES CREDIT CBA,0,958.24,435182.58,CR,REF615231,CBA,Savings
16-08-2025 13:47,CBA3E826218A3F24A75BA58,063-000-001,22222222,AMAZON AU CBA,12.06,0,435170.52,DR,REF728374,CBA,Savings
16-08-2025 14:19,CBA830803862C2F4B17B135,063-000-001,22222222,RAILWAY STATION CBA,24.36,0,435146.16,DR,REF273427,CBA,Savings
16-08-2025 14:20,CBACEBFDD5C70A74A9C9327,063-000-001,22222222,MENULOG CBA,134.32,0,435011.84,DR,REF851882,CBA,Savings
16-08-2025 14:33,CBAC33E65097638421A9C28,063-000-001,22222222,KFC CBA,13.88,0,434997.96,DR,REF127464,CBA,Savings
16-08-2025 14:42,CBA41A2F6BAA2BB4202BD29,063-000-001,22222222,TAFE BOOKSHOP CBA,6.89,0,434991.07,DR,REF392675,CBA,Savings
16-08-2025 14:44,CBAD34EF94855F5406C9511,063-000-001,22222222,WOOLWORTHS CBA,38.48,0,434952.59,DR,REF953924,CBA,Savings
16-08-2025 15:59,CBA5E01ADA01EB241F2BB63,063-000-001,22222222,BWS CBA,35.56,0,434917.03,DR,REF424771,CBA,Savings
16-08-2025 16:41,INTD503D354148D4A30B929,063-000-001,22222222,TRANSFER FROM CBA 33333333,0,449.18,435366.21,CR,INT-40658,CBA,Savings
16-08-2025 17:04,CBACF61FEE52BB44338907D,063-000-001,22222222,BANK FEE CBA,49.55,0,435316.66,DR,REF363566,CBA,Savings
16-08-2025 17:07,CBA73100376873346E7A5B2,063-000-001,22222222,BIGW CBA,33.08,0,435283.58,DR,REF407655,CBA,Savings
16-08-2025 17:11,INT94E6772FC65A422DA2C3,063-000-001,22222222,TRANSFER FROM NAB 44444444,0,1408.19,436691.77,CR,INT-28626,CBA,Savings
16-08-2025 17:25,CBA0A9B975BFEAD44E5A768,063-000-001,22222222,WOOLWORTHS CBA,150.74,0,436541.03,DR,REF657960,CBA,Savings
16-08-2025 17:32,CBA475D91655EAC40E1B8DC,063-000-001,22222222,ZOOM CBA,114.15,0,436426.88,DR,REF829590,CBA,Savings
16-08-2025 17:54,CBAF049C8C98B2E455EBB35,063-000-001,22222222,TAFE BOOKSHOP CBA,67.5,0,436359.38,DR,REF151481,CBA,Savings
16-08-2025 18:35,CBA8DFB55A613FB43CA858A,063-000-001,22222222,COMPANY PAYROLL CBA,0,7128.57,443487.95,CR,REF678102,CBA,Savings
16-08-2025 18:39,CBAB0518026A12F4BEBA943,063-000-001,22222222,BWS CBA,21.33,0,443466.62,DR,REF179590,CBA,Savings
16-08-2025 19:03,CBAF3A227BF0AFD4617AA8D,063-000-001,22222222,LIQUORLAND CBA,134.72,0,443331.9,DR,REF828218,CBA,Savings
16-08-2025 19:21,CBA29AC72F9FF894AF09ABC,063-000-001,22222222,PAYMENT GATEWAY CBA,22.8,0,443309.1,DR,REF265424,CBA,Savings
16-08-2025 19:30,CBAD74778BC49824405B29C,063-000-001,22222222,MCDONALDS CBA,2.95,0,443306.15,DR,REF982381,CBA,Savings
16-08-2025 19:30,CBA88F53CE35F6349FE80EB,063-000-001,22222222,SPOTIFY CBA,76.33,0,443229.82,DR,REF200634,CBA,Savings
16-08-2025 20:43,CBA0B27D83EE0DA4B5A83E9,063-000-001,22222222,KFC CBA,11.27,0,443218.55,DR,REF980088,CBA,Savings
16-08-2025 20:51,CBAAF70181B87494E038A00,063-000-001,22222222,FLIXBUS CBA,30.71,0,443187.84,DR,REF223087,CBA,Savings
16-08-2025 20:52,CBAA250E1540A3C4D20800A,063-000-001,22222222,SALARY PAYMENT CBA,0,5113,448300.84,CR,REF614927,CBA,Savings
16-08-2025 20:58,CBA29E3441342A14225979D,063-000-001,22222222,DOMINO'S PIZZA CBA,21.85,0,448278.99,DR,REF575645,CBA,Savings
16-08-2025 21:12,CBA2646029FC9424868B32E,063-000-001,22222222,PAYPAL *NETFLIX CBA,65.78,0,448213.21,DR,REF584410,CBA,Savings
16-08-2025 21:23,CBAF4D05CF6823A4FF6A17E,063-000-001,22222222,BP CBA,17.01,0,448196.2,DR,REF703120,CBA,Savings
16-08-2025 21:44,CBA3174EB15FF2644798BDB,063-000-001,22222222,7-ELEVEN CBA,96.68,0,448099.52,DR,REF530841,CBA,Savings
16-08-2025 21:59,CBAF2396E7C4CF643F79AC3,063-000-001,22222222,7-ELEVEN CBA,30.85,0,448068.67,DR,REF912569,CBA,Savings
16-08-2025 22:28,CBADB3E679D301A4996B109,063-000-001,22222222,CITYLINK CBA,122.18,0,447946.49,DR,REF670310,CBA,Savings
16-08-2025 23:18,CBAC1C07A20973943D5A009,063-000-001,22222222,FLIXBUS CBA,86.02,0,447860.47,DR,REF544316,CBA,Savings
16-08-2025 23:51,CBA28548FFB8C744E2C8955,063-000-001,22222222,UBER EATS CBA,23.56,0,447836.91,DR,REF248420,CBA,Savings
16-08-2025 23:53,CBABBDC8ED7DE594B6E97BE,063-000-001,22222222,INTERNET TRANSFER CBA,15.01,0,447821.9,DR,REF872235,CBA,Savings
17-08-2025 00:05,CBAC5C4422CC0AA4F1981E8,063-000-001,22222222,LIQUORLAND CBA,66.82,0,447755.08,DR,REF520250,CBA,Savings
17-08-2025 00:09,CBA972B49BC754C460CA6BE,063-000-001,22222222,UBER EATS CBA,13.94,0,447741.14,DR,REF796658,CBA,Savings
17-08-2025 00:13,CBAF614D0CE625D4491A053,063-000-001,22222222,AMAZON AU CBA,6.8,0,447734.34,DR,REF622961,CBA,Savings
17-08-2025 00:22,CBA96215CC30F4D4F9387D3,063-000-001,22222222,KFC CBA,11.99,0,447722.35,DR,REF788307,CBA,Savings
17-08-2025 00:51,CBA8079210FAC83459F9549,063-000-001,22222222,PAY - SALARY CBA,0,5324.57,453046.92,CR,REF975339,CBA,Savings
17-08-2025 00:58,CBA87F143027D094289B6EF,063-000-001,22222222,FLIXBUS CBA,48.58,0,452998.34,DR,REF253754,CBA,Savings
17-08-2025 01:02,CBA2466596C4BAB4733A6EB,063-000-001,22222222,CITYLINK CBA,38.06,0,452960.28,DR,REF151390,CBA,Savings
17-08-2025 01:19,CBA575711AFBEBC494CB5C0,063-000-001,22222222,LIQUORLAND CBA,28.02,0,452932.26,DR,REF196870,CBA,Savings
17-08-2025 02:29,CBA1F6DAC95F0564E66AD23,063-000-001,22222222,ALDI CBA,78.03,0,452854.23,DR,REF594656,CBA,Savings
17-08-2025 02:33,CBACF320D71BD7F44F79E05,063-000-001,22222222,PAYPAL *NETFLIX CBA,9.28,0,452844.95,DR,REF706794,CBA,Savings
17-08-2025 02:56,CBAAE9C52BB1EDE4E51A074,063-000-001,22222222,COLES CBA,25.79,0,452819.16,DR,REF236561,CBA,Savings
17-08-2025 03:10,CBA41D468F5B7EE44538C34,063-000-001,22222222,WOOLWORTHS CBA,64.02,0,452755.14,DR,REF490994,CBA,Savings
17-08-2025 03:18,CBAE2960F658DB24E3A82EE,063-000-001,22222222,PAYMENT GATEWAY CBA,43.31,0,452711.83,DR,REF283662,CBA,Savings
17-08-2025 03:28,CBA5D7D3E26C8364A07B3F7,063-000-001,22222222,TAFE BOOKSHOP CBA,32.77,0,452679.06,DR,REF260139,CBA,Savings
17-08-2025 03:33,CBAEBD1F874FF5649028684,063-000-001,22222222,UBER EATS CBA,176.91,0,452502.15,DR,REF432886,CBA,Savings
17-08-2025 03:55,CBAD401E9DEFEE142E88210,063-000-001,22222222,FLIXBUS CBA,121.18,0,452380.97,DR,REF948223,CBA,Savings
17-08-2025 04:37,CBAA7094AB62C71453EAA5A,063-000-001,22222222,MENULOG CBA,67.97,0,452313,DR,REF188812,CBA,Savings
17-08-2025 04:47,CBA6E4C783BF4104A39832F,063-000-001,22222222,COMPANY PAYROLL CBA,0,5942.28,458255.28,CR,REF190727,CBA,Savings
17-08-2025 04:55,CBA3A00D036FB014674913A,063-000-001,22222222,RAILWAY STATION CBA,172.53,0,458082.75,DR,REF293458,CBA,Savings
17-08-2025 05:02,CBA1D8472E0B3D74E7794E0,063-000-001,22222222,SPOTIFY CBA,49.73,0,458033.02,DR,REF820870,CBA,Savings
17-08-2025 05:11,CBAD4526745219049D9AFE7,063-000-001,22222222,APPLE CBA,11.02,0,458022,DR,REF222277,CBA,Savings
17-08-2025 05:13,CBACDD39ED63877458F84AC,063-000-001,22222222,HARVEY NORMAN CBA,99.13,0,457922.87,DR,REF873650,CBA,Savings
17-08-2025 05:15,CBA71C6E552F5A847F3AA36,063-000-001,22222222,SPOTIFY CBA,123.39,0,457799.48,DR,REF849473,CBA,Savings
17-08-2025 05:29,CBA8887BBCFFC9140489FE1,063-000-001,22222222,APPLE CBA,77.17,0,457722.31,DR,REF119479,CBA,Savings
17-08-2025 06:14,CBAD7E1367BB5944AA6BE7D,063-000-001,22222222,RAILWAY STATION CBA,100.23,0,457622.08,DR,REF102313,CBA,Savings
17-08-2025 06:25,CBA7BC2DEA73625430C9324,063-000-001,22222222,INTERNET TRANSFER CBA,3.47,0,457618.61,DR,REF374931,CBA,Savings
17-08-2025 06:49,CBA329EBCE45A5E407086A8,063-000-001,22222222,BWS CBA,26.13,0,457592.48,DR,REF667019,CBA,Savings
17-08-2025 06:58,CBA97ABF0FAF3CB4B3CB957,063-000-001,22222222,AMAZON AU CBA,15.99,0,457576.49,DR,REF475517,CBA,Savings
17-08-2025 07:40,CBADF84826390A04EF78AD0,063-000-001,22222222,APPLE CBA,22.31,0,457554.18,DR,REF810016,CBA,Savings
17-08-2025 08:01,CBAF6ED0083503248F9AE2E,063-000-001,22222222,KFC CBA,144.05,0,457410.13,DR,REF442838,CBA,Savings
17-08-2025 08:10,CBA6D49E45995174E9FAC57,063-000-001,22222222,ALDI CBA,61.65,0,457348.48,DR,REF955824,CBA,Savings
17-08-2025 08:29,CBADCCF22F39A7342588D65,063-000-001,22222222,PAY - SALARY CBA,0,4678.86,462027.34,CR,REF156171,CBA,Savings
17-08-2025 10:14,CBA994EB86C369B437B8013,063-000-001,22222222,PAYMENT GATEWAY CBA,247.94,0,461779.4,DR,REF655786,CBA,Savings
17-08-2025 11:00,CBA3AE1F9DE91E14C72B765,063-000-001,22222222,MENULOG CBA,56.76,0,461722.64,DR,REF684799,CBA,Savings
17-08-2025 11:08,CBA74A83E090C1C492685B5,063-000-001,22222222,SPOTIFY CBA,7.52,0,461715.12,DR,REF574779,CBA,Savings
17-08-2025 11:31,CBA31EBBEA5716E491CA5C9,063-000-001,22222222,CITYLINK CBA,28.15,0,461686.97,DR,REF369104,CBA,Savings
17-08-2025 12:00,CBABE247D64E89F42E28544,063-000-001,22222222,INTERNET TRANSFER CBA,84.35,0,461602.62,DR,REF414771,CBA,Savings
17-08-2025 12:10,CBAFCF53A1A89404ECF9EE2,063-000-001,22222222,7-ELEVEN CBA,68.98,0,461533.64,DR,REF529365,CBA,Savings
17-08-2025 12:14,CBA32E2DDC4C1574EBE9330,063-000-001,22222222,CITYLINK CBA,25.33,0,461508.31,DR,REF803840,CBA,Savings
17-08-2025 12:50,CBAB46F3519C0574D25A97A,063-000-001,22222222,RAILWAY STATION CBA,139.57,0,461368.74,DR,REF126595,CBA,Savings
17-08-2025 13:10,CBA7A7A6A5330FD490B8166,063-000-001,22222222,ZOOM CBA,66.76,0,461301.98,DR,REF339518,CBA,Savings
17-08-2025 13:31,CBAB248A6876906480A9340,063-000-001,22222222,CITYLINK CBA,16.22,0,461285.76,DR,REF783099,CBA,Savings
17-08-2025 13:36,CBA3A446789BEAE443FA7F6,063-000-001,22222222,SPOTIFY CBA,16.66,0,461269.1,DR,REF657738,CBA,Savings
17-08-2025 13:54,CBABB13D6FD92E84E84B591,063-000-001,22222222,PAY - SALARY CBA,0,6109.67,467378.77,CR,REF945039,CBA,Savings
17-08-2025 14:30,INT36EE382E0EDD47DFA0B2,063-000-001,22222222,TRANSFER FROM CBA 33333333,0,1256.54,468635.31,CR,INT-40286,CBA,Savings
17-08-2025 14:35,CBA353028F3B9BE421FA68A,063-000-001,22222222,RAILWAY STATION CBA,56.62,0,468578.69,DR,REF297490,CBA,Savings
17-08-2025 14:42,CBAD353866402D14F21824D,063-000-001,22222222,WOOLWORTHS CBA,3.97,0,468574.72,DR,REF365018,CBA,Savings
17-08-2025 15:10,CBA670A49FC82E049CB9368,063-000-001,22222222,SPOTIFY CBA,77.56,0,468497.16,DR,REF102704,CBA,Savings
17-08-2025 15:12,CBAE87FDBF2AE134D238BA8,063-000-001,22222222,TAFE BOOKSHOP CBA,131.55,0,468365.61,DR,REF893722,CBA,Savings
17-08-2025 15:24,CBAC891720CAE3A4C848A94,063-000-001,22222222,ZOOM CBA,7.86,0,468357.75,DR,REF507651,CBA,Savings
17-08-2025 15:49,CBA6E83C0146DC844C8B6BA,063-000-001,22222222,CITYLINK CBA,87.95,0,468269.8,DR,REF246110,CBA,Savings
17-08-2025 16:34,CBA8E2E7715C8744CBCB1E0,063-000-001,22222222,ALDI CBA,12.81,0,468256.99,DR,REF784345,CBA,Savings
17-08-2025 17:34,CBA34676E4D3808459283A5,063-000-001,22222222,AMAZON AU CBA,33.78,0,468223.21,DR,REF491319,CBA,Savings
17-08-2025 17:38,CBAEBD7AE9790B2456F88DF,063-000-001,22222222,7-ELEVEN CBA,5.17,0,468218.04,DR,REF218854,CBA,Savings
17-08-2025 17:46,CBA716A5E842B0D42DD9481,063-000-001,22222222,ALDI CBA,117.83,0,468100.21,DR,REF779387,CBA,Savings
17-08-2025 18:06,INTB802257936D44CA99FFA,063-000-001,22222222,TRANSFER TO ANZ 11111111,1107.23,0,466992.98,DR,INT-25088,CBA,Savings
17-08-2025 18:09,INT9AB8E3287F4249FF9301,063-000-001,22222222,TRANSFER FROM NAB 44444444,0,1875.49,468868.47,CR,INT-67101,CBA,Savings
17-08-2025 18:23,CBA1A6D903C9B4C4C80994B,063-000-001,22222222,BIGW CBA,28.71,0,468839.76,DR,REF434435,CBA,Savings
17-08-2025 18:43,CBA5DEE23027825456FA6C0,063-000-001,22222222,RAILWAY STATION CBA,217.52,0,468622.24,DR,REF671617,CBA,Savings
17-08-2025 19:13,CBA00C26E1E136A4279A4BC,063-000-001,22222222,KFC CBA,78.29,0,468543.95,DR,REF370111,CBA,Savings
17-08-2025 19:24,CBA0851A2AE05514B93A328,063-000-001,22222222,LIQUORLAND CBA,77.32,0,468466.63,DR,REF200057,CBA,Savings
17-08-2025 20:39,CBAF195273479734245B061,063-000-001,22222222,SHELL CBA,39.76,0,468426.87,DR,REF418481,CBA,Savings
17-08-2025 20:49,CBA2016455A1C8B4B84BB8E,063-000-001,22222222,INTERNET TRANSFER CBA,68.46,0,468358.41,DR,REF481143,CBA,Savings
17-08-2025 21:00,CBAB41C845BA7834813BD94,063-000-001,22222222,BWS CBA,89.89,0,468268.52,DR,REF632119,CBA,Savings
17-08-2025 21:01,CBA5626D3BA8700416F8BDC,063-000-001,22222222,PAYPAL *NETFLIX CBA,15.8,0,468252.72,DR,REF956145,CBA,Savings
17-08-2025 21:07,CBA3C8B839E204248D9B302,063-000-001,22222222,AMAZON AU CBA,42.57,0,468210.15,DR,REF502320,CBA,Savings
17-08-2025 21:14,CBA1ECCB59229CE42B48320,063-000-001,22222222,SPOTIFY CBA,7.69,0,468202.46,DR,REF265157,CBA,Savings
17-08-2025 21:18,CBAF1A7F78ECDCD4F059043,063-000-001,22222222,COMPANY PAYROLL CBA,0,7434.03,475636.49,CR,REF681505,CBA,Savings
17-08-2025 21:20,CBA762C5BF8C1C9468193E8,063-000-001,22222222,MCDONALDS CBA,82.82,0,475553.67,DR,REF345537,CBA,Savings
17-08-2025 22:09,CBAE8E7788A9C794853B069,063-000-001,22222222,AMAZON AU CBA,17.82,0,475535.85,DR,REF150024,CBA,Savings
17-08-2025 22:18,CBA3CA1418A284448658A5A,063-000-001,22222222,FLIXBUS CBA,125.62,0,475410.23,DR,REF298277,CBA,Savings
17-08-2025 22:18,CBA4DC41AEE6B5D45A09C4A,063-000-001,22222222,PAYPAL *NETFLIX CBA,19.23,0,475391,DR,REF749572,CBA,Savings
17-08-2025 23:13,CBA860CA0BC215149FE9098,063-000-001,22222222,JB HI-FI CBA,22.94,0,475368.06,DR,REF645065,CBA,Savings
17-08-2025 23:32,CBAE04C77C88EEC4592B2A3,063-000-001,22222222,BANK FEE CBA,9.02,0,475359.04,DR,REF532260,CBA,Savings
17-08-2025 23:41,CBAD0B0A8D37F7B4A3590B2,063-000-001,22222222,PAYPAL *NETFLIX CBA,57.63,0,475301.41,DR,REF608078,CBA,Savings
17-08-2025 23:42,CBA4F255198FD7E4E10BEF1,063-000-001,22222222,COMPANY PAYROLL CBA,0,2721.9,478023.31,CR,REF799549,CBA,Savings
17-08-2025 23:52,CBA21969B7CF0014ACEB0C3,063-000-001,22222222,BIGW CBA,16.26,0,478007.05,DR,REF485271,CBA,Savings
17-08-2025 23:57,CBAB068BA637FA54998BBE8,063-000-001,22222222,ZOOM CBA,7.77,0,477999.28,DR,REF262921,CBA,Savings
18-08-2025 00:12,CBAB3DE9095BD774F3DBFED,063-000-001,22222222,MENULOG CBA,71.99,0,477927.29,DR,REF955331,CBA,Savings
18-08-2025 01:33,CBA264C4053F6CB4F51A091,063-000-001,22222222,KFC CBA,38.98,0,477888.31,DR,REF441501,CBA,Savings
18-08-2025 01:42,CBA15BA151056F14D77906D,063-000-001,22222222,7-ELEVEN CBA,102.84,0,477785.47,DR,REF475181,CBA,Savings
18-08-2025 01:59,CBACCB21A8B615A44AA9EC9,063-000-001,22222222,DOMINO'S PIZZA CBA,105.21,0,477680.26,DR,REF344562,CBA,Savings
18-08-2025 02:14,CBA49D029CCE7474AFEA0E0,063-000-001,22222222,PAY - SALARY CBA,0,897.32,478577.58,CR,REF654066,CBA,Savings
18-08-2025 02:17,CBAFADAC3AADE5B4245BFBC,063-000-001,22222222,JB HI-FI CBA,7.35,0,478570.23,DR,REF912757,CBA,Savings
18-08-2025 02:49,CBA1AF7224807A84D93B3C9,063-000-001,22222222,WOOLWORTHS CBA,44.97,0,478525.26,DR,REF571309,CBA,Savings
18-08-2025 03:20,CBAC661246B20EB41A89588,063-000-001,22222222,BP CBA,43.62,0,478481.64,DR,REF837377,CBA,Savings
18-08-2025 03:37,CBA8CF2B331F2FA40BA8590,063-000-001,22222222,BP CBA,15.3,0,478466.34,DR,REF789263,CBA,Savings
18-08-2025 04:15,CBAD12C2002FE744CB0BE0F,063-000-001,22222222,LIQUORLAND CBA,5.93,0,478460.41,DR,REF313840,CBA,Savings
18-08-2025 04:24,CBAC66E6909DFA64F0AB828,063-000-001,22222222,BIGW CBA,21.9,0,478438.51,DR,REF462111,CBA,Savings
18-08-2025 04:24,CBA572E1B784A934349AAE3,063-000-001,22222222,BWS CBA,45.07,0,478393.44,DR,REF719276,CBA,Savings
18-08-2025 04:35,CBA23CB7C181F8D4AC4AC1D,063-000-001,22222222,SPOTIFY CBA,175.66,0,478217.78,DR,REF936896,CBA,Savings
18-08-2025 04:46,CBA6A09E9C5C8074431BBC1,063-000-001,22222222,BP CBA,7.44,0,478210.34,DR,REF653420,CBA,Savings
18-08-2025 04:49,CBA75E60E07241E4640B976,063-000-001,22222222,BIGW CBA,2.11,0,478208.23,DR,REF732215,CBA,Savings
18-08-2025 05:12,CBA71452E7B5A854C8092D4,063-000-001,22222222,PAY - SALARY CBA,0,536.44,478744.67,CR,REF245050,CBA,Savings
18-08-2025 05:32,INTB481EB9889C349DD9554,063-000-001,22222222,TRANSFER FROM ANZ 11111111,0,1712.82,480457.49,CR,INT-17116,CBA,Savings
18-08-2025 05:44,CBAA4FDD787D45A4B689D77,063-000-001,22222222,PAYPAL *NETFLIX CBA,31.99,0,480425.5,DR,REF154322,CBA,Savings
18-08-2025 05:53,CBADFB688A73F9F419FBC95,063-000-001,22222222,SALARY PAYMENT CBA,0,101.19,480526.69,CR,REF101541,CBA,Savings
18-08-2025 05:54,CBA7689B1124F484FCCB5C8,063-000-001,22222222,AMAZON AU CBA,53.17,0,480473.52,DR,REF394319,CBA,Savings
18-08-2025 06:57,CBAE578EC1F4FDD498D9825,063-000-001,22222222,BWS CBA,3.3,0,480470.22,DR,REF837340,CBA,Savings
18-08-2025 08:08,CBABE673189955742998F42,063-000-001,22222222,AMAZON AU CBA,57.45,0,480412.77,DR,REF285023,CBA,Savings
18-08-2025 08:35,CBA571E30EB8C0944AC87FB,063-000-001,22222222,COMPANY PAYROLL CBA,0,7459.36,487872.13,CR,REF328378,CBA,Savings
18-08-2025 08:42,CBAFBDDC2FD2D154F8589C0,063-000-001,22222222,PAYMENT GATEWAY CBA,21.99,0,487850.14,DR,REF506567,CBA,Savings
18-08-2025 09:45,CBA091EEE6BABE64B9B898F,063-000-001,22222222,SHELL CBA,40.67,0,487809.47,DR,REF360061,CBA,Savings
18-08-2025 09:52,CBA2E83BD69DF7A4626B025,063-000-001,22222222,BP CBA,51.54,0,487757.93,DR,REF653469,CBA,Savings
18-08-2025 10:05,CBA24664D46959B4BE999D1,063-000-001,22222222,AMAZON AU CBA,13.2,0,487744.73,DR,REF921339,CBA,Savings
18-08-2025 10:16,CBAFDA93269A8EE4E92A41C,063-000-001,22222222,RAILWAY STATION CBA,23.27,0,487721.46,DR,REF839757,CBA,Savings
18-08-2025 10:20,CBAB8D6E715F564401C897D,063-000-001,22222222,AMAZON AU CBA,96.5,0,487624.96,DR,REF549194,CBA,Savings
18-08-2025 10:51,CBAD8859205032647E093E5,063-000-001,22222222,JB HI-FI CBA,187.73,0,487437.23,DR,REF915937,CBA,Savings
18-08-2025 11:15,INT508BE026C08843B6A490,063-000-001,22222222,TRANSFER FROM CBA 33333333,0,1379.29,488816.52,CR,INT-70040,CBA,Savings
18-08-2025 11:22,CBA8D19CCBCE4384652BD5C,063-000-001,22222222,TAFE BOOKSHOP CBA,23.78,0,488792.74,DR,REF171788,CBA,Savings
18-08-2025 12:24,CBA7A8EA0B75D1D42D4875F,063-000-001,22222222,KFC CBA,21.75,0,488770.99,DR,REF354270,CBA,Savings
18-08-2025 13:02,CBA2C5FA6FF62C5425186CB,063-000-001,22222222,BP CBA,16.64,0,488754.35,DR,REF706337,CBA,Savings
18-08-2025 13:14,CBAEC6FFE69FE164AB6AE63,063-000-001,22222222,MENULOG CBA,9.3,0,488745.05,DR,REF162589,CBA,Savings
18-08-2025 13:14,CBAD6D8A95293884CAFB8B7,063-000-001,22222222,PAYMENT GATEWAY CBA,18.6,0,488726.45,DR,REF486673,CBA,Savings
18-08-2025 13:19,CBAFBABFD3253DF48E2A746,063-000-001,22222222,FLIXBUS CBA,26.35,0,488700.1,DR,REF710196,CBA,Savings
18-08-2025 13:32,CBA07A7DD5098A343CE88CF,063-000-001,22222222,JB HI-FI CBA,64.76,0,488635.34,DR,REF737816,CBA,Savings
18-08-2025 13:54,CBABE5FF5360C9B4A898D7E,063-000-001,22222222,DOMINO'S PIZZA CBA,28.35,0,488606.99,DR,REF443857,CBA,Savings
18-08-2025 14:11,CBA2F296CFF976249C1ABCF,063-000-001,22222222,PAYMENT GATEWAY CBA,27.6,0,488579.39,DR,REF340527,CBA,Savings
18-08-2025 14:18,CBAE00BEEFB3BDC4C7DB520,063-000-001,22222222,PAYMENT GATEWAY CBA,87.16,0,488492.23,DR,REF577168,CBA,Savings
18-08-2025 14:22,CBADFDFEB61B1824FE99270,063-000-001,22222222,UBER EATS CBA,35.72,0,488456.51,DR,REF841476,CBA,Savings
18-08-2025 14:34,CBA6F70B65F69084713A23A,063-000-001,22222222,ZOOM CBA,17.1,0,488439.41,DR,REF101089,CBA,Savings
18-08-2025 14:34,CBABED5D2695EE94AE89C95,063-000-001,22222222,SPOTIFY CBA,124.99,0,488314.42,DR,REF814169,CBA,Savings
18-08-2025 14:39,CBA1B0E8AB34B6C4E0E8929,063-000-001,22222222,ZOOM CBA,76.4,0,488238.02,DR,REF467034,CBA,Savings
18-08-2025 15:05,CBABF58AF78A18C4A679B2F,063-000-001,22222222,ZOOM CBA,41.39,0,488196.63,DR,REF177591,CBA,Savings
18-08-2025 15:20,CBAB4810FFCF56D4A94894B,063-000-001,22222222,JB HI-FI CBA,64.29,0,488132.34,DR,REF330927,CBA,Savings
18-08-2025 15:33,CBA4DDA0192A93A40F69553,063-000-001,22222222,DOMINO'S PIZZA CBA,22.13,0,488110.21,DR,REF422692,CBA,Savings
18-08-2025 15:35,CBA925EDA8A038F448797D4,063-000-001,22222222,COLES CBA,32.82,0,488077.39,DR,REF805079,CBA,Savings
18-08-2025 15:38,CBA8271F27F19A1421BB7CC,063-000-001,22222222,MENULOG CBA,68.68,0,488008.71,DR,REF271295,CBA,Savings
18-08-2025 16:25,CBA36C84C87E6EF4DBABCE5,063-000-001,22222222,CITYLINK CBA,25.9,0,487982.81,DR,REF294095,CBA,Savings
18-08-2025 16:37,CBA07E9099D05FE46E7A761,063-000-001,22222222,WOOLWORTHS CBA,24.19,0,487958.62,DR,REF833009,CBA,Savings
18-08-2025 16:54,CBA386FB9D49F1B450789D5,063-000-001,22222222,SPOTIFY CBA,13.18,0,487945.44,DR,REF509302,CBA,Savings
18-08-2025 17:13,CBA50C6D7C7A3914B7484B2,063-000-001,22222222,HARVEY NORMAN CBA,22.82,0,487922.62,DR,REF553631,CBA,Savings
18-08-2025 17:26,CBAF28E8364EED04D2C964D,063-000-001,22222222,STARBUCKS CBA,100.69,0,487821.93,DR,REF305963,CBA,Savings
18-08-2025 17:29,CBAE583947C76274D298A20,063-000-001,22222222,APPLE CBA,44.54,0,487777.39,DR,REF402402,CBA,Savings
18-08-2025 17:50,CBA4DE9A77DA16B4420A5B2,063-000-001,22222222,LIQUORLAND CBA,10.74,0,487766.65,DR,REF667070,CBA,Savings
18-08-2025 18:03,CBA2A6C7FAD47D64AF6866D,063-000-001,22222222,APPLE CBA,11.1,0,487755.55,DR,REF807750,CBA,Savings
18-08-2025 18:33,CBA60387AD7824640728C4E,063-000-001,22222222,AMAZON AU CBA,13.66,0,487741.89,DR,REF736741,CBA,Savings
18-08-2025 18:57,CBA295CE39DC3B64F81BF27,063-000-001,22222222,STARBUCKS CBA,127.38,0,487614.51,DR,REF798680,CBA,Savings
18-08-2025 19:12,CBA2647BCA46BCA4C088DA8,063-000-001,22222222,COLES CBA,42.2,0,487572.31,DR,REF461314,CBA,Savings
18-08-2025 20:03,CBA40B7D4ECC4CB4310BF56,063-000-001,22222222,WOOLWORTHS CBA,44.13,0,487528.18,DR,REF293433,CBA,Savings
18-08-2025 20:13,CBAC0BDF25CB4EF41B1B7FF,063-000-001,22222222,SALARY PAYMENT CBA,0,701.55,488229.73,CR,REF166676,CBA,Savings
18-08-2025 22:22,CBA12EBDEF77B064138A038,063-000-001,22222222,COLES CBA,71.75,0,488157.98,DR,REF280959,CBA,Savings
18-08-2025 22:23,INT4E95C9127D94404DA59C,063-000-001,22222222,TRANSFER TO ANZ 11111111,881.08,0,487276.9,DR,INT-25157,CBA,Savings
18-08-2025 22:44,CBAD4270577A547403D846B,063-000-001,22222222,BIGW CBA,50.02,0,487226.88,DR,REF638250,CBA,Savings
18-08-2025 23:02,CBA3E4D87AC2C16490CBEED,063-000-001,22222222,COMPANY PAYROLL CBA,0,3771.07,490997.95,CR,REF531837,CBA,Savings
18-08-2025 23:21,CBA92ECFFBE537F49D3A535,063-000-001,22222222,CITYLINK CBA,106.76,0,490891.19,DR,REF966075,CBA,Savings
18-08-2025 23:37,CBA9170F937D50441E6B948,063-000-001,22222222,ZOOM CBA,6.07,0,490885.12,DR,REF825698,CBA,Savings
19-08-2025 00:26,CBA24F00480FC1546FE8EB1,063-000-001,22222222,INTERNET TRANSFER CBA,3.26,0,490881.86,DR,REF208092,CBA,Savings
19-08-2025 00:35,CBAB836EB7BB8BC479AA67E,063-000-001,22222222,JB HI-FI CBA,96.64,0,490785.22,DR,REF289441,CBA,Savings
19-08-2025 00:43,CBA347ACF1ACBEF4A699FE3,063-000-001,22222222,SPOTIFY CBA,5.75,0,490779.47,DR,REF127272,CBA,Savings
19-08-2025 01:20,CBACA07E1CC3B1E41ADBC76,063-000-001,22222222,SPOTIFY CBA,23.75,0,490755.72,DR,REF595992,CBA,Savings
19-08-2025 01:36,CBAC31C8EB756204807BC5E,063-000-001,22222222,SALARY PAYMENT CBA,0,4307.12,495062.84,CR,REF262613,CBA,Savings
19-08-2025 01:55,CBAF899A0111C2D4E7DA6F5,063-000-001,22222222,LIQUORLAND CBA,43.8,0,495019.04,DR,REF251969,CBA,Savings
19-08-2025 01:58,CBA7B32CDDA8BCF4685BCCA,063-000-001,22222222,COMPANY PAYROLL CBA,0,5377.22,500396.26,CR,REF836466,CBA,Savings
19-08-2025 02:08,CBA4D5DE47D6A3B469BAA87,063-000-001,22222222,COLES CBA,70.22,0,500326.04,DR,REF460612,CBA,Savings
19-08-2025 02:22,CBA30C54278EDAD42538097,063-000-001,22222222,MCDONALDS CBA,21.62,0,500304.42,DR,REF197219,CBA,Savings
19-08-2025 02:30,CBA2E73F9AC553349DAA1EB,063-000-001,22222222,INTERNET TRANSFER CBA,14.18,0,500290.24,DR,REF572665,CBA,Savings
19-08-2025 03:56,CBA4D76CC3827784C9EB526,063-000-001,22222222,COLES CBA,40.11,0,500250.13,DR,REF738264,CBA,Savings
19-08-2025 04:00,CBA454CCF9285C84374BCF8,063-000-001,22222222,PAY - SALARY CBA,0,836.9,501087.03,CR,REF183964,CBA,Savings
19-08-2025 04:02,CBA17E17E7E4AD7472FB435,063-000-001,22222222,HARVEY NORMAN CBA,85.5,0,501001.53,DR,REF943676,CBA,Savings
19-08-2025 04:47,CBAA45937E263A24DC39418,063-000-001,22222222,COLES CBA,9.73,0,500991.8,DR,REF777494,CBA,Savings
19-08-2025 05:21,CBA8DB04F54C6D843729044,063-000-001,22222222,INTERNET TRANSFER CBA,5.04,0,500986.76,DR,REF247917,CBA,Savings
19-08-2025 05:43,CBA271CE9C6FCBC42B89C6F,063-000-001,22222222,WAGES CREDIT CBA,0,1827.02,502813.78,CR,REF114814,CBA,Savings
19-08-2025 06:08,CBA21E71B30A88C4FD78F2D,063-000-001,22222222,BWS CBA,94.08,0,502719.7,DR,REF805760,CBA,Savings
19-08-2025 06:34,CBA0EBE74D4C4414BE39E76,063-000-001,22222222,MCDONALDS CBA,8.61,0,502711.09,DR,REF287336,CBA,Savings
19-08-2025 06:36,INTEE9B5D8AF36F460FBB1C,063-000-001,22222222,TRANSFER TO ANZ 11111111,276.64,0,502434.45,DR,INT-57610,CBA,Savings
19-08-2025 06:40,CBA02CED4DA0A904860A51E,063-000-001,22222222,JB HI-FI CBA,112.31,0,502322.14,DR,REF445804,CBA,Savings
19-08-2025 06:43,CBA7372135BC200478389F5,063-000-001,22222222,APPLE CBA,72.37,0,502249.77,DR,REF817886,CBA,Savings
19-08-2025 07:51,CBA7952D557A8F04972B31D,063-000-001,22222222,PAY - SALARY CBA,0,687.95,502937.72,CR,REF105283,CBA,Savings
19-08-2025 07:57,CBAD316FAB31DD34F7E9E9C,063-000-001,22222222,UBER EATS CBA,47.65,0,502890.07,DR,REF591177,CBA,Savings
19-08-2025 07:59,INTBDE0DB7D212C476B94A5,063-000-001,22222222,TRANSFER TO CBA 33333333,872.33,0,502017.74,DR,INT-30926,CBA,Savings
19-08-2025 09:53,CBA3FBAEA164BEA4C158F3D,063-000-001,22222222,BIGW CBA,55.04,0,501962.7,DR,REF522181,CBA,Savings
19-08-2025 10:05,CBAC2EDD9DCEA2D4302B861,063-000-001,22222222,MCDONALDS CBA,7.47,0,501955.23,DR,REF538510,CBA,Savings
19-08-2025 10:14,CBAF6C008B5C3074647BAA2,063-000-001,22222222,PAYPAL *NETFLIX CBA,70.34,0,501884.89,DR,REF346632,CBA,Savings
19-08-2025 10:18,CBA6AFF7076CDB94A798845,063-000-001,22222222,FLIXBUS CBA,40.58,0,501844.31,DR,REF698883,CBA,Savings
19-08-2025 10:20,INTB5DCEF271B174DFBAAA5,063-000-001,22222222,TRANSFER TO NAB 44444444,1312.85,0,500531.46,DR,INT-33871,CBA,Savings
19-08-2025 10:27,CBACDE8BAF13BD44A5380C9,063-000-001,22222222,FLIXBUS CBA,7.42,0,500524.04,DR,REF722696,CBA,Savings
19-08-2025 10:27,CBA25E58DAE60574A09B599,063-000-001,22222222,STARBUCKS CBA,64.39,0,500459.65,DR,REF760160,CBA,Savings
19-08-2025 10:28,CBAA24387BBE91B49E0B8C1,063-000-001,22222222,COMPANY PAYROLL CBA,0,4083.54,504543.19,CR,REF854409,CBA,Savings
19-08-2025 10:31,CBA30AB12EE7017493097D7,063-000-001,22222222,SPOTIFY CBA,36.98,0,504506.21,DR,REF206750,CBA,Savings
19-08-2025 10:50,CBAC039C1DF8E08475EBB6E,063-000-001,22222222,BANK FEE CBA,79.56,0,504426.65,DR,REF656610,CBA,Savings
19-08-2025 11:25,CBA0A186F48925B4B9DA504,063-000-001,22222222,STARBUCKS CBA,114.91,0,504311.74,DR,REF839902,CBA,Savings
19-08-2025 11:47,CBAFAE8712910EF4B00B7FA,063-000-001,22222222,COMPANY PAYROLL CBA,0,3386.07,507697.81,CR,REF886802,CBA,Savings
19-08-2025 11:58,CBA00D4C142068C4B2BBC30,063-000-001,22222222,STARBUCKS CBA,79.94,0,507617.87,DR,REF705687,CBA,Savings
19-08-2025 12:08,CBA8323A8DED516466FB1BC,063-000-001,22222222,KFC CBA,61.37,0,507556.5,DR,REF308212,CBA,Savings
19-08-2025 12:14,CBAB4448CF396264BF386B9,063-000-001,22222222,CITYLINK CBA,3.7,0,507552.8,DR,REF640885,CBA,Savings
19-08-2025 12:24,CBAFB082A677D5F4F85ADC4,063-000-001,22222222,KFC CBA,21.61,0,507531.19,DR,REF683927,CBA,Savings
19-08-2025 12:35,CBAF8CC91B51CD242DF9222,063-000-001,22222222,COMPANY PAYROLL CBA,0,6689.58,514220.77,CR,REF251465,CBA,Savings
19-08-2025 12:39,CBA823422E23B6848E295C7,063-000-001,22222222,PAYPAL *NETFLIX CBA,10.28,0,514210.49,DR,REF378953,CBA,Savings
19-08-2025 14:17,CBAE2D6295082214A9A8E67,063-000-001,22222222,MENULOG CBA,176.59,0,514033.9,DR,REF274311,CBA,Savings
19-08-2025 14:45,CBAE0DE6BE9249B45F19796,063-000-001,22222222,UBER EATS CBA,47.12,0,513986.78,DR,REF640387,CBA,Savings
19-08-2025 14:56,CBA6B59761311144FA3903F,063-000-001,22222222,RAILWAY STATION CBA,18.46,0,513968.32,DR,REF660176,CBA,Savings
19-08-2025 15:09,CBA1C7516CAAE7341E78D0A,063-000-001,22222222,SHELL CBA,53.74,0,513914.58,DR,REF766474,CBA,Savings
19-08-2025 15:16,CBAF559B43DEAC14686ACFD,063-000-001,22222222,ALDI CBA,91.03,0,513823.55,DR,REF423245,CBA,Savings
19-08-2025 15:39,CBA87696C6EDC7C4648A3D9,063-000-001,22222222,CITYLINK CBA,54.91,0,513768.64,DR,REF589061,CBA,Savings
19-08-2025 15:54,CBA37B1B849BCBD4824B257,063-000-001,22222222,KFC CBA,21.91,0,513746.73,DR,REF881688,CBA,Savings
19-08-2025 16:28,INT34AD055889AD42AAA95C,063-000-001,22222222,TRANSFER TO CBA 33333333,1513.7,0,512233.03,DR,INT-60238,CBA,Savings
19-08-2025 16:33,CBAF49DA363E00C445AACB5,063-000-001,22222222,SPOTIFY CBA,95.94,0,512137.09,DR,REF443209,CBA,Savings
19-08-2025 16:53,CBA60E8805F8AD94BE58663,063-000-001,22222222,BP CBA,65.95,0,512071.14,DR,REF109958,CBA,Savings
19-08-2025 16:54,CBAE7E27AFF3CA34BC58FAA,063-000-001,22222222,WAGES CREDIT CBA,0,7513.15,519584.29,CR,REF247997,CBA,Savings
19-08-2025 17:46,CBAD1D9D4D0E4DF40818BD8,063-000-001,22222222,BIGW CBA,54.21,0,519530.08,DR,REF957428,CBA,Savings
19-08-2025 17:55,CBA16BD8B8DCB4F4F8C9B3C,063-000-001,22222222,MCDONALDS CBA,169.94,0,519360.14,DR,REF342611,CBA,Savings
19-08-2025 17:55,CBA88E4071AABBD4FBB808A,063-000-001,22222222,HARVEY NORMAN CBA,4.51,0,519355.63,DR,REF255431,CBA,Savings
19-08-2025 17:57,INT8C6B69B8FA13481EA935,063-000-001,22222222,TRANSFER FROM CBA 33333333,0,1189.37,520545,CR,INT-21943,CBA,Savings
19-08-2025 18:02,CBAB40DB1C9A2054972A38C,063-000-001,22222222,MCDONALDS CBA,74.51,0,520470.49,DR,REF582733,CBA,Savings
19-08-2025 18:21,CBA55895C80677746279AA9,063-000-001,22222222,UBER EATS CBA,13.68,0,520456.81,DR,REF584481,CBA,Savings
19-08-2025 18:23,CBA9A9EAE14E204452BAB53,063-000-001,22222222,COLES CBA,90.09,0,520366.72,DR,REF643799,CBA,Savings
19-08-2025 18:51,CBA1C5198A2F92F427C8757,063-000-001,22222222,APPLE CBA,2.93,0,520363.79,DR,REF749663,CBA,Savings
19-08-2025 19:01,CBA88407398E1D64265B2BC,063-000-001,22222222,PAYMENT GATEWAY CBA,84.55,0,520279.24,DR,REF231182,CBA,Savings
19-08-2025 19:31,CBA71ADE860A4F6443FA239,063-000-001,22222222,ALDI CBA,65.44,0,520213.8,DR,REF340938,CBA,Savings
19-08-2025 19:40,CBA06A512AFB7F949EB8E7C,063-000-001,22222222,INTERNET TRANSFER CBA,21.52,0,520192.28,DR,REF412136,CBA,Savings
19-08-2025 19:55,CBA64BBD1E2C14647D096B5,063-000-001,22222222,PAYROLL CREDIT CBA,0,620.81,520813.09,CR,REF879176,CBA,Savings
19-08-2025 20:28,CBAF22B34EAE9FF45BD99CC,063-000-001,22222222,BP CBA,107.59,0,520705.5,DR,REF800566,CBA,Savings
19-08-2025 20:37,CBA6EBA1FDC702F4DFDB156,063-000-001,22222222,BIGW CBA,47.35,0,520658.15,DR,REF671951,CBA,Savings
19-08-2025 20:41,CBAF3AF3F8CFFAC4D4DA708,063-000-001,22222222,PAYMENT GATEWAY CBA,50.55,0,520607.6,DR,REF303389,CBA,Savings
19-08-2025 21:00,CBA5EF735FE50664D1CA600,063-000-001,22222222,TAFE BOOKSHOP CBA,37.21,0,520570.39,DR,REF450733,CBA,Savings
19-08-2025 21:01,CBA9CA15B3EF97C45EBBCF9,063-000-001,22222222,PAY - SALARY CBA,0,4949.64,525520.03,CR,REF577203,CBA,Savings
19-08-2025 21:11,CBA976DC79BBE3948889F2B,063-000-001,22222222,MENULOG CBA,17,0,525503.03,DR,REF563859,CBA,Savings
19-08-2025 21:18,CBAEF3AFEDB376040BC8109,063-000-001,22222222,DOMINO'S PIZZA CBA,11.62,0,525491.41,DR,REF349934,CBA,Savings
19-08-2025 21:47,CBA4DD65912AC43476BBB34,063-000-001,22222222,WOOLWORTHS CBA,97.59,0,525393.82,DR,REF638848,CBA,Savings
19-08-2025 21:52,CBA100296A3EA4E425BA5B9,063-000-001,22222222,BANK FEE CBA,42.99,0,525350.83,DR,REF724124,CBA,Savings
19-08-2025 22:44,CBA497A8C985D9743ACB20C,063-000-001,22222222,KFC CBA,22.22,0,525328.61,DR,REF959472,CBA,Savings
19-08-2025 22:58,CBAAE7AC1D5279A4BFDBB9A,063-000-001,22222222,ZOOM CBA,6.78,0,525321.83,DR,REF685447,CBA,Savings
19-08-2025 23:03,CBAEFDC9339351241508A15,063-000-001,22222222,APPLE CBA,49.6,0,525272.23,DR,REF708393,CBA,Savings
19-08-2025 23:36,CBA74A138E6356642AF9609,063-000-001,22222222,SALARY PAYMENT CBA,0,6919.96,532192.19,CR,REF321259,CBA,Savings
20-08-2025 00:45,CBAD0A745213CBF48DCB4D3,063-000-001,22222222,ZOOM CBA,61.27,0,532130.92,DR,REF387759,CBA,Savings
20-08-2025 01:27,CBA734CFF4EE5154ABAB937,063-000-001,22222222,JB HI-FI CBA,17.49,0,532113.43,DR,REF506912,CBA,Savings
20-08-2025 01:52,CBAA13C80EA4AE045E1B9D3,063-000-001,22222222,WOOLWORTHS CBA,214.98,0,531898.45,DR,REF676368,CBA,Savings
20-08-2025 02:47,CBA453C86B95394465F9AFF,063-000-001,22222222,WOOLWORTHS CBA,72.22,0,531826.23,DR,REF752179,CBA,Savings
20-08-2025 03:49,CBA4FC25D710D4F4ACAB448,063-000-001,22222222,SHELL CBA,206.41,0,531619.82,DR,REF886118,CBA,Savings
20-08-2025 04:42,CBAFC4BF33F270E42A480BF,063-000-001,22222222,PAY - SALARY CBA,0,754.25,532374.07,CR,REF897299,CBA,Savings
20-08-2025 05:00,CBA85CEBE5DBE5F4A3F90D0,063-000-001,22222222,UBER EATS CBA,25.97,0,532348.1,DR,REF894034,CBA,Savings
20-08-2025 05:13,CBAFE2C29410E6B49A1B377,063-000-001,22222222,STARBUCKS CBA,23.34,0,532324.76,DR,REF190424,CBA,Savings
20-08-2025 05:32,CBA683EDF489A5F4AB5972E,063-000-001,22222222,SPOTIFY CBA,103.85,0,532220.91,DR,REF573055,CBA,Savings
20-08-2025 05:55,INTD236245458E7472AB7FE,063-000-001,22222222,TRANSFER FROM ANZ 11111111,0,1848.84,534069.75,CR,INT-17167,CBA,Savings
20-08-2025 06:11,CBAD478ACC3525945609424,063-000-001,22222222,BIGW CBA,15.41,0,534054.34,DR,REF707874,CBA,Savings
20-08-2025 07:00,CBA65A1F46762014DA0A7B3,063-000-001,22222222,FLIXBUS CBA,92.9,0,533961.44,DR,REF452795,CBA,Savings
20-08-2025 07:06,CBA6A9829A867B24F218E2F,063-000-001,22222222,COMPANY PAYROLL CBA,0,7433.86,541395.3,CR,REF382390,CBA,Savings
20-08-2025 07:09,CBAFB9A6C88A9AA4497944C,063-000-001,22222222,WOOLWORTHS CBA,20.88,0,541374.42,DR,REF829576,CBA,Savings
20-08-2025 07:40,CBA491BA95E65374046AE4C,063-000-001,22222222,UBER EATS CBA,102.23,0,541272.19,DR,REF399772,CBA,Savings
20-08-2025 08:19,CBA2F7BA28C552A4F0FACA7,063-000-001,22222222,BP CBA,42.26,0,541229.93,DR,REF422579,CBA,Savings
20-08-2025 08:34,CBAE236BC6A599D4BD99109,063-000-001,22222222,APPLE CBA,67.12,0,541162.81,DR,REF631591,CBA,Savings
20-08-2025 08:41,CBAE84A47FDA3744EAAAFAE,063-000-001,22222222,RAILWAY STATION CBA,151.89,0,541010.92,DR,REF900272,CBA,Savings
20-08-2025 08:56,CBA3B122D0710AE49789098,063-000-001,22222222,PAY - SALARY CBA,0,6070.53,547081.45,CR,REF897833,CBA,Savings
20-08-2025 09:20,CBA3BA7852C615049AAAB55,063-000-001,22222222,SHELL CBA,19.63,0,547061.82,DR,REF353888,CBA,Savings
20-08-2025 09:29,CBA16054D6B2561498C9374,063-000-001,22222222,TAFE BOOKSHOP CBA,26.28,0,547035.54,DR,REF840971,CBA,Savings
20-08-2025 09:36,CBA5357C0F4C791481B987C,063-000-001,22222222,SPOTIFY CBA,17.37,0,547018.17,DR,REF791884,CBA,Savings
20-08-2025 09:36,CBA0F2EB0A224B94808BF10,063-000-001,22222222,AMAZON AU CBA,129.96,0,546888.21,DR,REF757993,CBA,Savings
20-08-2025 10:04,CBA16BA8FD7036A481C847A,063-000-001,22222222,7-ELEVEN CBA,44.6,0,546843.61,DR,REF309636,CBA,Savings
20-08-2025 10:30,CBA69636694A6F94F4CB27D,063-000-001,22222222,COLES CBA,43.5,0,546800.11,DR,REF711085,CBA,Savings
20-08-2025 11:08,CBA9FA2E035C1B8494B9966,063-000-001,22222222,PAYMENT GATEWAY CBA,23.49,0,546776.62,DR,REF475816,CBA,Savings
20-08-2025 11:09,CBAC94B4BC40E984CFAAFAD,063-000-001,22222222,HARVEY NORMAN CBA,28.01,0,546748.61,DR,REF984097,CBA,Savings
20-08-2025 11:42,CBAC01CAE8EC0B247D98C1E,063-000-001,22222222,RAILWAY STATION CBA,38.59,0,546710.02,DR,REF653596,CBA,Savings
20-08-2025 12:32,CBA302699CA830947FBBCA5,063-000-001,22222222,DOMINO'S PIZZA CBA,40.15,0,546669.87,DR,REF838586,CBA,Savings
20-08-2025 12:49,CBA4DD468D8FCAF478CACF2,063-000-001,22222222,STARBUCKS CBA,45.4,0,546624.47,DR,REF822643,CBA,Savings
20-08-2025 12:58,CBA46A09E399ECA4B789AD1,063-000-001,22222222,LIQUORLAND CBA,32.75,0,546591.72,DR,REF840193,CBA,Savings
20-08-2025 13:17,CBAA190B075620B49D2AD0F,063-000-001,22222222,DOMINO'S PIZZA CBA,91.22,0,546500.5,DR,REF908180,CBA,Savings
20-08-2025 13:44,CBA7EB2629C0E1C48DBB229,063-000-001,22222222,SPOTIFY CBA,155.32,0,546345.18,DR,REF750041,CBA,Savings
20-08-2025 13:54,CBAF902E864CBB34D82BF82,063-000-001,22222222,ZOOM CBA,45.18,0,546300,DR,REF949287,CBA,Savings
20-08-2025 14:16,CBA41A4CF9205524F8AB540,063-000-001,22222222,PAYROLL CREDIT CBA,0,3751.43,550051.43,CR,REF424866,CBA,Savings
20-08-2025 14:49,CBA586BFC6F956243F8B462,063-000-001,22222222,HARVEY NORMAN CBA,166.07,0,549885.36,DR,REF797843,CBA,Savings
20-08-2025 14:53,CBA827AB9144C574525BD0C,063-000-001,22222222,PAYROLL CREDIT CBA,0,614.97,550500.33,CR,REF528963,CBA,Savings
20-08-2025 15:07,CBA56C1A1C8619D4A5098DC,063-000-001,22222222,APPLE CBA,16.03,0,550484.3,DR,REF391732,CBA,Savings
20-08-2025 15:44,CBA6E416390F30543E39561,063-000-001,22222222,RAILWAY STATION CBA,75.84,0,550408.46,DR,REF374347,CBA,Savings
20-08-2025 15:56,CBA750182D8219348CB8C5A,063-000-001,22222222,PAYROLL CREDIT CBA,0,767.77,551176.23,CR,REF585256,CBA,Savings
20-08-2025 16:07,CBAA622DDD2D5714548A487,063-000-001,22222222,ZOOM CBA,5.93,0,551170.3,DR,REF439161,CBA,Savings
20-08-2025 16:32,CBACFEF8F6402BD4FD3B5E3,063-000-001,22222222,UBER EATS CBA,60.99,0,551109.31,DR,REF104082,CBA,Savings
20-08-2025 16:45,CBAC3B0E0094E9842EAB1B5,063-000-001,22222222,PAYROLL CREDIT CBA,0,856.68,551965.99,CR,REF686904,CBA,Savings
20-08-2025 16:58,INT985E7B7A25CC4E64AC4F,063-000-001,22222222,TRANSFER TO NAB 44444444,890.56,0,551075.43,DR,INT-93756,CBA,Savings
20-08-2025 17:05,INT1B9962150BDD477791D1,063-000-001,22222222,TRANSFER FROM NAB 44444444,0,1264.5,552339.93,CR,INT-64548,CBA,Savings
20-08-2025 17:24,CBA79F0976AA1C34841882F,063-000-001,22222222,FLIXBUS CBA,78.51,0,552261.42,DR,REF878358,CBA,Savings
20-08-2025 17:49,CBAAE21F026B3B94CE8A761,063-000-001,22222222,LIQUORLAND CBA,12.49,0,552248.93,DR,REF498702,CBA,Savings
20-08-2025 17:50,CBAA0E45257BA0E4C48B133,063-000-001,22222222,CITYLINK CBA,31.5,0,552217.43,DR,REF388148,CBA,Savings
20-08-2025 18:36,CBA385F53543CBB4682B54A,063-000-001,22222222,BANK FEE CBA,53.88,0,552163.55,DR,REF248195,CBA,Savings
20-08-2025 18:38,CBA023D14D94FF049F391F9,063-000-001,22222222,UBER EATS CBA,63.7,0,552099.85,DR,REF323081,CBA,Savings
20-08-2025 18:47,CBA75135C4A48AE47958728,063-000-001,22222222,FLIXBUS CBA,19.88,0,552079.97,DR,REF329510,CBA,Savings
20-08-2025 19:17,CBA2E523434E5D14E3A9B7E,063-000-001,22222222,DOMINO'S PIZZA CBA,63,0,552016.97,DR,REF249811,CBA,Savings
20-08-2025 19:37,CBA3C1C26B943004AABA00F,063-000-001,22222222,FLIXBUS CBA,31.65,0,551985.32,DR,REF596981,CBA,Savings
20-08-2025 19:42,CBACB180823CDB34B80A580,063-000-001,22222222,UBER EATS CBA,36.5,0,551948.82,DR,REF600998,CBA,Savings
20-08-2025 19:45,CBAC959BEFE852845FAB607,063-000-001,22222222,HARVEY NORMAN CBA,110.1,0,551838.72,DR,REF962160,CBA,Savings
20-08-2025 19:58,CBA71DAF9C540F549C0A28F,063-000-001,22222222,AMAZON AU CBA,241.54,0,551597.18,DR,REF933584,CBA,Savings
20-08-2025 19:58,CBAE7C7F60F606F48AAAEAC,063-000-001,22222222,KFC CBA,58.2,0,551538.98,DR,REF409237,CBA,Savings
20-08-2025 20:12,CBA55A4416D3111471887A8,063-000-001,22222222,BANK FEE CBA,5.15,0,551533.83,DR,REF913909,CBA,Savings
20-08-2025 20:32,CBAE2C138C3F8B34954BB94,063-000-001,22222222,BIGW CBA,33.34,0,551500.49,DR,REF319632,CBA,Savings
20-08-2025 20:37,CBAA10E2820F434437BBDBF,063-000-001,22222222,DOMINO'S PIZZA CBA,68.89,0,551431.6,DR,REF809852,CBA,Savings
20-08-2025 20:54,CBA348AA299FF0D41D4BFFB,063-000-001,22222222,AMAZON AU CBA,9.63,0,551421.97,DR,REF164989,CBA,Savings
20-08-2025 21:09,CBAB2C5088A45EB465990F9,063-000-001,22222222,AMAZON AU CBA,25.37,0,551396.6,DR,REF305429,CBA,Savings
20-08-2025 21:21,CBA52D8FB73CB6147B5A981,063-000-001,22222222,COLES CBA,2.2,0,551394.4,DR,REF710165,CBA,Savings
20-08-2025 21:46,CBA977C39A059F8439EAA1E,063-000-001,22222222,WOOLWORTHS CBA,260.11,0,551134.29,DR,REF813086,CBA,Savings
20-08-2025 21:58,CBA302A48ED725A415E8614,063-000-001,22222222,WOOLWORTHS CBA,20.98,0,551113.31,DR,REF239270,CBA,Savings
20-08-2025 22:06,CBA4644DF61197A47229B03,063-000-001,22222222,JB HI-FI CBA,5.71,0,551107.6,DR,REF446764,CBA,Savings
20-08-2025 22:13,CBA09FC0E2EF6FF4CC79CDE,063-000-001,22222222,SALARY PAYMENT CBA,0,6562.91,557670.51,CR,REF156608,CBA,Savings
20-08-2025 22:14,CBA0902BBE902684FAFB566,063-000-001,22222222,SHELL CBA,40.86,0,557629.65,DR,REF736431,CBA,Savings
20-08-2025 23:00,CBA8BFE9BB2E6E74BEBA8E4,063-000-001,22222222,LIQUORLAND CBA,62.34,0,557567.31,DR,REF579097,CBA,Savings
20-08-2025 23:30,CBA971EFAB3038E4477B24B,063-000-001,22222222,APPLE CBA,53.87,0,557513.44,DR,REF955408,CBA,Savings
20-08-2025 23:41,CBA6B341FB157AC49C58EF6,063-000-001,22222222,PAYPAL *NETFLIX CBA,7.87,0,557505.57,DR,REF659204,CBA,Savings
21-08-2025 00:17,CBA1AB637178F2A497CB159,063-000-001,22222222,7-ELEVEN CBA,10.35,0,557495.22,DR,REF468795,CBA,Savings
21-08-2025 00:17,CBA69135F126B274191B2A5,063-000-001,22222222,APPLE CBA,60.72,0,557434.5,DR,REF801901,CBA,Savings
21-08-2025 00:29,CBA30A8B588E6864278AF14,063-000-001,22222222,PAYPAL *NETFLIX CBA,98.26,0,557336.24,DR,REF465419,CBA,Savings
21-08-2025 00:51,INT95E55133FF3C4A0CB601,063-000-001,22222222,TRANSFER FROM NAB 44444444,0,602.5,557938.74,CR,INT-47013,CBA,Savings
21-08-2025 00:56,CBA853E07506EA3407A8155,063-000-001,22222222,STARBUCKS CBA,41.91,0,557896.83,DR,REF433326,CBA,Savings
21-08-2025 00:57,INT73188E648600444F81E3,063-000-001,22222222,TRANSFER FROM NAB 44444444,0,1901.33,559798.16,CR,INT-87177,CBA,Savings
21-08-2025 00:59,CBA3B5447D64A4442D49D0E,063-000-001,22222222,FLIXBUS CBA,12.25,0,559785.91,DR,REF888544,CBA,Savings
21-08-2025 01:12,CBA19407DF8BC6145038A0E,063-000-001,22222222,MENULOG CBA,55.7,0,559730.21,DR,REF541722,CBA,Savings
21-08-2025 02:15,CBAD2FDB24354454BBBA22F,063-000-001,22222222,COMPANY PAYROLL CBA,0,7735.4,567465.61,CR,REF611030,CBA,Savings
21-08-2025 02:24,CBA652154B918234FB7B559,063-000-001,22222222,MCDONALDS CBA,18.13,0,567447.48,DR,REF300145,CBA,Savings
21-08-2025 02:36,CBAF693FA9799A1475088D1,063-000-001,22222222,CITYLINK CBA,4.17,0,567443.31,DR,REF988357,CBA,Savings
21-08-2025 02:37,CBAA09446971E1A45029D7C,063-000-001,22222222,BANK FEE CBA,19.34,0,567423.97,DR,REF270272,CBA,Savings
21-08-2025 02:39,CBAE1433B0D6C0E45F28EA8,063-000-001,22222222,UBER EATS CBA,31.58,0,567392.39,DR,REF997837,CBA,Savings
21-08-2025 03:01,CBA39054240524A4B6BBD3A,063-000-001,22222222,LIQUORLAND CBA,7.8,0,567384.59,DR,REF359669,CBA,Savings
21-08-2025 03:23,CBAF7AEA67EA5D5406A8520,063-000-001,22222222,SHELL CBA,47.06,0,567337.53,DR,REF987125,CBA,Savings
21-08-2025 03:52,CBAACA47A6290E0453DAF1E,063-000-001,22222222,COLES CBA,20.07,0,567317.46,DR,REF972039,CBA,Savings
21-08-2025 04:03,CBA6D125EC353C74992AB28,063-000-001,22222222,SALARY PAYMENT CBA,0,5947.5,573264.96,CR,REF911095,CBA,Savings
21-08-2025 04:07,CBA0E8855452C5C4EED9D90,063-000-001,22222222,SHELL CBA,47.38,0,573217.58,DR,REF605591,CBA,Savings
21-08-2025 04:17,CBAC95A918D12DC4830A9E5,063-000-001,22222222,TAFE BOOKSHOP CBA,20.51,0,573197.07,DR,REF558760,CBA,Savings
21-08-2025 04:35,CBAEF2565A42FF1475A9BFB,063-000-001,22222222,SHELL CBA,13.65,0,573183.42,DR,REF143989,CBA,Savings
21-08-2025 04:48,CBAD8C6468301EA4A92A3DD,063-000-001,22222222,PAYPAL *NETFLIX CBA,19.37,0,573164.05,DR,REF710274,CBA,Savings
21-08-2025 05:02,CBAAA4DD1C62C694F0EA0C5,063-000-001,22222222,MCDONALDS CBA,18.17,0,573145.88,DR,REF576725,CBA,Savings
21-08-2025 05:04,CBA4ADB7FD66AC54746A2FD,063-000-001,22222222,TAFE BOOKSHOP CBA,11.15,0,573134.73,DR,REF298238,CBA,Savings
21-08-2025 05:11,CBA6470FEF9BD464BAC99D3,063-000-001,22222222,BP CBA,111.16,0,573023.57,DR,REF280566,CBA,Savings
21-08-2025 05:18,CBA9DA3D094B85D41CA981A,063-000-001,22222222,BANK FEE CBA,215.52,0,572808.05,DR,REF974649,CBA,Savings
21-08-2025 05:54,CBA80600AEB01424B7C8E04,063-000-001,22222222,ZOOM CBA,124.41,0,572683.64,DR,REF216058,CBA,Savings
21-08-2025 06:10,CBA51BA62597EF441199CD2,063-000-001,22222222,BWS CBA,28.1,0,572655.54,DR,REF788874,CBA,Savings
21-08-2025 06:22,CBA3999D859B86845BEAACB,063-000-001,22222222,KFC CBA,49.29,0,572606.25,DR,REF481676,CBA,Savings
21-08-2025 07:24,CBABBA050108BF64D3F81FE,063-000-001,22222222,7-ELEVEN CBA,72.33,0,572533.92,DR,REF594945,CBA,Savings
21-08-2025 07:28,CBA1760CEC3B172407F99BC,063-000-001,22222222,ZOOM CBA,20.54,0,572513.38,DR,REF904989,CBA,Savings
21-08-2025 07:42,CBAFDE0AC34339A49C89CBC,063-000-001,22222222,APPLE CBA,218.35,0,572295.03,DR,REF433567,CBA,Savings
21-08-2025 07:53,CBA7E47B058F520405EAD61,063-000-001,22222222,PAYROLL CREDIT CBA,0,6774.36,579069.39,CR,REF760472,CBA,Savings
21-08-2025 08:55,CBA0C049A0DF0AC403EA1F3,063-000-001,22222222,WOOLWORTHS CBA,119.87,0,578949.52,DR,REF447044,CBA,Savings
21-08-2025 09:06,CBAC6EF6550795440FF9F58,063-000-001,22222222,CITYLINK CBA,63.29,0,578886.23,DR,REF436380,CBA,Savings
21-08-2025 09:19,CBADA401624DC794615BD52,063-000-001,22222222,KFC CBA,13.83,0,578872.4,DR,REF276174,CBA,Savings
21-08-2025 09:19,CBAC101F8D1D03A452194E2,063-000-001,22222222,PAY - SALARY CBA,0,7883.17,586755.57,CR,REF634481,CBA,Savings
21-08-2025 09:22,CBAF1A5E62281F44B5EBC3D,063-000-001,22222222,INTERNET TRANSFER CBA,43.58,0,586711.99,DR,REF623259,CBA,Savings
21-08-2025 09:30,CBA88574539C1DF4587BF56,063-000-001,22222222,PAYPAL *NETFLIX CBA,107.73,0,586604.26,DR,REF795618,CBA,Savings
21-08-2025 09:45,CBAFD16C994BD304DA68EB6,063-000-001,22222222,ZOOM CBA,5.49,0,586598.77,DR,REF297101,CBA,Savings
21-08-2025 09:54,INT99B007291BF84C46AD7F,063-000-001,22222222,TRANSFER FROM ANZ 11111111,0,753.4,587352.17,CR,INT-72056,CBA,Savings
21-08-2025 10:11,CBA47A5FC393BB54B9DBB0E,063-000-001,22222222,BIGW CBA,35.39,0,587316.78,DR,REF341604,CBA,Savings
21-08-2025 10:15,CBA45DD1762BE5F45E79C1C,063-000-001,22222222,HARVEY NORMAN CBA,4.99,0,587311.79,DR,REF330932,CBA,Savings
21-08-2025 10:25,CBAA9F9ED1977E34975B8AB,063-000-001,22222222,BIGW CBA,21.57,0,587290.22,DR,REF991036,CBA,Savings
21-08-2025 10:37,CBA4D309606290C4AA4968B,063-000-001,22222222,DOMINO'S PIZZA CBA,81.63,0,587208.59,DR,REF323578,CBA,Savings
21-08-2025 11:29,CBA58E2C5C480AC47928734,063-000-001,22222222,COLES CBA,46.02,0,587162.57,DR,REF201666,CBA,Savings
21-08-2025 11:34,CBAE7CFB2B12FBD4674BC19,063-000-001,22222222,PAYROLL CREDIT CBA,0,748,587910.57,CR,REF981110,CBA,Savings
21-08-2025 11:43,CBADF1A73D435C24E7CBAB6,063-000-001,22222222,ALDI CBA,21.22,0,587889.35,DR,REF284368,CBA,Savings
21-08-2025 11:45,CBA149694D4176C4CF5A4DB,063-000-001,22222222,ZOOM CBA,3.61,0,587885.74,DR,REF334841,CBA,Savings
21-08-2025 12:05,CBA18BE3447766F49E28908,063-000-001,22222222,BP CBA,21.22,0,587864.52,DR,REF809217,CBA,Savings
21-08-2025 12:07,CBAACB86AC3E03C401AA856,063-000-001,22222222,WAGES CREDIT CBA,0,191.14,588055.66,CR,REF231124,CBA,Savings
21-08-2025 12:11,CBAE28A7757C31A45F59023,063-000-001,22222222,ALDI CBA,5.55,0,588050.11,DR,REF411892,CBA,Savings
21-08-2025 12:19,CBA228548F51CA7436DAB93,063-000-001,22222222,FLIXBUS CBA,69.9,0,587980.21,DR,REF105199,CBA,Savings
21-08-2025 12:33,CBA7D577ECE48AB4987AD1F,063-000-001,22222222,APPLE CBA,66.81,0,587913.4,DR,REF344396,CBA,Savings
21-08-2025 13:35,CBA9117788D4C674936858E,063-000-001,22222222,SHELL CBA,100.71,0,587812.69,DR,REF622951,CBA,Savings
21-08-2025 13:42,CBA1EE3CC68B02B4685A991,063-000-001,22222222,HARVEY NORMAN CBA,7.93,0,587804.76,DR,REF369598,CBA,Savings
21-08-2025 13:42,CBA21DFD338734142FCA70C,063-000-001,22222222,BP CBA,40.88,0,587763.88,DR,REF989232,CBA,Savings
21-08-2025 13:49,CBAACB5682C69E44AF08FC0,063-000-001,22222222,CITYLINK CBA,39.35,0,587724.53,DR,REF602742,CBA,Savings
21-08-2025 14:13,CBA712B8E5ACC764CFCAFE7,063-000-001,22222222,BANK FEE CBA,36.11,0,587688.42,DR,REF946638,CBA,Savings
21-08-2025 14:27,CBAD8F576C4BACD4E99B1CD,063-000-001,22222222,PAYPAL *NETFLIX CBA,80.7,0,587607.72,DR,REF626046,CBA,Savings
21-08-2025 15:01,INT0A595BD742644BCBA788,063-000-001,22222222,TRANSFER TO ANZ 11111111,1818.23,0,585789.49,DR,INT-95644,CBA,Savings
21-08-2025 15:21,CBA75E7E256FDF34AF68198,063-000-001,22222222,MENULOG CBA,10.18,0,585779.31,DR,REF344994,CBA,Savings
21-08-2025 15:37,CBA8BBA14FD357A4B28BE6A,063-000-001,22222222,MCDONALDS CBA,28.02,0,585751.29,DR,REF996391,CBA,Savings
21-08-2025 15:53,CBAEDA37AA4AC3C497ABBC6,063-000-001,22222222,COLES CBA,217.31,0,585533.98,DR,REF597655,CBA,Savings
21-08-2025 16:03,CBA70A778242F424960AF4C,063-000-001,22222222,PAYROLL CREDIT CBA,0,1049.32,586583.3,CR,REF975988,CBA,Savings
21-08-2025 16:35,CBA8AFDAC7A5BA74403864D,063-000-001,22222222,PAYMENT GATEWAY CBA,60.01,0,586523.29,DR,REF311525,CBA,Savings
21-08-2025 16:49,CBA79BD3BE4C83F4A4BA023,063-000-001,22222222,DOMINO'S PIZZA CBA,70.12,0,586453.17,DR,REF880321,CBA,Savings
21-08-2025 16:52,CBA1E1E1E382BF74B47AD27,063-000-001,22222222,COMPANY PAYROLL CBA,0,847.04,587300.21,CR,REF703601,CBA,Savings
21-08-2025 17:16,CBA81F4291856F345558FD7,063-000-001,22222222,PAYROLL CREDIT CBA,0,5230.55,592530.76,CR,REF742254,CBA,Savings
21-08-2025 17:21,CBA5FBC37BCA06743B09366,063-000-001,22222222,BIGW CBA,29.8,0,592500.96,DR,REF428822,CBA,Savings
21-08-2025 17:50,CBAA4F6F65D8B2B4789954B,063-000-001,22222222,MENULOG CBA,14.12,0,592486.84,DR,REF227214,CBA,Savings
21-08-2025 18:13,CBA7D9A83DC8820478BBE0A,063-000-001,22222222,KFC CBA,199.55,0,592287.29,DR,REF454475,CBA,Savings
21-08-2025 19:48,CBA51651E961C604B399E77,063-000-001,22222222,PAYROLL CREDIT CBA,0,2874.96,595162.25,CR,REF204901,CBA,Savings
21-08-2025 20:05,CBAAA97D370E39C47E8AE83,063-000-001,22222222,SPOTIFY CBA,44.71,0,595117.54,DR,REF812884,CBA,Savings
21-08-2025 20:12,CBA90EAF2036A144791BC0E,063-000-001,22222222,INTERNET TRANSFER CBA,6.13,0,595111.41,DR,REF502760,CBA,Savings
21-08-2025 20:19,CBADD7D7B907FCB440BA3AF,063-000-001,22222222,PAY - SALARY CBA,0,6275.94,601387.35,CR,REF261895,CBA,Savings
21-08-2025 20:21,CBAB7A291E47C1F448182EB,063-000-001,22222222,PAYMENT GATEWAY CBA,18.45,0,601368.9,DR,REF868008,CBA,Savings
21-08-2025 20:32,CBA86BDB8F13AC04916A311,063-000-001,22222222,STARBUCKS CBA,57.37,0,601311.53,DR,REF217876,CBA,Savings
21-08-2025 20:34,CBA645B36AE37464226A007,063-000-001,22222222,PAYMENT GATEWAY CBA,36.53,0,601275,DR,REF416439,CBA,Savings
21-08-2025 21:18,CBAE07E778B10C4443E9F34,063-000-001,22222222,KFC CBA,11.17,0,601263.83,DR,REF135416,CBA,Savings
21-08-2025 21:26,CBAAE0E57F181194A328BE5,063-000-001,22222222,DOMINO'S PIZZA CBA,41.35,0,601222.48,DR,REF662535,CBA,Savings
21-08-2025 21:26,INTC2F35D82F1AC41948174,063-000-001,22222222,TRANSFER FROM CBA 33333333,0,1449.46,602671.94,CR,INT-50487,CBA,Savings
21-08-2025 21:38,CBAC6D7E4C25F4248068E54,063-000-001,22222222,STARBUCKS CBA,54.32,0,602617.62,DR,REF863286,CBA,Savings
21-08-2025 21:48,CBACFD95A2B750742F88967,063-000-001,22222222,LIQUORLAND CBA,186.35,0,602431.27,DR,REF183686,CBA,Savings
21-08-2025 22:14,CBA7549431251C343DDB431,063-000-001,22222222,APPLE CBA,40.19,0,602391.08,DR,REF914838,CBA,Savings
21-08-2025 22:21,INT500CA21100D64F3EAAA4,063-000-001,22222222,TRANSFER FROM NAB 44444444,0,1336.83,603727.91,CR,INT-45920,CBA,Savings
21-08-2025 22:27,CBA189846C1F72944B988AD,063-000-001,22222222,JB HI-FI CBA,48.64,0,603679.27,DR,REF107059,CBA,Savings
21-08-2025 22:36,INT5369169EB934485F96D0,063-000-001,22222222,TRANSFER FROM ANZ 11111111,0,1742.74,605422.01,CR,INT-22178,CBA,Savings
21-08-2025 22:41,CBA251881139CC94AD695F7,063-000-001,22222222,STARBUCKS CBA,14.36,0,605407.65,DR,REF798059,CBA,Savings
21-08-2025 23:32,CBAD3175A2C19C74212A6EE,063-000-001,22222222,ALDI CBA,73.03,0,605334.62,DR,REF686233,CBA,Savings
21-08-2025 23:37,CBAD62E1BB0CF5C46BE984A,063-000-001,22222222,DOMINO'S PIZZA CBA,99.43,0,605235.19,DR,REF706376,CBA,Savings
22-08-2025 00:02,CBA5E70868F7BCF4B599350,063-000-001,22222222,SALARY PAYMENT CBA,0,666.32,605901.51,CR,REF757826,CBA,Savings
22-08-2025 00:11,CBA9AB8CD398FE04335A4A8,063-000-001,22222222,UBER EATS CBA,8.08,0,605893.43,DR,REF515412,CBA,Savings
22-08-2025 00:20,CBABDB38F8809C94FD4A1F1,063-000-001,22222222,FLIXBUS CBA,17.45,0,605875.98,DR,REF907282,CBA,Savings
22-08-2025 00:33,CBAAF801D5396844809992E,063-000-001,22222222,7-ELEVEN CBA,63.59,0,605812.39,DR,REF862538,CBA,Savings
22-08-2025 00:46,CBAC9F697840BA34C36BC06,063-000-001,22222222,RAILWAY STATION CBA,3.47,0,605808.92,DR,REF263588,CBA,Savings
22-08-2025 01:17,CBAE1C817D5FD0A4CFB9CEB,063-000-001,22222222,HARVEY NORMAN CBA,47.14,0,605761.78,DR,REF772061,CBA,Savings
22-08-2025 01:24,CBA87B7039CD7CA4086A7CF,063-000-001,22222222,PAYPAL *NETFLIX CBA,45.68,0,605716.1,DR,REF351651,CBA,Savings
22-08-2025 01:55,CBAC902563F83E34006A259,063-000-001,22222222,STARBUCKS CBA,21.26,0,605694.84,DR,REF825279,CBA,Savings
22-08-2025 02:07,CBA1D46ADCBB9094C329422,063-000-001,22222222,BIGW CBA,6.33,0,605688.51,DR,REF358366,CBA,Savings
22-08-2025 02:32,CBA966D2E34C3024ECBA013,063-000-001,22222222,APPLE CBA,46.67,0,605641.84,DR,REF342848,CBA,Savings
22-08-2025 02:40,CBAAD2D2DB62D9F4C98BF3E,063-000-001,22222222,WAGES CREDIT CBA,0,2637.58,608279.42,CR,REF184460,CBA,Savings
22-08-2025 02:52,CBA7156E118BA274CE197E6,063-000-001,22222222,SPOTIFY CBA,20.28,0,608259.14,DR,REF915849,CBA,Savings
22-08-2025 03:12,CBA5883976AF026437D9B77,063-000-001,22222222,SPOTIFY CBA,12.7,0,608246.44,DR,REF600280,CBA,Savings
22-08-2025 03:45,CBAE2895C56499A44BABCCB,063-000-001,22222222,DOMINO'S PIZZA CBA,17.62,0,608228.82,DR,REF747511,CBA,Savings
22-08-2025 04:03,CBA40B2C1B1BCD34E558BE5,063-000-001,22222222,SPOTIFY CBA,13.17,0,608215.65,DR,REF317016,CBA,Savings
22-08-2025 04:05,CBA9D4421F3151A445B90B1,063-000-001,22222222,SPOTIFY CBA,85.92,0,608129.73,DR,REF706669,CBA,Savings
22-08-2025 04:30,CBA7F89490D6502497984C4,063-000-001,22222222,UBER EATS CBA,74.9,0,608054.83,DR,REF407616,CBA,Savings
22-08-2025 04:46,CBAD6978E031BAF49ABB61C,063-000-001,22222222,STARBUCKS CBA,20.08,0,608034.75,DR,REF201256,CBA,Savings
22-08-2025 05:03,CBAF091CBBD07804A96A3D1,063-000-001,22222222,PAYMENT GATEWAY CBA,22.07,0,608012.68,DR,REF732415,CBA,Savings
22-08-2025 05:03,INT856C827FAEED4C16B567,063-000-001,22222222,TRANSFER FROM CBA 33333333,0,246.06,608258.74,CR,INT-89886,CBA,Savings
22-08-2025 05:29,CBACAF10133FBD246AD93A3,063-000-001,22222222,TAFE BOOKSHOP CBA,64.71,0,608194.03,DR,REF853365,CBA,Savings
22-08-2025 05:30,CBAF90E1AC677C34126B5BE,063-000-001,22222222,CITYLINK CBA,34.33,0,608159.7,DR,REF306826,CBA,Savings
22-08-2025 05:38,CBAA28604B7DC8740118E7F,063-000-001,22222222,SHELL CBA,39.5,0,608120.2,DR,REF120859,CBA,Savings
22-08-2025 05:44,CBA9A6B592905B5466FA96A,063-000-001,22222222,PAYPAL *NETFLIX CBA,37.2,0,608083,DR,REF232105,CBA,Savings
22-08-2025 05:58,CBAFE07CFBBA06744F3B532,063-000-001,22222222,FLIXBUS CBA,25.37,0,608057.63,DR,REF288895,CBA,Savings
22-08-2025 06:42,CBA696B770F8775484D8498,063-000-001,22222222,RAILWAY STATION CBA,75.6,0,607982.03,DR,REF520452,CBA,Savings
22-08-2025 06:56,CBAB527C157D5C14CE1BFBC,063-000-001,22222222,7-ELEVEN CBA,8.78,0,607973.25,DR,REF640737,CBA,Savings
22-08-2025 06:57,CBA7E38D5321105472C96AC,063-000-001,22222222,COMPANY PAYROLL CBA,0,7305.63,615278.88,CR,REF413034,CBA,Savings
22-08-2025 07:22,CBA2C889B50618D473AA37E,063-000-001,22222222,KFC CBA,75.58,0,615203.3,DR,REF879803,CBA,Savings
22-08-2025 07:53,CBAB61FB61F396E42BF9FFA,063-000-001,22222222,BIGW CBA,87.32,0,615115.98,DR,REF412812,CBA,Savings
22-08-2025 07:53,CBAEDF1D9F225F34DB8AB05,063-000-001,22222222,AMAZON AU CBA,6.38,0,615109.6,DR,REF592444,CBA,Savings
22-08-2025 07:55,CBAA1E17F27F07444FDA1BF,063-000-001,22222222,FLIXBUS CBA,61.41,0,615048.19,DR,REF733426,CBA,Savings
22-08-2025 07:59,INT480D2A6B3B6D4D70A23E,063-000-001,22222222,TRANSFER FROM ANZ 11111111,0,567.36,615615.55,CR,INT-36251,CBA,Savings
22-08-2025 08:00,CBAB52D903705C94F0B821B,063-000-001,22222222,BANK FEE CBA,134.24,0,615481.31,DR,REF442275,CBA,Savings
22-08-2025 08:03,CBA1F5CA6C78F0545EEA6C3,063-000-001,22222222,MCDONALDS CBA,35.68,0,615445.63,DR,REF565858,CBA,Savings
22-08-2025 08:40,CBA3B7B768DE9F44494AD1C,063-000-001,22222222,TAFE BOOKSHOP CBA,5.64,0,615439.99,DR,REF418507,CBA,Savings
22-08-2025 09:03,CBA43C650FCC30446B5AD34,063-000-001,22222222,PAYROLL CREDIT CBA,0,2752.55,618192.54,CR,REF898357,CBA,Savings
22-08-2025 09:18,CBA5041C08968F548E0A3D8,063-000-001,22222222,PAYPAL *NETFLIX CBA,72.17,0,618120.37,DR,REF370740,CBA,Savings
22-08-2025 09:20,CBAB4BE50DD843C4A29A578,063-000-001,22222222,7-ELEVEN CBA,66.24,0,618054.13,DR,REF424777,CBA,Savings
22-08-2025 10:11,CBA43D0D12A8FD1414687BC,063-000-001,22222222,LIQUORLAND CBA,65.75,0,617988.38,DR,REF316126,CBA,Savings
22-08-2025 10:25,CBAF961F2D2CE864355ABDD,063-000-001,22222222,BANK FEE CBA,9.25,0,617979.13,DR,REF631277,CBA,Savings
22-08-2025 10:48,CBAF7BCFC50D49648319D2C,063-000-001,22222222,ZOOM CBA,44.73,0,617934.4,DR,REF497200,CBA,Savings
22-08-2025 10:57,CBA75F8B694995642A8A1EB,063-000-001,22222222,HARVEY NORMAN CBA,24.68,0,617909.72,DR,REF641929,CBA,Savings
22-08-2025 11:01,CBAF31330CDEB4A4D7B9D08,063-000-001,22222222,SHELL CBA,70.15,0,617839.57,DR,REF297973,CBA,Savings
22-08-2025 11:22,CBA6AAE15F4FA0B4CE69C43,063-000-001,22222222,PAYROLL CREDIT CBA,0,552.7,618392.27,CR,REF668662,CBA,Savings
22-08-2025 11:27,CBA1A31B8C37D07470E8D13,063-000-001,22222222,COMPANY PAYROLL CBA,0,7906.82,626299.09,CR,REF693311,CBA,Savings
22-08-2025 12:12,CBAECC2B48051614CF0A580,063-000-001,22222222,HARVEY NORMAN CBA,42.8,0,626256.29,DR,REF770936,CBA,Savings
22-08-2025 12:19,CBA38342F91E9564C758340,063-000-001,22222222,SPOTIFY CBA,21.9,0,626234.39,DR,REF230846,CBA,Savings
22-08-2025 12:25,CBA98FD7650068D4ED4A170,063-000-001,22222222,MENULOG CBA,14.98,0,626219.41,DR,REF712007,CBA,Savings
22-08-2025 12:31,CBA370484BA89C349C49961,063-000-001,22222222,PAYMENT GATEWAY CBA,110.9,0,626108.51,DR,REF953415,CBA,Savings
22-08-2025 12:39,CBA798326BE6F674951A530,063-000-001,22222222,BANK FEE CBA,121.62,0,625986.89,DR,REF361661,CBA,Savings
22-08-2025 12:41,CBA643EA85FB5D0461EA7B9,063-000-001,22222222,FLIXBUS CBA,12.01,0,625974.88,DR,REF141649,CBA,Savings
22-08-2025 12:54,CBA9AAB44ADD48B48529B64,063-000-001,22222222,SHELL CBA,15.31,0,625959.57,DR,REF105013,CBA,Savings
22-08-2025 13:30,CBA92FBD1504E474B599D35,063-000-001,22222222,INTERNET TRANSFER CBA,5.59,0,625953.98,DR,REF905864,CBA,Savings
22-08-2025 13:47,CBAB9434662891745CDBEA2,063-000-001,22222222,LIQUORLAND CBA,86.96,0,625867.02,DR,REF511410,CBA,Savings
22-08-2025 13:50,CBA9F05A0353FC041F9A8CA,063-000-001,22222222,APPLE CBA,37.68,0,625829.34,DR,REF762686,CBA,Savings
22-08-2025 13:53,CBA978434487BC44959A355,063-000-001,22222222,STARBUCKS CBA,14.58,0,625814.76,DR,REF483095,CBA,Savings
22-08-2025 14:32,CBAC1496E10F83B4C7DB84E,063-000-001,22222222,CITYLINK CBA,11.94,0,625802.82,DR,REF664306,CBA,Savings
22-08-2025 15:07,CBA6696FF5C6AA84B339256,063-000-001,22222222,WAGES CREDIT CBA,0,3206.99,629009.81,CR,REF954999,CBA,Savings
22-08-2025 15:19,CBABD3FBFAD24D94A4E91F3,063-000-001,22222222,MENULOG CBA,17.3,0,628992.51,DR,REF638143,CBA,Savings
22-08-2025 15:30,CBA18996D3BABBE4581B2AE,063-000-001,22222222,KFC CBA,22.46,0,628970.05,DR,REF544517,CBA,Savings
22-08-2025 15:39,CBA6534ED6DC64D4D639520,063-000-001,22222222,SALARY PAYMENT CBA,0,653.75,629623.8,CR,REF660609,CBA,Savings
22-08-2025 15:51,CBA6FF231D39BAE433EA4A0,063-000-001,22222222,ZOOM CBA,33.1,0,629590.7,DR,REF302018,CBA,Savings
22-08-2025 15:56,CBAC28CCCCC1D2247EBB30A,063-000-001,22222222,HARVEY NORMAN CBA,68.2,0,629522.5,DR,REF867275,CBA,Savings
22-08-2025 15:59,CBADD2ADCD1F27E4FA38B2E,063-000-001,22222222,ALDI CBA,15.11,0,629507.39,DR,REF557149,CBA,Savings
22-08-2025 16:10,CBAA9781F3E8B42454A9C17,063-000-001,22222222,PAYROLL CREDIT CBA,0,4742.66,634250.05,CR,REF861995,CBA,Savings
22-08-2025 16:25,CBAED7AC11DEA454D01A77A,063-000-001,22222222,PAYMENT GATEWAY CBA,18.67,0,634231.38,DR,REF410613,CBA,Savings
22-08-2025 16:31,CBA979BFB6C5E0F4CD79E58,063-000-001,22222222,RAILWAY STATION CBA,42.43,0,634188.95,DR,REF320770,CBA,Savings
22-08-2025 16:45,CBA6C240F779EFB4D8B930E,063-000-001,22222222,MENULOG CBA,21.32,0,634167.63,DR,REF983977,CBA,Savings
22-08-2025 17:28,CBAB36B23E228BC4D33AEFC,063-000-001,22222222,PAYMENT GATEWAY CBA,28.88,0,634138.75,DR,REF774625,CBA,Savings
22-08-2025 17:30,CBA2E2E65A438C04C4AA7C7,063-000-001,22222222,AMAZON AU CBA,33.97,0,634104.78,DR,REF841901,CBA,Savings
22-08-2025 17:34,CBA4127C0893596406DB518,063-000-001,22222222,PAYROLL CREDIT CBA,0,149.02,634253.8,CR,REF728892,CBA,Savings
22-08-2025 17:42,CBACAAA85658EE049B59638,063-000-001,22222222,BANK FEE CBA,6.21,0,634247.59,DR,REF102542,CBA,Savings
22-08-2025 17:58,CBAE121F071FDFE4293A017,063-000-001,22222222,COMPANY PAYROLL CBA,0,6549.62,640797.21,CR,REF172292,CBA,Savings
22-08-2025 18:18,CBABA8722AA1EC5423693F1,063-000-001,22222222,UBER EATS CBA,215.58,0,640581.63,DR,REF806582,CBA,Savings
22-08-2025 18:27,CBAB38AF3F42E584577AAF5,063-000-001,22222222,HARVEY NORMAN CBA,19,0,640562.63,DR,REF142303,CBA,Savings
22-08-2025 18:41,INT3F7534A7EAF0402B83C9,063-000-001,22222222,TRANSFER TO CBA 33333333,938.52,0,639624.11,DR,INT-46335,CBA,Savings
22-08-2025 19:16,CBA721B17D5938F4786BFBC,063-000-001,22222222,CITYLINK CBA,54.68,0,639569.43,DR,REF106403,CBA,Savings
22-08-2025 19:31,CBA8E6A2F019FDF40598B4E,063-000-001,22222222,PAY - SALARY CBA,0,805.06,640374.49,CR,REF733231,CBA,Savings
22-08-2025 19:37,CBA9F643E1735C1490A8B32,063-000-001,22222222,RAILWAY STATION CBA,139.97,0,640234.52,DR,REF360059,CBA,Savings
22-08-2025 20:34,CBABCD0AB1648B44A3E82CC,063-000-001,22222222,BANK FEE CBA,40.76,0,640193.76,DR,REF696286,CBA,Savings
22-08-2025 20:35,CBADA6BD4FCC70D44BEBFA2,063-000-001,22222222,TAFE BOOKSHOP CBA,14.75,0,640179.01,DR,REF396773,CBA,Savings
22-08-2025 20:36,CBAAE3EF53AF22A40DBA78E,063-000-001,22222222,WAGES CREDIT CBA,0,414.9,640593.91,CR,REF976423,CBA,Savings
22-08-2025 21:47,CBAC6C36D5C57774379A72C,063-000-001,22222222,WOOLWORTHS CBA,53.49,0,640540.42,DR,REF458130,CBA,Savings
22-08-2025 22:42,CBAC17E6843D689459F8965,063-000-001,22222222,LIQUORLAND CBA,6.26,0,640534.16,DR,REF305412,CBA,Savings
22-08-2025 22:42,CBA89CC2E85F91245CD9A1D,063-000-001,22222222,KFC CBA,26.01,0,640508.15,DR,REF537087,CBA,Savings
22-08-2025 22:57,CBAB5328C04B81C47E080A7,063-000-001,22222222,PAY - SALARY CBA,0,3533.93,644042.08,CR,REF113834,CBA,Savings
22-08-2025 23:02,INT87057587F3CD424D8193,063-000-001,22222222,TRANSFER FROM NAB 44444444,0,958.81,645000.89,CR,INT-68056,CBA,Savings
22-08-2025 23:17,CBA19783FC28F0F47E8B91F,063-000-001,22222222,PAYROLL CREDIT CBA,0,413.52,645414.41,CR,REF349855,CBA,Savings
22-08-2025 23:57,CBAE9DB8DA0145346379495,063-000-001,22222222,UBER EATS CBA,6.58,0,645407.83,DR,REF186751,CBA,Savings
23-08-2025 00:05,CBAEC7443F95B79420DBF85,063-000-001,22222222,BWS CBA,19.3,0,645388.53,DR,REF609098,CBA,Savings
23-08-2025 00:14,CBAD7185C5F87BB4CD0B433,063-000-001,22222222,MENULOG CBA,88.13,0,645300.4,DR,REF912698,CBA,Savings
23-08-2025 00:15,CBA481172694412486ABA92,063-000-001,22222222,BANK FEE CBA,45.55,0,645254.85,DR,REF460029,CBA,Savings
23-08-2025 00:34,CBA0F01D13955674AFC94FC,063-000-001,22222222,BANK FEE CBA,60.83,0,645194.02,DR,REF149860,CBA,Savings
23-08-2025 01:13,CBA37BFAA55AD73416D935F,063-000-001,22222222,STARBUCKS CBA,55.21,0,645138.81,DR,REF706040,CBA,Savings
23-08-2025 01:23,CBA877796BDF71241189AFC,063-000-001,22222222,RAILWAY STATION CBA,12.61,0,645126.2,DR,REF917380,CBA,Savings
23-08-2025 01:45,CBA69553A8218C84E7F9733,063-000-001,22222222,KFC CBA,43.72,0,645082.48,DR,REF467640,CBA,Savings
23-08-2025 02:05,CBAC7BDDA32DE8140028BBB,063-000-001,22222222,CITYLINK CBA,107.47,0,644975.01,DR,REF273298,CBA,Savings
23-08-2025 02:40,CBA94434539B069458DB6F3,063-000-001,22222222,FLIXBUS CBA,12.82,0,644962.19,DR,REF953641,CBA,Savings
23-08-2025 02:40,CBA6E62C2D26C364CA39D30,063-000-001,22222222,WOOLWORTHS CBA,50.27,0,644911.92,DR,REF418446,CBA,Savings
23-08-2025 03:16,CBA8F205B375CDF4C138806,063-000-001,22222222,COLES CBA,10.08,0,644901.84,DR,REF558553,CBA,Savings
23-08-2025 03:59,CBAA056400F30324CF8978B,063-000-001,22222222,ZOOM CBA,55.8,0,644846.04,DR,REF975447,CBA,Savings
23-08-2025 05:03,CBAEC9603A5228A42AEB20E,063-000-001,22222222,APPLE CBA,5.71,0,644840.33,DR,REF578144,CBA,Savings
23-08-2025 05:33,CBA3D59346798B142629CCC,063-000-001,22222222,SALARY PAYMENT CBA,0,666.45,645506.78,CR,REF821612,CBA,Savings
23-08-2025 05:52,CBA16A895D836F24DD7ABAE,063-000-001,22222222,BIGW CBA,13.63,0,645493.15,DR,REF320915,CBA,Savings
23-08-2025 06:13,CBA6864A964B6B94569A2B3,063-000-001,22222222,TAFE BOOKSHOP CBA,50.53,0,645442.62,DR,REF205553,CBA,Savings
23-08-2025 06:17,CBA643372881F474861A120,063-000-001,22222222,INTERNET TRANSFER CBA,62.07,0,645380.55,DR,REF430930,CBA,Savings
23-08-2025 06:26,CBA8A01F388CB2047B58D0F,063-000-001,22222222,TAFE BOOKSHOP CBA,31.36,0,645349.19,DR,REF172956,CBA,Savings
23-08-2025 06:29,CBACF29324ADC484BE8923A,063-000-001,22222222,TAFE BOOKSHOP CBA,40.25,0,645308.94,DR,REF408750,CBA,Savings
23-08-2025 06:32,CBA02C789823A804778A58F,063-000-001,22222222,KFC CBA,32.19,0,645276.75,DR,REF874109,CBA,Savings
23-08-2025 06:41,CBAC9D24D6D0D2E42CDADC8,063-000-001,22222222,BP CBA,31.77,0,645244.98,DR,REF234067,CBA,Savings
23-08-2025 06:47,CBAB05DF3F3C7F944DDAD72,063-000-001,22222222,BIGW CBA,219.05,0,645025.93,DR,REF998967,CBA,Savings
23-08-2025 06:48,CBAE437548A7AF2463899E9,063-000-001,22222222,INTERNET TRANSFER CBA,23.59,0,645002.34,DR,REF162404,CBA,Savings
23-08-2025 07:28,CBAC998CC1D79BF445C9088,063-000-001,22222222,APPLE CBA,127.87,0,644874.47,DR,REF272534,CBA,Savings
23-08-2025 07:33,CBAAD6E20B0149E4EEDB5C2,063-000-001,22222222,KFC CBA,1.61,0,644872.86,DR,REF236681,CBA,Savings
23-08-2025 07:37,CBA1FC078D5204B4EB4B281,063-000-001,22222222,BANK FEE CBA,67.28,0,644805.58,DR,REF379898,CBA,Savings
23-08-2025 07:42,CBA27AC0534BD82437A9EDD,063-000-001,22222222,PAYROLL CREDIT CBA,0,5904.39,650709.97,CR,REF861295,CBA,Savings
23-08-2025 07:44,CBA47F9D1E7FE07448B902D,063-000-001,22222222,COLES CBA,22.86,0,650687.11,DR,REF152087,CBA,Savings
23-08-2025 07:48,INTE5A3128272BC45FB8D5D,063-000-001,22222222,TRANSFER TO ANZ 11111111,1295.65,0,649391.46,DR,INT-88536,CBA,Savings
23-08-2025 07:57,CBA5C52675BC18B41898CB9,063-000-001,22222222,STARBUCKS CBA,15.83,0,649375.63,DR,REF148115,CBA,Savings
23-08-2025 08:02,CBA7A823D8992C742EB8676,063-000-001,22222222,HARVEY NORMAN CBA,14.19,0,649361.44,DR,REF595672,CBA,Savings
23-08-2025 08:23,CBAFF6C10F5C60F4DEB966E,063-000-001,22222222,DOMINO'S PIZZA CBA,35.03,0,649326.41,DR,REF451179,CBA,Savings
23-08-2025 08:59,CBADF0879292F7847789632,063-000-001,22222222,COLES CBA,3.73,0,649322.68,DR,REF886043,CBA,Savings
23-08-2025 09:00,CBA646ADDDFC5E24F01A828,063-000-001,22222222,STARBUCKS CBA,24.3,0,649298.38,DR,REF122192,CBA,Savings
23-08-2025 09:07,CBAAAFC8284E4874565B2AE,063-000-001,22222222,INTERNET TRANSFER CBA,13.09,0,649285.29,DR,REF583236,CBA,Savings
23-08-2025 09:17,CBAA0A714D56CE94223BCC4,063-000-001,22222222,PAYPAL *NETFLIX CBA,11.42,0,649273.87,DR,REF157645,CBA,Savings
23-08-2025 09:25,CBACCDFF01BE5E44FD38BF5,063-000-001,22222222,MENULOG CBA,121.38,0,649152.49,DR,REF107512,CBA,Savings
23-08-2025 10:39,CBA2DC62B8021484302BEE2,063-000-001,22222222,PAY - SALARY CBA,0,5873.5,655025.99,CR,REF505789,CBA,Savings
23-08-2025 10:47,CBAD4ECAE8C5CCC465F8BC0,063-000-001,22222222,KFC CBA,22.1,0,655003.89,DR,REF434709,CBA,Savings
23-08-2025 10:49,CBAAB44FF88F674444981ED,063-000-001,22222222,COLES CBA,18.53,0,654985.36,DR,REF836607,CBA,Savings
23-08-2025 10:51,CBA64AFF6B8BA694B83AD21,063-000-001,22222222,DOMINO'S PIZZA CBA,26.72,0,654958.64,DR,REF756675,CBA,Savings
23-08-2025 11:48,CBA577537818E2D46BA8A07,063-000-001,22222222,SALARY PAYMENT CBA,0,890.56,655849.2,CR,REF924087,CBA,Savings
23-08-2025 11:51,CBACA571977C89F44D39EF5,063-000-001,22222222,DOMINO'S PIZZA CBA,5.13,0,655844.07,DR,REF657805,CBA,Savings
23-08-2025 11:59,CBA96CDCDA0200040A39376,063-000-001,22222222,LIQUORLAND CBA,89.79,0,655754.28,DR,REF718605,CBA,Savings
23-08-2025 12:52,INTB982C00A3D9D42C99C6B,063-000-001,22222222,TRANSFER FROM NAB 44444444,0,1135.09,656889.37,CR,INT-92259,CBA,Savings
23-08-2025 12:54,CBA5D171B0FE74641E19416,063-000-001,22222222,SHELL CBA,10.88,0,656878.49,DR,REF604664,CBA,Savings
23-08-2025 13:56,CBAC34D9E448464478CA123,063-000-001,22222222,BWS CBA,6.29,0,656872.2,DR,REF466489,CBA,Savings
23-08-2025 14:09,CBAF2184E269BE641ECAD4D,063-000-001,22222222,ZOOM CBA,32.07,0,656840.13,DR,REF397827,CBA,Savings
23-08-2025 14:25,CBA3DE90EC2A6D7485AAAE9,063-000-001,22222222,COMPANY PAYROLL CBA,0,2986.05,659826.18,CR,REF945405,CBA,Savings
23-08-2025 14:36,CBA223737B3ADF249B58352,063-000-001,22222222,STARBUCKS CBA,30.14,0,659796.04,DR,REF113512,CBA,Savings
23-08-2025 14:39,CBA4BC99B569E604D1F82E7,063-000-001,22222222,PAYROLL CREDIT CBA,0,1126.09,660922.13,CR,REF227660,CBA,Savings
23-08-2025 14:45,CBA86DD766692454D64B3C5,063-000-001,22222222,SHELL CBA,82.86,0,660839.27,DR,REF939702,CBA,Savings
23-08-2025 14:50,CBA967CF9EFF4A241B2841F,063-000-001,22222222,ZOOM CBA,4.12,0,660835.15,DR,REF924923,CBA,Savings
23-08-2025 15:59,CBA3EC70C49844945769726,063-000-001,22222222,PAY - SALARY CBA,0,7797.06,668632.21,CR,REF711517,CBA,Savings
23-08-2025 16:34,CBA0DFA97E084344EE2866D,063-000-001,22222222,TAFE BOOKSHOP CBA,60.59,0,668571.62,DR,REF872036,CBA,Savings
23-08-2025 16:44,CBAEBE76AEC703B48ED89F5,063-000-001,22222222,COMPANY PAYROLL CBA,0,5836.97,674408.59,CR,REF925564,CBA,Savings
23-08-2025 16:49,CBAEA4F55822AB744ECB9E0,063-000-001,22222222,CITYLINK CBA,45.02,0,674363.57,DR,REF730645,CBA,Savings
23-08-2025 17:09,CBAE1C8B38D14F34A84800E,063-000-001,22222222,UBER EATS CBA,11.85,0,674351.72,DR,REF957019,CBA,Savings
23-08-2025 17:26,CBA3FAD5A4C149C4C359233,063-000-001,22222222,PAYROLL CREDIT CBA,0,3142.74,677494.46,CR,REF796742,CBA,Savings
23-08-2025 17:34,CBA43850C7CB4554BB697F7,063-000-001,22222222,PAYMENT GATEWAY CBA,40.95,0,677453.51,DR,REF207628,CBA,Savings
23-08-2025 17:38,CBA716B5389DB724B03B369,063-000-001,22222222,CITYLINK CBA,24.49,0,677429.02,DR,REF426701,CBA,Savings
23-08-2025 17:44,CBA81780137EEE7475F88DB,063-000-001,22222222,BIGW CBA,90.53,0,677338.49,DR,REF607378,CBA,Savings
23-08-2025 18:00,CBA7797218B87294B079541,063-000-001,22222222,COMPANY PAYROLL CBA,0,3691.02,681029.51,CR,REF434627,CBA,Savings
23-08-2025 18:04,CBA5C1FF893129A42EDA175,063-000-001,22222222,UBER EATS CBA,17.52,0,681011.99,DR,REF579892,CBA,Savings
23-08-2025 18:09,CBAB9EE31B8A0404317805D,063-000-001,22222222,PAYROLL CREDIT CBA,0,6479.55,687491.54,CR,REF992249,CBA,Savings
23-08-2025 18:21,INT8FB6C34C5FF74091A019,063-000-001,22222222,TRANSFER TO NAB 44444444,1399.92,0,686091.62,DR,INT-74013,CBA,Savings
23-08-2025 18:42,CBAFACA29385E534216A351,063-000-001,22222222,KFC CBA,32.94,0,686058.68,DR,REF122677,CBA,Savings
23-08-2025 18:43,CBADB5743BE73F145BE9297,063-000-001,22222222,7-ELEVEN CBA,143.66,0,685915.02,DR,REF570625,CBA,Savings
23-08-2025 19:08,CBA80FAFDB60CD748218CCF,063-000-001,22222222,ZOOM CBA,15.35,0,685899.67,DR,REF815732,CBA,Savings
23-08-2025 19:54,CBABBC1B79F56C24B3C97FA,063-000-001,22222222,COMPANY PAYROLL CBA,0,325.14,686224.81,CR,REF378627,CBA,Savings
23-08-2025 19:56,CBA5FC4921D2CDC4B3D9366,063-000-001,22222222,BIGW CBA,86.98,0,686137.83,DR,REF317316,CBA,Savings
23-08-2025 19:57,CBAF21207F2D4E145E7BC95,063-000-001,22222222,PAYMENT GATEWAY CBA,162.11,0,685975.72,DR,REF262462,CBA,Savings
23-08-2025 20:01,CBA0550268B11CD4B539A58,063-000-001,22222222,APPLE CBA,65.62,0,685910.1,DR,REF866636,CBA,Savings
23-08-2025 20:08,CBA92D13ECC82B3443A901F,063-000-001,22222222,SALARY PAYMENT CBA,0,773.01,686683.11,CR,REF861582,CBA,Savings
23-08-2025 20:10,CBA4B2528C1C5A546F6876A,063-000-001,22222222,SALARY PAYMENT CBA,0,5229.8,691912.91,CR,REF261515,CBA,Savings
23-08-2025 20:27,CBA00118135785040F8BE6C,063-000-001,22222222,HARVEY NORMAN CBA,35.91,0,691877,DR,REF395719,CBA,Savings
23-08-2025 20:37,CBA4B2DA26945D244BD85F4,063-000-001,22222222,CITYLINK CBA,15.52,0,691861.48,DR,REF164615,CBA,Savings
23-08-2025 20:48,CBAEC6925491D664AB5B435,063-000-001,22222222,DOMINO'S PIZZA CBA,3.98,0,691857.5,DR,REF281203,CBA,Savings
23-08-2025 21:11,CBAF99EF5D2A30E47038259,063-000-001,22222222,SPOTIFY CBA,17.61,0,691839.89,DR,REF579979,CBA,Savings
23-08-2025 21:19,CBA5BF8294B530647D489BF,063-000-001,22222222,BWS CBA,17.61,0,691822.28,DR,REF932972,CBA,Savings
23-08-2025 22:01,CBABC0232420A7F4589B370,063-000-001,22222222,SHELL CBA,45.17,0,691777.11,DR,REF729588,CBA,Savings
23-08-2025 22:06,CBA1C9817180B6845E5B488,063-000-001,22222222,HARVEY NORMAN CBA,92.61,0,691684.5,DR,REF177843,CBA,Savings
23-08-2025 22:27,CBA5B4760E64AE04D7DB8C4,063-000-001,22222222,INTERNET TRANSFER CBA,11.34,0,691673.16,DR,REF155146,CBA,Savings
23-08-2025 22:47,CBA603178EE98904261ACDA,063-000-001,22222222,WAGES CREDIT CBA,0,3380.56,695053.72,CR,REF583422,CBA,Savings
23-08-2025 22:52,CBA034ADEEB783046DAB23E,063-000-001,22222222,SALARY PAYMENT CBA,0,1818.86,696872.58,CR,REF818906,CBA,Savings
23-08-2025 22:55,CBABAD9F7CDE5124048924B,063-000-001,22222222,SHELL CBA,20.58,0,696852,DR,REF966640,CBA,Savings
23-08-2025 23:21,CBA9B9DFB6875D1444FA555,063-000-001,22222222,RAILWAY STATION CBA,97.04,0,696754.96,DR,REF959390,CBA,Savings
23-08-2025 23:49,CBAB2075476C7F54E56BB25,063-000-001,22222222,PAY - SALARY CBA,0,5856.7,702611.66,CR,REF865404,CBA,Savings
24-08-2025 01:20,CBAD47E0085DF7340499814,063-000-001,22222222,SALARY PAYMENT CBA,0,3267.3,705878.96,CR,REF145193,CBA,Savings
24-08-2025 01:21,CBAFE0B225159624D6FB611,063-000-001,22222222,APPLE CBA,61.24,0,705817.72,DR,REF557754,CBA,Savings
24-08-2025 01:26,CBA3365D968EBB943E9A270,063-000-001,22222222,BP CBA,4.48,0,705813.24,DR,REF428570,CBA,Savings
24-08-2025 01:26,CBAB4B7EDD2150346C7B8C4,063-000-001,22222222,CITYLINK CBA,63.07,0,705750.17,DR,REF126096,CBA,Savings
24-08-2025 02:08,CBAC308E032DCD14EA99672,063-000-001,22222222,STARBUCKS CBA,16.47,0,705733.7,DR,REF985636,CBA,Savings
24-08-2025 02:14,CBA8DCD0FCB219143CDA6DE,063-000-001,22222222,MCDONALDS CBA,76.22,0,705657.48,DR,REF880183,CBA,Savings
24-08-2025 03:23,CBA0DEE83B27F414F789563,063-000-001,22222222,ALDI CBA,44.18,0,705613.3,DR,REF670754,CBA,Savings
24-08-2025 03:31,CBA295141DB40CA41F196E6,063-000-001,22222222,BANK FEE CBA,39.84,0,705573.46,DR,REF238771,CBA,Savings
24-08-2025 03:38,CBABB7FC5CEAF6243A88C65,063-000-001,22222222,WAGES CREDIT CBA,0,782.34,706355.8,CR,REF263098,CBA,Savings
24-08-2025 03:55,CBAE5AA2475456F45BF9E18,063-000-001,22222222,DOMINO'S PIZZA CBA,49,0,706306.8,DR,REF852576,CBA,Savings
24-08-2025 03:57,CBAECE22080550B42EC8F10,063-000-001,22222222,DOMINO'S PIZZA CBA,8.49,0,706298.31,DR,REF839858,CBA,Savings
24-08-2025 04:07,CBA009D66A4DB534BE0B0E8,063-000-001,22222222,TAFE BOOKSHOP CBA,8.8,0,706289.51,DR,REF411871,CBA,Savings
24-08-2025 04:08,CBAB85D7F468B564A52AA72,063-000-001,22222222,COMPANY PAYROLL CBA,0,598.98,706888.49,CR,REF959787,CBA,Savings
24-08-2025 04:28,CBADA72866341C241E69DA4,063-000-001,22222222,RAILWAY STATION CBA,178.29,0,706710.2,DR,REF454172,CBA,Savings
24-08-2025 04:44,CBAF7C841DF02234FE5B9B6,063-000-001,22222222,CITYLINK CBA,41.27,0,706668.93,DR,REF467724,CBA,Savings
24-08-2025 04:46,CBA1A7622617C474B498695,063-000-001,22222222,MENULOG CBA,34.11,0,706634.82,DR,REF136322,CBA,Savings
24-08-2025 04:46,CBA2CA72F250BEC470CB947,063-000-001,22222222,CITYLINK CBA,67.42,0,706567.4,DR,REF170078,CBA,Savings
24-08-2025 05:18,CBA7BD249182D6149C89634,063-000-001,22222222,7-ELEVEN CBA,8.31,0,706559.09,DR,REF350301,CBA,Savings
24-08-2025 05:42,CBA13331E576B28403E8C9E,063-000-001,22222222,TAFE BOOKSHOP CBA,81.81,0,706477.28,DR,REF430052,CBA,Savings
24-08-2025 06:17,CBA09AA8386CBD24F1D8320,063-000-001,22222222,PAYROLL CREDIT CBA,0,4650.96,711128.24,CR,REF442547,CBA,Savings
24-08-2025 06:28,CBA6AF9479018B243D4B97B,063-000-001,22222222,TAFE BOOKSHOP CBA,30.75,0,711097.49,DR,REF977779,CBA,Savings
24-08-2025 06:35,CBA0D5E297B9AD74866B667,063-000-001,22222222,WAGES CREDIT CBA,0,3629.56,714727.05,CR,REF605981,CBA,Savings
24-08-2025 06:47,CBA35AF3AD3955E4056AC82,063-000-001,22222222,MCDONALDS CBA,27.99,0,714699.06,DR,REF113966,CBA,Savings
24-08-2025 06:52,CBAAD9887DFD0044ADFB5AB,063-000-001,22222222,RAILWAY STATION CBA,14.68,0,714684.38,DR,REF819037,CBA,Savings
24-08-2025 06:55,CBAFFFCC29AFE7B4EB3A6B7,063-000-001,22222222,TAFE BOOKSHOP CBA,6.67,0,714677.71,DR,REF455348,CBA,Savings
24-08-2025 07:14,CBA74E9A6E7CEB34C69BACF,063-000-001,22222222,LIQUORLAND CBA,93.26,0,714584.45,DR,REF173608,CBA,Savings
24-08-2025 07:15,CBA6343E3DB779E4F41B4C2,063-000-001,22222222,PAY - SALARY CBA,0,3082.13,717666.58,CR,REF447541,CBA,Savings
24-08-2025 07:31,CBAFBD2511A07C9469A915A,063-000-001,22222222,HARVEY NORMAN CBA,28.14,0,717638.44,DR,REF713914,CBA,Savings
24-08-2025 07:48,CBA78244C2EB2D04DF5A864,063-000-001,22222222,UBER EATS CBA,26.71,0,717611.73,DR,REF865043,CBA,Savings
24-08-2025 07:50,CBAB738FEB07CF84046B9EB,063-000-001,22222222,PAYMENT GATEWAY CBA,83.46,0,717528.27,DR,REF863564,CBA,Savings
24-08-2025 07:53,CBA0557B984BC604E84AA3D,063-000-001,22222222,MENULOG CBA,66.55,0,717461.72,DR,REF124802,CBA,Savings
24-08-2025 08:14,CBA45E72D1F5D234C85A619,063-000-001,22222222,WOOLWORTHS CBA,43.69,0,717418.03,DR,REF418863,CBA,Savings
24-08-2025 08:55,CBA4E5B445325704E6B8A4D,063-000-001,22222222,ZOOM CBA,76.31,0,717341.72,DR,REF468054,CBA,Savings
24-08-2025 09:18,CBABED79B7670384EEA81DE,063-000-001,22222222,RAILWAY STATION CBA,75.14,0,717266.58,DR,REF802708,CBA,Savings
24-08-2025 09:27,CBA90DF583C4F9945A28D6E,063-000-001,22222222,LIQUORLAND CBA,27.64,0,717238.94,DR,REF684523,CBA,Savings
24-08-2025 09:43,CBA418FC8ED343C4BE4AC01,063-000-001,22222222,TAFE BOOKSHOP CBA,117.31,0,717121.63,DR,REF158997,CBA,Savings
24-08-2025 10:35,CBA1BA9860F7D7846CAA298,063-000-001,22222222,STARBUCKS CBA,40.3,0,717081.33,DR,REF618849,CBA,Savings
24-08-2025 10:48,CBAD5BC7076D0124D239911,063-000-001,22222222,KFC CBA,10.7,0,717070.63,DR,REF436784,CBA,Savings
24-08-2025 10:50,CBA4D0FBCDAFBB44FF8B4A8,063-000-001,22222222,ZOOM CBA,38.64,0,717031.99,DR,REF973123,CBA,Savings
24-08-2025 11:01,CBABDC76D03316B47FA92AD,063-000-001,22222222,LIQUORLAND CBA,7.27,0,717024.72,DR,REF157382,CBA,Savings
24-08-2025 11:43,CBA05EECE29951741FDADA2,063-000-001,22222222,SHELL CBA,45.15,0,716979.57,DR,REF900931,CBA,Savings
24-08-2025 12:21,CBAD6A885B997D94A7EAE17,063-000-001,22222222,STARBUCKS CBA,5.96,0,716973.61,DR,REF468965,CBA,Savings
24-08-2025 12:58,CBA30497128D793402AACE6,063-000-001,22222222,COLES CBA,13.2,0,716960.41,DR,REF915773,CBA,Savings
24-08-2025 13:02,CBADA17C4B16A9447BC987B,063-000-001,22222222,ZOOM CBA,10.66,0,716949.75,DR,REF680246,CBA,Savings
24-08-2025 13:06,CBAD8F2211757AC41B1A851,063-000-001,22222222,UBER EATS CBA,47.27,0,716902.48,DR,REF144781,CBA,Savings
24-08-2025 13:47,CBAED84C9D11EA5488B9C09,063-000-001,22222222,UBER EATS CBA,15.35,0,716887.13,DR,REF784369,CBA,Savings
24-08-2025 14:51,CBACC7317112256431B80B0,063-000-001,22222222,APPLE CBA,96.99,0,716790.14,DR,REF872608,CBA,Savings
24-08-2025 15:04,CBA8CC889A49DCF408192AC,063-000-001,22222222,LIQUORLAND CBA,43.43,0,716746.71,DR,REF168992,CBA,Savings
24-08-2025 15:06,CBAF10B49E3AD474E588CCF,063-000-001,22222222,KFC CBA,145.31,0,716601.4,DR,REF618025,CBA,Savings
24-08-2025 15:15,CBA93394D156ECA41159330,063-000-001,22222222,APPLE CBA,58.4,0,716543,DR,REF635566,CBA,Savings
24-08-2025 16:31,CBA3EB2D08B883945E7ACC0,063-000-001,22222222,LIQUORLAND CBA,94.01,0,716448.99,DR,REF975132,CBA,Savings
24-08-2025 17:14,CBAC56A4B3426844E2482D6,063-000-001,22222222,UBER EATS CBA,127.47,0,716321.52,DR,REF766639,CBA,Savings
24-08-2025 17:23,INTD8CD005ED6F74A948BA5,063-000-001,22222222,TRANSFER FROM ANZ 11111111,0,1012.01,717333.53,CR,INT-71207,CBA,Savings
24-08-2025 17:45,CBA19C8F2B4F4B948F88BEE,063-000-001,22222222,KFC CBA,4.18,0,717329.35,DR,REF887266,CBA,Savings
24-08-2025 18:21,CBA7B2B6E086D5A4B319253,063-000-001,22222222,STARBUCKS CBA,43.16,0,717286.19,DR,REF131018,CBA,Savings
24-08-2025 18:51,CBAA28492901AEA4EB2B460,063-000-001,22222222,MENULOG CBA,48.56,0,717237.63,DR,REF103799,CBA,Savings
24-08-2025 20:16,CBAB3836604AC4147829303,063-000-001,22222222,PAYMENT GATEWAY CBA,29.82,0,717207.81,DR,REF699196,CBA,Savings
24-08-2025 20:21,CBA75D5F42355BA4497B6A8,063-000-001,22222222,ALDI CBA,55.59,0,717152.22,DR,REF614841,CBA,Savings
24-08-2025 21:14,CBAFD7884F4E8E74661B3F6,063-000-001,22222222,MCDONALDS CBA,81.32,0,717070.9,DR,REF624959,CBA,Savings
24-08-2025 21:41,CBA3BCD16403433432483D3,063-000-001,22222222,APPLE CBA,62.18,0,717008.72,DR,REF344501,CBA,Savings
24-08-2025 22:08,CBA82F7E9487FF3444CB899,063-000-001,22222222,COLES CBA,22.32,0,716986.4,DR,REF579593,CBA,Savings
24-08-2025 22:30,CBAA3089AD0DD5843EE949E,063-000-001,22222222,LIQUORLAND CBA,13.16,0,716973.24,DR,REF351214,CBA,Savings
24-08-2025 22:42,CBA7035B6D032E8497C84B6,063-000-001,22222222,PAYMENT GATEWAY CBA,3.92,0,716969.32,DR,REF865878,CBA,Savings
24-08-2025 22:55,CBA862AE5C0538E4618B6B5,063-000-001,22222222,WOOLWORTHS CBA,14.8,0,716954.52,DR,REF959373,CBA,Savings
24-08-2025 22:56,CBA2EA167E75A4447EF9C26,063-000-001,22222222,PAYPAL *NETFLIX CBA,26.21,0,716928.31,DR,REF275421,CBA,Savings
24-08-2025 23:08,CBAC73956755B484179A499,063-000-001,22222222,BIGW CBA,58.88,0,716869.43,DR,REF294888,CBA,Savings
24-08-2025 23:09,INT045CDB0516CE4305963F,063-000-001,22222222,TRANSFER FROM ANZ 11111111,0,1643.87,718513.3,CR,INT-16979,CBA,Savings
24-08-2025 23:55,CBA1BDF1B5AAD554DCDA8DD,063-000-001,22222222,WAGES CREDIT CBA,0,3969.89,722483.19,CR,REF395477,CBA,Savings
24-08-2025 23:58,CBADCBED36942004605A32F,063-000-001,22222222,KFC CBA,11.24,0,722471.95,DR,REF864477,CBA,Savings
25-08-2025 00:23,CBA7616D7F452C14A9CBAD8,063-000-001,22222222,MENULOG CBA,51.68,0,722420.27,DR,REF809331,CBA,Savings
25-08-2025 00:34,CBA157EDF49962546538D07,063-000-001,22222222,BANK FEE CBA,46.89,0,722373.38,DR,REF485600,CBA,Savings
25-08-2025 01:05,CBACBF8501B9AAD49ACB4E4,063-000-001,22222222,CITYLINK CBA,2.79,0,722370.59,DR,REF406561,CBA,Savings
25-08-2025 01:26,CBABF3BA05538E24F73BD42,063-000-001,22222222,APPLE CBA,26.48,0,722344.11,DR,REF214415,CBA,Savings
25-08-2025 01:47,CBAD4DD3AEC26D047278673,063-000-001,22222222,7-ELEVEN CBA,37.34,0,722306.77,DR,REF832657,CBA,Savings
25-08-2025 02:00,CBA110D9D297AF341078BE8,063-000-001,22222222,BIGW CBA,32.23,0,722274.54,DR,REF394574,CBA,Savings
25-08-2025 02:06,CBAFA4D62E2543A4B37B788,063-000-001,22222222,MENULOG CBA,51.73,0,722222.81,DR,REF620849,CBA,Savings
25-08-2025 02:31,CBA296C3368C0E64D58AEC8,063-000-001,22222222,HARVEY NORMAN CBA,9.07,0,722213.74,DR,REF990139,CBA,Savings
25-08-2025 02:34,CBA335B29A60B0147BDA2BD,063-000-001,22222222,LIQUORLAND CBA,80.39,0,722133.35,DR,REF721807,CBA,Savings
25-08-2025 03:21,CBAB27CB106143745A4B992,063-000-001,22222222,DOMINO'S PIZZA CBA,46.06,0,722087.29,DR,REF537711,CBA,Savings
25-08-2025 03:25,CBA9F37027C587D426F95CE,063-000-001,22222222,PAYMENT GATEWAY CBA,215.97,0,721871.32,DR,REF856274,CBA,Savings
25-08-2025 03:33,CBAFBCAF59AEEC0418581A1,063-000-001,22222222,BWS CBA,69.82,0,721801.5,DR,REF272079,CBA,Savings
25-08-2025 04:11,CBA1EA2F96009C44E6CB581,063-000-001,22222222,7-ELEVEN CBA,40,0,721761.5,DR,REF742363,CBA,Savings
25-08-2025 04:13,CBA85A8C7B13D5F40F9870E,063-000-001,22222222,AMAZON AU CBA,8.36,0,721753.14,DR,REF223948,CBA,Savings
25-08-2025 04:14,CBA85BD44ADB3694844850E,063-000-001,22222222,TAFE BOOKSHOP CBA,43.72,0,721709.42,DR,REF549221,CBA,Savings
25-08-2025 04:40,CBA454978BBDB0D4394B562,063-000-001,22222222,SPOTIFY CBA,122.3,0,721587.12,DR,REF635135,CBA,Savings
25-08-2025 04:44,CBA3507057AAE54486B80B0,063-000-001,22222222,UBER EATS CBA,180.67,0,721406.45,DR,REF654874,CBA,Savings
25-08-2025 04:53,CBA049D36BA52F44DC4A5B6,063-000-001,22222222,MCDONALDS CBA,126.39,0,721280.06,DR,REF209811,CBA,Savings
25-08-2025 05:09,CBAFE7125B50F274C80B74B,063-000-001,22222222,DOMINO'S PIZZA CBA,173.58,0,721106.48,DR,REF928383,CBA,Savings
25-08-2025 05:59,CBA78F44E2AA3BD41868EED,063-000-001,22222222,FLIXBUS CBA,33.1,0,721073.38,DR,REF713165,CBA,Savings
25-08-2025 06:14,CBA5F8774AE63434F468DC0,063-000-001,22222222,SPOTIFY CBA,74.15,0,720999.23,DR,REF733693,CBA,Savings
25-08-2025 06:33,CBACFA30120A5CB4F84959B,063-000-001,22222222,COMPANY PAYROLL CBA,0,3263.43,724262.66,CR,REF596377,CBA,Savings
25-08-2025 06:33,CBAB520B596197B4C7A83A3,063-000-001,22222222,LIQUORLAND CBA,58.14,0,724204.52,DR,REF449581,CBA,Savings
25-08-2025 06:41,CBA0DB362695E11426D9FF7,063-000-001,22222222,PAYMENT GATEWAY CBA,39.07,0,724165.45,DR,REF217613,CBA,Savings
25-08-2025 06:48,CBABA6DF0A573CA43BBAF38,063-000-001,22222222,WAGES CREDIT CBA,0,4159.42,728324.87,CR,REF767791,CBA,Savings
25-08-2025 07:03,CBA5EBF8A8D7792445CA01C,063-000-001,22222222,AMAZON AU CBA,72.95,0,728251.92,DR,REF355134,CBA,Savings
25-08-2025 07:25,CBAAE3CAB8D3EDD4485B284,063-000-001,22222222,INTERNET TRANSFER CBA,14.48,0,728237.44,DR,REF533058,CBA,Savings
25-08-2025 07:44,CBA84B47A8892244A908B15,063-000-001,22222222,PAY - SALARY CBA,0,824.68,729062.12,CR,REF464174,CBA,Savings
25-08-2025 07:56,CBAF5DCDA51F70A496B82FA,063-000-001,22222222,LIQUORLAND CBA,38.67,0,729023.45,DR,REF668563,CBA,Savings
25-08-2025 07:57,CBA091EAFBF5A904BC9BF25,063-000-001,22222222,ZOOM CBA,87.4,0,728936.05,DR,REF499901,CBA,Savings
25-08-2025 07:59,CBAA70D146C6546406CA8CF,063-000-001,22222222,AMAZON AU CBA,18.3,0,728917.75,DR,REF126007,CBA,Savings
25-08-2025 08:11,CBA9ECA4A16C7D144BFB53F,063-000-001,22222222,PAYMENT GATEWAY CBA,73.53,0,728844.22,DR,REF792578,CBA,Savings
25-08-2025 08:33,CBA67E18A798F2D4DD9A65C,063-000-001,22222222,MCDONALDS CBA,47.24,0,728796.98,DR,REF862489,CBA,Savings
25-08-2025 08:36,CBA91169D04534445A3A8A8,063-000-001,22222222,ALDI CBA,19.8,0,728777.18,DR,REF184353,CBA,Savings
25-08-2025 08:40,CBA8CA999EEEE034563B5E2,063-000-001,22222222,PAY - SALARY CBA,0,869.65,729646.83,CR,REF495509,CBA,Savings
25-08-2025 08:52,CBA12F84BC9C4CF410DB9BE,063-000-001,22222222,MENULOG CBA,62.76,0,729584.07,DR,REF813597,CBA,Savings
25-08-2025 09:03,CBAD49AF7ABB7A64495B0EE,063-000-001,22222222,PAYROLL CREDIT CBA,0,7774.68,737358.75,CR,REF409704,CBA,Savings
25-08-2025 09:08,INTA848334E10534D2F8D9C,063-000-001,22222222,TRANSFER FROM CBA 33333333,0,1445.71,738804.46,CR,INT-74428,CBA,Savings
25-08-2025 09:17,CBA32A8A7D5EC88409FA053,063-000-001,22222222,AMAZON AU CBA,22.87,0,738781.59,DR,REF935119,CBA,Savings
25-08-2025 10:03,CBAD320526BE01A4B4D8A32,063-000-001,22222222,UBER EATS CBA,10.67,0,738770.92,DR,REF243371,CBA,Savings
25-08-2025 11:13,CBA3A06174A413947989F8D,063-000-001,22222222,CITYLINK CBA,31.84,0,738739.08,DR,REF754789,CBA,Savings
25-08-2025 11:14,CBABCE8CB1263ED455FB1BC,063-000-001,22222222,PAY - SALARY CBA,0,814.33,739553.41,CR,REF516350,CBA,Savings
25-08-2025 11:35,CBA6F8B75FFAE3D41DEBD1F,063-000-001,22222222,CITYLINK CBA,25.72,0,739527.69,DR,REF937728,CBA,Savings
25-08-2025 11:56,CBA62F3EAFE887C4461A0D8,063-000-001,22222222,MENULOG CBA,61.9,0,739465.79,DR,REF737656,CBA,Savings
25-08-2025 12:00,CBAFD993DAC43D34124BFC6,063-000-001,22222222,TAFE BOOKSHOP CBA,41.89,0,739423.9,DR,REF112952,CBA,Savings
25-08-2025 12:09,CBAA74F0186C0614DAA9A63,063-000-001,22222222,PAYMENT GATEWAY CBA,118.31,0,739305.59,DR,REF393858,CBA,Savings
25-08-2025 12:37,CBA1A0D0BB69B9A488A951B,063-000-001,22222222,PAYPAL *NETFLIX CBA,31.56,0,739274.03,DR,REF387195,CBA,Savings
25-08-2025 12:59,CBA7B6337471C0B4EC7813A,063-000-001,22222222,STARBUCKS CBA,6.39,0,739267.64,DR,REF882302,CBA,Savings
25-08-2025 13:36,CBA892257E433D149CBADD3,063-000-001,22222222,FLIXBUS CBA,16.88,0,739250.76,DR,REF141964,CBA,Savings
25-08-2025 13:38,CBA4B02BB4BB15F4FC19A27,063-000-001,22222222,KFC CBA,47.51,0,739203.25,DR,REF835094,CBA,Savings
25-08-2025 14:19,CBA5778120530F5483EA209,063-000-001,22222222,ZOOM CBA,3.96,0,739199.29,DR,REF233272,CBA,Savings
25-08-2025 14:53,CBA3B23AA1F25574DFFA769,063-000-001,22222222,PAY - SALARY CBA,0,985.42,740184.71,CR,REF987848,CBA,Savings
25-08-2025 15:03,CBA10A9FFBB849B4C54B892,063-000-001,22222222,DOMINO'S PIZZA CBA,121.46,0,740063.25,DR,REF677129,CBA,Savings
25-08-2025 15:23,CBA1B286A1A95C94FAFAFF5,063-000-001,22222222,PAYPAL *NETFLIX CBA,63.64,0,739999.61,DR,REF603954,CBA,Savings
25-08-2025 15:43,CBA3855BEBE08F34494BE27,063-000-001,22222222,SPOTIFY CBA,195.3,0,739804.31,DR,REF855683,CBA,Savings
25-08-2025 15:51,CBA96BAC92A81914816AD5E,063-000-001,22222222,PAYROLL CREDIT CBA,0,2787.35,742591.66,CR,REF113410,CBA,Savings
25-08-2025 16:14,CBA32D2E622169D4A68B6C9,063-000-001,22222222,7-ELEVEN CBA,13.36,0,742578.3,DR,REF892477,CBA,Savings
25-08-2025 16:31,CBA8FE3C72A1615498193F5,063-000-001,22222222,RAILWAY STATION CBA,34.78,0,742543.52,DR,REF734960,CBA,Savings
25-08-2025 18:19,CBAA2034636D0CD43BF956F,063-000-001,22222222,ALDI CBA,21.62,0,742521.9,DR,REF611555,CBA,Savings
25-08-2025 18:32,CBAB157DB7B67C24A39AEE9,063-000-001,22222222,FLIXBUS CBA,22.73,0,742499.17,DR,REF919338,CBA,Savings
25-08-2025 18:49,CBAD5AA019A211E427A88ED,063-000-001,22222222,AMAZON AU CBA,54.6,0,742444.57,DR,REF523468,CBA,Savings
25-08-2025 19:03,CBAA9360E8E311C411A8B94,063-000-001,22222222,BWS CBA,66.46,0,742378.11,DR,REF983244,CBA,Savings
25-08-2025 19:50,CBA32EE811C48F348A49732,063-000-001,22222222,COLES CBA,134.15,0,742243.96,DR,REF459098,CBA,Savings
25-08-2025 20:28,CBA64C8A4176F1F49FF9EF2,063-000-001,22222222,CITYLINK CBA,72.01,0,742171.95,DR,REF524479,CBA,Savings
25-08-2025 20:36,CBAEE4EF12380CE4921B09E,063-000-001,22222222,RAILWAY STATION CBA,80.72,0,742091.23,DR,REF938328,CBA,Savings
25-08-2025 20:37,CBAD5BB275E89AC44E48A6C,063-000-001,22222222,MENULOG CBA,31.13,0,742060.1,DR,REF819999,CBA,Savings
25-08-2025 21:01,CBA36F3AACD847C46D1BB0F,063-000-001,22222222,WAGES CREDIT CBA,0,1177.11,743237.21,CR,REF146616,CBA,Savings
25-08-2025 21:06,CBA76EB4FE1F2F34C929C1C,063-000-001,22222222,TAFE BOOKSHOP CBA,33.64,0,743203.57,DR,REF766063,CBA,Savings
25-08-2025 21:41,CBA2B064ED1352C4EDBA7E4,063-000-001,22222222,PAYPAL *NETFLIX CBA,74.99,0,743128.58,DR,REF245518,CBA,Savings
25-08-2025 21:44,CBA4EF7F476CF2145F2ABAD,063-000-001,22222222,SPOTIFY CBA,79.39,0,743049.19,DR,REF599883,CBA,Savings
25-08-2025 22:02,CBA3AF093BF2765432197F5,063-000-001,22222222,MCDONALDS CBA,3.67,0,743045.52,DR,REF729028,CBA,Savings
25-08-2025 22:14,CBAF3AE78B0F0A54E15AE5F,063-000-001,22222222,APPLE CBA,38.08,0,743007.44,DR,REF820533,CBA,Savings
25-08-2025 22:16,CBA30F32738BA094AC28446,063-000-001,22222222,7-ELEVEN CBA,5.18,0,743002.26,DR,REF303612,CBA,Savings
25-08-2025 22:20,CBA1A62AF8400C641CEB4FA,063-000-001,22222222,CITYLINK CBA,112.23,0,742890.03,DR,REF247969,CBA,Savings
25-08-2025 22:35,INT358E0C1435684595B81F,063-000-001,22222222,TRANSFER FROM CBA 33333333,0,1579.38,744469.41,CR,INT-29798,CBA,Savings
25-08-2025 22:55,CBA0D64EC17E3E845AE9BB2,063-000-001,22222222,RAILWAY STATION CBA,130.17,0,744339.24,DR,REF612253,CBA,Savings
25-08-2025 23:13,CBAD5E5C1CCF44C4582B1C5,063-000-001,22222222,BP CBA,97.29,0,744241.95,DR,REF557681,CBA,Savings
25-08-2025 23:14,INT51CEA71F20C848F49DA2,063-000-001,22222222,TRANSFER FROM ANZ 11111111,0,958.53,745200.48,CR,INT-14310,CBA,Savings
25-08-2025 23:28,CBA85D02BF85DB64676B3EE,063-000-001,22222222,PAY - SALARY CBA,0,2876.88,748077.36,CR,REF458073,CBA,Savings
26-08-2025 00:22,CBA494E8418CE524C509423,063-000-001,22222222,INTERNET TRANSFER CBA,14.53,0,748062.83,DR,REF335913,CBA,Savings
26-08-2025 00:29,INTD556EDCD1BC245EE8365,063-000-001,22222222,TRANSFER FROM ANZ 11111111,0,1878.85,749941.68,CR,INT-36060,CBA,Savings
26-08-2025 00:41,CBA84E44CAB05C04FB08ED2,063-000-001,22222222,APPLE CBA,72.9,0,749868.78,DR,REF141527,CBA,Savings
26-08-2025 01:03,CBA632AFF93B8CE4DF395FF,063-000-001,22222222,AMAZON AU CBA,35.05,0,749833.73,DR,REF544969,CBA,Savings
26-08-2025 01:04,CBA32DDA339DAAF44C7A8FB,063-000-001,22222222,7-ELEVEN CBA,18.32,0,749815.41,DR,REF357828,CBA,Savings
26-08-2025 01:19,CBAE5265A154CDA4CE2B265,063-000-001,22222222,HARVEY NORMAN CBA,54.81,0,749760.6,DR,REF444241,CBA,Savings
26-08-2025 01:43,CBA328A79A72ED4445CBE7C,063-000-001,22222222,HARVEY NORMAN CBA,23.52,0,749737.08,DR,REF400586,CBA,Savings
26-08-2025 01:47,CBAEF825A9ADBB243AABBD9,063-000-001,22222222,FLIXBUS CBA,163.56,0,749573.52,DR,REF965715,CBA,Savings
26-08-2025 01:48,INT9F3957338AFB495991E4,063-000-001,22222222,TRANSFER TO CBA 33333333,1864.88,0,747708.64,DR,INT-92851,CBA,Savings
26-08-2025 02:17,CBA9F9D24CEF940451ABBBE,063-000-001,22222222,SPOTIFY CBA,83.67,0,747624.97,DR,REF252790,CBA,Savings
26-08-2025 02:59,CBA61DCD137D60840178300,063-000-001,22222222,TAFE BOOKSHOP CBA,76.72,0,747548.25,DR,REF617962,CBA,Savings
26-08-2025 03:04,CBA684FA2FAC0794589847D,063-000-001,22222222,AMAZON AU CBA,26.05,0,747522.2,DR,REF292933,CBA,Savings
26-08-2025 03:11,CBABC14BA347BDF4F50AE88,063-000-001,22222222,BP CBA,28.01,0,747494.19,DR,REF728433,CBA,Savings
26-08-2025 03:25,CBA165756AEA5664C9BA99E,063-000-001,22222222,TAFE BOOKSHOP CBA,9.39,0,747484.8,DR,REF768322,CBA,Savings
26-08-2025 03:37,CBA5B33F45E1BEE47F9B550,063-000-001,22222222,BIGW CBA,38.94,0,747445.86,DR,REF180203,CBA,Savings
26-08-2025 03:48,CBA81864AF1320A4643A0D7,063-000-001,22222222,PAYMENT GATEWAY CBA,10.08,0,747435.78,DR,REF860527,CBA,Savings
26-08-2025 04:08,CBACB52B0AFD3CC4E468A9D,063-000-001,22222222,COLES CBA,18.58,0,747417.2,DR,REF682799,CBA,Savings
26-08-2025 04:28,CBAFE21382692AA4D7FA1A4,063-000-001,22222222,KFC CBA,41.75,0,747375.45,DR,REF665963,CBA,Savings
26-08-2025 04:39,CBA8E5458C2500F4703ABA2,063-000-001,22222222,TAFE BOOKSHOP CBA,28.34,0,747347.11,DR,REF336650,CBA,Savings
26-08-2025 05:28,INT807BCA325240421CB84B,063-000-001,22222222,TRANSFER FROM ANZ 11111111,0,1849.34,749196.45,CR,INT-80072,CBA,Savings
26-08-2025 05:28,CBA0D6CF1129BEB44C694F7,063-000-001,22222222,SALARY PAYMENT CBA,0,7446.76,756643.21,CR,REF482580,CBA,Savings
26-08-2025 05:31,CBAC671672B0DC449E792F7,063-000-001,22222222,BIGW CBA,103.61,0,756539.6,DR,REF192203,CBA,Savings
26-08-2025 05:40,CBA8DAADB8C907D479C95A8,063-000-001,22222222,BIGW CBA,15.78,0,756523.82,DR,REF385599,CBA,Savings
26-08-2025 05:47,CBAC7FCF2746F984BF68B1D,063-000-001,22222222,MCDONALDS CBA,58.51,0,756465.31,DR,REF120755,CBA,Savings
26-08-2025 05:52,CBAD3775817CEAA4728B560,063-000-001,22222222,JB HI-FI CBA,4.68,0,756460.63,DR,REF649541,CBA,Savings
26-08-2025 05:53,CBABC51AA776C53445A898E,063-000-001,22222222,FLIXBUS CBA,28.76,0,756431.87,DR,REF694329,CBA,Savings
26-08-2025 05:55,CBA1E9B06EC258647B5BC02,063-000-001,22222222,SHELL CBA,4.02,0,756427.85,DR,REF762360,CBA,Savings
26-08-2025 06:09,CBA5E394542EDA44A0D8DDC,063-000-001,22222222,BP CBA,38.22,0,756389.63,DR,REF408671,CBA,Savings
26-08-2025 06:11,CBAD9D40459C7AD4D9080B3,063-000-001,22222222,INTERNET TRANSFER CBA,86.94,0,756302.69,DR,REF957491,CBA,Savings
26-08-2025 06:28,CBA3DAAB16471B74871B173,063-000-001,22222222,PAYPAL *NETFLIX CBA,8.65,0,756294.04,DR,REF688004,CBA,Savings
26-08-2025 06:53,CBA9A692AEDCB5947E58DE1,063-000-001,22222222,SALARY PAYMENT CBA,0,1048.73,757342.77,CR,REF933521,CBA,Savings
26-08-2025 07:07,CBA315D56A86C3A40D18C34,063-000-001,22222222,UBER EATS CBA,38.49,0,757304.28,DR,REF836728,CBA,Savings
26-08-2025 07:20,CBA4C25707B2B43447C8EAA,063-000-001,22222222,PAYPAL *NETFLIX CBA,9.82,0,757294.46,DR,REF190397,CBA,Savings
26-08-2025 07:29,CBA19A6EAB5DB6646D7A60F,063-000-001,22222222,JB HI-FI CBA,62.52,0,757231.94,DR,REF997392,CBA,Savings
26-08-2025 08:39,CBAD3337954A8F44080AE10,063-000-001,22222222,DOMINO'S PIZZA CBA,22.62,0,757209.32,DR,REF459320,CBA,Savings
26-08-2025 09:10,INT173855B6D74545D9B259,063-000-001,22222222,TRANSFER TO NAB 44444444,1355.46,0,755853.86,DR,INT-75204,CBA,Savings
26-08-2025 09:11,CBA23D9600E34CC4A3E90BF,063-000-001,22222222,PAYMENT GATEWAY CBA,4.21,0,755849.65,DR,REF673965,CBA,Savings
26-08-2025 09:25,CBAFD708ABFC1CE4B4BA621,063-000-001,22222222,ALDI CBA,77.75,0,755771.9,DR,REF482367,CBA,Savings
26-08-2025 09:54,CBA7043566B6A08427B98BA,063-000-001,22222222,AMAZON AU CBA,75.39,0,755696.51,DR,REF897697,CBA,Savings
26-08-2025 10:19,CBA489B2BD73007499C858B,063-000-001,22222222,SPOTIFY CBA,39.98,0,755656.53,DR,REF859189,CBA,Savings
26-08-2025 10:25,CBA3E3DA730902A41A6B00A,063-000-001,22222222,BP CBA,31.27,0,755625.26,DR,REF302449,CBA,Savings
26-08-2025 10:47,CBA99F43EE352D24CAE957A,063-000-001,22222222,BP CBA,49.02,0,755576.24,DR,REF735190,CBA,Savings
26-08-2025 11:03,CBAB989396D4B934B7EAD91,063-000-001,22222222,BP CBA,14.14,0,755562.1,DR,REF408511,CBA,Savings
26-08-2025 11:42,CBA6D39C82B1BDC4F41B92F,063-000-001,22222222,BP CBA,96.6,0,755465.5,DR,REF559554,CBA,Savings
26-08-2025 11:48,CBA53442D13109C4C3BA02A,063-000-001,22222222,AMAZON AU CBA,72,0,755393.5,DR,REF886691,CBA,Savings
26-08-2025 11:58,CBADB538811DCE3477694E0,063-000-001,22222222,SPOTIFY CBA,102.51,0,755290.99,DR,REF853444,CBA,Savings
26-08-2025 12:45,CBAA0CDAEF1A4BB453EBF9E,063-000-001,22222222,BANK FEE CBA,36.2,0,755254.79,DR,REF804073,CBA,Savings
26-08-2025 12:55,CBA485B756201534A98BD2A,063-000-001,22222222,ALDI CBA,12.67,0,755242.12,DR,REF939958,CBA,Savings
26-08-2025 13:03,CBA6FA96C3C59AE4D319FEE,063-000-001,22222222,SHELL CBA,76.63,0,755165.49,DR,REF946688,CBA,Savings
26-08-2025 13:11,CBAEA158C54F3884AD687B7,063-000-001,22222222,BIGW CBA,39.82,0,755125.67,DR,REF581733,CBA,Savings
26-08-2025 14:00,CBA4ED066502023482FBE25,063-000-001,22222222,AMAZON AU CBA,12.66,0,755113.01,DR,REF774144,CBA,Savings
26-08-2025 14:02,CBA311DD195C63343DEA3E0,063-000-001,22222222,LIQUORLAND CBA,14.85,0,755098.16,DR,REF675417,CBA,Savings
26-08-2025 14:19,CBA6F3FB45B99FA4264A171,063-000-001,22222222,PAYPAL *NETFLIX CBA,40.89,0,755057.27,DR,REF211851,CBA,Savings
26-08-2025 14:40,CBA2E6F80A00798426FB6AC,063-000-001,22222222,PAYROLL CREDIT CBA,0,6395.14,761452.41,CR,REF153444,CBA,Savings
26-08-2025 14:55,CBAE00DAB87AD6A4EA484FF,063-000-001,22222222,KFC CBA,74.07,0,761378.34,DR,REF209281,CBA,Savings
26-08-2025 15:11,CBA15485A0CC4494468AC27,063-000-001,22222222,PAYPAL *NETFLIX CBA,70.56,0,761307.78,DR,REF550663,CBA,Savings
26-08-2025 16:00,CBAF420ABA4F36C4DCA864A,063-000-001,22222222,UBER EATS CBA,151.96,0,761155.82,DR,REF570710,CBA,Savings
26-08-2025 16:32,CBA3E21E73EC38E4B7E987E,063-000-001,22222222,COLES CBA,40.47,0,761115.35,DR,REF129136,CBA,Savings
26-08-2025 16:59,CBACBB3A97E19B64D199E25,063-000-001,22222222,CITYLINK CBA,15.21,0,761100.14,DR,REF435430,CBA,Savings
26-08-2025 17:03,CBAFE4CA3199F214A389862,063-000-001,22222222,ZOOM CBA,12.01,0,761088.13,DR,REF305575,CBA,Savings
26-08-2025 17:10,CBA40D9BAC1138246F88F08,063-000-001,22222222,MCDONALDS CBA,3.21,0,761084.92,DR,REF346740,CBA,Savings
26-08-2025 17:41,CBACD7C9B896C604A698D4D,063-000-001,22222222,BP CBA,72.93,0,761011.99,DR,REF235954,CBA,Savings
26-08-2025 17:46,CBAA37AF5C3ECFE40AAA482,063-000-001,22222222,SALARY PAYMENT CBA,0,5.61,761017.6,CR,REF267490,CBA,Savings
26-08-2025 18:20,CBAA5F0417CE5104A1590F1,063-000-001,22222222,CITYLINK CBA,84.75,0,760932.85,DR,REF376240,CBA,Savings
26-08-2025 18:50,CBA18F1191D8BCB457BAC49,063-000-001,22222222,DOMINO'S PIZZA CBA,121.96,0,760810.89,DR,REF842855,CBA,Savings
26-08-2025 19:08,CBACC3F46BF400C46D9B458,063-000-001,22222222,LIQUORLAND CBA,61.46,0,760749.43,DR,REF356157,CBA,Savings
26-08-2025 19:21,CBA30EDBE8362194A5BA0AE,063-000-001,22222222,INTERNET TRANSFER CBA,34.59,0,760714.84,DR,REF352877,CBA,Savings
26-08-2025 19:38,CBAB93CFDD39B5C4DF9A88F,063-000-001,22222222,SALARY PAYMENT CBA,0,652.42,761367.26,CR,REF805823,CBA,Savings
26-08-2025 20:20,CBA60AEFA3E616F47E880E3,063-000-001,22222222,FLIXBUS CBA,162.23,0,761205.03,DR,REF838428,CBA,Savings
26-08-2025 20:38,CBA36556858E5944AC88E73,063-000-001,22222222,LIQUORLAND CBA,13.63,0,761191.4,DR,REF673644,CBA,Savings
26-08-2025 20:59,INT4BDDB171836A4E33808E,063-000-001,22222222,TRANSFER FROM NAB 44444444,0,1488.84,762680.24,CR,INT-71702,CBA,Savings
26-08-2025 21:23,CBAE1BCBF5D34CB430F8738,063-000-001,22222222,ALDI CBA,63.18,0,762617.06,DR,REF276089,CBA,Savings
26-08-2025 21:24,CBA2112EB04102B4D25BB2B,063-000-001,22222222,JB HI-FI CBA,109.7,0,762507.36,DR,REF224910,CBA,Savings
26-08-2025 21:34,CBAB9B34396E400401A9BC4,063-000-001,22222222,ZOOM CBA,114.23,0,762393.13,DR,REF681922,CBA,Savings
26-08-2025 21:53,CBAAEA498B512704E469B8E,063-000-001,22222222,ZOOM CBA,36.51,0,762356.62,DR,REF518365,CBA,Savings
26-08-2025 22:26,INT648B1B3364994D62824F,063-000-001,22222222,TRANSFER FROM ANZ 11111111,0,1592.83,763949.45,CR,INT-41964,CBA,Savings
26-08-2025 22:35,CBA2B5EA5583C6A46299DBA,063-000-001,22222222,SALARY PAYMENT CBA,0,994.44,764943.89,CR,REF964755,CBA,Savings
26-08-2025 22:50,CBAA91A78B5BEB24CB39E0E,063-000-001,22222222,DOMINO'S PIZZA CBA,3.49,0,764940.4,DR,REF259810,CBA,Savings
26-08-2025 22:52,CBA7E5A6281B78B4928BF1C,063-000-001,22222222,SHELL CBA,61.39,0,764879.01,DR,REF150156,CBA,Savings
26-08-2025 22:54,CBA83D7C4DC322741EC9820,063-000-001,22222222,ALDI CBA,61.88,0,764817.13,DR,REF541163,CBA,Savings
26-08-2025 23:01,CBAE92D6A339BFD4305969A,063-000-001,22222222,LIQUORLAND CBA,48.43,0,764768.7,DR,REF666722,CBA,Savings
26-08-2025 23:10,CBA468C82DC6030481DB8FA,063-000-001,22222222,STARBUCKS CBA,24.94,0,764743.76,DR,REF768658,CBA,Savings
26-08-2025 23:25,CBAB9F45CA0217D41C8BD3D,063-000-001,22222222,WAGES CREDIT CBA,0,628.36,765372.12,CR,REF529822,CBA,Savings
26-08-2025 23:40,CBAD5B031710DDF4D3AA05F,063-000-001,22222222,WOOLWORTHS CBA,19.99,0,765352.13,DR,REF621141,CBA,Savings
26-08-2025 23:49,CBAB4A1CC40434847E49024,063-000-001,22222222,PAYROLL CREDIT CBA,0,6507.1,771859.23,CR,REF164201,CBA,Savings
26-08-2025 23:49,CBAA1FB56E963E2422F97F6,063-000-001,22222222,AMAZON AU CBA,71.35,0,771787.88,DR,REF124499,CBA,Savings
27-08-2025 00:04,CBAEFA4F4D412474B59A5B4,063-000-001,22222222,STARBUCKS CBA,182.32,0,771605.56,DR,REF301351,CBA,Savings
27-08-2025 01:38,CBA46D2A4A6FB5F4B76BCAD,063-000-001,22222222,WAGES CREDIT CBA,0,1140.79,772746.35,CR,REF263320,CBA,Savings
27-08-2025 02:15,CBA35D6B7568DA742D1945A,063-000-001,22222222,DOMINO'S PIZZA CBA,14.04,0,772732.31,DR,REF395717,CBA,Savings
27-08-2025 02:21,CBAEC9E721C209A47A580BE,063-000-001,22222222,BWS CBA,3.09,0,772729.22,DR,REF722977,CBA,Savings
27-08-2025 02:22,CBA0E6422FD494740E59738,063-000-001,22222222,ZOOM CBA,37.69,0,772691.53,DR,REF128718,CBA,Savings
27-08-2025 02:41,INTB4C8C776F06D423C9F73,063-000-001,22222222,TRANSFER FROM ANZ 11111111,0,1795.3,774486.83,CR,INT-72594,CBA,Savings
27-08-2025 02:51,CBA289F425CDCC4494D8A53,063-000-001,22222222,WOOLWORTHS CBA,77.55,0,774409.28,DR,REF816703,CBA,Savings
27-08-2025 03:24,CBA923AD25EF93647A38C61,063-000-001,22222222,INTERNET TRANSFER CBA,102.2,0,774307.08,DR,REF453290,CBA,Savings
27-08-2025 03:34,CBA3837F46FB50A4A80A843,063-000-001,22222222,TAFE BOOKSHOP CBA,71.52,0,774235.56,DR,REF916540,CBA,Savings
27-08-2025 03:40,CBAA0842AB958FE4F999EE6,063-000-001,22222222,CITYLINK CBA,55.8,0,774179.76,DR,REF489529,CBA,Savings
27-08-2025 03:47,CBA1529057C8B5941B2B851,063-000-001,22222222,MCDONALDS CBA,97.26,0,774082.5,DR,REF340248,CBA,Savings
27-08-2025 04:42,CBACA0E0445F1694C83B9A3,063-000-001,22222222,7-ELEVEN CBA,3.3,0,774079.2,DR,REF165500,CBA,Savings
27-08-2025 05:13,CBA38B3B51786C947F58C49,063-000-001,22222222,TAFE BOOKSHOP CBA,14.47,0,774064.73,DR,REF192726,CBA,Savings
27-08-2025 05:20,CBAC98EE3E6BAEF47F2B651,063-000-001,22222222,UBER EATS CBA,101.5,0,773963.23,DR,REF211128,CBA,Savings
27-08-2025 05:23,CBA21979037D3C443D0B61A,063-000-001,22222222,PAYPAL *NETFLIX CBA,9.88,0,773953.35,DR,REF635508,CBA,Savings
27-08-2025 06:05,CBA2AC1EDE309BC4719BE54,063-000-001,22222222,WAGES CREDIT CBA,0,4329.91,778283.26,CR,REF426302,CBA,Savings
27-08-2025 06:18,CBAA1A76FF35ECF48429C9B,063-000-001,22222222,BWS CBA,25.7,0,778257.56,DR,REF157948,CBA,Savings
27-08-2025 06:25,CBAE9A473D4ECDE4814A1A1,063-000-001,22222222,INTERNET TRANSFER CBA,35.83,0,778221.73,DR,REF412744,CBA,Savings
27-08-2025 06:49,CBAEF9A99781B0B48F99AD2,063-000-001,22222222,PAYROLL CREDIT CBA,0,3018.01,781239.74,CR,REF539872,CBA,Savings
27-08-2025 07:23,INT6BB451D52A8C4FE5891C,063-000-001,22222222,TRANSFER TO CBA 33333333,251.64,0,780988.1,DR,INT-75127,CBA,Savings
27-08-2025 07:34,CBA93F83FBB76A241698898,063-000-001,22222222,APPLE CBA,9.22,0,780978.88,DR,REF321131,CBA,Savings
27-08-2025 07:57,CBAC53F81E14C02436F8A1F,063-000-001,22222222,BWS CBA,25.34,0,780953.54,DR,REF963543,CBA,Savings
27-08-2025 08:12,CBA88CDC5E0ED154F829DEC,063-000-001,22222222,HARVEY NORMAN CBA,15.61,0,780937.93,DR,REF397258,CBA,Savings
27-08-2025 08:32,CBADC639CBED6DB4C6DBE8D,063-000-001,22222222,JB HI-FI CBA,9.48,0,780928.45,DR,REF568022,CBA,Savings
27-08-2025 08:32,CBAF79CD18ABF2948DD9D28,063-000-001,22222222,UBER EATS CBA,10.52,0,780917.93,DR,REF455120,CBA,Savings
27-08-2025 09:03,INTD2FE4913621D4DC594FF,063-000-001,22222222,TRANSFER FROM CBA 33333333,0,1147.62,782065.55,CR,INT-22708,CBA,Savings
27-08-2025 09:08,CBA49C7F7322FD7425EA8E3,063-000-001,22222222,MCDONALDS CBA,29.29,0,782036.26,DR,REF672515,CBA,Savings
27-08-2025 09:13,INT3E749FAE93954CA9A6E8,063-000-001,22222222,TRANSFER TO ANZ 11111111,1157.46,0,780878.8,DR,INT-65508,CBA,Savings
27-08-2025 09:17,CBA8262323B924E493E94C8,063-000-001,22222222,APPLE CBA,19.77,0,780859.03,DR,REF835265,CBA,Savings
27-08-2025 09:21,CBA4D16A35C93ED4001B900,063-000-001,22222222,PAYPAL *NETFLIX CBA,127.98,0,780731.05,DR,REF905938,CBA,Savings
27-08-2025 09:37,INTCC4F5C246AC04693964C,063-000-001,22222222,TRANSFER FROM NAB 44444444,0,604.8,781335.85,CR,INT-53948,CBA,Savings
27-08-2025 09:53,CBAE5AA5DDAAC9E4AF886BD,063-000-001,22222222,BIGW CBA,44.22,0,781291.63,DR,REF787397,CBA,Savings
27-08-2025 10:00,CBA463EA86FEC8047539CEC,063-000-001,22222222,APPLE CBA,36.4,0,781255.23,DR,REF228016,CBA,Savings
27-08-2025 10:06,CBAAE4866B5410848FDA14C,063-000-001,22222222,RAILWAY STATION CBA,49.21,0,781206.02,DR,REF173135,CBA,Savings
27-08-2025 10:13,CBA2B37F5B4BDE04C93A6DC,063-000-001,22222222,SALARY PAYMENT CBA,0,4187.41,785393.43,CR,REF156423,CBA,Savings
27-08-2025 10:14,CBAE43578656DAC49A3BEDD,063-000-001,22222222,LIQUORLAND CBA,72.38,0,785321.05,DR,REF477077,CBA,Savings
27-08-2025 10:57,CBA5F3EE4E724C4494794F6,063-000-001,22222222,LIQUORLAND CBA,59.87,0,785261.18,DR,REF289265,CBA,Savings
27-08-2025 12:01,CBA6880817D5AA8421F8DBE,063-000-001,22222222,PAYROLL CREDIT CBA,0,403.99,785665.17,CR,REF275144,CBA,Savings
27-08-2025 12:35,CBA1CEDB070463D4D7EB140,063-000-001,22222222,FLIXBUS CBA,21.29,0,785643.88,DR,REF478355,CBA,Savings
27-08-2025 13:08,CBA5DA2D354DB9249368134,063-000-001,22222222,BANK FEE CBA,14.51,0,785629.37,DR,REF307703,CBA,Savings
27-08-2025 13:28,CBA4FA2E5C0384E4AF3AF22,063-000-001,22222222,PAYMENT GATEWAY CBA,105.12,0,785524.25,DR,REF511109,CBA,Savings
27-08-2025 13:31,CBACE5109F8F6764B05A00F,063-000-001,22222222,SPOTIFY CBA,246.42,0,785277.83,DR,REF311356,CBA,Savings
27-08-2025 13:32,CBA20FEC0D81D554A288B1C,063-000-001,22222222,RAILWAY STATION CBA,5.92,0,785271.91,DR,REF980735,CBA,Savings
27-08-2025 13:36,CBABAC7E37F5729493D8666,063-000-001,22222222,SHELL CBA,6.9,0,785265.01,DR,REF852982,CBA,Savings
27-08-2025 13:47,CBA420D55E82B2C4476870A,063-000-001,22222222,SPOTIFY CBA,31.74,0,785233.27,DR,REF643013,CBA,Savings
27-08-2025 14:23,CBA79C723B1384B417CBD66,063-000-001,22222222,UBER EATS CBA,73.21,0,785160.06,DR,REF301338,CBA,Savings
27-08-2025 14:29,CBA7CAEF8300CB44D9EB6F1,063-000-001,22222222,HARVEY NORMAN CBA,240.4,0,784919.66,DR,REF333008,CBA,Savings
27-08-2025 14:38,CBAAD795AF78B7341058798,063-000-001,22222222,AMAZON AU CBA,26.84,0,784892.82,DR,REF148571,CBA,Savings
27-08-2025 14:49,CBAD4162604288044F78CC4,063-000-001,22222222,BIGW CBA,120.59,0,784772.23,DR,REF426359,CBA,Savings
27-08-2025 14:52,CBA83F000D2DA2D4FFA82BB,063-000-001,22222222,MCDONALDS CBA,18.19,0,784754.04,DR,REF198811,CBA,Savings
27-08-2025 15:05,CBA5022F332879743DEBF10,063-000-001,22222222,DOMINO'S PIZZA CBA,29.86,0,784724.18,DR,REF825778,CBA,Savings
27-08-2025 15:44,CBACAA46860864242DC873D,063-000-001,22222222,HARVEY NORMAN CBA,17.82,0,784706.36,DR,REF730522,CBA,Savings
27-08-2025 15:51,CBA0944737270DE4E428218,063-000-001,22222222,TAFE BOOKSHOP CBA,46.88,0,784659.48,DR,REF877682,CBA,Savings
27-08-2025 16:01,CBA2838F46B15D14B11BC16,063-000-001,22222222,SPOTIFY CBA,12.8,0,784646.68,DR,REF474001,CBA,Savings
27-08-2025 16:26,CBA73F565709AF34DB4898F,063-000-001,22222222,BANK FEE CBA,107.39,0,784539.29,DR,REF290794,CBA,Savings
27-08-2025 16:59,CBAD19F01AC9B8445B183E6,063-000-001,22222222,LIQUORLAND CBA,16.9,0,784522.39,DR,REF784498,CBA,Savings
27-08-2025 17:05,CBAF03F20F604F14B039036,063-000-001,22222222,TAFE BOOKSHOP CBA,53.36,0,784469.03,DR,REF412054,CBA,Savings
27-08-2025 17:29,CBA3557CA44727A42D8AFC3,063-000-001,22222222,CITYLINK CBA,31.56,0,784437.47,DR,REF732166,CBA,Savings
27-08-2025 17:40,CBAABEE958018DD40A2B1FF,063-000-001,22222222,DOMINO'S PIZZA CBA,22.75,0,784414.72,DR,REF132516,CBA,Savings
27-08-2025 17:55,CBA6F5001DECFF845B380C9,063-000-001,22222222,ALDI CBA,76.6,0,784338.12,DR,REF489142,CBA,Savings
27-08-2025 18:19,CBAED8F7F351A064DE88FE0,063-000-001,22222222,DOMINO'S PIZZA CBA,28.18,0,784309.94,DR,REF133762,CBA,Savings
27-08-2025 18:39,CBAAD347FA4517A450CBB01,063-000-001,22222222,INTERNET TRANSFER CBA,26.53,0,784283.41,DR,REF990088,CBA,Savings
27-08-2025 18:55,CBA552A0528A28545DAA7D5,063-000-001,22222222,LIQUORLAND CBA,29.75,0,784253.66,DR,REF726117,CBA,Savings
27-08-2025 18:55,CBAA008CB7DAE4D49F5B931,063-000-001,22222222,KFC CBA,6.05,0,784247.61,DR,REF530390,CBA,Savings
27-08-2025 19:20,CBAE7DE4C56BE4E4D0AB945,063-000-001,22222222,SALARY PAYMENT CBA,0,653.19,784900.8,CR,REF704853,CBA,Savings
27-08-2025 19:24,CBAB446377ACD284263B320,063-000-001,22222222,APPLE CBA,26.46,0,784874.34,DR,REF635646,CBA,Savings
27-08-2025 19:25,CBAB6ADEF1748D34FF0A819,063-000-001,22222222,MENULOG CBA,5.76,0,784868.58,DR,REF365082,CBA,Savings
27-08-2025 19:50,CBA2948C8C1FC6C46DFA9CA,063-000-001,22222222,MCDONALDS CBA,71.83,0,784796.75,DR,REF741054,CBA,Savings
27-08-2025 20:05,CBABD99C960140A439C9A30,063-000-001,22222222,APPLE CBA,15.84,0,784780.91,DR,REF761134,CBA,Savings
27-08-2025 20:06,CBA7F6C241C2E7F474282A5,063-000-001,22222222,WOOLWORTHS CBA,57.77,0,784723.14,DR,REF948071,CBA,Savings
27-08-2025 20:19,CBA3B7978BADA614536AA92,063-000-001,22222222,COMPANY PAYROLL CBA,0,2509.81,787232.95,CR,REF943816,CBA,Savings
27-08-2025 20:55,CBADD783A83E00842DC854B,063-000-001,22222222,PAYMENT GATEWAY CBA,90.31,0,787142.64,DR,REF450705,CBA,Savings
27-08-2025 21:18,CBA4048D881A39847CB8F46,063-000-001,22222222,AMAZON AU CBA,15.3,0,787127.34,DR,REF877147,CBA,Savings
27-08-2025 21:45,CBA0D8AA6B420374211BE48,063-000-001,22222222,HARVEY NORMAN CBA,18.54,0,787108.8,DR,REF392995,CBA,Savings
27-08-2025 22:17,CBA2538A1CBBA1848A8AA8C,063-000-001,22222222,WAGES CREDIT CBA,0,7130.74,794239.54,CR,REF679329,CBA,Savings
27-08-2025 22:21,CBAA391D3D2B1E848FABC74,063-000-001,22222222,BIGW CBA,48.29,0,794191.25,DR,REF890975,CBA,Savings
27-08-2025 22:25,CBAB04C80F8367C40D4B996,063-000-001,22222222,SPOTIFY CBA,44.49,0,794146.76,DR,REF614273,CBA,Savings
27-08-2025 22:25,CBAFD0876B4F4F843FB9B84,063-000-001,22222222,WAGES CREDIT CBA,0,7375.39,801522.15,CR,REF333925,CBA,Savings
27-08-2025 22:33,CBAEF1910D71ECA4D0689B8,063-000-001,22222222,PAYMENT GATEWAY CBA,9.53,0,801512.62,DR,REF172742,CBA,Savings
27-08-2025 22:39,CBADD14E4EACE4B4ABABA28,063-000-001,22222222,COMPANY PAYROLL CBA,0,1720.94,803233.56,CR,REF412293,CBA,Savings
27-08-2025 23:04,CBAE0DC865EEDF849B1A0D5,063-000-001,22222222,ALDI CBA,44.97,0,803188.59,DR,REF872501,CBA,Savings
27-08-2025 23:38,CBA83F0A04A64E04FAB8F4C,063-000-001,22222222,7-ELEVEN CBA,181.12,0,803007.47,DR,REF200259,CBA,Savings
27-08-2025 23:44,CBA729802E25EEC489E8E52,063-000-001,22222222,SPOTIFY CBA,23.15,0,802984.32,DR,REF921178,CBA,Savings
28-08-2025 00:14,CBA1427406ED5724FBE8226,063-000-001,22222222,WOOLWORTHS CBA,88.22,0,802896.1,DR,REF720117,CBA,Savings
28-08-2025 00:22,CBA7C40D1EC33F04EB380FA,063-000-001,22222222,CITYLINK CBA,87.3,0,802808.8,DR,REF362776,CBA,Savings
28-08-2025 00:40,CBA23D0C8423A83409F84E2,063-000-001,22222222,ZOOM CBA,10.97,0,802797.83,DR,REF240287,CBA,Savings
28-08-2025 01:02,CBAB2E966E0D4924C219213,063-000-001,22222222,FLIXBUS CBA,217.12,0,802580.71,DR,REF821362,CBA,Savings
28-08-2025 01:21,CBAE3EF600FF69B4E81A6F2,063-000-001,22222222,DOMINO'S PIZZA CBA,50.3,0,802530.41,DR,REF713547,CBA,Savings
28-08-2025 02:00,CBA51FB5732D0EE4077B9A2,063-000-001,22222222,CITYLINK CBA,40.83,0,802489.58,DR,REF617738,CBA,Savings
28-08-2025 02:15,CBA9FE54C6F68A4429197A7,063-000-001,22222222,HARVEY NORMAN CBA,89.2,0,802400.38,DR,REF886734,CBA,Savings
28-08-2025 02:16,CBAD57CA1165FF347EBB77E,063-000-001,22222222,STARBUCKS CBA,13.11,0,802387.27,DR,REF196176,CBA,Savings
28-08-2025 02:17,CBA06432571C2684B55A9BB,063-000-001,22222222,LIQUORLAND CBA,44.24,0,802343.03,DR,REF590142,CBA,Savings
28-08-2025 02:24,CBA805CB2C266DC4EE2A426,063-000-001,22222222,FLIXBUS CBA,2.76,0,802340.27,DR,REF994827,CBA,Savings
28-08-2025 02:42,INTFF34414D312C4AEFB334,063-000-001,22222222,TRANSFER TO ANZ 11111111,171.6,0,802168.67,DR,INT-71174,CBA,Savings
28-08-2025 02:43,CBAE7C965F2FB0E4E8AA1AD,063-000-001,22222222,AMAZON AU CBA,29.69,0,802138.98,DR,REF845343,CBA,Savings
28-08-2025 03:37,CBAE78637BA39D747C3952B,063-000-001,22222222,SHELL CBA,43.7,0,802095.28,DR,REF989706,CBA,Savings
28-08-2025 03:38,CBAE6219BE1C255488182FC,063-000-001,22222222,JB HI-FI CBA,34.03,0,802061.25,DR,REF617768,CBA,Savings
28-08-2025 03:58,CBAA491604C9CA440278EC2,063-000-001,22222222,COMPANY PAYROLL CBA,0,2501.48,804562.73,CR,REF677180,CBA,Savings
28-08-2025 04:18,CBA270C8F84F89947C3A280,063-000-001,22222222,TAFE BOOKSHOP CBA,14.4,0,804548.33,DR,REF972740,CBA,Savings
28-08-2025 04:41,CBA4EFFBAA1780A4CBCA8A4,063-000-001,22222222,UBER EATS CBA,36.13,0,804512.2,DR,REF707157,CBA,Savings
28-08-2025 05:31,CBA4D06C93544634FA68656,063-000-001,22222222,APPLE CBA,23.64,0,804488.56,DR,REF807076,CBA,Savings
28-08-2025 05:41,CBA06FD8481ADD148189B81,063-000-001,22222222,BIGW CBA,25.92,0,804462.64,DR,REF348825,CBA,Savings
28-08-2025 05:48,INTF91E7172D9494FE39ABA,063-000-001,22222222,TRANSFER FROM ANZ 11111111,0,978.23,805440.87,CR,INT-85043,CBA,Savings
28-08-2025 06:06,CBAC6BF00BC4BAB4DB8A58D,063-000-001,22222222,PAYROLL CREDIT CBA,0,618.21,806059.08,CR,REF419739,CBA,Savings
28-08-2025 06:13,CBAFBC88265DEE84E8F87B0,063-000-001,22222222,MENULOG CBA,207.96,0,805851.12,DR,REF866092,CBA,Savings
28-08-2025 06:59,CBAD05D90FDA13E48099402,063-000-001,22222222,LIQUORLAND CBA,6.28,0,805844.84,DR,REF451264,CBA,Savings
28-08-2025 07:04,CBA0F3179769BA24B08BB74,063-000-001,22222222,AMAZON AU CBA,3.51,0,805841.33,DR,REF102008,CBA,Savings
28-08-2025 07:15,CBA5CF864C2345B4221947B,063-000-001,22222222,UBER EATS CBA,18.08,0,805823.25,DR,REF842634,CBA,Savings
28-08-2025 07:44,CBAC1ACCBA12A33452CAC85,063-000-001,22222222,BIGW CBA,10.7,0,805812.55,DR,REF363794,CBA,Savings
28-08-2025 07:48,CBA66A1EB5E9AB64D22A7EC,063-000-001,22222222,ALDI CBA,23.21,0,805789.34,DR,REF195812,CBA,Savings
28-08-2025 08:13,CBAF9E566A98A2A4A6296D2,063-000-001,22222222,BP CBA,9.27,0,805780.07,DR,REF664722,CBA,Savings
28-08-2025 08:30,CBA89B2A79F62104D7D9A6F,063-000-001,22222222,BP CBA,61.86,0,805718.21,DR,REF425549,CBA,Savings
28-08-2025 08:46,CBACDE6AF5A06E44A37891C,063-000-001,22222222,WOOLWORTHS CBA,6.31,0,805711.9,DR,REF362522,CBA,Savings
28-08-2025 08:58,CBAC42AC7AD3A6B4446A4FE,063-000-001,22222222,WAGES CREDIT CBA,0,6089.86,811801.76,CR,REF403476,CBA,Savings
28-08-2025 09:31,CBAFF7C753C4EFE4AF99174,063-000-001,22222222,PAYMENT GATEWAY CBA,14.12,0,811787.64,DR,REF474700,CBA,Savings
28-08-2025 09:37,INTC61C8CB2610240158A7F,063-000-001,22222222,TRANSFER TO ANZ 11111111,1019.81,0,810767.83,DR,INT-65574,CBA,Savings
28-08-2025 11:02,CBA84C02C6BE4164CE7BD9D,063-000-001,22222222,PAY - SALARY CBA,0,1029.58,811797.41,CR,REF386919,CBA,Savings
28-08-2025 11:08,CBA2C97090E4C1246A9BEBF,063-000-001,22222222,APPLE CBA,25.19,0,811772.22,DR,REF214530,CBA,Savings
28-08-2025 11:11,CBA4B0822E83B14460AAC34,063-000-001,22222222,SHELL CBA,29.65,0,811742.57,DR,REF860725,CBA,Savings
28-08-2025 11:20,CBAE1C593010C24498BB22A,063-000-001,22222222,APPLE CBA,18.16,0,811724.41,DR,REF623586,CBA,Savings
28-08-2025 11:21,CBA72329693D6184D11ADF1,063-000-001,22222222,PAYMENT GATEWAY CBA,124.26,0,811600.15,DR,REF261839,CBA,Savings
28-08-2025 11:21,CBA8F412CC95CE942FB92A2,063-000-001,22222222,COLES CBA,20.45,0,811579.7,DR,REF401744,CBA,Savings
28-08-2025 12:25,CBA72193F7303214ECB93E3,063-000-001,22222222,BWS CBA,74.65,0,811505.05,DR,REF759941,CBA,Savings
28-08-2025 12:29,CBAC30EEB76E56644A8B5E1,063-000-001,22222222,SHELL CBA,108.9,0,811396.15,DR,REF341966,CBA,Savings
28-08-2025 12:47,INT2196A574125C4B4C88B1,063-000-001,22222222,TRANSFER FROM NAB 44444444,0,581.54,811977.69,CR,INT-95914,CBA,Savings
28-08-2025 13:02,INT241A590B8EC44DA9A26A,063-000-001,22222222,TRANSFER FROM CBA 33333333,0,1043.43,813021.12,CR,INT-35633,CBA,Savings
28-08-2025 13:15,CBA3FBE963F9FD34B618F0B,063-000-001,22222222,TAFE BOOKSHOP CBA,65.8,0,812955.32,DR,REF131839,CBA,Savings
28-08-2025 14:09,CBA205D9FEA7F0444849FDA,063-000-001,22222222,WOOLWORTHS CBA,14.42,0,812940.9,DR,REF521729,CBA,Savings
28-08-2025 14:18,CBA5B88DFA072B345F8926B,063-000-001,22222222,AMAZON AU CBA,67.41,0,812873.49,DR,REF384774,CBA,Savings
28-08-2025 14:26,CBA63CBBEF8A9EF451BA119,063-000-001,22222222,PAYROLL CREDIT CBA,0,4092.4,816965.89,CR,REF282519,CBA,Savings
28-08-2025 14:29,CBA6E3E27466231420DA0EA,063-000-001,22222222,SPOTIFY CBA,94.67,0,816871.22,DR,REF172445,CBA,Savings
28-08-2025 14:43,CBADD0956A72AC6483BA10F,063-000-001,22222222,PAYMENT GATEWAY CBA,64.93,0,816806.29,DR,REF945806,CBA,Savings
28-08-2025 15:02,CBA6797021865DC41BE8617,063-000-001,22222222,COMPANY PAYROLL CBA,0,7000.31,823806.6,CR,REF463871,CBA,Savings
28-08-2025 15:04,CBAE7A329372B4744BD8B4D,063-000-001,22222222,COLES CBA,52.08,0,823754.52,DR,REF440100,CBA,Savings
28-08-2025 15:15,CBA463B448DB5434E1AA51A,063-000-001,22222222,MENULOG CBA,16.62,0,823737.9,DR,REF365345,CBA,Savings
28-08-2025 15:19,CBA9DC249D2773643D8834F,063-000-001,22222222,PAYMENT GATEWAY CBA,23.88,0,823714.02,DR,REF893228,CBA,Savings
28-08-2025 15:35,CBABC86A4E4A8E54D91AA69,063-000-001,22222222,SALARY PAYMENT CBA,0,5544.72,829258.74,CR,REF184036,CBA,Savings
28-08-2025 15:45,CBA1DD9243B89F547FF8F35,063-000-001,22222222,BIGW CBA,22.75,0,829235.99,DR,REF664933,CBA,Savings
28-08-2025 16:46,CBA97C45C3F045C46A0A128,063-000-001,22222222,COLES CBA,101.45,0,829134.54,DR,REF951630,CBA,Savings
28-08-2025 18:07,CBA408FFCE0A18C46BE84EA,063-000-001,22222222,RAILWAY STATION CBA,48.5,0,829086.04,DR,REF363480,CBA,Savings
28-08-2025 18:53,CBA2A8068E1CA9B4D27BF4D,063-000-001,22222222,PAYMENT GATEWAY CBA,5.29,0,829080.75,DR,REF795313,CBA,Savings
28-08-2025 19:08,CBA3BD3CE46B0B949E98297,063-000-001,22222222,PAYPAL *NETFLIX CBA,21.83,0,829058.92,DR,REF523273,CBA,Savings
28-08-2025 19:50,CBA89BEE6C8210049008D22,063-000-001,22222222,BIGW CBA,119.45,0,828939.47,DR,REF579782,CBA,Savings
28-08-2025 19:50,CBACAE017579160470EB777,063-000-001,22222222,PAY - SALARY CBA,0,781.97,829721.44,CR,REF857006,CBA,Savings
28-08-2025 20:05,INTA2558CD2156342BBBAA6,063-000-001,22222222,TRANSFER TO NAB 44444444,282.34,0,829439.1,DR,INT-56821,CBA,Savings
28-08-2025 20:34,CBA0DF95F1679BE40C4BAB1,063-000-001,22222222,7-ELEVEN CBA,16.93,0,829422.17,DR,REF251801,CBA,Savings
28-08-2025 20:46,CBAA3CCA52EC0E843E497C3,063-000-001,22222222,BP CBA,6.53,0,829415.64,DR,REF667450,CBA,Savings
28-08-2025 21:07,CBA93F799DEFCCF41DA8984,063-000-001,22222222,TAFE BOOKSHOP CBA,42.32,0,829373.32,DR,REF679929,CBA,Savings
28-08-2025 21:10,CBA233003E6A6244560AA9E,063-000-001,22222222,HARVEY NORMAN CBA,24.67,0,829348.65,DR,REF740706,CBA,Savings
28-08-2025 21:37,CBA0A6D3E886C544BE3894D,063-000-001,22222222,BWS CBA,28.49,0,829320.16,DR,REF253300,CBA,Savings
28-08-2025 21:37,CBA8F08913F2AD2482F83E0,063-000-001,22222222,INTERNET TRANSFER CBA,21.28,0,829298.88,DR,REF721261,CBA,Savings
28-08-2025 22:27,CBAC38EABAEA019488D92D5,063-000-001,22222222,COLES CBA,20,0,829278.88,DR,REF297874,CBA,Savings
28-08-2025 22:59,CBA16897A20321D4643BDE2,063-000-001,22222222,BIGW CBA,167.77,0,829111.11,DR,REF744122,CBA,Savings
28-08-2025 23:25,CBA2C2767FF3F5F45B890F9,063-000-001,22222222,MENULOG CBA,11.43,0,829099.68,DR,REF527199,CBA,Savings
28-08-2025 23:37,CBA959C76F03D1E4A84A0D2,063-000-001,22222222,DOMINO'S PIZZA CBA,28.85,0,829070.83,DR,REF899095,CBA,Savings
29-08-2025 00:01,CBA9EF1A9F73AF144A799F6,063-000-001,22222222,JB HI-FI CBA,62.98,0,829007.85,DR,REF281531,CBA,Savings
29-08-2025 00:05,CBA5E93B49E492B41E08734,063-000-001,22222222,BWS CBA,10.7,0,828997.15,DR,REF335684,CBA,Savings
29-08-2025 01:14,CBA5D36D5F8F66647A0BED3,063-000-001,22222222,BANK FEE CBA,111.09,0,828886.06,DR,REF831582,CBA,Savings
29-08-2025 01:28,CBABDEC6527EAF543AA9963,063-000-001,22222222,RAILWAY STATION CBA,44.64,0,828841.42,DR,REF196912,CBA,Savings
29-08-2025 01:56,CBAF9FCA850FA0B4CC6BDCA,063-000-001,22222222,STARBUCKS CBA,114.43,0,828726.99,DR,REF695866,CBA,Savings
29-08-2025 02:26,CBAF7FA6627DEB949CEB7D2,063-000-001,22222222,BWS CBA,33.91,0,828693.08,DR,REF685692,CBA,Savings
29-08-2025 02:29,CBA5E19D798E9744A91B8F5,063-000-001,22222222,MENULOG CBA,26.13,0,828666.95,DR,REF663766,CBA,Savings
29-08-2025 02:48,CBA0B39F3C5BDB44C4BA8BB,063-000-001,22222222,SHELL CBA,2.19,0,828664.76,DR,REF477874,CBA,Savings
29-08-2025 02:51,CBA6662E064045C4C8FAA4E,063-000-001,22222222,LIQUORLAND CBA,96.52,0,828568.24,DR,REF371932,CBA,Savings
29-08-2025 03:08,CBA7A99F55BF1624DEDB240,063-000-001,22222222,UBER EATS CBA,11.49,0,828556.75,DR,REF290455,CBA,Savings
29-08-2025 03:11,CBA8E707E94B9484D99A7B1,063-000-001,22222222,ZOOM CBA,64.94,0,828491.81,DR,REF173922,CBA,Savings
29-08-2025 03:31,CBA6CBF98A1496649EAABF7,063-000-001,22222222,LIQUORLAND CBA,8.52,0,828483.29,DR,REF589271,CBA,Savings
29-08-2025 03:48,CBA8F49F59E8DDA4BBFA0BA,063-000-001,22222222,MENULOG CBA,73.07,0,828410.22,DR,REF502153,CBA,Savings
29-08-2025 04:24,CBA1825458239704DD5BAE1,063-000-001,22222222,INTERNET TRANSFER CBA,36.82,0,828373.4,DR,REF744781,CBA,Savings
29-08-2025 04:29,CBAF3707B2A688F4E0EA1CE,063-000-001,22222222,PAYMENT GATEWAY CBA,80.61,0,828292.79,DR,REF657313,CBA,Savings
29-08-2025 04:31,CBABA5585FD644A481884D4,063-000-001,22222222,JB HI-FI CBA,339.86,0,827952.93,DR,REF825459,CBA,Savings
29-08-2025 05:02,CBA91ECA823E8B0479ABAA5,063-000-001,22222222,AMAZON AU CBA,49.2,0,827903.73,DR,REF765653,CBA,Savings
29-08-2025 05:05,CBA78F0C26E117A43368B2F,063-000-001,22222222,STARBUCKS CBA,35.16,0,827868.57,DR,REF232299,CBA,Savings
29-08-2025 05:16,CBA53F1EEB2736645B9A04E,063-000-001,22222222,INTERNET TRANSFER CBA,38.32,0,827830.25,DR,REF960734,CBA,Savings
29-08-2025 05:19,CBA9A73452664B340E8A610,063-000-001,22222222,BWS CBA,13.13,0,827817.12,DR,REF403198,CBA,Savings
29-08-2025 05:28,CBA522866BA512348E99F71,063-000-001,22222222,SHELL CBA,171.13,0,827645.99,DR,REF484017,CBA,Savings
29-08-2025 05:37,CBAE9E7214C34BA493F8B96,063-000-001,22222222,APPLE CBA,40.31,0,827605.68,DR,REF950182,CBA,Savings
29-08-2025 05:47,CBA0995864C2EF24CF388E9,063-000-001,22222222,HARVEY NORMAN CBA,17.55,0,827588.13,DR,REF406199,CBA,Savings
29-08-2025 05:50,CBA3B8D60C0B9F749F2B292,063-000-001,22222222,CITYLINK CBA,170.61,0,827417.52,DR,REF791835,CBA,Savings
29-08-2025 05:56,CBA7241873476464A7CBADD,063-000-001,22222222,DOMINO'S PIZZA CBA,12.33,0,827405.19,DR,REF143533,CBA,Savings
29-08-2025 06:33,CBA4B08A60ED9FC477196FE,063-000-001,22222222,MCDONALDS CBA,7.96,0,827397.23,DR,REF535493,CBA,Savings
29-08-2025 07:03,CBA61A07984BC1249B2B754,063-000-001,22222222,ALDI CBA,53.31,0,827343.92,DR,REF592771,CBA,Savings
29-08-2025 07:04,CBA73EED91B9C244E25B269,063-000-001,22222222,PAYPAL *NETFLIX CBA,5.15,0,827338.77,DR,REF600693,CBA,Savings
29-08-2025 07:09,CBA35F4CCCAE1D241DEB389,063-000-001,22222222,7-ELEVEN CBA,142.4,0,827196.37,DR,REF747541,CBA,Savings
29-08-2025 07:20,CBA4449D1EDAE4F4C0BB0C2,063-000-001,22222222,LIQUORLAND CBA,1.49,0,827194.88,DR,REF601015,CBA,Savings
29-08-2025 07:31,CBAFD6C3F1FC60A45EFBF63,063-000-001,22222222,AMAZON AU CBA,122.82,0,827072.06,DR,REF357399,CBA,Savings
29-08-2025 08:01,CBA0CED07C576604C12BA0D,063-000-001,22222222,WAGES CREDIT CBA,0,2005.91,829077.97,CR,REF109469,CBA,Savings
29-08-2025 08:38,CBADC3F10250629484B9333,063-000-001,22222222,INTERNET TRANSFER CBA,26.41,0,829051.56,DR,REF168356,CBA,Savings
29-08-2025 08:41,CBAFC92064B4D0A4D348C1F,063-000-001,22222222,PAY - SALARY CBA,0,4151.84,833203.4,CR,REF687135,CBA,Savings
29-08-2025 08:41,CBA4B97B53C27AE41AE8E18,063-000-001,22222222,PAYROLL CREDIT CBA,0,2642.13,835845.53,CR,REF264461,CBA,Savings
29-08-2025 08:50,CBA6256197220E248A7895B,063-000-001,22222222,JB HI-FI CBA,69.97,0,835775.56,DR,REF346906,CBA,Savings
29-08-2025 09:23,CBA1911913464144A69AEDC,063-000-001,22222222,DOMINO'S PIZZA CBA,30.43,0,835745.13,DR,REF914984,CBA,Savings
29-08-2025 09:28,CBA13CAF8725164491791EB,063-000-001,22222222,HARVEY NORMAN CBA,87.92,0,835657.21,DR,REF615239,CBA,Savings
29-08-2025 10:33,CBA5BEBFC62E4194030B515,063-000-001,22222222,KFC CBA,42.49,0,835614.72,DR,REF429722,CBA,Savings
29-08-2025 10:35,CBA43EC020372D14C988A36,063-000-001,22222222,HARVEY NORMAN CBA,10.16,0,835604.56,DR,REF720073,CBA,Savings
29-08-2025 10:36,CBAC39D060236A14C378F3F,063-000-001,22222222,APPLE CBA,76.28,0,835528.28,DR,REF362561,CBA,Savings
29-08-2025 10:47,CBAB935BC1BC77349F49E3F,063-000-001,22222222,HARVEY NORMAN CBA,43.13,0,835485.15,DR,REF538024,CBA,Savings
29-08-2025 11:29,CBA4C1A8B34DABE494284C0,063-000-001,22222222,CITYLINK CBA,20.78,0,835464.37,DR,REF342589,CBA,Savings
29-08-2025 11:33,CBA789B60696FDD492E8FBC,063-000-001,22222222,BWS CBA,19.29,0,835445.08,DR,REF631763,CBA,Savings
29-08-2025 11:47,CBA0F6DA1982AF04579AF89,063-000-001,22222222,RAILWAY STATION CBA,19.79,0,835425.29,DR,REF356408,CBA,Savings
29-08-2025 12:15,CBA1387048E0FE64E61B365,063-000-001,22222222,ZOOM CBA,6.19,0,835419.1,DR,REF110030,CBA,Savings
29-08-2025 12:41,CBAA3295A05A9F14B24805A,063-000-001,22222222,MCDONALDS CBA,190.47,0,835228.63,DR,REF496489,CBA,Savings
29-08-2025 12:42,CBA638CE359F870429EBFC3,063-000-001,22222222,COLES CBA,33.47,0,835195.16,DR,REF927668,CBA,Savings
29-08-2025 13:31,CBA447CC49B2F9940E79AE8,063-000-001,22222222,LIQUORLAND CBA,5.87,0,835189.29,DR,REF530185,CBA,Savings
29-08-2025 13:36,CBAD9018D75A3A14381A642,063-000-001,22222222,KFC CBA,9.07,0,835180.22,DR,REF201787,CBA,Savings
29-08-2025 14:11,CBAC8CEE6635CDF49919ECF,063-000-001,22222222,TAFE BOOKSHOP CBA,42.46,0,835137.76,DR,REF340367,CBA,Savings
29-08-2025 14:14,CBA66214769A4BA4C199B4C,063-000-001,22222222,MENULOG CBA,25.92,0,835111.84,DR,REF224222,CBA,Savings
29-08-2025 14:20,CBADF39B830A5454602A456,063-000-001,22222222,DOMINO'S PIZZA CBA,17.68,0,835094.16,DR,REF631258,CBA,Savings
29-08-2025 14:26,CBA4ED6EDCF24DA41F4B766,063-000-001,22222222,KFC CBA,18.12,0,835076.04,DR,REF667156,CBA,Savings
29-08-2025 15:00,CBA0F3A143DAC3948AB9AB2,063-000-001,22222222,HARVEY NORMAN CBA,57.6,0,835018.44,DR,REF239310,CBA,Savings
29-08-2025 15:08,CBA753EF9D457B040D988D5,063-000-001,22222222,JB HI-FI CBA,8.76,0,835009.68,DR,REF249935,CBA,Savings
29-08-2025 15:19,CBA5E5C1146356D4AE0A77B,063-000-001,22222222,BANK FEE CBA,40.38,0,834969.3,DR,REF549043,CBA,Savings
29-08-2025 15:36,CBAB8E4EF8A4772493DA43A,063-000-001,22222222,PAY - SALARY CBA,0,7953.62,842922.92,CR,REF400812,CBA,Savings
29-08-2025 15:36,CBA416B9F7EF70E4E70827D,063-000-001,22222222,7-ELEVEN CBA,42.13,0,842880.79,DR,REF957211,CBA,Savings
29-08-2025 16:59,CBAC5BF5C9EC42547E68D47,063-000-001,22222222,7-ELEVEN CBA,157.51,0,842723.28,DR,REF330605,CBA,Savings
29-08-2025 17:09,CBA80D5FB49BD5445E0BAD7,063-000-001,22222222,PAYROLL CREDIT CBA,0,4398.56,847121.84,CR,REF174949,CBA,Savings
29-08-2025 17:37,CBA75B4C58A61BD4E6B8935,063-000-001,22222222,PAY - SALARY CBA,0,7524.31,854646.15,CR,REF379907,CBA,Savings
29-08-2025 17:48,CBA60848CC3D7684F57BC3C,063-000-001,22222222,ALDI CBA,81.78,0,854564.37,DR,REF743161,CBA,Savings
29-08-2025 18:02,CBA9D76A4886DBD4E6CAF81,063-000-001,22222222,AMAZON AU CBA,39.94,0,854524.43,DR,REF356502,CBA,Savings
29-08-2025 18:11,CBACE8D13BB60824979A4BD,063-000-001,22222222,LIQUORLAND CBA,60.22,0,854464.21,DR,REF116995,CBA,Savings
29-08-2025 18:46,CBA77ACA1A11AA14F54A949,063-000-001,22222222,SHELL CBA,15.63,0,854448.58,DR,REF764229,CBA,Savings
29-08-2025 19:01,CBA55A10276BA1E44C5AE7F,063-000-001,22222222,BWS CBA,93.65,0,854354.93,DR,REF309667,CBA,Savings
29-08-2025 19:32,CBAD40A1996D998473DB958,063-000-001,22222222,KFC CBA,7.71,0,854347.22,DR,REF180616,CBA,Savings
29-08-2025 19:38,INT1EFAF39078A94ABF97F2,063-000-001,22222222,TRANSFER FROM NAB 44444444,0,1349.89,855697.11,CR,INT-56459,CBA,Savings
29-08-2025 19:52,INTC6E39F06D2084A608F84,063-000-001,22222222,TRANSFER TO ANZ 11111111,223.9,0,855473.21,DR,INT-78466,CBA,Savings
29-08-2025 20:14,INT27333ECDF2E54F4DB397,063-000-001,22222222,TRANSFER FROM CBA 33333333,0,58.98,855532.19,CR,INT-59624,CBA,Savings
29-08-2025 20:30,CBA985EB374AD2F4B799C75,063-000-001,22222222,CITYLINK CBA,38.35,0,855493.84,DR,REF156677,CBA,Savings
29-08-2025 20:44,INT7E07FAF46FAC40EBA65A,063-000-001,22222222,TRANSFER FROM CBA 33333333,0,320.2,855814.04,CR,INT-66374,CBA,Savings
29-08-2025 21:10,CBAB833C78D42964F219089,063-000-001,22222222,COMPANY PAYROLL CBA,0,7603.9,863417.94,CR,REF881010,CBA,Savings
29-08-2025 21:31,CBABCECB98787204578B8D5,063-000-001,22222222,JB HI-FI CBA,75.21,0,863342.73,DR,REF580810,CBA,Savings
29-08-2025 21:46,CBA893F7F8214A941C79F8D,063-000-001,22222222,WAGES CREDIT CBA,0,723.77,864066.5,CR,REF966092,CBA,Savings
29-08-2025 22:19,CBAB6C38DCAC3374B0880DD,063-000-001,22222222,JB HI-FI CBA,87.17,0,863979.33,DR,REF743110,CBA,Savings
29-08-2025 22:19,CBA73F3B4DE9A8F4205B546,063-000-001,22222222,SPOTIFY CBA,86.24,0,863893.09,DR,REF554122,CBA,Savings
29-08-2025 22:57,CBA7081A58FAAA74A3F9442,063-000-001,22222222,BANK FEE CBA,22.84,0,863870.25,DR,REF300941,CBA,Savings
29-08-2025 23:28,CBA1E55627687A7481680AE,063-000-001,22222222,SPOTIFY CBA,68.06,0,863802.19,DR,REF829185,CBA,Savings
29-08-2025 23:29,CBA10AC408A4F66450AAA55,063-000-001,22222222,MCDONALDS CBA,53.39,0,863748.8,DR,REF172381,CBA,Savings
29-08-2025 23:33,CBA76A8C50362D845B1A839,063-000-001,22222222,BIGW CBA,4.07,0,863744.73,DR,REF163680,CBA,Savings
29-08-2025 23:39,CBABE6D1C56CED4468E9A0B,063-000-001,22222222,BP CBA,37.34,0,863707.39,DR,REF828503,CBA,Savings
29-08-2025 23:48,INTA82D321E4B3D44258D3F,063-000-001,22222222,TRANSFER FROM CBA 33333333,0,1461.58,865168.97,CR,INT-16559,CBA,Savings
29-08-2025 23:56,CBAD2669BB81A7940AFABF8,063-000-001,22222222,7-ELEVEN CBA,5.78,0,865163.19,DR,REF626385,CBA,Savings
30-08-2025 00:11,CBAA150D11ED0584E39880D,063-000-001,22222222,COMPANY PAYROLL CBA,0,4639.84,869803.03,CR,REF793832,CBA,Savings
30-08-2025 00:13,CBA7AF0821E79154F509A17,063-000-001,22222222,STARBUCKS CBA,15.12,0,869787.91,DR,REF442708,CBA,Savings
30-08-2025 00:15,CBAC26B8EF5DD9749788822,063-000-001,22222222,KFC CBA,25.87,0,869762.04,DR,REF732874,CBA,Savings
30-08-2025 00:20,CBA24D73E79DAA947B9B8A8,063-000-001,22222222,PAYMENT GATEWAY CBA,36.64,0,869725.4,DR,REF415444,CBA,Savings
30-08-2025 00:21,CBAB77B5ED31F2E413ABFFC,063-000-001,22222222,COMPANY PAYROLL CBA,0,314.56,870039.96,CR,REF179618,CBA,Savings
30-08-2025 00:30,CBAA0759ADAC39B427F88BE,063-000-001,22222222,JB HI-FI CBA,10.94,0,870029.02,DR,REF251824,CBA,Savings
30-08-2025 01:00,CBA6C5131275D544EFD88D3,063-000-001,22222222,PAYPAL *NETFLIX CBA,61.84,0,869967.18,DR,REF808640,CBA,Savings
30-08-2025 01:39,CBAE6273A87CB784A12BD80,063-000-001,22222222,TAFE BOOKSHOP CBA,56.14,0,869911.04,DR,REF293668,CBA,Savings
30-08-2025 01:43,CBAA37EE7A648E94B078B35,063-000-001,22222222,UBER EATS CBA,122.76,0,869788.28,DR,REF162294,CBA,Savings
30-08-2025 01:50,CBA8872F40C0FD743DC9E34,063-000-001,22222222,TAFE BOOKSHOP CBA,63.54,0,869724.74,DR,REF460326,CBA,Savings
30-08-2025 02:04,CBACA36EB2DD8694EE7852F,063-000-001,22222222,CITYLINK CBA,8.59,0,869716.15,DR,REF552308,CBA,Savings
30-08-2025 02:16,CBABD39AF60A4304A53BEDD,063-000-001,22222222,APPLE CBA,3.87,0,869712.28,DR,REF832550,CBA,Savings
30-08-2025 02:23,CBAC857150E50EB4B2E9F4A,063-000-001,22222222,UBER EATS CBA,7.24,0,869705.04,DR,REF397003,CBA,Savings
30-08-2025 02:31,CBA743BE30DACA54D69A6D0,063-000-001,22222222,HARVEY NORMAN CBA,180.19,0,869524.85,DR,REF646258,CBA,Savings
30-08-2025 03:45,CBAB8D7B053959E4D62A8A7,063-000-001,22222222,RAILWAY STATION CBA,29.79,0,869495.06,DR,REF573124,CBA,Savings
30-08-2025 03:46,CBA2D8202BDC48D42FE8C26,063-000-001,22222222,PAYMENT GATEWAY CBA,17.27,0,869477.79,DR,REF214994,CBA,Savings
30-08-2025 04:17,CBA3F73EB4215074216865B,063-000-001,22222222,COMPANY PAYROLL CBA,0,406.9,869884.69,CR,REF663226,CBA,Savings
30-08-2025 04:17,CBA4EB630AEE0254E41B2CA,063-000-001,22222222,KFC CBA,12.44,0,869872.25,DR,REF204787,CBA,Savings
30-08-2025 04:23,CBA71F7EEAFEB1B4D40BDE3,063-000-001,22222222,AMAZON AU CBA,12.31,0,869859.94,DR,REF457805,CBA,Savings
30-08-2025 04:51,CBAB054E57CCBD14103BFF9,063-000-001,22222222,UBER EATS CBA,4.54,0,869855.4,DR,REF241648,CBA,Savings
30-08-2025 04:53,CBAB924DB55ECAD423AAEA1,063-000-001,22222222,ZOOM CBA,103.63,0,869751.77,DR,REF661215,CBA,Savings
30-08-2025 05:20,CBA26A59343891A40038EB7,063-000-001,22222222,INTERNET TRANSFER CBA,64.21,0,869687.56,DR,REF775094,CBA,Savings
30-08-2025 05:20,CBAB7BB7AF635E74645A485,063-000-001,22222222,WAGES CREDIT CBA,0,6143.7,875831.26,CR,REF885424,CBA,Savings
30-08-2025 05:42,CBA5C5DEF4B9F0D42F29FDF,063-000-001,22222222,MCDONALDS CBA,24.35,0,875806.91,DR,REF918000,CBA,Savings
30-08-2025 05:45,CBA1B366F05ABD44D12A240,063-000-001,22222222,INTERNET TRANSFER CBA,31.88,0,875775.03,DR,REF805571,CBA,Savings
30-08-2025 05:55,CBA9AB5280449894E4FA2D3,063-000-001,22222222,COLES CBA,46.67,0,875728.36,DR,REF631718,CBA,Savings
30-08-2025 05:56,CBA6E261B6A2BBC481A83F3,063-000-001,22222222,SALARY PAYMENT CBA,0,5744.61,881472.97,CR,REF657351,CBA,Savings
30-08-2025 06:07,CBAF4D3DDD978244BA99B11,063-000-001,22222222,MCDONALDS CBA,33.25,0,881439.72,DR,REF216114,CBA,Savings
30-08-2025 06:32,CBAB94924E477B1425ABCF7,063-000-001,22222222,PAY - SALARY CBA,0,2912.01,884351.73,CR,REF275316,CBA,Savings
30-08-2025 07:13,CBA83D7DC57A57A4FF7868C,063-000-001,22222222,TAFE BOOKSHOP CBA,51.22,0,884300.51,DR,REF360848,CBA,Savings
30-08-2025 07:15,CBAA82B125B3D6B45428C67,063-000-001,22222222,STARBUCKS CBA,88.48,0,884212.03,DR,REF442549,CBA,Savings
30-08-2025 07:24,CBADB2E09F0838A4750B1EA,063-000-001,22222222,WOOLWORTHS CBA,101.71,0,884110.32,DR,REF147265,CBA,Savings
30-08-2025 07:49,CBA3B2BF41202C446E6B436,063-000-001,22222222,COLES CBA,18.41,0,884091.91,DR,REF697895,CBA,Savings
30-08-2025 07:58,CBA938FBE50B1A14DA19A7B,063-000-001,22222222,PAYPAL *NETFLIX CBA,66.56,0,884025.35,DR,REF847591,CBA,Savings
30-08-2025 08:33,CBAAC9BF7BD8FB044FB853D,063-000-001,22222222,APPLE CBA,59.3,0,883966.05,DR,REF573113,CBA,Savings
30-08-2025 08:39,CBA9404E822D77540718621,063-000-001,22222222,PAYROLL CREDIT CBA,0,7075.36,891041.41,CR,REF484858,CBA,Savings
30-08-2025 08:43,CBA1860F09E67A142BB935A,063-000-001,22222222,PAYMENT GATEWAY CBA,233.25,0,890808.16,DR,REF431575,CBA,Savings
30-08-2025 08:53,CBAEBC39007506E4A2F84B7,063-000-001,22222222,SHELL CBA,21.47,0,890786.69,DR,REF200094,CBA,Savings
30-08-2025 08:57,CBA703E401D13D444BFB80A,063-000-001,22222222,PAYMENT GATEWAY CBA,26.34,0,890760.35,DR,REF933056,CBA,Savings
30-08-2025 09:31,CBA64985EEDA71440FD8F72,063-000-001,22222222,KFC CBA,10.42,0,890749.93,DR,REF568972,CBA,Savings
30-08-2025 09:33,CBA588AADD2CB664EB4B498,063-000-001,22222222,7-ELEVEN CBA,22.6,0,890727.33,DR,REF574398,CBA,Savings
30-08-2025 09:53,CBACC36A490017B4853B331,063-000-001,22222222,AMAZON AU CBA,7.4,0,890719.93,DR,REF641791,CBA,Savings
30-08-2025 09:57,CBA42038B2E97DA4C9EB242,063-000-001,22222222,KFC CBA,27.67,0,890692.26,DR,REF294195,CBA,Savings
30-08-2025 10:25,CBA738C398F373D45B28195,063-000-001,22222222,BIGW CBA,76.07,0,890616.19,DR,REF595599,CBA,Savings
30-08-2025 10:32,CBA2288C7B12145407C818D,063-000-001,22222222,COMPANY PAYROLL CBA,0,6137.19,896753.38,CR,REF981757,CBA,Savings
30-08-2025 10:48,CBABC211CC14E0C409198EE,063-000-001,22222222,FLIXBUS CBA,30.59,0,896722.79,DR,REF198209,CBA,Savings
30-08-2025 11:10,CBAD62D902B34EB46E783B5,063-000-001,22222222,SHELL CBA,10.94,0,896711.85,DR,REF317900,CBA,Savings
30-08-2025 11:11,CBA307757413E4146758F93,063-000-001,22222222,ZOOM CBA,18.05,0,896693.8,DR,REF189278,CBA,Savings
30-08-2025 11:20,CBAA8ECE0D1AD7A44BB844D,063-000-001,22222222,MCDONALDS CBA,13.03,0,896680.77,DR,REF613668,CBA,Savings
30-08-2025 11:44,CBA2D8924A8847E44818C79,063-000-001,22222222,WAGES CREDIT CBA,0,935.29,897616.06,CR,REF475320,CBA,Savings
30-08-2025 11:48,CBA20DC5C87072C458DBA19,063-000-001,22222222,LIQUORLAND CBA,10.78,0,897605.28,DR,REF520002,CBA,Savings
30-08-2025 12:09,CBAAE330688CBD34F248543,063-000-001,22222222,COMPANY PAYROLL CBA,0,79.61,897684.89,CR,REF649807,CBA,Savings
30-08-2025 12:15,INTE66A6C1010CD4C4EB95E,063-000-001,22222222,TRANSFER TO CBA 33333333,218.68,0,897466.21,DR,INT-44802,CBA,Savings
30-08-2025 12:22,CBA244C1217A9D14C0AB941,063-000-001,22222222,WAGES CREDIT CBA,0,6290.65,903756.86,CR,REF926412,CBA,Savings
30-08-2025 12:27,CBA372DCABDA04645C4B1DF,063-000-001,22222222,ZOOM CBA,17.08,0,903739.78,DR,REF378046,CBA,Savings
30-08-2025 12:33,CBAC5D1B943F02F4D55BB75,063-000-001,22222222,SPOTIFY CBA,8.43,0,903731.35,DR,REF963615,CBA,Savings
30-08-2025 12:45,CBA767D107D77A04DAEB6C8,063-000-001,22222222,AMAZON AU CBA,140,0,903591.35,DR,REF547605,CBA,Savings
30-08-2025 13:00,CBA33B81CEDE9514716966B,063-000-001,22222222,HARVEY NORMAN CBA,34.66,0,903556.69,DR,REF330949,CBA,Savings
30-08-2025 13:21,CBAAF8EDB9229E342D19041,063-000-001,22222222,KFC CBA,11.91,0,903544.78,DR,REF969854,CBA,Savings
30-08-2025 13:37,CBAF5D44A91E4E049469B25,063-000-001,22222222,KFC CBA,162.01,0,903382.77,DR,REF650281,CBA,Savings
30-08-2025 14:20,CBA689DC5940D6548F89BB3,063-000-001,22222222,PAYPAL *NETFLIX CBA,6.26,0,903376.51,DR,REF944837,CBA,Savings
30-08-2025 14:44,CBA44045B62D6444FB38D5E,063-000-001,22222222,MCDONALDS CBA,10.76,0,903365.75,DR,REF514389,CBA,Savings
30-08-2025 14:52,CBA02C419333D7C4104A138,063-000-001,22222222,RAILWAY STATION CBA,52.74,0,903313.01,DR,REF612462,CBA,Savings
30-08-2025 14:53,CBA7F32BFA421F744CE8386,063-000-001,22222222,BANK FEE CBA,45.98,0,903267.03,DR,REF450401,CBA,Savings
30-08-2025 14:59,CBA1FFE0923916647DB9371,063-000-001,22222222,WAGES CREDIT CBA,0,841.1,904108.13,CR,REF681373,CBA,Savings
30-08-2025 15:24,INT986A99EACAE544948E71,063-000-001,22222222,TRANSFER FROM ANZ 11111111,0,1259.82,905367.95,CR,INT-86483,CBA,Savings
30-08-2025 15:55,CBAB0C97BBC8F4B45AFBB05,063-000-001,22222222,CITYLINK CBA,9.67,0,905358.28,DR,REF158931,CBA,Savings
30-08-2025 17:07,CBAFCDE4AC976AB48559CFC,063-000-001,22222222,DOMINO'S PIZZA CBA,11.53,0,905346.75,DR,REF777091,CBA,Savings
30-08-2025 17:51,CBAE27B308656F9451FB1B8,063-000-001,22222222,BWS CBA,34.15,0,905312.6,DR,REF974615,CBA,Savings
30-08-2025 18:00,CBA526DA553E1C147D4BA8F,063-000-001,22222222,ALDI CBA,12.3,0,905300.3,DR,REF379871,CBA,Savings
30-08-2025 18:16,CBACC59EB231420435187AD,063-000-001,22222222,SHELL CBA,6.57,0,905293.73,DR,REF899449,CBA,Savings
30-08-2025 18:28,CBAD1D694B4961F49089D68,063-000-001,22222222,AMAZON AU CBA,7.87,0,905285.86,DR,REF674172,CBA,Savings
30-08-2025 18:51,CBA8A7EBAC1A35043DC8576,063-000-001,22222222,SHELL CBA,55.64,0,905230.22,DR,REF807468,CBA,Savings
30-08-2025 19:03,CBAFB02B5E0899D4BA2B74A,063-000-001,22222222,7-ELEVEN CBA,11.85,0,905218.37,DR,REF803019,CBA,Savings
30-08-2025 19:33,CBA958051CA3A35472E9CE2,063-000-001,22222222,FLIXBUS CBA,6.15,0,905212.22,DR,REF745212,CBA,Savings
30-08-2025 20:24,CBADB8472D1143F4B72BA08,063-000-001,22222222,MCDONALDS CBA,36,0,905176.22,DR,REF293002,CBA,Savings
30-08-2025 20:58,CBACAC48AFA84164AE4BA3A,063-000-001,22222222,MENULOG CBA,51.58,0,905124.64,DR,REF196730,CBA,Savings
30-08-2025 21:27,CBA91AA00F8CC6749629ED3,063-000-001,22222222,COLES CBA,85.76,0,905038.88,DR,REF396630,CBA,Savings
30-08-2025 22:04,CBA13CAE69626EB427C9F93,063-000-001,22222222,KFC CBA,56.89,0,904981.99,DR,REF845305,CBA,Savings
30-08-2025 22:08,CBAE4508AB22D9246D6B632,063-000-001,22222222,WOOLWORTHS CBA,140.73,0,904841.26,DR,REF704286,CBA,Savings
30-08-2025 22:19,CBA6123088BF33E494EA790,063-000-001,22222222,APPLE CBA,38,0,904803.26,DR,REF787553,CBA,Savings
30-08-2025 22:19,CBA9647AE45EF454CF2ABA5,063-000-001,22222222,RAILWAY STATION CBA,71.16,0,904732.1,DR,REF638409,CBA,Savings
30-08-2025 23:00,CBA0360477FD1B84987B445,063-000-001,22222222,UBER EATS CBA,135.09,0,904597.01,DR,REF658339,CBA,Savings
30-08-2025 23:02,CBA429C059177B3465899CD,063-000-001,22222222,PAYMENT GATEWAY CBA,145.17,0,904451.84,DR,REF256259,CBA,Savings
30-08-2025 23:14,CBA729CC9EFE75F4958B066,063-000-001,22222222,COLES CBA,15.95,0,904435.89,DR,REF894752,CBA,Savings
30-08-2025 23:37,INT2F958579285F4D119D0B,063-000-001,22222222,TRANSFER FROM NAB 44444444,0,1863.57,906299.46,CR,INT-17947,CBA,Savings
31-08-2025 00:02,CBABE617B913E2C4CCDB635,063-000-001,22222222,SPOTIFY CBA,84.3,0,906215.16,DR,REF872305,CBA,Savings
31-08-2025 00:19,CBAE4827EB548264C678F80,063-000-001,22222222,COMPANY PAYROLL CBA,0,6916.61,913131.77,CR,REF637134,CBA,Savings
31-08-2025 00:45,CBA6D1784177959471491E0,063-000-001,22222222,JB HI-FI CBA,10.48,0,913121.29,DR,REF318794,CBA,Savings
31-08-2025 00:54,CBAC32574A209B44DCF98AB,063-000-001,22222222,TAFE BOOKSHOP CBA,227.63,0,912893.66,DR,REF679683,CBA,Savings
31-08-2025 00:57,CBA815DA0A7E2D94D35B310,063-000-001,22222222,DOMINO'S PIZZA CBA,56.07,0,912837.59,DR,REF609369,CBA,Savings
31-08-2025 01:04,CBA94F6BF756A4947CFAA6E,063-000-001,22222222,BANK FEE CBA,41.38,0,912796.21,DR,REF184345,CBA,Savings
31-08-2025 01:05,CBA98E0474CCA5446048CCB,063-000-001,22222222,SHELL CBA,26.2,0,912770.01,DR,REF200433,CBA,Savings
31-08-2025 01:25,CBA0034D6F5E2EF49A48535,063-000-001,22222222,PAYPAL *NETFLIX CBA,35.3,0,912734.71,DR,REF334483,CBA,Savings
31-08-2025 02:09,CBAB2C18602AF29479FB85B,063-000-001,22222222,UBER EATS CBA,43.93,0,912690.78,DR,REF896093,CBA,Savings
31-08-2025 02:11,CBA40830DC4D5A04A2E9FB9,063-000-001,22222222,BANK FEE CBA,86.6,0,912604.18,DR,REF446598,CBA,Savings
31-08-2025 02:21,CBAAF2FB6B34A1A46369D50,063-000-001,22222222,KFC CBA,133.46,0,912470.72,DR,REF781699,CBA,Savings
31-08-2025 03:02,CBA7E40911FC40D495FB2D9,063-000-001,22222222,SALARY PAYMENT CBA,0,4202.84,916673.56,CR,REF734358,CBA,Savings
31-08-2025 04:02,CBA904E4980158A4067987D,063-000-001,22222222,TAFE BOOKSHOP CBA,10.69,0,916662.87,DR,REF789526,CBA,Savings
31-08-2025 04:06,INT8B5907610C5A4B168137,063-000-001,22222222,TRANSFER FROM NAB 44444444,0,127.33,916790.2,CR,INT-44900,CBA,Savings
31-08-2025 04:08,CBAA8D2975577D947CFA8FC,063-000-001,22222222,ZOOM CBA,51.87,0,916738.33,DR,REF690253,CBA,Savings
31-08-2025 04:56,CBAF9EE06549ABA474AAF36,063-000-001,22222222,WOOLWORTHS CBA,13.79,0,916724.54,DR,REF625932,CBA,Savings
31-08-2025 05:17,CBA173736CC248940DBAC1A,063-000-001,22222222,ALDI CBA,36.87,0,916687.67,DR,REF932165,CBA,Savings
31-08-2025 05:46,CBA4E0FE5A1335F4E4EA05C,063-000-001,22222222,WOOLWORTHS CBA,60.25,0,916627.42,DR,REF131388,CBA,Savings
31-08-2025 05:51,CBAF69DFBAC6CA54FD190FC,063-000-001,22222222,SHELL CBA,33.54,0,916593.88,DR,REF834303,CBA,Savings
31-08-2025 06:09,CBA7240CB4A9D4B4055BA5E,063-000-001,22222222,RAILWAY STATION CBA,51.82,0,916542.06,DR,REF562766,CBA,Savings
31-08-2025 06:57,CBA796ADAD59791486EA788,063-000-001,22222222,BP CBA,77.96,0,916464.1,DR,REF972201,CBA,Savings
31-08-2025 07:01,CBAE67E2169890D475184FE,063-000-001,22222222,UBER EATS CBA,68.79,0,916395.31,DR,REF455707,CBA,Savings
31-08-2025 07:27,CBA3BCBCB8B4BF44122B22F,063-000-001,22222222,INTERNET TRANSFER CBA,9.77,0,916385.54,DR,REF105219,CBA,Savings
31-08-2025 07:33,CBA4471BA1C251F4C82A0A2,063-000-001,22222222,SALARY PAYMENT CBA,0,1087.26,917472.8,CR,REF317393,CBA,Savings
31-08-2025 09:03,CBA36D181E56AC140B8969B,063-000-001,22222222,PAYMENT GATEWAY CBA,22.74,0,917450.06,DR,REF321177,CBA,Savings
31-08-2025 09:28,CBA42B187BC368C45EAA5EA,063-000-001,22222222,COMPANY PAYROLL CBA,0,1932.36,919382.42,CR,REF134468,CBA,Savings
31-08-2025 09:56,CBAAEB54F9236214430A481,063-000-001,22222222,SPOTIFY CBA,32.82,0,919349.6,DR,REF992123,CBA,Savings
31-08-2025 10:46,CBAE6C9EB21609F414A9024,063-000-001,22222222,BWS CBA,118.92,0,919230.68,DR,REF121538,CBA,Savings
31-08-2025 11:14,CBA6C8754F16C0F4F0F9FB7,063-000-001,22222222,LIQUORLAND CBA,174.87,0,919055.81,DR,REF434993,CBA,Savings
31-08-2025 12:01,CBAE739EB5D6C154FA68EBF,063-000-001,22222222,BANK FEE CBA,47.85,0,919007.96,DR,REF781620,CBA,Savings
31-08-2025 12:11,CBA393679D65CFA4DD294C6,063-000-001,22222222,CITYLINK CBA,45.45,0,918962.51,DR,REF726821,CBA,Savings
31-08-2025 12:17,CBA321969EEF7A84831BB0D,063-000-001,22222222,DOMINO'S PIZZA CBA,232.69,0,918729.82,DR,REF783052,CBA,Savings
31-08-2025 12:30,CBA1A3DD537A418455AB336,063-000-001,22222222,KFC CBA,86.17,0,918643.65,DR,REF144839,CBA,Savings
31-08-2025 12:45,CBA59B8DC5F84C8400DA5C3,063-000-001,22222222,PAY - SALARY CBA,0,820.07,919463.72,CR,REF235320,CBA,Savings
31-08-2025 13:02,CBA53F5536689C8471EB024,063-000-001,22222222,RAILWAY STATION CBA,70.74,0,919392.98,DR,REF166231,CBA,Savings
31-08-2025 13:09,CBA298AB81068B24A0387A7,063-000-001,22222222,BANK FEE CBA,30.76,0,919362.22,DR,REF105182,CBA,Savings
31-08-2025 13:30,CBAE0611FBF03564A25BA44,063-000-001,22222222,LIQUORLAND CBA,120.14,0,919242.08,DR,REF681572,CBA,Savings
31-08-2025 14:06,CBA54DA53A8C559404F923C,063-000-001,22222222,ZOOM CBA,27.59,0,919214.49,DR,REF997047,CBA,Savings
31-08-2025 14:28,CBA8CDA4FCCEC234FD0AE60,063-000-001,22222222,7-ELEVEN CBA,77.97,0,919136.52,DR,REF230902,CBA,Savings
31-08-2025 14:37,CBA0F8EE3A24CEC4389A736,063-000-001,22222222,AMAZON AU CBA,34.26,0,919102.26,DR,REF275329,CBA,Savings
31-08-2025 14:42,CBA90C81B40C5664488904F,063-000-001,22222222,SPOTIFY CBA,7.18,0,919095.08,DR,REF963581,CBA,Savings
31-08-2025 14:44,CBAC9AB0872FC9F491B9BC0,063-000-001,22222222,WAGES CREDIT CBA,0,781.62,919876.7,CR,REF599412,CBA,Savings
31-08-2025 15:21,CBA81978A3ABCB74334BBE8,063-000-001,22222222,PAYPAL *NETFLIX CBA,26.2,0,919850.5,DR,REF786134,CBA,Savings
31-08-2025 15:30,CBA3122AE74F7F447F9BFD6,063-000-001,22222222,COLES CBA,78.48,0,919772.02,DR,REF284637,CBA,Savings
31-08-2025 15:34,CBA7E6B4929C89142658382,063-000-001,22222222,PAYPAL *NETFLIX CBA,183.5,0,919588.52,DR,REF142126,CBA,Savings
31-08-2025 15:48,CBAB3F72B8ADD544D1AB785,063-000-001,22222222,MENULOG CBA,17.38,0,919571.14,DR,REF881266,CBA,Savings
31-08-2025 16:04,CBAAC5A814A022748B8BD78,063-000-001,22222222,SHELL CBA,85.73,0,919485.41,DR,REF537506,CBA,Savings
31-08-2025 17:00,CBA64A4C23B4B6C4E6DAD47,063-000-001,22222222,PAYPAL *NETFLIX CBA,62.41,0,919423,DR,REF349420,CBA,Savings
31-08-2025 17:10,CBAD42AE7455AB346BC838E,063-000-001,22222222,BP CBA,6.97,0,919416.03,DR,REF496569,CBA,Savings
31-08-2025 17:20,CBA2734B1DC2FBA48DDB56B,063-000-001,22222222,CITYLINK CBA,104.62,0,919311.41,DR,REF347326,CBA,Savings
31-08-2025 17:28,CBAF26151BB64AE45A59CFD,063-000-001,22222222,SHELL CBA,20.15,0,919291.26,DR,REF292038,CBA,Savings
31-08-2025 17:40,CBA50EB7952E0FB405BAB61,063-000-001,22222222,PAYPAL *NETFLIX CBA,54.88,0,919236.38,DR,REF117503,CBA,Savings
31-08-2025 17:42,CBA739623C72D1544E6983A,063-000-001,22222222,INTERNET TRANSFER CBA,117.8,0,919118.58,DR,REF768930,CBA,Savings
31-08-2025 17:47,CBAC1B186EC6D7E41C891EE,063-000-001,22222222,ALDI CBA,183.5,0,918935.08,DR,REF647487,CBA,Savings
31-08-2025 18:03,CBA58CBA286F6044755906E,063-000-001,22222222,PAY - SALARY CBA,0,6529.79,925464.87,CR,REF464528,CBA,Savings
31-08-2025 18:21,CBA3A29CC9E438743D28DE6,063-000-001,22222222,COLES CBA,49.13,0,925415.74,DR,REF456495,CBA,Savings
31-08-2025 18:58,CBABBCB4BF938C24FF58E50,063-000-001,22222222,WAGES CREDIT CBA,0,7764.72,933180.46,CR,REF904910,CBA,Savings
31-08-2025 18:58,CBA7F5FD4399F104A768335,063-000-001,22222222,KFC CBA,20.02,0,933160.44,DR,REF446087,CBA,Savings
31-08-2025 19:04,CBAB39A58AF937449A3B6ED,063-000-001,22222222,BANK FEE CBA,5.47,0,933154.97,DR,REF869969,CBA,Savings
31-08-2025 19:19,CBA11C51B00BFFA48C282B6,063-000-001,22222222,SALARY PAYMENT CBA,0,230.48,933385.45,CR,REF937899,CBA,Savings
31-08-2025 19:22,CBA85196D47C09D482BA878,063-000-001,22222222,UBER EATS CBA,122.73,0,933262.72,DR,REF641653,CBA,Savings
31-08-2025 19:27,CBA3480738560D94765BC8F,063-000-001,22222222,MCDONALDS CBA,35.9,0,933226.82,DR,REF931871,CBA,Savings
31-08-2025 19:36,CBAB14CF9FA86F64A1FA2F1,063-000-001,22222222,PAYPAL *NETFLIX CBA,34.47,0,933192.35,DR,REF870076,CBA,Savings
31-08-2025 19:43,CBAD80749721FCD4CE0BCC0,063-000-001,22222222,HARVEY NORMAN CBA,8.09,0,933184.26,DR,REF422795,CBA,Savings
31-08-2025 19:52,CBA26F21227BA3847E0BEB9,063-000-001,22222222,7-ELEVEN CBA,93.41,0,933090.85,DR,REF266911,CBA,Savings
31-08-2025 20:42,CBAFE867A5E51834C72BAD1,063-000-001,22222222,UBER EATS CBA,158.37,0,932932.48,DR,REF390131,CBA,Savings
31-08-2025 20:50,INTD4496B4976414001A128,063-000-001,22222222,TRANSFER FROM ANZ 11111111,0,1184.81,934117.29,CR,INT-91556,CBA,Savings
31-08-2025 21:18,CBAD41189B902444EABAD90,063-000-001,22222222,SHELL CBA,16.89,0,934100.4,DR,REF699419,CBA,Savings
31-08-2025 21:34,INT8CA005006A9048889FA2,063-000-001,22222222,TRANSFER TO ANZ 11111111,508.46,0,933591.94,DR,INT-69730,CBA,Savings
31-08-2025 21:36,CBA3AA0CD34FB7842F59625,063-000-001,22222222,LIQUORLAND CBA,42.03,0,933549.91,DR,REF789954,CBA,Savings
31-08-2025 22:02,CBA7B59CFF337FC4AEE90CF,063-000-001,22222222,ZOOM CBA,29.05,0,933520.86,DR,REF580994,CBA,Savings
31-08-2025 22:06,CBA516AE66CABDA4AB8BB6C,063-000-001,22222222,PAYMENT GATEWAY CBA,50.35,0,933470.51,DR,REF847556,CBA,Savings
31-08-2025 22:16,CBA372D187FBFA541658DFC,063-000-001,22222222,SHELL CBA,98.24,0,933372.27,DR,REF752574,CBA,Savings
31-08-2025 23:19,CBAA3ED51C14A224FBBAAE3,063-000-001,22222222,PAYMENT GATEWAY CBA,43.26,0,933329.01,DR,REF859344,CBA,Savings
31-08-2025 23:35,CBACB19591285E64C2F818E,063-000-001,22222222,LIQUORLAND CBA,47.44,0,933281.57,DR,REF848752,CBA,Savings
31-08-2025 23:55,CBA10A877E4772B44828C25,063-000-001,22222222,BIGW CBA,83.66,0,933197.91,DR,REF472413,CBA,Savings
01-09-2025 00:38,CBAE55421805888458F9444,063-000-001,22222222,TAFE BOOKSHOP CBA,19.92,0,933177.99,DR,REF335430,CBA,Savings
01-09-2025 00:40,CBA2C0CF7AC1AB34DF2ABD3,063-000-001,22222222,ZOOM CBA,38.16,0,933139.83,DR,REF796578,CBA,Savings
01-09-2025 00:43,CBA1F137BCF98944A7381BC,063-000-001,22222222,HARVEY NORMAN CBA,50.92,0,933088.91,DR,REF603308,CBA,Savings
01-09-2025 00:47,CBA65EFB78B13124D1E9777,063-000-001,22222222,TAFE BOOKSHOP CBA,15.03,0,933073.88,DR,REF673403,CBA,Savings
01-09-2025 00:55,CBA73C3C59BEA1A4A4C8B94,063-000-001,22222222,PAY - SALARY CBA,0,2013.61,935087.49,CR,REF283475,CBA,Savings
01-09-2025 01:09,CBACA0FDE728A2B44639D5D,063-000-001,22222222,TAFE BOOKSHOP CBA,34.04,0,935053.45,DR,REF475195,CBA,Savings
01-09-2025 01:18,CBA77E8B3F1772B4698914F,063-000-001,22222222,AMAZON AU CBA,5.92,0,935047.53,DR,REF633877,CBA,Savings
01-09-2025 01:20,CBA07035844D1B249F18BA3,063-000-001,22222222,BWS CBA,38.81,0,935008.72,DR,REF773981,CBA,Savings
01-09-2025 01:52,CBA99C73398ED5548E08225,063-000-001,22222222,BWS CBA,79.46,0,934929.26,DR,REF351884,CBA,Savings
01-09-2025 01:59,CBA7FC92B5A82A14A65A5F4,063-000-001,22222222,STARBUCKS CBA,36.56,0,934892.7,DR,REF302472,CBA,Savings
01-09-2025 02:33,CBA64E5AF45884944448A86,063-000-001,22222222,MCDONALDS CBA,87.19,0,934805.51,DR,REF738769,CBA,Savings
01-09-2025 03:06,CBA22BD78058A54449096FE,063-000-001,22222222,MCDONALDS CBA,56.42,0,934749.09,DR,REF402424,CBA,Savings
01-09-2025 03:36,CBAB963C60602534D8AB836,063-000-001,22222222,CITYLINK CBA,205.28,0,934543.81,DR,REF597418,CBA,Savings
01-09-2025 04:01,CBA8085410CBF4D49FF91F1,063-000-001,22222222,MENULOG CBA,14.52,0,934529.29,DR,REF820022,CBA,Savings
01-09-2025 04:01,CBACBDE38B1BAC348DD9FC2,063-000-001,22222222,TAFE BOOKSHOP CBA,44.62,0,934484.67,DR,REF242447,CBA,Savings
01-09-2025 04:03,CBA97ACAA5912DE4CFEB026,063-000-001,22222222,WOOLWORTHS CBA,12.55,0,934472.12,DR,REF264809,CBA,Savings
01-09-2025 04:07,CBA29BA34BB7C3C474CBB0A,063-000-001,22222222,COLES CBA,42.23,0,934429.89,DR,REF837313,CBA,Savings
01-09-2025 04:54,CBA6F15DC21DB5840439D95,063-000-001,22222222,LIQUORLAND CBA,10.04,0,934419.85,DR,REF624046,CBA,Savings
01-09-2025 05:10,CBAE824E244A7284AA2BE3E,063-000-001,22222222,PAYPAL *NETFLIX CBA,24.53,0,934395.32,DR,REF921180,CBA,Savings
01-09-2025 05:14,CBA44BF40696E004C55AF21,063-000-001,22222222,BP CBA,5.65,0,934389.67,DR,REF212158,CBA,Savings
01-09-2025 05:20,CBABB0969D822DB4D9EBE59,063-000-001,22222222,PAY - SALARY CBA,0,485.64,934875.31,CR,REF754059,CBA,Savings
01-09-2025 05:37,CBA268F6013358440A69F7E,063-000-001,22222222,BANK FEE CBA,72.52,0,934802.79,DR,REF731835,CBA,Savings
01-09-2025 05:46,CBADEBC43CB4BAB47448635,063-000-001,22222222,UBER EATS CBA,87.25,0,934715.54,DR,REF188086,CBA,Savings
01-09-2025 06:03,CBA78FEB171CAD2482DB37E,063-000-001,22222222,ZOOM CBA,34.95,0,934680.59,DR,REF885151,CBA,Savings
01-09-2025 06:11,CBA53EED7AA4EFA43AB8860,063-000-001,22222222,MENULOG CBA,30.29,0,934650.3,DR,REF197737,CBA,Savings
01-09-2025 06:19,CBA73D54F6026364438BCB9,063-000-001,22222222,FLIXBUS CBA,11.88,0,934638.42,DR,REF333304,CBA,Savings
01-09-2025 07:14,CBA7CF863AC0B83447B95E9,063-000-001,22222222,TAFE BOOKSHOP CBA,458.23,0,934180.19,DR,REF978137,CBA,Savings
01-09-2025 07:15,CBA7C0CF36B74FB49ACBEBE,063-000-001,22222222,JB HI-FI CBA,25.68,0,934154.51,DR,REF874665,CBA,Savings
01-09-2025 07:35,CBA3115C607BC67458D8043,063-000-001,22222222,ALDI CBA,27.26,0,934127.25,DR,REF752494,CBA,Savings
01-09-2025 07:53,CBA030722B45617462D941A,063-000-001,22222222,HARVEY NORMAN CBA,13.38,0,934113.87,DR,REF973876,CBA,Savings
01-09-2025 08:17,CBA124608A8408140C8931A,063-000-001,22222222,7-ELEVEN CBA,11.44,0,934102.43,DR,REF586626,CBA,Savings
01-09-2025 08:36,CBA95DFD2AB4E8F475FB7F7,063-000-001,22222222,PAYMENT GATEWAY CBA,93.96,0,934008.47,DR,REF845538,CBA,Savings
01-09-2025 08:41,CBAE8E74647297D45A9BC0B,063-000-001,22222222,BANK FEE CBA,9.3,0,933999.17,DR,REF286506,CBA,Savings
01-09-2025 08:44,CBA09A466EEC40B4F5C8FCC,063-000-001,22222222,RAILWAY STATION CBA,4.86,0,933994.31,DR,REF540051,CBA,Savings
01-09-2025 08:51,CBAF7971CB09D10406096B2,063-000-001,22222222,JB HI-FI CBA,14.81,0,933979.5,DR,REF168239,CBA,Savings
01-09-2025 08:59,INT5039D669134F46368816,063-000-001,22222222,TRANSFER FROM NAB 44444444,0,1541.05,935520.55,CR,INT-99521,CBA,Savings
01-09-2025 09:19,CBA2A5DE10E88984535AFCD,063-000-001,22222222,CITYLINK CBA,19.87,0,935500.68,DR,REF328371,CBA,Savings
01-09-2025 10:27,CBA51C01B2967624FF199F5,063-000-001,22222222,KFC CBA,30.38,0,935470.3,DR,REF787981,CBA,Savings
01-09-2025 10:37,CBA0053831AE629406EA0C4,063-000-001,22222222,BANK FEE CBA,176.86,0,935293.44,DR,REF484331,CBA,Savings
01-09-2025 11:27,CBAB30204E701CA49669827,063-000-001,22222222,WOOLWORTHS CBA,32,0,935261.44,DR,REF119912,CBA,Savings
01-09-2025 11:33,CBA3FBC3C61A0304E80A451,063-000-001,22222222,CITYLINK CBA,30.87,0,935230.57,DR,REF454090,CBA,Savings
01-09-2025 11:40,CBAD95A9A92ADDB486B91F4,063-000-001,22222222,PAYROLL CREDIT CBA,0,3957.82,939188.39,CR,REF592816,CBA,Savings
01-09-2025 11:49,CBA54722296A0544805BCC3,063-000-001,22222222,COLES CBA,3.31,0,939185.08,DR,REF420140,CBA,Savings
01-09-2025 11:50,CBAB63A8684C7ED44109644,063-000-001,22222222,ZOOM CBA,37.21,0,939147.87,DR,REF591082,CBA,Savings
01-09-2025 12:25,CBA4328705C0F0846E9A280,063-000-001,22222222,BANK FEE CBA,14.29,0,939133.58,DR,REF437149,CBA,Savings
01-09-2025 12:44,CBAD81C41B261A84027B264,063-000-001,22222222,DOMINO'S PIZZA CBA,17.78,0,939115.8,DR,REF157959,CBA,Savings
01-09-2025 12:51,INT3F43250E86A54512B779,063-000-001,22222222,TRANSFER FROM CBA 33333333,0,1974.2,941090,CR,INT-53628,CBA,Savings
01-09-2025 13:02,CBA1EE6643938C841DF9A31,063-000-001,22222222,STARBUCKS CBA,83.48,0,941006.52,DR,REF866865,CBA,Savings
01-09-2025 13:51,CBA6153929C165F485A9210,063-000-001,22222222,RAILWAY STATION CBA,68.79,0,940937.73,DR,REF583502,CBA,Savings
01-09-2025 13:56,CBAFE88F8B199134BA8A56C,063-000-001,22222222,WAGES CREDIT CBA,0,6039.69,946977.42,CR,REF116015,CBA,Savings
01-09-2025 14:04,CBAD661B8E267294537A248,063-000-001,22222222,INTERNET TRANSFER CBA,12.04,0,946965.38,DR,REF253690,CBA,Savings
01-09-2025 14:12,CBA1B008A44F125444B9F34,063-000-001,22222222,7-ELEVEN CBA,20.46,0,946944.92,DR,REF106226,CBA,Savings
01-09-2025 14:14,CBA67FF76AD26514505A5FD,063-000-001,22222222,HARVEY NORMAN CBA,55.83,0,946889.09,DR,REF100888,CBA,Savings
01-09-2025 14:23,CBA3A99BFE2E92741C7A60D,063-000-001,22222222,ZOOM CBA,24.57,0,946864.52,DR,REF465541,CBA,Savings
01-09-2025 14:39,CBA7786F291A5984AC1A978,063-000-001,22222222,MCDONALDS CBA,16.48,0,946848.04,DR,REF579897,CBA,Savings
01-09-2025 15:18,CBAFAE970FFCC9F459F9B3E,063-000-001,22222222,LIQUORLAND CBA,26.12,0,946821.92,DR,REF982725,CBA,Savings
01-09-2025 16:00,CBA98733F2EF3E34198A741,063-000-001,22222222,KFC CBA,32.57,0,946789.35,DR,REF968681,CBA,Savings
01-09-2025 16:11,CBAE225AF5A9BDE4C66A33F,063-000-001,22222222,HARVEY NORMAN CBA,49.41,0,946739.94,DR,REF735778,CBA,Savings
01-09-2025 16:16,CBADF6E690F00494F6B8AC7,063-000-001,22222222,TAFE BOOKSHOP CBA,75.46,0,946664.48,DR,REF797960,CBA,Savings
01-09-2025 16:39,CBA605CCB032F2C45738333,063-000-001,22222222,JB HI-FI CBA,81.21,0,946583.27,DR,REF741796,CBA,Savings
01-09-2025 16:53,CBA1B0D8378FA69432F95DA,063-000-001,22222222,RAILWAY STATION CBA,44.8,0,946538.47,DR,REF519829,CBA,Savings
01-09-2025 17:01,CBA6208D630DEDC4BA58973,063-000-001,22222222,KFC CBA,45.13,0,946493.34,DR,REF729865,CBA,Savings
01-09-2025 18:12,CBAC732C10952E048929C54,063-000-001,22222222,PAYPAL *NETFLIX CBA,14.25,0,946479.09,DR,REF573975,CBA,Savings
01-09-2025 18:15,CBA0A2F3EC083834AAAA43F,063-000-001,22222222,HARVEY NORMAN CBA,12.45,0,946466.64,DR,REF577024,CBA,Savings
01-09-2025 18:34,CBA770A8ABA3E6A4059A033,063-000-001,22222222,AMAZON AU CBA,223.8,0,946242.84,DR,REF535774,CBA,Savings
01-09-2025 19:03,CBAEF01653B9F3C4B8C9DB8,063-000-001,22222222,WAGES CREDIT CBA,0,5901,952143.84,CR,REF273260,CBA,Savings
01-09-2025 19:05,CBA930ED64F47F34D0A87C2,063-000-001,22222222,PAYROLL CREDIT CBA,0,2989.87,955133.71,CR,REF966023,CBA,Savings
01-09-2025 19:44,CBA5069730F10BD49FBAFC5,063-000-001,22222222,APPLE CBA,70.92,0,955062.79,DR,REF211222,CBA,Savings
01-09-2025 20:00,CBA0DF4DD714BB5406B8240,063-000-001,22222222,PAYPAL *NETFLIX CBA,2.68,0,955060.11,DR,REF332140,CBA,Savings
01-09-2025 21:21,CBA81B4839E1C3A4D579F77,063-000-001,22222222,SPOTIFY CBA,6.43,0,955053.68,DR,REF319241,CBA,Savings
01-09-2025 21:59,CBA4BAEA18F9EAA46628DB6,063-000-001,22222222,LIQUORLAND CBA,156.04,0,954897.64,DR,REF746526,CBA,Savings
01-09-2025 22:10,CBA75AD1F3F0C0841219013,063-000-001,22222222,JB HI-FI CBA,21.9,0,954875.74,DR,REF149548,CBA,Savings
01-09-2025 22:13,CBABE4C093785384F7FBE04,063-000-001,22222222,PAYMENT GATEWAY CBA,3.8,0,954871.94,DR,REF333546,CBA,Savings
01-09-2025 22:27,CBA50C5E55FC4A74CB2866D,063-000-001,22222222,DOMINO'S PIZZA CBA,3.27,0,954868.67,DR,REF398844,CBA,Savings
01-09-2025 22:43,CBA8E450C87E8AB4E1F976D,063-000-001,22222222,ALDI CBA,63.56,0,954805.11,DR,REF293982,CBA,Savings
01-09-2025 23:17,CBAB83602D61BD84D0EBC24,063-000-001,22222222,INTERNET TRANSFER CBA,31.73,0,954773.38,DR,REF918535,CBA,Savings
01-09-2025 23:27,INTF0874A0F5AF74C309B25,063-000-001,22222222,TRANSFER FROM NAB 44444444,0,1600.97,956374.35,CR,INT-45913,CBA,Savings
01-09-2025 23:30,CBAB0E018B74BE543B495E3,063-000-001,22222222,WOOLWORTHS CBA,34.28,0,956340.07,DR,REF900885,CBA,Savings
01-09-2025 23:30,CBAE2E79AE2468D44D9BF9E,063-000-001,22222222,LIQUORLAND CBA,16.12,0,956323.95,DR,REF481461,CBA,Savings
01-09-2025 23:33,CBA3BB4A14CE99E47E7B5D2,063-000-001,22222222,JB HI-FI CBA,112.26,0,956211.69,DR,REF631057,CBA,Savings
01-09-2025 23:56,CBAC4A579F407D445CAA7D9,063-000-001,22222222,HARVEY NORMAN CBA,5.02,0,956206.67,DR,REF580322,CBA,Savings
02-09-2025 00:02,CBA9982D89163EC45599BA0,063-000-001,22222222,MCDONALDS CBA,26.89,0,956179.78,DR,REF136039,CBA,Savings
02-09-2025 00:10,CBA19214030406040A5A163,063-000-001,22222222,PAYPAL *NETFLIX CBA,130.81,0,956048.97,DR,REF226307,CBA,Savings
02-09-2025 00:39,CBA6D6F7A97F0F049408B11,063-000-001,22222222,BIGW CBA,129.7,0,955919.27,DR,REF598619,CBA,Savings
02-09-2025 00:40,CBA2188DBF000244B9F81C9,063-000-001,22222222,TAFE BOOKSHOP CBA,132.71,0,955786.56,DR,REF327829,CBA,Savings
02-09-2025 01:47,CBA9CAF3E14A3994BC383D9,063-000-001,22222222,BANK FEE CBA,155.59,0,955630.97,DR,REF928602,CBA,Savings
02-09-2025 01:58,CBA17E600AC0850452293B9,063-000-001,22222222,CITYLINK CBA,6.2,0,955624.77,DR,REF508474,CBA,Savings
02-09-2025 02:15,CBA83957B2A18C74D47BB0E,063-000-001,22222222,WAGES CREDIT CBA,0,7766.75,963391.52,CR,REF514893,CBA,Savings
02-09-2025 02:27,CBA7E2FBB43DFCD4CD49D90,063-000-001,22222222,PAYMENT GATEWAY CBA,9.53,0,963381.99,DR,REF711194,CBA,Savings
02-09-2025 03:51,CBA40E610023DDB480D8A3E,063-000-001,22222222,PAY - SALARY CBA,0,3756.8,967138.79,CR,REF918469,CBA,Savings
02-09-2025 04:11,CBAF99231D1939644D2A3C7,063-000-001,22222222,ALDI CBA,9.05,0,967129.74,DR,REF794504,CBA,Savings
02-09-2025 04:34,CBA60DE3AA35A8D438CBAF3,063-000-001,22222222,7-ELEVEN CBA,33.83,0,967095.91,DR,REF703482,CBA,Savings
02-09-2025 05:40,INT0A84057907674E76BDED,063-000-001,22222222,TRANSFER FROM ANZ 11111111,0,1472.24,968568.15,CR,INT-48776,CBA,Savings
02-09-2025 06:21,CBA003FD00A17D1403BBECB,063-000-001,22222222,LIQUORLAND CBA,86.28,0,968481.87,DR,REF584908,CBA,Savings
02-09-2025 06:51,CBA429B551AC16A442E8803,063-000-001,22222222,BWS CBA,32.14,0,968449.73,DR,REF498810,CBA,Savings
02-09-2025 06:52,CBA52AB884562194E259D64,063-000-001,22222222,MCDONALDS CBA,8.88,0,968440.85,DR,REF507206,CBA,Savings
02-09-2025 07:02,CBA619A0C346312423C8EC7,063-000-001,22222222,AMAZON AU CBA,11.63,0,968429.22,DR,REF625137,CBA,Savings
02-09-2025 07:05,CBA8DCBA30965AF4FAC91C4,063-000-001,22222222,JB HI-FI CBA,64.36,0,968364.86,DR,REF385925,CBA,Savings
02-09-2025 07:16,CBAAAC45508DD554B06BE63,063-000-001,22222222,SPOTIFY CBA,11.6,0,968353.26,DR,REF354392,CBA,Savings
02-09-2025 07:32,CBADF4BF9669A02411F8009,063-000-001,22222222,JB HI-FI CBA,134.18,0,968219.08,DR,REF718250,CBA,Savings
02-09-2025 07:47,CBAC02BB292F9EA469EB62C,063-000-001,22222222,MENULOG CBA,28.43,0,968190.65,DR,REF835922,CBA,Savings
02-09-2025 07:59,CBA619000330B63407B990A,063-000-001,22222222,WOOLWORTHS CBA,26.2,0,968164.45,DR,REF332111,CBA,Savings
02-09-2025 08:45,CBA4F0F5C6E832044A88C51,063-000-001,22222222,AMAZON AU CBA,7.74,0,968156.71,DR,REF990132,CBA,Savings
02-09-2025 09:03,CBA1DA54D7C6B384C7D9742,063-000-001,22222222,LIQUORLAND CBA,22.07,0,968134.64,DR,REF618112,CBA,Savings
02-09-2025 09:04,CBA585D82AA26E6431FACEA,063-000-001,22222222,BWS CBA,7.06,0,968127.58,DR,REF647660,CBA,Savings
02-09-2025 09:27,CBAAC79591F420A4BD9945E,063-000-001,22222222,7-ELEVEN CBA,82.8,0,968044.78,DR,REF949286,CBA,Savings
02-09-2025 09:33,INTBE635431E11042E98ADF,063-000-001,22222222,TRANSFER TO NAB 44444444,1367.47,0,966677.31,DR,INT-90332,CBA,Savings
02-09-2025 09:44,CBADFEA64C944F0414FA824,063-000-001,22222222,RAILWAY STATION CBA,78.41,0,966598.9,DR,REF721281,CBA,Savings
02-09-2025 09:54,INTC71F69464DC0492FA2CE,063-000-001,22222222,TRANSFER FROM ANZ 11111111,0,1920.57,968519.47,CR,INT-66963,CBA,Savings
02-09-2025 09:55,CBADA64FF6FC38E47E6922F,063-000-001,22222222,LIQUORLAND CBA,89.64,0,968429.83,DR,REF431429,CBA,Savings
02-09-2025 10:31,CBA4331E0F56E3B4AF8B725,063-000-001,22222222,PAYROLL CREDIT CBA,0,701.66,969131.49,CR,REF882908,CBA,Savings
02-09-2025 10:34,INT5259195E977A4AA29F36,063-000-001,22222222,TRANSFER TO CBA 33333333,1355.69,0,967775.8,DR,INT-56484,CBA,Savings
02-09-2025 10:41,CBA401F013982784A3E9584,063-000-001,22222222,WAGES CREDIT CBA,0,7443.14,975218.94,CR,REF847966,CBA,Savings
02-09-2025 10:44,CBACE84A08123E64E759EAE,063-000-001,22222222,PAYROLL CREDIT CBA,0,2261.26,977480.2,CR,REF760514,CBA,Savings
02-09-2025 11:18,INT18A0BE084AC54F64B001,063-000-001,22222222,TRANSFER FROM NAB 44444444,0,1456.47,978936.67,CR,INT-27349,CBA,Savings
02-09-2025 11:40,CBAE1E8589D036843329CDB,063-000-001,22222222,TAFE BOOKSHOP CBA,80.58,0,978856.09,DR,REF640776,CBA,Savings
02-09-2025 11:47,CBA7BC096188FFB43CB8B03,063-000-001,22222222,AMAZON AU CBA,7.69,0,978848.4,DR,REF775693,CBA,Savings
02-09-2025 11:50,CBA700A5C05C2644EC788E3,063-000-001,22222222,SALARY PAYMENT CBA,0,7692.61,986541.01,CR,REF141730,CBA,Savings
02-09-2025 11:54,CBA43684EF55E234EB8915F,063-000-001,22222222,UBER EATS CBA,25.35,0,986515.66,DR,REF288667,CBA,Savings
02-09-2025 12:08,CBAABC6476670474A81837F,063-000-001,22222222,SHELL CBA,35.91,0,986479.75,DR,REF255864,CBA,Savings
02-09-2025 12:29,CBABDDFB753F91E4024A2FF,063-000-001,22222222,BP CBA,53.47,0,986426.28,DR,REF959289,CBA,Savings
02-09-2025 12:35,CBADA67FB3BC17446ACA0A0,063-000-001,22222222,DOMINO'S PIZZA CBA,86.22,0,986340.06,DR,REF556241,CBA,Savings
02-09-2025 13:18,CBA13DF53DE3DD84452B25A,063-000-001,22222222,WAGES CREDIT CBA,0,7566.94,993907,CR,REF327691,CBA,Savings
02-09-2025 13:49,CBA0D24D9122E284F30B80E,063-000-001,22222222,KFC CBA,22.86,0,993884.14,DR,REF443115,CBA,Savings
02-09-2025 13:56,CBA978ADEBC7BD741D6BCF5,063-000-001,22222222,AMAZON AU CBA,23.53,0,993860.61,DR,REF581111,CBA,Savings
02-09-2025 14:25,CBABA61C51F85F947099191,063-000-001,22222222,COLES CBA,16.6,0,993844.01,DR,REF672054,CBA,Savings
02-09-2025 14:52,CBA6E0EEF5900E5490AABEF,063-000-001,22222222,COLES CBA,24.36,0,993819.65,DR,REF611694,CBA,Savings
02-09-2025 14:55,CBA70449F23FFB849E495FF,063-000-001,22222222,SALARY PAYMENT CBA,0,2443.2,996262.85,CR,REF784319,CBA,Savings
02-09-2025 15:14,CBA0D021C587D7A43D88BB1,063-000-001,22222222,INTERNET TRANSFER CBA,123.88,0,996138.97,DR,REF401610,CBA,Savings
02-09-2025 15:33,INTD1DD5396280C4CA9B5EF,063-000-001,22222222,TRANSFER FROM NAB 44444444,0,1703.75,997842.72,CR,INT-38883,CBA,Savings
02-09-2025 16:07,CBA84E724053D3947BC9AF3,063-000-001,22222222,ZOOM CBA,83.13,0,997759.59,DR,REF399230,CBA,Savings
02-09-2025 16:14,CBA35674A7147FF4E0BBF4C,063-000-001,22222222,PAYPAL *NETFLIX CBA,132.62,0,997626.97,DR,REF217570,CBA,Savings
02-09-2025 16:27,CBAC0DBD6981C0941A2AAC9,063-000-001,22222222,DOMINO'S PIZZA CBA,30.77,0,997596.2,DR,REF177925,CBA,Savings
02-09-2025 17:45,CBAB7EC8A1E9DD840D09D95,063-000-001,22222222,PAYROLL CREDIT CBA,0,380.13,997976.33,CR,REF661180,CBA,Savings
02-09-2025 18:19,CBA1B3AA83D40C647E584A1,063-000-001,22222222,ZOOM CBA,37.14,0,997939.19,DR,REF796203,CBA,Savings
02-09-2025 18:25,CBA59E1A3AED222401194E1,063-000-001,22222222,ALDI CBA,24.71,0,997914.48,DR,REF325215,CBA,Savings
02-09-2025 18:35,INTEB967717767F419A8438,063-000-001,22222222,TRANSFER TO CBA 33333333,96.56,0,997817.92,DR,INT-28152,CBA,Savings
02-09-2025 18:47,CBAAD9C72A496C64D9DBBF3,063-000-001,22222222,ZOOM CBA,18.52,0,997799.4,DR,REF200693,CBA,Savings
02-09-2025 18:50,CBAE3E601F7EA924778B29B,063-000-001,22222222,MENULOG CBA,29.73,0,997769.67,DR,REF199426,CBA,Savings
02-09-2025 19:21,INTB94F5F48CCB944619A58,063-000-001,22222222,TRANSFER FROM CBA 33333333,0,1832,999601.67,CR,INT-72860,CBA,Savings
02-09-2025 19:39,CBA65F0E10782634A4F993C,063-000-001,22222222,TAFE BOOKSHOP CBA,50.79,0,999550.88,DR,REF771373,CBA,Savings
02-09-2025 19:49,CBA42A0CF6AA9CF444F923B,063-000-001,22222222,BANK FEE CBA,15.16,0,999535.72,DR,REF534885,CBA,Savings
02-09-2025 20:14,CBAB4B0F12A37B342CE9E47,063-000-001,22222222,TAFE BOOKSHOP CBA,15.86,0,999519.86,DR,REF822212,CBA,Savings
02-09-2025 20:50,CBA1C1A9DD221774D5A8A36,063-000-001,22222222,UBER EATS CBA,10.46,0,999509.4,DR,REF800374,CBA,Savings
02-09-2025 20:55,CBA523E1E3F9F224FF9B6AD,063-000-001,22222222,FLIXBUS CBA,30.18,0,999479.22,DR,REF253409,CBA,Savings
02-09-2025 21:16,INT7528DD180B4141159AC4,063-000-001,22222222,TRANSFER TO NAB 44444444,283.48,0,999195.74,DR,INT-33938,CBA,Savings
02-09-2025 21:22,CBAE78D8DC1CFF04CA392C7,063-000-001,22222222,PAYPAL *NETFLIX CBA,11.44,0,999184.3,DR,REF518420,CBA,Savings
02-09-2025 21:43,CBA78264171D9274979963D,063-000-001,22222222,WOOLWORTHS CBA,27.4,0,999156.9,DR,REF824533,CBA,Savings
02-09-2025 21:50,CBAE2B3FC214F8844459809,063-000-001,22222222,INTERNET TRANSFER CBA,94.76,0,999062.14,DR,REF567301,CBA,Savings
02-09-2025 21:51,CBADAB4B0A946B94646AABB,063-000-001,22222222,LIQUORLAND CBA,33.43,0,999028.71,DR,REF768442,CBA,Savings
02-09-2025 22:08,CBAC5AF1BBE65D14B65A64A,063-000-001,22222222,FLIXBUS CBA,102.08,0,998926.63,DR,REF194644,CBA,Savings
02-09-2025 22:19,CBA2A76888B04C64D8DA66E,063-000-001,22222222,COLES CBA,20.76,0,998905.87,DR,REF875944,CBA,Savings
02-09-2025 22:29,CBADAE25C67A4374AF1B539,063-000-001,22222222,INTERNET TRANSFER CBA,65.01,0,998840.86,DR,REF328415,CBA,Savings
02-09-2025 22:40,INTCC55AC0BA45F410F8920,063-000-001,22222222,TRANSFER FROM NAB 44444444,0,1820.88,1000661.74,CR,INT-95281,CBA,Savings
02-09-2025 23:14,CBA682BF5D7C9DF410BA6EE,063-000-001,22222222,STARBUCKS CBA,25.99,0,1000635.75,DR,REF416502,CBA,Savings
02-09-2025 23:46,CBA549833D192FB436895CF,063-000-001,22222222,HARVEY NORMAN CBA,22.42,0,1000613.33,DR,REF747288,CBA,Savings
02-09-2025 23:59,CBA6B359B6373AE4F0AAC53,063-000-001,22222222,BIGW CBA,28.99,0,1000584.34,DR,REF462262,CBA,Savings
03-09-2025 00:46,CBA4995673E6CD241F887A0,063-000-001,22222222,MCDONALDS CBA,52.57,0,1000531.77,DR,REF161129,CBA,Savings
03-09-2025 00:50,CBACF68AF5EA1424F5BAE0F,063-000-001,22222222,MCDONALDS CBA,53.68,0,1000478.09,DR,REF315653,CBA,Savings
03-09-2025 01:25,CBA4851AFCA24B6433F8C83,063-000-001,22222222,PAY - SALARY CBA,0,3537.2,1004015.29,CR,REF403432,CBA,Savings
03-09-2025 02:12,CBAF20D144585374B9A8AB9,063-000-001,22222222,CITYLINK CBA,59.09,0,1003956.2,DR,REF515927,CBA,Savings
03-09-2025 02:16,CBA5505FF47B68A417E9716,063-000-001,22222222,LIQUORLAND CBA,169.18,0,1003787.02,DR,REF792680,CBA,Savings
03-09-2025 02:18,INT4D2E8592C0274808A639,063-000-001,22222222,TRANSFER FROM ANZ 11111111,0,84.08,1003871.1,CR,INT-43082,CBA,Savings
03-09-2025 02:26,CBADBB22CD8580B48978900,063-000-001,22222222,ZOOM CBA,41.23,0,1003829.87,DR,REF268544,CBA,Savings
03-09-2025 02:47,CBA1D5E07205ED94734B066,063-000-001,22222222,7-ELEVEN CBA,31.23,0,1003798.64,DR,REF766431,CBA,Savings
03-09-2025 03:32,CBAB94F92842E504E4D9C60,063-000-001,22222222,ALDI CBA,6.89,0,1003791.75,DR,REF277375,CBA,Savings
03-09-2025 03:33,CBA181F43D60E774B7498CD,063-000-001,22222222,KFC CBA,103.18,0,1003688.57,DR,REF184293,CBA,Savings
03-09-2025 03:41,CBAAE2D72FC047F4581A9AB,063-000-001,22222222,COMPANY PAYROLL CBA,0,5861.16,1009549.73,CR,REF512634,CBA,Savings
03-09-2025 03:45,CBA5D88509615D840488FA8,063-000-001,22222222,ALDI CBA,180.82,0,1009368.91,DR,REF963037,CBA,Savings
03-09-2025 04:01,CBA4BB39EC4BCEE483592B5,063-000-001,22222222,WOOLWORTHS CBA,12.31,0,1009356.6,DR,REF994897,CBA,Savings
03-09-2025 04:20,CBA8754C08280724C5ABE60,063-000-001,22222222,PAYMENT GATEWAY CBA,4.35,0,1009352.25,DR,REF708682,CBA,Savings
03-09-2025 04:21,CBABA2F71298DCD468CB24A,063-000-001,22222222,TAFE BOOKSHOP CBA,2.87,0,1009349.38,DR,REF596433,CBA,Savings
03-09-2025 05:44,CBAE030E921802C464C9726,063-000-001,22222222,COMPANY PAYROLL CBA,0,7557.51,1016906.89,CR,REF942438,CBA,Savings
03-09-2025 05:58,CBAA9E75964DEA646EB846F,063-000-001,22222222,INTERNET TRANSFER CBA,67.33,0,1016839.56,DR,REF677473,CBA,Savings
03-09-2025 06:37,CBA4F52F6FE006347CEB990,063-000-001,22222222,COLES CBA,21.84,0,1016817.72,DR,REF819432,CBA,Savings
03-09-2025 06:52,CBA97FE57FF805D4806B32F,063-000-001,22222222,HARVEY NORMAN CBA,19.76,0,1016797.96,DR,REF192748,CBA,Savings
03-09-2025 07:09,CBAFC58F38C510D444C9A7E,063-000-001,22222222,ALDI CBA,42.98,0,1016754.98,DR,REF620215,CBA,Savings
03-09-2025 07:09,CBA2E0BAAC081184CC2B71C,063-000-001,22222222,STARBUCKS CBA,25.5,0,1016729.48,DR,REF579957,CBA,Savings
03-09-2025 07:22,CBABFC111906833405499A1,063-000-001,22222222,ZOOM CBA,24.72,0,1016704.76,DR,REF944685,CBA,Savings
03-09-2025 07:44,CBA2B1E2A5DF17644FBB34D,063-000-001,22222222,MCDONALDS CBA,57.12,0,1016647.64,DR,REF917419,CBA,Savings
03-09-2025 08:50,CBAC9F9BB0CFE9B4CF499BB,063-000-001,22222222,LIQUORLAND CBA,36.7,0,1016610.94,DR,REF253428,CBA,Savings
03-09-2025 08:50,CBAB53406DB58324EED8031,063-000-001,22222222,RAILWAY STATION CBA,62.95,0,1016547.99,DR,REF616631,CBA,Savings
03-09-2025 08:52,CBA9EF54EFE2B9142259677,063-000-001,22222222,ALDI CBA,29.7,0,1016518.29,DR,REF707073,CBA,Savings
03-09-2025 08:55,CBA365D2E40E12345048C09,063-000-001,22222222,BANK FEE CBA,75.62,0,1016442.67,DR,REF896129,CBA,Savings
03-09-2025 08:57,CBA04964219C4344DA7B93D,063-000-001,22222222,KFC CBA,127.9,0,1016314.77,DR,REF137365,CBA,Savings
03-09-2025 09:31,CBA41B1E0584B7B45069637,063-000-001,22222222,INTERNET TRANSFER CBA,107.99,0,1016206.78,DR,REF612455,CBA,Savings
03-09-2025 09:46,CBABB4F21F2974448EFB7CE,063-000-001,22222222,SPOTIFY CBA,54.08,0,1016152.7,DR,REF632155,CBA,Savings
03-09-2025 09:54,CBA94322D0511D64897B49F,063-000-001,22222222,TAFE BOOKSHOP CBA,3.57,0,1016149.13,DR,REF805875,CBA,Savings
03-09-2025 10:05,CBAC9CB071019764C32A619,063-000-001,22222222,TAFE BOOKSHOP CBA,14.23,0,1016134.9,DR,REF807971,CBA,Savings
03-09-2025 10:08,INT60047F02A8DF41EC9D72,063-000-001,22222222,TRANSFER TO CBA 33333333,889.3,0,1015245.6,DR,INT-39652,CBA,Savings
03-09-2025 10:20,CBAEFDB108324F341E598A2,063-000-001,22222222,BIGW CBA,28.49,0,1015217.11,DR,REF756589,CBA,Savings
03-09-2025 10:23,CBA82FB09C0D84E46DFA1AA,063-000-001,22222222,AMAZON AU CBA,10.5,0,1015206.61,DR,REF858084,CBA,Savings
03-09-2025 11:17,CBABA2CCA70A776430DB1F1,063-000-001,22222222,COLES CBA,24.61,0,1015182,DR,REF538679,CBA,Savings
03-09-2025 11:17,CBA643621DCCE864F8688CA,063-000-001,22222222,BWS CBA,75.02,0,1015106.98,DR,REF379143,CBA,Savings
03-09-2025 11:43,CBAF9427FE3A7AB484CBC0D,063-000-001,22222222,FLIXBUS CBA,16.3,0,1015090.68,DR,REF349120,CBA,Savings
03-09-2025 11:50,CBAFCA67BBF056D4364AB89,063-000-001,22222222,LIQUORLAND CBA,41.16,0,1015049.52,DR,REF642536,CBA,Savings
03-09-2025 11:53,CBAB61E93DF197F4727A93D,063-000-001,22222222,JB HI-FI CBA,5.42,0,1015044.1,DR,REF302287,CBA,Savings
03-09-2025 12:10,CBA771DE6DFF931417FB4D8,063-000-001,22222222,AMAZON AU CBA,58.32,0,1014985.78,DR,REF757798,CBA,Savings
03-09-2025 12:13,CBA42522D2508CB444D98AB,063-000-001,22222222,RAILWAY STATION CBA,32.41,0,1014953.37,DR,REF797599,CBA,Savings
03-09-2025 14:19,CBA9B9FF5F83FE546E383E6,063-000-001,22222222,STARBUCKS CBA,104.59,0,1014848.78,DR,REF759252,CBA,Savings
03-09-2025 14:29,CBABCDF55465D0348FDAF44,063-000-001,22222222,ALDI CBA,5.29,0,1014843.49,DR,REF627784,CBA,Savings
03-09-2025 14:32,CBAE1D154F1563343F991A5,063-000-001,22222222,AMAZON AU CBA,46.32,0,1014797.17,DR,REF528341,CBA,Savings
03-09-2025 14:49,CBAA67050B584484E659CA0,063-000-001,22222222,APPLE CBA,140.64,0,1014656.53,DR,REF528463,CBA,Savings
03-09-2025 15:30,CBA567A1F325FA143F68B7C,063-000-001,22222222,UBER EATS CBA,17.54,0,1014638.99,DR,REF120346,CBA,Savings
03-09-2025 15:32,CBA0C5106A7E2AF41DEA634,063-000-001,22222222,CITYLINK CBA,22.42,0,1014616.57,DR,REF335328,CBA,Savings
03-09-2025 15:34,CBA808A3DEF6F8F425891F6,063-000-001,22222222,COMPANY PAYROLL CBA,0,1681.42,1016297.99,CR,REF451257,CBA,Savings
03-09-2025 16:00,CBA53FAA59E76D14329B4EC,063-000-001,22222222,INTERNET TRANSFER CBA,44.28,0,1016253.71,DR,REF454775,CBA,Savings
03-09-2025 16:16,CBAE07243AADCF64685BA9C,063-000-001,22222222,WOOLWORTHS CBA,6.1,0,1016247.61,DR,REF549520,CBA,Savings
03-09-2025 16:40,CBABF187F9575604E959D83,063-000-001,22222222,ALDI CBA,105.99,0,1016141.62,DR,REF574262,CBA,Savings
03-09-2025 16:48,CBA1B8D5C5E5D964F429F1A,063-000-001,22222222,LIQUORLAND CBA,13.3,0,1016128.32,DR,REF475453,CBA,Savings
03-09-2025 18:52,CBA3E4D2E885BE8492AB068,063-000-001,22222222,WAGES CREDIT CBA,0,2743.89,1018872.21,CR,REF915041,CBA,Savings
03-09-2025 18:52,CBADCEF1C7D7045467A8D80,063-000-001,22222222,BANK FEE CBA,59.32,0,1018812.89,DR,REF987434,CBA,Savings
03-09-2025 19:02,CBABA3F6D0B038242CFA0E9,063-000-001,22222222,COLES CBA,61.43,0,1018751.46,DR,REF207049,CBA,Savings
03-09-2025 19:13,CBA84631D3C3E9C495792C4,063-000-001,22222222,INTERNET TRANSFER CBA,19.78,0,1018731.68,DR,REF370394,CBA,Savings
03-09-2025 19:14,CBA09E8EF7057D44C449661,063-000-001,22222222,DOMINO'S PIZZA CBA,32.16,0,1018699.52,DR,REF897758,CBA,Savings
03-09-2025 20:13,CBA6CAFCA59F01A4F01B16E,063-000-001,22222222,BWS CBA,9.68,0,1018689.84,DR,REF431835,CBA,Savings
03-09-2025 20:29,CBAB1E7497459FF4174945B,063-000-001,22222222,MCDONALDS CBA,75.98,0,1018613.86,DR,REF980610,CBA,Savings
03-09-2025 20:42,CBA6FF7A97BB09D45FC89B7,063-000-001,22222222,RAILWAY STATION CBA,32.91,0,1018580.95,DR,REF127405,CBA,Savings
03-09-2025 21:20,CBA2FA3715B4320498D97AB,063-000-001,22222222,JB HI-FI CBA,46.72,0,1018534.23,DR,REF175884,CBA,Savings
03-09-2025 22:16,CBA0D2D33CF172549DA88EA,063-000-001,22222222,STARBUCKS CBA,20.63,0,1018513.6,DR,REF742474,CBA,Savings
03-09-2025 22:30,CBAF2A85638FF7F4D83B21E,063-000-001,22222222,KFC CBA,32.84,0,1018480.76,DR,REF948767,CBA,Savings
03-09-2025 23:18,CBA6133E6F79A914075AC8C,063-000-001,22222222,KFC CBA,236.01,0,1018244.75,DR,REF991233,CBA,Savings
03-09-2025 23:29,CBA49F249040937487C9DB0,063-000-001,22222222,PAYMENT GATEWAY CBA,49.72,0,1018195.03,DR,REF716275,CBA,Savings
03-09-2025 23:30,INT100266D788D54D2C8337,063-000-001,22222222,TRANSFER FROM CBA 33333333,0,790.21,1018985.24,CR,INT-74913,CBA,Savings
03-09-2025 23:56,CBA999EDD28602341E39D15,063-000-001,22222222,HARVEY NORMAN CBA,46.07,0,1018939.17,DR,REF992483,CBA,Savings
04-09-2025 00:28,CBACCB1D8045167404597A0,063-000-001,22222222,KFC CBA,6.89,0,1018932.28,DR,REF799747,CBA,Savings
04-09-2025 00:43,INT27ECF20BAB6248F3A770,063-000-001,22222222,TRANSFER TO ANZ 11111111,656.83,0,1018275.45,DR,INT-26724,CBA,Savings
04-09-2025 01:22,CBA1FB9CD0F8F1F4300928D,063-000-001,22222222,ALDI CBA,69.67,0,1018205.78,DR,REF803808,CBA,Savings
04-09-2025 01:39,CBAF7BD0C18C8104273855B,063-000-001,22222222,SPOTIFY CBA,54.39,0,1018151.39,DR,REF158405,CBA,Savings
04-09-2025 01:58,CBA23EDBBAB6BD84378996D,063-000-001,22222222,DOMINO'S PIZZA CBA,4.29,0,1018147.1,DR,REF157495,CBA,Savings
04-09-2025 02:37,CBAD5F4DF55E3DF4334B3F2,063-000-001,22222222,MCDONALDS CBA,143.17,0,1018003.93,DR,REF611237,CBA,Savings
04-09-2025 03:05,INT70A7940E41DD402CAAC0,063-000-001,22222222,TRANSFER FROM ANZ 11111111,0,1921.45,1019925.38,CR,INT-87753,CBA,Savings
04-09-2025 03:07,CBA674B621A8D324F6E8E13,063-000-001,22222222,STARBUCKS CBA,72.44,0,1019852.94,DR,REF915121,CBA,Savings
04-09-2025 03:08,CBAE4941F7F191446C8B844,063-000-001,22222222,UBER EATS CBA,128.64,0,1019724.3,DR,REF898027,CBA,Savings
04-09-2025 03:17,CBA448FC5790CF94264BD26,063-000-001,22222222,UBER EATS CBA,87.79,0,1019636.51,DR,REF782639,CBA,Savings
04-09-2025 03:33,CBA576384B05C7648B6921C,063-000-001,22222222,WOOLWORTHS CBA,33.19,0,1019603.32,DR,REF327868,CBA,Savings
04-09-2025 03:39,CBA05149EDA3C46471295F2,063-000-001,22222222,BIGW CBA,13.38,0,1019589.94,DR,REF280522,CBA,Savings
04-09-2025 04:13,CBAC2EA3AB0BFC14E1F9BC4,063-000-001,22222222,SHELL CBA,4.5,0,1019585.44,DR,REF136158,CBA,Savings
04-09-2025 04:19,CBAD5139D71AC23474C84B0,063-000-001,22222222,CITYLINK CBA,114.86,0,1019470.58,DR,REF836419,CBA,Savings
04-09-2025 04:29,CBAA1E239D825E44CF0843A,063-000-001,22222222,BWS CBA,37.81,0,1019432.77,DR,REF619293,CBA,Savings
04-09-2025 04:41,CBACD7940A3FB5E459A86A9,063-000-001,22222222,BANK FEE CBA,15.09,0,1019417.68,DR,REF954146,CBA,Savings
04-09-2025 05:16,CBA339A50259FA84326BD48,063-000-001,22222222,BIGW CBA,69.53,0,1019348.15,DR,REF188949,CBA,Savings
04-09-2025 07:05,CBA6EC9EE540E8C419D9D19,063-000-001,22222222,PAYPAL *NETFLIX CBA,60.1,0,1019288.05,DR,REF396653,CBA,Savings
04-09-2025 07:18,CBA4F38B4DB5EC847BABD4E,063-000-001,22222222,BANK FEE CBA,48.85,0,1019239.2,DR,REF130332,CBA,Savings
04-09-2025 07:49,CBAA355F58AD36944E8B815,063-000-001,22222222,COLES CBA,31.59,0,1019207.61,DR,REF371146,CBA,Savings
04-09-2025 08:17,CBAE9A5B5133FE441C1A84F,063-000-001,22222222,SHELL CBA,45.78,0,1019161.83,DR,REF475755,CBA,Savings
04-09-2025 08:47,CBAD9721EC008724485B7E0,063-000-001,22222222,PAYMENT GATEWAY CBA,70.3,0,1019091.53,DR,REF482013,CBA,Savings
04-09-2025 08:57,CBA7B8197938DAD42259341,063-000-001,22222222,COLES CBA,25.91,0,1019065.62,DR,REF402994,CBA,Savings
04-09-2025 09:01,CBAFB90923974914BC8AF4E,063-000-001,22222222,CITYLINK CBA,23.98,0,1019041.64,DR,REF939212,CBA,Savings
04-09-2025 09:38,CBAC951CA2488FD46759375,063-000-001,22222222,BWS CBA,66.74,0,1018974.9,DR,REF946875,CBA,Savings
04-09-2025 09:44,CBA877881A6334740A6B0F8,063-000-001,22222222,AMAZON AU CBA,82.04,0,1018892.86,DR,REF986860,CBA,Savings
04-09-2025 11:41,CBAC48296382C3041128916,063-000-001,22222222,COLES CBA,55.09,0,1018837.77,DR,REF862626,CBA,Savings
04-09-2025 11:48,CBA65A8F0F613FE4EAE964E,063-000-001,22222222,MCDONALDS CBA,12.12,0,1018825.65,DR,REF348868,CBA,Savings
04-09-2025 12:10,CBA7191FE88C3F749658088,063-000-001,22222222,WOOLWORTHS CBA,9.42,0,1018816.23,DR,REF386147,CBA,Savings
04-09-2025 12:13,CBABA20EB5A2D0143908D1B,063-000-001,22222222,FLIXBUS CBA,191.52,0,1018624.71,DR,REF676006,CBA,Savings
04-09-2025 13:09,CBAE7140D652D734496BE72,063-000-001,22222222,KFC CBA,11.47,0,1018613.24,DR,REF736323,CBA,Savings
04-09-2025 13:13,CBA369F9898527D496FA485,063-000-001,22222222,PAY - SALARY CBA,0,4155.18,1022768.42,CR,REF583939,CBA,Savings
04-09-2025 13:56,CBA8CD53FA2CB754228A931,063-000-001,22222222,INTERNET TRANSFER CBA,36.12,0,1022732.3,DR,REF785449,CBA,Savings
04-09-2025 14:54,CBAE1107BC4BA934604959D,063-000-001,22222222,ALDI CBA,62.75,0,1022669.55,DR,REF243108,CBA,Savings
04-09-2025 15:06,CBA284C5250FE5D4E9FA59E,063-000-001,22222222,LIQUORLAND CBA,59.98,0,1022609.57,DR,REF136615,CBA,Savings
04-09-2025 15:19,CBAA3E2DD84004742AE9DF3,063-000-001,22222222,LIQUORLAND CBA,29.52,0,1022580.05,DR,REF686249,CBA,Savings
04-09-2025 15:30,CBACF941E39E4EB4333A184,063-000-001,22222222,LIQUORLAND CBA,151.3,0,1022428.75,DR,REF935947,CBA,Savings
04-09-2025 16:21,CBA017CA81F73FD410E99E7,063-000-001,22222222,LIQUORLAND CBA,26.25,0,1022402.5,DR,REF972348,CBA,Savings
04-09-2025 16:34,CBA087ECE61ECD347339A18,063-000-001,22222222,MENULOG CBA,6.33,0,1022396.17,DR,REF256022,CBA,Savings
04-09-2025 16:37,CBAB3A6ADCE753247789274,063-000-001,22222222,INTERNET TRANSFER CBA,50.13,0,1022346.04,DR,REF266270,CBA,Savings
04-09-2025 16:43,CBADB5189FE087A4B018F06,063-000-001,22222222,PAY - SALARY CBA,0,7717.12,1030063.16,CR,REF590945,CBA,Savings
04-09-2025 17:08,CBA3BAF57B0308545E293CD,063-000-001,22222222,PAYPAL *NETFLIX CBA,32.11,0,1030031.05,DR,REF831419,CBA,Savings
04-09-2025 17:14,CBA7E1CEC061C7A449C84B6,063-000-001,22222222,APPLE CBA,33.03,0,1029998.02,DR,REF887310,CBA,Savings
04-09-2025 17:35,CBA957605566A59413685F7,063-000-001,22222222,LIQUORLAND CBA,11.49,0,1029986.53,DR,REF692728,CBA,Savings
04-09-2025 17:50,CBAB596C3D6833E4910AC39,063-000-001,22222222,HARVEY NORMAN CBA,5.25,0,1029981.28,DR,REF890061,CBA,Savings
04-09-2025 17:58,CBADED2917742B34A628135,063-000-001,22222222,AMAZON AU CBA,78.86,0,1029902.42,DR,REF971434,CBA,Savings
04-09-2025 18:10,CBA9A4AACBCA6B8466D882C,063-000-001,22222222,UBER EATS CBA,64.85,0,1029837.57,DR,REF858073,CBA,Savings
04-09-2025 18:39,CBA324407549E5E4E15A1DC,063-000-001,22222222,MCDONALDS CBA,120.6,0,1029716.97,DR,REF142388,CBA,Savings
04-09-2025 19:07,CBA66E19CCBEEDF42888BBB,063-000-001,22222222,BIGW CBA,52.43,0,1029664.54,DR,REF735416,CBA,Savings
04-09-2025 19:10,INTF23FEA9AD35F4E6D985C,063-000-001,22222222,TRANSFER TO CBA 33333333,1833.33,0,1027831.21,DR,INT-27795,CBA,Savings
04-09-2025 19:26,CBA2012A919309541388910,063-000-001,22222222,AMAZON AU CBA,185.53,0,1027645.68,DR,REF630493,CBA,Savings
04-09-2025 19:37,CBA597B8AF726F94813A1BA,063-000-001,22222222,ALDI CBA,123.53,0,1027522.15,DR,REF102056,CBA,Savings
04-09-2025 20:00,CBA52A7D9446C4C4B609D8C,063-000-001,22222222,PAYMENT GATEWAY CBA,10.14,0,1027512.01,DR,REF966723,CBA,Savings
04-09-2025 20:10,CBA39E0B42F86F5447C980B,063-000-001,22222222,COMPANY PAYROLL CBA,0,3442.3,1030954.31,CR,REF866868,CBA,Savings
04-09-2025 21:04,CBA39D34442AFF142998912,063-000-001,22222222,COLES CBA,35.98,0,1030918.33,DR,REF555418,CBA,Savings
04-09-2025 21:16,CBA556CFBAB94374FFD9DCD,063-000-001,22222222,TAFE BOOKSHOP CBA,19.63,0,1030898.7,DR,REF516269,CBA,Savings
04-09-2025 21:42,CBAC574F55EC1664C558FC2,063-000-001,22222222,JB HI-FI CBA,17.1,0,1030881.6,DR,REF418415,CBA,Savings
04-09-2025 22:17,CBA74613CDE122B41658C27,063-000-001,22222222,BWS CBA,65.07,0,1030816.53,DR,REF875691,CBA,Savings
04-09-2025 22:24,CBA15175F24D5D9460A8E5B,063-000-001,22222222,SALARY PAYMENT CBA,0,7030.27,1037846.8,CR,REF372432,CBA,Savings
04-09-2025 22:43,CBA7073C1D51C90446E9A0A,063-000-001,22222222,BIGW CBA,83.13,0,1037763.67,DR,REF303083,CBA,Savings
04-09-2025 23:39,CBAEFC286D3C94C44DDB618,063-000-001,22222222,KFC CBA,33.78,0,1037729.89,DR,REF262645,CBA,Savings
04-09-2025 23:45,CBA6F2B121313FE4C019C8D,063-000-001,22222222,7-ELEVEN CBA,20.25,0,1037709.64,DR,REF488985,CBA,Savings
05-09-2025 00:00,CBA74D4720FD3F044C88ED4,063-000-001,22222222,FLIXBUS CBA,106.21,0,1037603.43,DR,REF186263,CBA,Savings
05-09-2025 00:09,CBA5C2F15EFF81B46DE99E2,063-000-001,22222222,ZOOM CBA,8.52,0,1037594.91,DR,REF552729,CBA,Savings
05-09-2025 00:12,CBA4985C0D49E2543719AF8,063-000-001,22222222,SHELL CBA,32.75,0,1037562.16,DR,REF118686,CBA,Savings
05-09-2025 01:35,CBADF4395820902431F83EE,063-000-001,22222222,BWS CBA,63.55,0,1037498.61,DR,REF501507,CBA,Savings
05-09-2025 01:36,CBADDE22416DBB9412AB9BE,063-000-001,22222222,BWS CBA,29.84,0,1037468.77,DR,REF188521,CBA,Savings
05-09-2025 01:52,CBAA049DB3BE35E4B1A8137,063-000-001,22222222,BWS CBA,28.47,0,1037440.3,DR,REF182226,CBA,Savings
05-09-2025 01:57,CBA728A168E2EFF449EB3F1,063-000-001,22222222,MCDONALDS CBA,45.93,0,1037394.37,DR,REF582508,CBA,Savings
05-09-2025 02:37,CBA10A8EDE39C4242F0AF4B,063-000-001,22222222,MCDONALDS CBA,18.72,0,1037375.65,DR,REF281729,CBA,Savings
05-09-2025 03:22,CBAEAD4F7C8455249669F5D,063-000-001,22222222,PAYMENT GATEWAY CBA,197.25,0,1037178.4,DR,REF121133,CBA,Savings
05-09-2025 03:35,CBAA26053718478435DB80C,063-000-001,22222222,COLES CBA,11.61,0,1037166.79,DR,REF957421,CBA,Savings
05-09-2025 03:40,CBA21312D6B922B4367A8DA,063-000-001,22222222,UBER EATS CBA,35.48,0,1037131.31,DR,REF358503,CBA,Savings
05-09-2025 03:48,CBABAAC24C291D84CCC986E,063-000-001,22222222,KFC CBA,89.35,0,1037041.96,DR,REF649153,CBA,Savings
05-09-2025 04:08,CBAAADFE40529C24D39B498,063-000-001,22222222,MENULOG CBA,33.23,0,1037008.73,DR,REF941513,CBA,Savings
05-09-2025 04:28,CBAAB79CF5ECF36414598F2,063-000-001,22222222,BIGW CBA,20.18,0,1036988.55,DR,REF866670,CBA,Savings
05-09-2025 04:49,CBA81FAE18AEF2D4A1B848D,063-000-001,22222222,COMPANY PAYROLL CBA,0,4400.27,1041388.82,CR,REF693681,CBA,Savings
05-09-2025 05:11,CBA8160284309A840B9A8BB,063-000-001,22222222,PAYPAL *NETFLIX CBA,32.25,0,1041356.57,DR,REF356507,CBA,Savings
05-09-2025 05:31,CBA28C1C30859494F2299F7,063-000-001,22222222,TAFE BOOKSHOP CBA,54.54,0,1041302.03,DR,REF742635,CBA,Savings
05-09-2025 06:09,CBA33720DD171BA4DEDB686,063-000-001,22222222,SHELL CBA,196.86,0,1041105.17,DR,REF111885,CBA,Savings
05-09-2025 06:35,CBACE6725242A684B2CB5EC,063-000-001,22222222,BWS CBA,48.24,0,1041056.93,DR,REF618724,CBA,Savings
05-09-2025 06:37,CBA64BBE32C4307447DB4E7,063-000-001,22222222,HARVEY NORMAN CBA,13.48,0,1041043.45,DR,REF730205,CBA,Savings
05-09-2025 06:49,CBAB7893F37E2724FB58E64,063-000-001,22222222,CITYLINK CBA,34.52,0,1041008.93,DR,REF327801,CBA,Savings
05-09-2025 06:51,CBAACFC08C1017F48AE89EC,063-000-001,22222222,MCDONALDS CBA,30.9,0,1040978.03,DR,REF335926,CBA,Savings
05-09-2025 06:53,CBA1970BB56F83A418E9B72,063-000-001,22222222,WAGES CREDIT CBA,0,5248.14,1046226.17,CR,REF771458,CBA,Savings
05-09-2025 07:05,CBA8383ABBB2D2046B0906D,063-000-001,22222222,SALARY PAYMENT CBA,0,5611.41,1051837.58,CR,REF371073,CBA,Savings
05-09-2025 07:19,CBAB4C6224FC7DB4896B475,063-000-001,22222222,STARBUCKS CBA,94.44,0,1051743.14,DR,REF739851,CBA,Savings
05-09-2025 07:19,CBA3D0A108E37C54EEE92BD,063-000-001,22222222,BP CBA,39.42,0,1051703.72,DR,REF480560,CBA,Savings
05-09-2025 07:50,CBAACDB8ED1EFD647E2AC93,063-000-001,22222222,ZOOM CBA,6.53,0,1051697.19,DR,REF300987,CBA,Savings
05-09-2025 08:02,CBAD2C5DD416D6C48AC88CF,063-000-001,22222222,BP CBA,5.03,0,1051692.16,DR,REF648874,CBA,Savings
05-09-2025 08:07,CBABA95A9E91142480D8BE6,063-000-001,22222222,COLES CBA,11.61,0,1051680.55,DR,REF915509,CBA,Savings
05-09-2025 08:15,CBA894CA99FE5AA4A2F820F,063-000-001,22222222,7-ELEVEN CBA,25.93,0,1051654.62,DR,REF600974,CBA,Savings
05-09-2025 08:24,CBA6FF35473D157418682A4,063-000-001,22222222,INTERNET TRANSFER CBA,12.42,0,1051642.2,DR,REF103998,CBA,Savings
05-09-2025 08:58,CBAA05A56A7E9754DC59A78,063-000-001,22222222,DOMINO'S PIZZA CBA,19.88,0,1051622.32,DR,REF943636,CBA,Savings
05-09-2025 09:13,CBA3273308550CB4A539175,063-000-001,22222222,SALARY PAYMENT CBA,0,6853.11,1058475.43,CR,REF117195,CBA,Savings
05-09-2025 09:42,CBAE12377F719F341CF9802,063-000-001,22222222,PAYPAL *NETFLIX CBA,16.59,0,1058458.84,DR,REF911506,CBA,Savings
05-09-2025 09:46,CBA134CCC76783444A5BA84,063-000-001,22222222,UBER EATS CBA,40.86,0,1058417.98,DR,REF576474,CBA,Savings
05-09-2025 10:12,CBABE19CBC8C2E948E2BB19,063-000-001,22222222,CITYLINK CBA,72.21,0,1058345.77,DR,REF345617,CBA,Savings
05-09-2025 11:49,CBA38B22C12074D4BCDB309,063-000-001,22222222,PAYPAL *NETFLIX CBA,28.91,0,1058316.86,DR,REF626983,CBA,Savings
05-09-2025 11:52,CBAE6D146681E6E43BA9D76,063-000-001,22222222,BP CBA,23.97,0,1058292.89,DR,REF974215,CBA,Savings
05-09-2025 12:38,CBAA595ED4FAF8A4301B7B4,063-000-001,22222222,JB HI-FI CBA,19.37,0,1058273.52,DR,REF633518,CBA,Savings
05-09-2025 12:50,CBA255171F8425E450C9354,063-000-001,22222222,WAGES CREDIT CBA,0,1547.42,1059820.94,CR,REF564889,CBA,Savings
05-09-2025 12:52,CBA4FDA75E035FF4378A026,063-000-001,22222222,FLIXBUS CBA,37.61,0,1059783.33,DR,REF576233,CBA,Savings
05-09-2025 13:17,CBA49A5E105E2E14D13A042,063-000-001,22222222,SPOTIFY CBA,226.48,0,1059556.85,DR,REF293369,CBA,Savings
05-09-2025 13:28,CBA7B06EF101A094B278570,063-000-001,22222222,KFC CBA,52.08,0,1059504.77,DR,REF973861,CBA,Savings
05-09-2025 13:41,CBA2E4B797706C24C3C9371,063-000-001,22222222,LIQUORLAND CBA,17.5,0,1059487.27,DR,REF483613,CBA,Savings
05-09-2025 13:47,CBAF6FD08328B7547279F07,063-000-001,22222222,WOOLWORTHS CBA,131.93,0,1059355.34,DR,REF395090,CBA,Savings
05-09-2025 13:49,CBA169DDFDDA552493FBD49,063-000-001,22222222,HARVEY NORMAN CBA,21.9,0,1059333.44,DR,REF286053,CBA,Savings
05-09-2025 13:59,CBAAA525EEE1F0D47B89CB1,063-000-001,22222222,LIQUORLAND CBA,298.82,0,1059034.62,DR,REF969986,CBA,Savings
05-09-2025 14:24,CBA0EC39E7B826840FE810B,063-000-001,22222222,LIQUORLAND CBA,69.25,0,1058965.37,DR,REF579727,CBA,Savings
05-09-2025 14:27,CBA023E5F647EEA42E59D53,063-000-001,22222222,BIGW CBA,69.67,0,1058895.7,DR,REF429733,CBA,Savings
05-09-2025 14:53,CBAC3BDE59C70FD4AF59EB3,063-000-001,22222222,CITYLINK CBA,58.43,0,1058837.27,DR,REF623179,CBA,Savings
05-09-2025 14:55,CBA454B1E1F51214C578989,063-000-001,22222222,INTERNET TRANSFER CBA,51.75,0,1058785.52,DR,REF607844,CBA,Savings
05-09-2025 14:58,CBA55C250DE569A4275A1A7,063-000-001,22222222,BIGW CBA,13.47,0,1058772.05,DR,REF993403,CBA,Savings
05-09-2025 15:15,CBA35485D8B4CC845B1A445,063-000-001,22222222,PAYMENT GATEWAY CBA,15.55,0,1058756.5,DR,REF778888,CBA,Savings
05-09-2025 15:22,INT7735D63D3E69485AA47F,063-000-001,22222222,TRANSFER FROM ANZ 11111111,0,1141.68,1059898.18,CR,INT-47138,CBA,Savings
05-09-2025 15:43,CBA2D679CF9901F4F289928,063-000-001,22222222,KFC CBA,8.94,0,1059889.24,DR,REF867050,CBA,Savings
05-09-2025 15:55,CBAEEECB3DC1C7042C6BDE4,063-000-001,22222222,7-ELEVEN CBA,79.98,0,1059809.26,DR,REF365370,CBA,Savings
05-09-2025 16:08,CBA0AB6624126F04B19B08A,063-000-001,22222222,PAY - SALARY CBA,0,885.14,1060694.4,CR,REF395351,CBA,Savings
05-09-2025 16:11,CBA3B0EE12E256A4EFCBC35,063-000-001,22222222,ALDI CBA,10.49,0,1060683.91,DR,REF430272,CBA,Savings
05-09-2025 16:36,CBA57DF0E88EE3D44878AFB,063-000-001,22222222,TAFE BOOKSHOP CBA,18.81,0,1060665.1,DR,REF218531,CBA,Savings
05-09-2025 16:41,CBA973DB16E0BDE44BB85BB,063-000-001,22222222,ZOOM CBA,166.76,0,1060498.34,DR,REF624359,CBA,Savings
05-09-2025 16:57,CBAC0423C2D44AF450481F7,063-000-001,22222222,DOMINO'S PIZZA CBA,37.91,0,1060460.43,DR,REF863138,CBA,Savings
05-09-2025 17:02,CBA9F37CAD7D0294227AB92,063-000-001,22222222,ZOOM CBA,29.03,0,1060431.4,DR,REF375855,CBA,Savings
05-09-2025 17:24,CBA77A4B42B90CD48CF9C3B,063-000-001,22222222,HARVEY NORMAN CBA,301.24,0,1060130.16,DR,REF135568,CBA,Savings
05-09-2025 17:32,CBAA42934BB902749BDB380,063-000-001,22222222,PAY - SALARY CBA,0,6688.59,1066818.75,CR,REF288732,CBA,Savings
05-09-2025 17:33,CBAAC8EE7EADB80497FBAA9,063-000-001,22222222,AMAZON AU CBA,40.78,0,1066777.97,DR,REF111279,CBA,Savings
05-09-2025 17:39,CBA23FED784126A439C8E6A,063-000-001,22222222,AMAZON AU CBA,53.48,0,1066724.49,DR,REF376297,CBA,Savings
05-09-2025 18:05,CBA6E46DDBEDFA442748E77,063-000-001,22222222,AMAZON AU CBA,90.2,0,1066634.29,DR,REF674137,CBA,Savings
05-09-2025 18:19,CBAD7FD126F0CB94051B8B1,063-000-001,22222222,WOOLWORTHS CBA,59.53,0,1066574.76,DR,REF182983,CBA,Savings
05-09-2025 18:31,CBA80BA073675234AF8BA53,063-000-001,22222222,PAYROLL CREDIT CBA,0,2612.09,1069186.85,CR,REF620634,CBA,Savings
05-09-2025 18:32,CBA5F807138623243E59ECA,063-000-001,22222222,MCDONALDS CBA,10.01,0,1069176.84,DR,REF865871,CBA,Savings
05-09-2025 18:34,CBA721589EA81BD429F9863,063-000-001,22222222,APPLE CBA,50.12,0,1069126.72,DR,REF118738,CBA,Savings
05-09-2025 18:35,CBA49D2BEBCE41847A29B49,063-000-001,22222222,FLIXBUS CBA,11.19,0,1069115.53,DR,REF547509,CBA,Savings
05-09-2025 18:38,CBA83D8C7D615B64628872E,063-000-001,22222222,CITYLINK CBA,10.8,0,1069104.73,DR,REF695433,CBA,Savings
05-09-2025 18:42,CBAC8194C0C36604D0A94AA,063-000-001,22222222,COLES CBA,29.38,0,1069075.35,DR,REF173962,CBA,Savings
05-09-2025 19:25,CBA0CE5AE49F4DB4A8D8D20,063-000-001,22222222,ZOOM CBA,111.57,0,1068963.78,DR,REF743088,CBA,Savings
05-09-2025 19:45,CBA2289E4DA7B9140A98DD7,063-000-001,22222222,FLIXBUS CBA,51.83,0,1068911.95,DR,REF138288,CBA,Savings
05-09-2025 20:44,CBAE9CB2A0F40144A469B22,063-000-001,22222222,JB HI-FI CBA,10.8,0,1068901.15,DR,REF644067,CBA,Savings
05-09-2025 21:06,CBAA34146314C904CA8A5DE,063-000-001,22222222,LIQUORLAND CBA,30.26,0,1068870.89,DR,REF569162,CBA,Savings
05-09-2025 21:08,CBAC2A60B526EE84FC6855B,063-000-001,22222222,BANK FEE CBA,57.53,0,1068813.36,DR,REF342716,CBA,Savings
05-09-2025 21:11,CBA1B67EDF07DE5423D90E1,063-000-001,22222222,SPOTIFY CBA,51.29,0,1068762.07,DR,REF519952,CBA,Savings
05-09-2025 21:14,CBADD93128E1C104F04A3BE,063-000-001,22222222,INTERNET TRANSFER CBA,48.55,0,1068713.52,DR,REF837060,CBA,Savings
05-09-2025 21:15,CBAABFEAC8DD6F34C899567,063-000-001,22222222,SPOTIFY CBA,9.37,0,1068704.15,DR,REF519103,CBA,Savings
05-09-2025 21:36,CBA0F6BC2ECA22B4B15AE93,063-000-001,22222222,WAGES CREDIT CBA,0,877.79,1069581.94,CR,REF878618,CBA,Savings
05-09-2025 21:39,CBA8E52C9E46652471D919E,063-000-001,22222222,PAYPAL *NETFLIX CBA,151.24,0,1069430.7,DR,REF224118,CBA,Savings
05-09-2025 21:39,INT6E77906122FD4935A088,063-000-001,22222222,TRANSFER TO ANZ 11111111,1370.15,0,1068060.55,DR,INT-69971,CBA,Savings
05-09-2025 21:47,CBAF20829AA891B4250BEFD,063-000-001,22222222,SALARY PAYMENT CBA,0,4071.66,1072132.21,CR,REF741005,CBA,Savings
05-09-2025 21:50,CBAEEA08B6383704F698D18,063-000-001,22222222,7-ELEVEN CBA,95.81,0,1072036.4,DR,REF807114,CBA,Savings
05-09-2025 22:30,CBA338221880FB64EA39ACF,063-000-001,22222222,COMPANY PAYROLL CBA,0,958.1,1072994.5,CR,REF898898,CBA,Savings
05-09-2025 22:49,INT0A255808698B44DAA0AC,063-000-001,22222222,TRANSFER FROM ANZ 11111111,0,465.48,1073459.98,CR,INT-30761,CBA,Savings
05-09-2025 22:53,CBACD98B5DEFFE44F0EA610,063-000-001,22222222,BWS CBA,21.83,0,1073438.15,DR,REF853067,CBA,Savings
05-09-2025 23:04,INT1090D4FB77EB41798178,063-000-001,22222222,TRANSFER TO NAB 44444444,1436.98,0,1072001.17,DR,INT-79977,CBA,Savings
05-09-2025 23:09,CBAA43FB4078C2448E6B188,063-000-001,22222222,UBER EATS CBA,24.24,0,1071976.93,DR,REF322539,CBA,Savings
06-09-2025 00:52,CBA109EDAD9E8A94482BF11,063-000-001,22222222,WAGES CREDIT CBA,0,2449.3,1074426.23,CR,REF877566,CBA,Savings
06-09-2025 01:01,CBA8347A1095D8D4F1B83D5,063-000-001,22222222,BP CBA,46.58,0,1074379.65,DR,REF982902,CBA,Savings
06-09-2025 01:20,CBA9A3B4028E13545B598A0,063-000-001,22222222,MENULOG CBA,82.54,0,1074297.11,DR,REF176114,CBA,Savings
06-09-2025 01:38,CBA34141F7EC8A348AC94AD,063-000-001,22222222,KFC CBA,26.03,0,1074271.08,DR,REF952600,CBA,Savings
06-09-2025 01:40,CBA2BB01FFD91614FD9904E,063-000-001,22222222,BANK FEE CBA,33.98,0,1074237.1,DR,REF299684,CBA,Savings
06-09-2025 01:42,CBA7C65C78AD01A41478972,063-000-001,22222222,STARBUCKS CBA,76.9,0,1074160.2,DR,REF723610,CBA,Savings
06-09-2025 01:46,CBACFD990E1DA6E44A3A972,063-000-001,22222222,MENULOG CBA,92.94,0,1074067.26,DR,REF306946,CBA,Savings
06-09-2025 02:37,CBA49A11AE930F54D37873B,063-000-001,22222222,BWS CBA,55.21,0,1074012.05,DR,REF889968,CBA,Savings
06-09-2025 02:42,CBA2B4FB2DC2B7B486D99F0,063-000-001,22222222,MCDONALDS CBA,91.66,0,1073920.39,DR,REF826216,CBA,Savings
06-09-2025 02:54,CBA588E75118ACF4A67A5B3,063-000-001,22222222,KFC CBA,29.08,0,1073891.31,DR,REF778639,CBA,Savings
06-09-2025 03:37,CBA0F5C44B59ED34933B03E,063-000-001,22222222,BP CBA,21.61,0,1073869.7,DR,REF329743,CBA,Savings
06-09-2025 03:52,CBA439458CD95E84AD49570,063-000-001,22222222,MENULOG CBA,25.18,0,1073844.52,DR,REF663366,CBA,Savings
06-09-2025 03:53,CBA46030A056FA14495B997,063-000-001,22222222,SALARY PAYMENT CBA,0,629.8,1074474.32,CR,REF331623,CBA,Savings
06-09-2025 04:17,CBAA3D7E71D99794B57B594,063-000-001,22222222,7-ELEVEN CBA,34.83,0,1074439.49,DR,REF976529,CBA,Savings
06-09-2025 04:24,CBAC61B21B19F6543CF8936,063-000-001,22222222,PAYROLL CREDIT CBA,0,6186.61,1080626.1,CR,REF200470,CBA,Savings
06-09-2025 05:46,CBA82094D41CAF74BFC9E13,063-000-001,22222222,COLES CBA,119.89,0,1080506.21,DR,REF678821,CBA,Savings
06-09-2025 06:04,CBAC2581BFBDED046108867,063-000-001,22222222,7-ELEVEN CBA,8.83,0,1080497.38,DR,REF705447,CBA,Savings
06-09-2025 06:22,CBAE8F7BE8E50E244998E7A,063-000-001,22222222,AMAZON AU CBA,134.01,0,1080363.37,DR,REF594566,CBA,Savings
06-09-2025 06:51,CBA372BF7F5694940FC86C3,063-000-001,22222222,HARVEY NORMAN CBA,4.24,0,1080359.13,DR,REF108740,CBA,Savings
06-09-2025 07:27,CBAF23E0555F0D44C71BDFF,063-000-001,22222222,PAY - SALARY CBA,0,1113.04,1081472.17,CR,REF799717,CBA,Savings
06-09-2025 07:39,CBA0D44E2322B9E470DBBA7,063-000-001,22222222,BWS CBA,13.29,0,1081458.88,DR,REF914657,CBA,Savings
06-09-2025 07:51,CBA7C9569468CD643678EC2,063-000-001,22222222,SHELL CBA,37.13,0,1081421.75,DR,REF509596,CBA,Savings
06-09-2025 08:05,CBA58798A52D4544E059697,063-000-001,22222222,PAYPAL *NETFLIX CBA,20.44,0,1081401.31,DR,REF205607,CBA,Savings
06-09-2025 08:08,CBA433D5732136F43FCBF5C,063-000-001,22222222,STARBUCKS CBA,15.85,0,1081385.46,DR,REF219426,CBA,Savings
06-09-2025 09:15,CBA24575B3EFE984B0FA20F,063-000-001,22222222,INTERNET TRANSFER CBA,21.86,0,1081363.6,DR,REF430140,CBA,Savings
06-09-2025 10:14,CBA387A6B8CF2E54DDDA0DA,063-000-001,22222222,WAGES CREDIT CBA,0,5770.11,1087133.71,CR,REF262530,CBA,Savings
06-09-2025 10:17,CBA30EA0C8A399B4C2483A5,063-000-001,22222222,PAYPAL *NETFLIX CBA,181.06,0,1086952.65,DR,REF544654,CBA,Savings
06-09-2025 10:22,CBA8736CE13504A421BB4EF,063-000-001,22222222,SALARY PAYMENT CBA,0,91.38,1087044.03,CR,REF858300,CBA,Savings
06-09-2025 11:14,CBA42F19EA6E5E0476AA0CA,063-000-001,22222222,LIQUORLAND CBA,4.05,0,1087039.98,DR,REF156079,CBA,Savings
06-09-2025 11:44,CBAF73337D036ED4191A8A7,063-000-001,22222222,APPLE CBA,142.05,0,1086897.93,DR,REF733975,CBA,Savings
06-09-2025 12:45,CBA062B06E51B2F407BBC03,063-000-001,22222222,PAYPAL *NETFLIX CBA,16.63,0,1086881.3,DR,REF700393,CBA,Savings
06-09-2025 13:08,CBA9F89E6102B2B47AC8239,063-000-001,22222222,HARVEY NORMAN CBA,192.05,0,1086689.25,DR,REF569822,CBA,Savings
06-09-2025 13:14,CBA3478DA349E83413D88B7,063-000-001,22222222,WAGES CREDIT CBA,0,1173.17,1087862.42,CR,REF822239,CBA,Savings
06-09-2025 13:24,CBA28D613E893BB479E9477,063-000-001,22222222,PAY - SALARY CBA,0,6515.56,1094377.98,CR,REF123438,CBA,Savings
06-09-2025 13:30,CBAA4F67728C5F045038D2B,063-000-001,22222222,JB HI-FI CBA,5.33,0,1094372.65,DR,REF522791,CBA,Savings
06-09-2025 13:30,CBA7AE33B0872DC4459A69A,063-000-001,22222222,STARBUCKS CBA,32.48,0,1094340.17,DR,REF840182,CBA,Savings
06-09-2025 13:36,CBA356D3F1E1EF7489ABB0A,063-000-001,22222222,COMPANY PAYROLL CBA,0,81.91,1094422.08,CR,REF504756,CBA,Savings
06-09-2025 13:38,CBAFA13F07BA6BB49C5B613,063-000-001,22222222,BP CBA,76.42,0,1094345.66,DR,REF254104,CBA,Savings
06-09-2025 13:40,CBAB79B9A9E369A46F29E21,063-000-001,22222222,HARVEY NORMAN CBA,19.9,0,1094325.76,DR,REF962187,CBA,Savings
06-09-2025 13:42,CBA314DD142FAC94428BD1C,063-000-001,22222222,AMAZON AU CBA,135.92,0,1094189.84,DR,REF580661,CBA,Savings
06-09-2025 14:11,CBAD5B59447907E416BA1A4,063-000-001,22222222,PAY - SALARY CBA,0,589.75,1094779.59,CR,REF397535,CBA,Savings
06-09-2025 14:28,CBAAC6132DDBB5A4012A3AD,063-000-001,22222222,BANK FEE CBA,23.83,0,1094755.76,DR,REF546620,CBA,Savings
06-09-2025 15:15,CBACE09C188E8C14A43981B,063-000-001,22222222,MCDONALDS CBA,18.45,0,1094737.31,DR,REF576557,CBA,Savings
06-09-2025 15:21,CBAD6C1D87B14B741428911,063-000-001,22222222,WOOLWORTHS CBA,34.15,0,1094703.16,DR,REF643380,CBA,Savings
06-09-2025 15:23,CBAF1FCEC5A0EAA4D6CA835,063-000-001,22222222,DOMINO'S PIZZA CBA,99.18,0,1094603.98,DR,REF306549,CBA,Savings
06-09-2025 15:35,CBA2301194C910E46D885A6,063-000-001,22222222,AMAZON AU CBA,49.3,0,1094554.68,DR,REF956968,CBA,Savings
06-09-2025 15:54,CBAA87DB191BCF84E02A79C,063-000-001,22222222,WOOLWORTHS CBA,36.71,0,1094517.97,DR,REF770666,CBA,Savings
06-09-2025 16:01,CBAF258A29B6B20464F895E,063-000-001,22222222,WOOLWORTHS CBA,90.01,0,1094427.96,DR,REF806663,CBA,Savings
06-09-2025 16:41,CBA211825970FA44A73A84A,063-000-001,22222222,RAILWAY STATION CBA,37.92,0,1094390.04,DR,REF879900,CBA,Savings
06-09-2025 16:46,CBAC8FFA6F8F5E34B1FB1D0,063-000-001,22222222,WAGES CREDIT CBA,0,2962.65,1097352.69,CR,REF373333,CBA,Savings
06-09-2025 16:49,CBAFE9F98DD408D40E49407,063-000-001,22222222,SPOTIFY CBA,52.36,0,1097300.33,DR,REF365739,CBA,Savings
06-09-2025 16:55,CBA20F91B45A5534CB58A7F,063-000-001,22222222,WOOLWORTHS CBA,38.48,0,1097261.85,DR,REF673660,CBA,Savings
06-09-2025 16:55,CBA9476DFF7C2794802ABC2,063-000-001,22222222,SPOTIFY CBA,55.38,0,1097206.47,DR,REF397540,CBA,Savings
06-09-2025 17:06,CBAF816E598EA824DAFB7E3,063-000-001,22222222,CITYLINK CBA,49.91,0,1097156.56,DR,REF445949,CBA,Savings
06-09-2025 17:08,CBA149EC92FC9AF4F0B8147,063-000-001,22222222,AMAZON AU CBA,56.78,0,1097099.78,DR,REF517385,CBA,Savings
06-09-2025 17:23,CBA407D62BAD31B40C1BCE6,063-000-001,22222222,BIGW CBA,24.11,0,1097075.67,DR,REF201082,CBA,Savings
06-09-2025 19:16,CBA2592B7842B924E78A7F6,063-000-001,22222222,COLES CBA,72.23,0,1097003.44,DR,REF941145,CBA,Savings
06-09-2025 19:20,CBA03F14B66238F48EFAEAD,063-000-001,22222222,SALARY PAYMENT CBA,0,3505.1,1100508.54,CR,REF237783,CBA,Savings
06-09-2025 19:29,CBAA977785365494AEA83FE,063-000-001,22222222,BP CBA,18.28,0,1100490.26,DR,REF976658,CBA,Savings
06-09-2025 20:26,CBAD276BC97CBDD48A6881A,063-000-001,22222222,BP CBA,27.55,0,1100462.71,DR,REF664493,CBA,Savings
06-09-2025 20:52,CBA77F561690D324F37BE9B,063-000-001,22222222,UBER EATS CBA,37.1,0,1100425.61,DR,REF766587,CBA,Savings
06-09-2025 20:55,CBAD78B4B21F5BA4A869BB5,063-000-001,22222222,INTERNET TRANSFER CBA,1.13,0,1100424.48,DR,REF738658,CBA,Savings
06-09-2025 21:47,CBA4C3FCF1FBA73452EB054,063-000-001,22222222,BWS CBA,52.79,0,1100371.69,DR,REF320301,CBA,Savings
06-09-2025 22:06,CBA0672456098D34258B598,063-000-001,22222222,WAGES CREDIT CBA,0,5473.44,1105845.13,CR,REF221625,CBA,Savings
06-09-2025 22:48,CBA7C433444BFE14D5B8FB4,063-000-001,22222222,SPOTIFY CBA,57.76,0,1105787.37,DR,REF558777,CBA,Savings
06-09-2025 23:05,CBAD71930F3EFE34283B23E,063-000-001,22222222,STARBUCKS CBA,32,0,1105755.37,DR,REF980298,CBA,Savings
06-09-2025 23:06,CBA5BD087327A07463594B8,063-000-001,22222222,INTERNET TRANSFER CBA,112.12,0,1105643.25,DR,REF949438,CBA,Savings
06-09-2025 23:07,CBA669AC91E28A94C9A8018,063-000-001,22222222,PAYPAL *NETFLIX CBA,27.16,0,1105616.09,DR,REF358529,CBA,Savings
06-09-2025 23:10,CBA0719E4F1758845A986A9,063-000-001,22222222,WAGES CREDIT CBA,0,1631.25,1107247.34,CR,REF226404,CBA,Savings
06-09-2025 23:41,CBA4AEB954A116249C381ED,063-000-001,22222222,MENULOG CBA,83.74,0,1107163.6,DR,REF580623,CBA,Savings
07-09-2025 00:30,CBA265EC692EA6D4DA69ABB,063-000-001,22222222,PAY - SALARY CBA,0,3845.52,1111009.12,CR,REF360457,CBA,Savings
07-09-2025 00:34,CBA382166EAFBA0407882F2,063-000-001,22222222,PAYPAL *NETFLIX CBA,63.19,0,1110945.93,DR,REF883238,CBA,Savings
07-09-2025 00:58,CBA4B7418B539BC46269E72,063-000-001,22222222,INTERNET TRANSFER CBA,145.49,0,1110800.44,DR,REF358331,CBA,Savings
07-09-2025 01:07,CBA704FE8F170674D328E86,063-000-001,22222222,JB HI-FI CBA,37.34,0,1110763.1,DR,REF628760,CBA,Savings
07-09-2025 01:09,CBA73B139C7287742B6AD42,063-000-001,22222222,LIQUORLAND CBA,63.53,0,1110699.57,DR,REF261917,CBA,Savings
07-09-2025 01:17,CBA424B3E8BD7D34634A28A,063-000-001,22222222,LIQUORLAND CBA,25.84,0,1110673.73,DR,REF897962,CBA,Savings
07-09-2025 02:02,CBA5CAB5BCBA2DE492A851C,063-000-001,22222222,ZOOM CBA,13.27,0,1110660.46,DR,REF642401,CBA,Savings
07-09-2025 02:36,CBA993C1395B9BD4808A377,063-000-001,22222222,DOMINO'S PIZZA CBA,4.41,0,1110656.05,DR,REF726965,CBA,Savings
07-09-2025 02:52,CBA30EACD43BA91482C835F,063-000-001,22222222,ALDI CBA,14.01,0,1110642.04,DR,REF863888,CBA,Savings
07-09-2025 02:59,CBADFCB4CC8D4014EB0B795,063-000-001,22222222,BWS CBA,20.14,0,1110621.9,DR,REF588380,CBA,Savings
07-09-2025 03:00,CBA84191779876B4B439550,063-000-001,22222222,MCDONALDS CBA,93.56,0,1110528.34,DR,REF612101,CBA,Savings
07-09-2025 03:18,CBAEEF2879EC3EF437F8480,063-000-001,22222222,LIQUORLAND CBA,54.87,0,1110473.47,DR,REF277339,CBA,Savings
07-09-2025 03:51,CBADFCF279FADBA4622BE16,063-000-001,22222222,MCDONALDS CBA,8.47,0,1110465,DR,REF461352,CBA,Savings
07-09-2025 03:57,CBA9B6364BD6646409CA3EA,063-000-001,22222222,LIQUORLAND CBA,20.14,0,1110444.86,DR,REF898872,CBA,Savings
07-09-2025 04:04,CBAA6F2F77F2E804EFCB9E5,063-000-001,22222222,AMAZON AU CBA,150.15,0,1110294.71,DR,REF648316,CBA,Savings
07-09-2025 04:56,CBAB737976451BE49A18CE9,063-000-001,22222222,BP CBA,35.48,0,1110259.23,DR,REF231606,CBA,Savings
07-09-2025 04:57,CBAE5A01A0C8EB743919EE3,063-000-001,22222222,SALARY PAYMENT CBA,0,203.19,1110462.42,CR,REF888341,CBA,Savings
07-09-2025 04:57,CBA8805678461FD4FF0AEF6,063-000-001,22222222,ALDI CBA,8.54,0,1110453.88,DR,REF751772,CBA,Savings
07-09-2025 05:03,CBAB6F7BD6BC54342A599A9,063-000-001,22222222,BWS CBA,32.09,0,1110421.79,DR,REF976773,CBA,Savings
07-09-2025 05:24,CBAB449D9C9C947432A8B0A,063-000-001,22222222,KFC CBA,23.28,0,1110398.51,DR,REF886060,CBA,Savings
07-09-2025 05:41,CBA49691458051644E8ABA8,063-000-001,22222222,FLIXBUS CBA,14.62,0,1110383.89,DR,REF968900,CBA,Savings
07-09-2025 06:04,CBAD93157C3AFDA4D1D8DD1,063-000-001,22222222,PAY - SALARY CBA,0,3153.07,1113536.96,CR,REF874674,CBA,Savings
07-09-2025 06:14,CBA14E9C89B2C604BCC8CBB,063-000-001,22222222,BIGW CBA,67.16,0,1113469.8,DR,REF119499,CBA,Savings
07-09-2025 06:40,CBAEA083F8B6B5D41C1901F,063-000-001,22222222,PAYROLL CREDIT CBA,0,2509.24,1115979.04,CR,REF842687,CBA,Savings
07-09-2025 07:01,CBAE84CB45166744E0487E1,063-000-001,22222222,WOOLWORTHS CBA,60.01,0,1115919.03,DR,REF296906,CBA,Savings
07-09-2025 07:08,CBACD56DACC05364863ABF6,063-000-001,22222222,PAY - SALARY CBA,0,5518.34,1121437.37,CR,REF539351,CBA,Savings
07-09-2025 07:13,CBA7B96BEC507EE4E4ABEF8,063-000-001,22222222,KFC CBA,51.78,0,1121385.59,DR,REF228758,CBA,Savings
07-09-2025 07:39,CBA768F1D7C35994522B712,063-000-001,22222222,FLIXBUS CBA,36.76,0,1121348.83,DR,REF601420,CBA,Savings
07-09-2025 07:47,CBA0A4278D53E9C4894990C,063-000-001,22222222,KFC CBA,193.2,0,1121155.63,DR,REF229385,CBA,Savings
07-09-2025 08:05,CBAC6E7EBE8C8A4436D8CC4,063-000-001,22222222,PAYROLL CREDIT CBA,0,5805.26,1126960.89,CR,REF546171,CBA,Savings
07-09-2025 08:15,CBAE2F10A862B1445889740,063-000-001,22222222,ZOOM CBA,45.97,0,1126914.92,DR,REF379855,CBA,Savings
07-09-2025 08:42,CBA5A5D33B0B36243FC9D5D,063-000-001,22222222,WAGES CREDIT CBA,0,671.19,1127586.11,CR,REF701774,CBA,Savings
07-09-2025 08:57,CBAC7B02A3477E141D588AE,063-000-001,22222222,BP CBA,31.6,0,1127554.51,DR,REF149408,CBA,Savings
07-09-2025 09:22,CBA7E24DA155C2740F5A579,063-000-001,22222222,SPOTIFY CBA,43.43,0,1127511.08,DR,REF516771,CBA,Savings
07-09-2025 09:22,CBA46AA5055DC48424B9A65,063-000-001,22222222,BANK FEE CBA,103.28,0,1127407.8,DR,REF343972,CBA,Savings
07-09-2025 09:23,CBA16970309CAD444B5AC63,063-000-001,22222222,ZOOM CBA,45.42,0,1127362.38,DR,REF127429,CBA,Savings
07-09-2025 09:29,CBADFBBB33021724DACB0EC,063-000-001,22222222,APPLE CBA,6.5,0,1127355.88,DR,REF393324,CBA,Savings
07-09-2025 09:35,CBA13524D54F60040B68C81,063-000-001,22222222,CITYLINK CBA,3.39,0,1127352.49,DR,REF969380,CBA,Savings
07-09-2025 09:46,CBAAEB861F2ADCB45D887D7,063-000-001,22222222,INTERNET TRANSFER CBA,12.25,0,1127340.24,DR,REF509820,CBA,Savings
07-09-2025 09:57,CBA21118635D95943ADB0D5,063-000-001,22222222,ALDI CBA,34.3,0,1127305.94,DR,REF906569,CBA,Savings
07-09-2025 10:26,CBA7EDDB9F41A56433BAA9B,063-000-001,22222222,AMAZON AU CBA,16.27,0,1127289.67,DR,REF994136,CBA,Savings
07-09-2025 10:37,CBAF2A2F784F22A45CA8E38,063-000-001,22222222,INTERNET TRANSFER CBA,8.92,0,1127280.75,DR,REF722168,CBA,Savings
07-09-2025 10:38,CBAEE1B424EF18540E0BAC6,063-000-001,22222222,TAFE BOOKSHOP CBA,3.02,0,1127277.73,DR,REF440528,CBA,Savings
07-09-2025 10:46,CBA94E092832CCA42FFA01D,063-000-001,22222222,BP CBA,11.39,0,1127266.34,DR,REF425609,CBA,Savings
07-09-2025 12:08,CBA07574C71841345A2A94D,063-000-001,22222222,APPLE CBA,22.67,0,1127243.67,DR,REF101539,CBA,Savings
07-09-2025 12:34,CBA70733C2E7E694243AD4C,063-000-001,22222222,WAGES CREDIT CBA,0,374.71,1127618.38,CR,REF180634,CBA,Savings
07-09-2025 12:52,CBAEF11654C178048BD97CB,063-000-001,22222222,SPOTIFY CBA,27.33,0,1127591.05,DR,REF543413,CBA,Savings
07-09-2025 13:10,CBAEBBD7C79E8C04ED7B998,063-000-001,22222222,BP CBA,76.48,0,1127514.57,DR,REF762829,CBA,Savings
07-09-2025 13:19,CBA9FB04581556C42E4B07F,063-000-001,22222222,MCDONALDS CBA,34.09,0,1127480.48,DR,REF339203,CBA,Savings
07-09-2025 13:27,CBAFF745184FAF04182A129,063-000-001,22222222,ALDI CBA,48.49,0,1127431.99,DR,REF902271,CBA,Savings
07-09-2025 14:56,CBA61BC533C8FF644899AF8,063-000-001,22222222,UBER EATS CBA,54.58,0,1127377.41,DR,REF351662,CBA,Savings
07-09-2025 14:57,CBA17EA16C1556D4A60BCB3,063-000-001,22222222,PAYROLL CREDIT CBA,0,3092.28,1130469.69,CR,REF966875,CBA,Savings
07-09-2025 15:00,CBAB6BDE80CA6FD430DAAB3,063-000-001,22222222,STARBUCKS CBA,11.38,0,1130458.31,DR,REF715463,CBA,Savings
07-09-2025 15:00,CBAD2458EA7CCF34A3C83D7,063-000-001,22222222,TAFE BOOKSHOP CBA,31.94,0,1130426.37,DR,REF611670,CBA,Savings
07-09-2025 15:17,CBA0B87E75A9F6740129457,063-000-001,22222222,ZOOM CBA,25.43,0,1130400.94,DR,REF288076,CBA,Savings
07-09-2025 15:51,CBA0AC56491A0DB49EF8A81,063-000-001,22222222,BIGW CBA,30.16,0,1130370.78,DR,REF289372,CBA,Savings
07-09-2025 16:31,CBA86C4CC7108324D839DE9,063-000-001,22222222,LIQUORLAND CBA,95.88,0,1130274.9,DR,REF187746,CBA,Savings
07-09-2025 16:37,CBA562E26AA456B4316B745,063-000-001,22222222,RAILWAY STATION CBA,28.59,0,1130246.31,DR,REF316514,CBA,Savings
07-09-2025 16:39,CBAC339202E8C1040C0B73C,063-000-001,22222222,CITYLINK CBA,143.45,0,1130102.86,DR,REF118535,CBA,Savings
07-09-2025 17:01,INT8E8C5D9E62D94A2DB3C0,063-000-001,22222222,TRANSFER FROM ANZ 11111111,0,642.51,1130745.37,CR,INT-26434,CBA,Savings
07-09-2025 17:10,CBAD97BC003832C481B9F48,063-000-001,22222222,KFC CBA,46.07,0,1130699.3,DR,REF190799,CBA,Savings
07-09-2025 17:21,CBA79C0F687D4674F83A1C3,063-000-001,22222222,RAILWAY STATION CBA,179.86,0,1130519.44,DR,REF973677,CBA,Savings
07-09-2025 17:30,CBAAC66C7F3DFF34EE8BAFE,063-000-001,22222222,MENULOG CBA,13.12,0,1130506.32,DR,REF309398,CBA,Savings
07-09-2025 17:53,CBAC12A875BA61D48DAA915,063-000-001,22222222,BP CBA,12.55,0,1130493.77,DR,REF101701,CBA,Savings
07-09-2025 18:02,CBA8B775198F5104435AFC6,063-000-001,22222222,APPLE CBA,5.37,0,1130488.4,DR,REF933189,CBA,Savings
07-09-2025 18:06,CBA32AE321DB74E496BBF4F,063-000-001,22222222,BANK FEE CBA,25.14,0,1130463.26,DR,REF175517,CBA,Savings
07-09-2025 18:20,CBACF0EB1528BD443CD860A,063-000-001,22222222,COMPANY PAYROLL CBA,0,162.8,1130626.06,CR,REF867452,CBA,Savings
07-09-2025 18:27,CBAD7E6768C50DF4318B416,063-000-001,22222222,BANK FEE CBA,79.53,0,1130546.53,DR,REF256065,CBA,Savings
07-09-2025 18:50,CBA8128A428CC6943EC9A4A,063-000-001,22222222,COLES CBA,17.37,0,1130529.16,DR,REF685231,CBA,Savings
07-09-2025 18:52,CBAE8259894F7934E09B49B,063-000-001,22222222,PAYROLL CREDIT CBA,0,5673.96,1136203.12,CR,REF466924,CBA,Savings
07-09-2025 18:56,CBAABE5E026A1B04CA7BF68,063-000-001,22222222,TAFE BOOKSHOP CBA,55.89,0,1136147.23,DR,REF636152,CBA,Savings
07-09-2025 19:01,CBA19C6783EF3144DA4A8EF,063-000-001,22222222,BANK FEE CBA,19.04,0,1136128.19,DR,REF463109,CBA,Savings
07-09-2025 19:17,CBA35AD2E78DB8B43A5AB8F,063-000-001,22222222,BP CBA,43.86,0,1136084.33,DR,REF535022,CBA,Savings
07-09-2025 20:32,CBA8729554DF8174024B353,063-000-001,22222222,MCDONALDS CBA,9.89,0,1136074.44,DR,REF696705,CBA,Savings
07-09-2025 23:32,CBAEADFA2C5B9214628B1F9,063-000-001,22222222,7-ELEVEN CBA,21.47,0,1136052.97,DR,REF500748,CBA,Savings
07-09-2025 23:52,CBA877C82F23C3745AE8D19,063-000-001,22222222,PAYMENT GATEWAY CBA,62.75,0,1135990.22,DR,REF790620,CBA,Savings
07-09-2025 23:55,CBAC87AFC0364C241E096B0,063-000-001,22222222,KFC CBA,119.5,0,1135870.72,DR,REF800050,CBA,Savings
07-09-2025 23:57,CBACC1A35AF92F64F3B84AE,063-000-001,22222222,TAFE BOOKSHOP CBA,183.31,0,1135687.41,DR,REF327737,CBA,Savings
08-09-2025 00:03,CBAF96BF195D5C54CE7AFCC,063-000-001,22222222,COMPANY PAYROLL CBA,0,2791.58,1138478.99,CR,REF593069,CBA,Savings
08-09-2025 00:12,CBA801A26144A5249BFA34E,063-000-001,22222222,RAILWAY STATION CBA,105.15,0,1138373.84,DR,REF245744,CBA,Savings
08-09-2025 00:24,CBA5121231B16304A0CABE0,063-000-001,22222222,BIGW CBA,22.26,0,1138351.58,DR,REF507632,CBA,Savings
08-09-2025 00:39,CBA3BD88D23E0704355A50D,063-000-001,22222222,SHELL CBA,26.64,0,1138324.94,DR,REF439352,CBA,Savings
08-09-2025 01:37,CBA46F947343FE34CA2A80E,063-000-001,22222222,FLIXBUS CBA,6.03,0,1138318.91,DR,REF395878,CBA,Savings
08-09-2025 02:06,CBA6FF836447E684B9A8E37,063-000-001,22222222,CITYLINK CBA,72.13,0,1138246.78,DR,REF385879,CBA,Savings
08-09-2025 02:24,CBAE582C90F44974C1E9976,063-000-001,22222222,UBER EATS CBA,24.47,0,1138222.31,DR,REF213952,CBA,Savings
08-09-2025 02:52,CBAFB706E2D8A564C3CB3E9,063-000-001,22222222,DOMINO'S PIZZA CBA,11.32,0,1138210.99,DR,REF115358,CBA,Savings
08-09-2025 03:13,CBA017F85099A6148A78AD2,063-000-001,22222222,RAILWAY STATION CBA,99.87,0,1138111.12,DR,REF722461,CBA,Savings
08-09-2025 03:29,CBA3D16BE478E504DDF83D9,063-000-001,22222222,ALDI CBA,58.18,0,1138052.94,DR,REF743340,CBA,Savings
08-09-2025 03:33,CBA41B383A1F11C4EBA96A5,063-000-001,22222222,BANK FEE CBA,96.4,0,1137956.54,DR,REF874331,CBA,Savings
08-09-2025 04:31,CBA4A7D3DFABE144B178700,063-000-001,22222222,7-ELEVEN CBA,98.05,0,1137858.49,DR,REF207240,CBA,Savings
08-09-2025 04:35,CBAA6C5283B2ECE461482E0,063-000-001,22222222,HARVEY NORMAN CBA,39.12,0,1137819.37,DR,REF289647,CBA,Savings
08-09-2025 04:39,CBAA004D09150EF4E928AF7,063-000-001,22222222,JB HI-FI CBA,41.5,0,1137777.87,DR,REF235188,CBA,Savings
08-09-2025 04:42,CBA6CE6ED567C46457F8C20,063-000-001,22222222,WOOLWORTHS CBA,39.89,0,1137737.98,DR,REF830569,CBA,Savings
08-09-2025 05:10,CBAD0827DBF785C44C5BA90,063-000-001,22222222,PAYMENT GATEWAY CBA,17.66,0,1137720.32,DR,REF864532,CBA,Savings
08-09-2025 06:05,CBA3E7F546926C6403EA7B0,063-000-001,22222222,COLES CBA,33.58,0,1137686.74,DR,REF733125,CBA,Savings
08-09-2025 06:15,CBA65A2B06E90F647DB9A87,063-000-001,22222222,AMAZON AU CBA,96.13,0,1137590.61,DR,REF390077,CBA,Savings
08-09-2025 07:08,CBA8DD11D9137314C808BCE,063-000-001,22222222,PAYPAL *NETFLIX CBA,40.05,0,1137550.56,DR,REF805368,CBA,Savings
08-09-2025 08:35,CBAEDB81478DF7845F38738,063-000-001,22222222,SHELL CBA,44.94,0,1137505.62,DR,REF622090,CBA,Savings
08-09-2025 08:42,CBA034729A597E94AACB416,063-000-001,22222222,BP CBA,20.03,0,1137485.59,DR,REF536426,CBA,Savings
08-09-2025 08:45,CBAE68A28716B4A45F9B0D9,063-000-001,22222222,AMAZON AU CBA,153.13,0,1137332.46,DR,REF952492,CBA,Savings
08-09-2025 08:46,CBA36924820844743C1B6B7,063-000-001,22222222,WOOLWORTHS CBA,87.94,0,1137244.52,DR,REF522937,CBA,Savings
08-09-2025 08:50,CBA22F2D9A4BBC042E19AE0,063-000-001,22222222,PAYPAL *NETFLIX CBA,60.97,0,1137183.55,DR,REF916165,CBA,Savings
08-09-2025 09:40,CBA8AF2085E57204D569B64,063-000-001,22222222,COMPANY PAYROLL CBA,0,5232.17,1142415.72,CR,REF449679,CBA,Savings
08-09-2025 09:48,CBAD1BCD470783649BF9D65,063-000-001,22222222,ALDI CBA,13.81,0,1142401.91,DR,REF999331,CBA,Savings
08-09-2025 10:10,CBAC35793EA0A5649BE9EA9,063-000-001,22222222,BWS CBA,21.2,0,1142380.71,DR,REF189663,CBA,Savings
08-09-2025 10:38,CBA521CACAFABB2470DBAAB,063-000-001,22222222,BWS CBA,12.89,0,1142367.82,DR,REF640344,CBA,Savings
08-09-2025 10:43,CBA25AC04DC50C84876BCF2,063-000-001,22222222,COLES CBA,14.05,0,1142353.77,DR,REF726991,CBA,Savings
08-09-2025 10:47,CBAF7BFA2DD0CDE42748AE4,063-000-001,22222222,WOOLWORTHS CBA,6.93,0,1142346.84,DR,REF393215,CBA,Savings
08-09-2025 10:51,CBAAE31371B92024ED7930D,063-000-001,22222222,PAYPAL *NETFLIX CBA,49.67,0,1142297.17,DR,REF942603,CBA,Savings
08-09-2025 10:56,CBA0FC312B8D2D94C40897E,063-000-001,22222222,BP CBA,38.09,0,1142259.08,DR,REF366548,CBA,Savings
08-09-2025 10:57,CBAA048CE7FE8294517BA8A,063-000-001,22222222,APPLE CBA,215.14,0,1142043.94,DR,REF571999,CBA,Savings
08-09-2025 12:16,CBA619368F461ED460681E9,063-000-001,22222222,BIGW CBA,196.45,0,1141847.49,DR,REF989437,CBA,Savings
08-09-2025 12:17,CBA77219FDC1A1B4F3C8446,063-000-001,22222222,CITYLINK CBA,31.33,0,1141816.16,DR,REF325743,CBA,Savings
08-09-2025 12:20,CBA5F2C554D14F8485FB016,063-000-001,22222222,FLIXBUS CBA,10.5,0,1141805.66,DR,REF928262,CBA,Savings
08-09-2025 12:31,CBA670707359D1C4AF688D3,063-000-001,22222222,WOOLWORTHS CBA,10.74,0,1141794.92,DR,REF735332,CBA,Savings
08-09-2025 12:34,CBA0FD765FC2F604E3D9DFD,063-000-001,22222222,BWS CBA,58.43,0,1141736.49,DR,REF463839,CBA,Savings
08-09-2025 12:37,CBA38CDCD33D7BC4691B45F,063-000-001,22222222,7-ELEVEN CBA,81.08,0,1141655.41,DR,REF581740,CBA,Savings
08-09-2025 12:42,CBAC5CCD1C7B9B7462AB431,063-000-001,22222222,LIQUORLAND CBA,42.24,0,1141613.17,DR,REF588662,CBA,Savings
08-09-2025 12:43,CBA7176A25CE9274D648159,063-000-001,22222222,DOMINO'S PIZZA CBA,45.74,0,1141567.43,DR,REF600762,CBA,Savings
08-09-2025 13:41,CBA1B18C351E90D40D3AD2D,063-000-001,22222222,PAYPAL *NETFLIX CBA,14.28,0,1141553.15,DR,REF895865,CBA,Savings
08-09-2025 14:00,CBA32AD8FBD10C141279D6D,063-000-001,22222222,COLES CBA,92.23,0,1141460.92,DR,REF744063,CBA,Savings
08-09-2025 14:10,CBAA09BABE547394F5D81A6,063-000-001,22222222,WOOLWORTHS CBA,15.1,0,1141445.82,DR,REF649205,CBA,Savings
08-09-2025 14:35,CBA4E7F9273C0F244D0BB05,063-000-001,22222222,7-ELEVEN CBA,175.72,0,1141270.1,DR,REF450797,CBA,Savings
08-09-2025 14:44,CBAE13B45B5FAA445A2A2DC,063-000-001,22222222,BANK FEE CBA,29.39,0,1141240.71,DR,REF453588,CBA,Savings
08-09-2025 14:46,CBA7DAF9AAE08B14C0393B4,063-000-001,22222222,COMPANY PAYROLL CBA,0,4130.63,1145371.34,CR,REF278972,CBA,Savings
08-09-2025 14:49,CBA7029795114414D889AF0,063-000-001,22222222,JB HI-FI CBA,31.56,0,1145339.78,DR,REF284365,CBA,Savings
08-09-2025 14:53,CBAE7A759ABA5894F49BBD0,063-000-001,22222222,MENULOG CBA,26.25,0,1145313.53,DR,REF550159,CBA,Savings
08-09-2025 14:56,CBA11644BF7A9704EBF88FB,063-000-001,22222222,BP CBA,88.35,0,1145225.18,DR,REF495802,CBA,Savings
08-09-2025 15:12,CBAE982DA29D6DD4DA3893D,063-000-001,22222222,BANK FEE CBA,69.44,0,1145155.74,DR,REF370731,CBA,Savings
08-09-2025 15:28,CBA74AE240ECF7B4B72A900,063-000-001,22222222,BWS CBA,51.34,0,1145104.4,DR,REF573540,CBA,Savings
08-09-2025 15:40,CBA29F1F44055AE4BE58EB2,063-000-001,22222222,SPOTIFY CBA,40.44,0,1145063.96,DR,REF778948,CBA,Savings
08-09-2025 15:40,CBAE16E960D0B49400D89A5,063-000-001,22222222,DOMINO'S PIZZA CBA,4.42,0,1145059.54,DR,REF465953,CBA,Savings
08-09-2025 16:21,CBABFF0C6F435664BB7AFC0,063-000-001,22222222,TAFE BOOKSHOP CBA,14.71,0,1145044.83,DR,REF711376,CBA,Savings
08-09-2025 16:42,CBA23C5E7BF1D5C4697AB14,063-000-001,22222222,MENULOG CBA,105.41,0,1144939.42,DR,REF650701,CBA,Savings
08-09-2025 17:01,CBA2079FA5EEE9E49A7AC3D,063-000-001,22222222,BIGW CBA,39.24,0,1144900.18,DR,REF703952,CBA,Savings
08-09-2025 17:12,CBA8574F84EA1F6490682BD,063-000-001,22222222,APPLE CBA,53.92,0,1144846.26,DR,REF184514,CBA,Savings
08-09-2025 17:35,CBA43BF8F9832184FED9B95,063-000-001,22222222,COMPANY PAYROLL CBA,0,2760.91,1147607.17,CR,REF322111,CBA,Savings
08-09-2025 17:53,CBABEF2F1A0C93C46B0AAF1,063-000-001,22222222,JB HI-FI CBA,80.46,0,1147526.71,DR,REF411774,CBA,Savings
08-09-2025 18:13,CBA1F7180556F734E019A27,063-000-001,22222222,PAYROLL CREDIT CBA,0,721.86,1148248.57,CR,REF763344,CBA,Savings
08-09-2025 18:34,CBAE76F97ECE29A436BA481,063-000-001,22222222,SHELL CBA,8.85,0,1148239.72,DR,REF471374,CBA,Savings
08-09-2025 19:06,CBAD836241E13984038AA21,063-000-001,22222222,ZOOM CBA,84.62,0,1148155.1,DR,REF383050,CBA,Savings
08-09-2025 20:00,CBA2C87C5160A33452A8307,063-000-001,22222222,BANK FEE CBA,30.53,0,1148124.57,DR,REF173017,CBA,Savings
08-09-2025 20:09,CBA404CBEA17CDB4ACEAF7E,063-000-001,22222222,BANK FEE CBA,50.27,0,1148074.3,DR,REF456387,CBA,Savings
08-09-2025 20:18,CBA220ED5A148D24B2B9CFB,063-000-001,22222222,MENULOG CBA,20.32,0,1148053.98,DR,REF343638,CBA,Savings
08-09-2025 20:24,CBA22DA650A0EAF48629066,063-000-001,22222222,PAYMENT GATEWAY CBA,21.19,0,1148032.79,DR,REF312382,CBA,Savings
08-09-2025 20:53,CBA508C54BB01004DCB9DB4,063-000-001,22222222,MCDONALDS CBA,17.21,0,1148015.58,DR,REF706650,CBA,Savings
08-09-2025 20:55,CBA9E0079D5479A41DC9DB4,063-000-001,22222222,APPLE CBA,30.26,0,1147985.32,DR,REF168941,CBA,Savings
08-09-2025 20:55,CBA261D9677C6404E5F9233,063-000-001,22222222,BANK FEE CBA,94.4,0,1147890.92,DR,REF940085,CBA,Savings
08-09-2025 21:02,CBA336510FEFF9B4F7BA6F1,063-000-001,22222222,UBER EATS CBA,53.21,0,1147837.71,DR,REF561580,CBA,Savings
08-09-2025 21:27,CBA5FE89ED6ED8B4797BAB5,063-000-001,22222222,STARBUCKS CBA,45.96,0,1147791.75,DR,REF541283,CBA,Savings
08-09-2025 21:39,CBA697BB46118F64B7A95EB,063-000-001,22222222,KFC CBA,77.73,0,1147714.02,DR,REF816497,CBA,Savings
08-09-2025 21:46,CBA373E5290AA6D4D5FBF44,063-000-001,22222222,SHELL CBA,101.85,0,1147612.17,DR,REF744325,CBA,Savings
08-09-2025 22:29,CBAC0EFDA60DAF24DFFA33A,063-000-001,22222222,HARVEY NORMAN CBA,5.49,0,1147606.68,DR,REF388405,CBA,Savings
08-09-2025 22:46,CBA0B264D9EFA9D477485EE,063-000-001,22222222,SPOTIFY CBA,16.37,0,1147590.31,DR,REF682770,CBA,Savings
08-09-2025 23:27,CBAD6A832C17D0F4308A523,063-000-001,22222222,MCDONALDS CBA,52.78,0,1147537.53,DR,REF575747,CBA,Savings
08-09-2025 23:32,CBADB1BB5589CC144F393DD,063-000-001,22222222,7-ELEVEN CBA,24.29,0,1147513.24,DR,REF305423,CBA,Savings
08-09-2025 23:49,CBA7D19F934FE9F46F0B1C3,063-000-001,22222222,MENULOG CBA,70.11,0,1147443.13,DR,REF996654,CBA,Savings
09-09-2025 00:08,CBA4BAFE6068BDF43D49C02,063-000-001,22222222,AMAZON AU CBA,27.63,0,1147415.5,DR,REF305158,CBA,Savings
09-09-2025 00:18,CBAF03785133E584C7F87CF,063-000-001,22222222,SHELL CBA,11.41,0,1147404.09,DR,REF396214,CBA,Savings
09-09-2025 00:31,CBA083283CB28614F3A96C3,063-000-001,22222222,COMPANY PAYROLL CBA,0,5185.7,1152589.79,CR,REF912287,CBA,Savings
09-09-2025 00:32,CBAFC02050D1A384E31B720,063-000-001,22222222,PAYMENT GATEWAY CBA,84.89,0,1152504.9,DR,REF919888,CBA,Savings
09-09-2025 00:40,CBAB335D1E26A674116922B,063-000-001,22222222,7-ELEVEN CBA,101.37,0,1152403.53,DR,REF623513,CBA,Savings
09-09-2025 01:14,CBACDA2D1BD213444969275,063-000-001,22222222,JB HI-FI CBA,187.62,0,1152215.91,DR,REF901278,CBA,Savings
09-09-2025 01:21,CBA1A0E27A1803844F3BB84,063-000-001,22222222,PAYMENT GATEWAY CBA,12.48,0,1152203.43,DR,REF141975,CBA,Savings
09-09-2025 01:46,CBAE116C760F2014B72B2B4,063-000-001,22222222,COLES CBA,273.63,0,1151929.8,DR,REF598426,CBA,Savings
09-09-2025 01:50,CBA1AEE1F94BEA64B46A7E9,063-000-001,22222222,SHELL CBA,33.62,0,1151896.18,DR,REF215819,CBA,Savings
09-09-2025 01:54,INT67264C8C5955441A81A9,063-000-001,22222222,TRANSFER FROM NAB 44444444,0,1423.61,1153319.79,CR,INT-75741,CBA,Savings
09-09-2025 02:13,CBA042BF71257404D8A9BA9,063-000-001,22222222,LIQUORLAND CBA,147.72,0,1153172.07,DR,REF337558,CBA,Savings
09-09-2025 02:36,CBAEDABF5D7495F4C72ADD8,063-000-001,22222222,CITYLINK CBA,42.45,0,1153129.62,DR,REF958769,CBA,Savings
09-09-2025 02:48,CBA37B7666E89C84FF88D25,063-000-001,22222222,AMAZON AU CBA,81.09,0,1153048.53,DR,REF201743,CBA,Savings
09-09-2025 03:00,CBA3C5743CEE0CF4DC49719,063-000-001,22222222,SPOTIFY CBA,66.13,0,1152982.4,DR,REF508870,CBA,Savings
09-09-2025 03:19,CBA84442E0C46BD43F5AD28,063-000-001,22222222,WAGES CREDIT CBA,0,2117.27,1155099.67,CR,REF496678,CBA,Savings
09-09-2025 03:31,CBA49B95E0DE5994F2FA4DD,063-000-001,22222222,COLES CBA,31.34,0,1155068.33,DR,REF836501,CBA,Savings
09-09-2025 04:01,CBAB18E5EC23D68431EAB23,063-000-001,22222222,MCDONALDS CBA,4.55,0,1155063.78,DR,REF392626,CBA,Savings
09-09-2025 04:42,CBAC76675A68640471898C0,063-000-001,22222222,PAYROLL CREDIT CBA,0,3035.28,1158099.06,CR,REF335293,CBA,Savings
09-09-2025 04:59,CBA79C1BBFB7EE24F839670,063-000-001,22222222,MCDONALDS CBA,83.83,0,1158015.23,DR,REF829585,CBA,Savings
09-09-2025 05:09,CBA44C569AF5B074942B689,063-000-001,22222222,APPLE CBA,71.84,0,1157943.39,DR,REF638568,CBA,Savings
09-09-2025 05:19,CBADC625B808FB641708A18,063-000-001,22222222,WOOLWORTHS CBA,96.47,0,1157846.92,DR,REF579847,CBA,Savings
09-09-2025 05:26,CBAABA72059B73741D6AA35,063-000-001,22222222,LIQUORLAND CBA,19.68,0,1157827.24,DR,REF448010,CBA,Savings
09-09-2025 06:22,CBA3A0649BB1F7542DBB6CE,063-000-001,22222222,UBER EATS CBA,44.52,0,1157782.72,DR,REF678757,CBA,Savings
09-09-2025 06:32,INTA7575E2FCE874134AC67,063-000-001,22222222,TRANSFER FROM NAB 44444444,0,361.79,1158144.51,CR,INT-87918,CBA,Savings
09-09-2025 06:35,CBA5592F13E4D714853BFED,063-000-001,22222222,PAYPAL *NETFLIX CBA,12.41,0,1158132.1,DR,REF360850,CBA,Savings
09-09-2025 06:36,CBA639611AA05BF4BA08183,063-000-001,22222222,PAYROLL CREDIT CBA,0,39.23,1158171.33,CR,REF147952,CBA,Savings
09-09-2025 07:28,INTCDF41952962840B9BC1F,063-000-001,22222222,TRANSFER TO ANZ 11111111,218.33,0,1157953,DR,INT-81609,CBA,Savings
09-09-2025 07:48,CBA88D0CBE68E85412DBE00,063-000-001,22222222,CITYLINK CBA,27.42,0,1157925.58,DR,REF800090,CBA,Savings
09-09-2025 08:17,CBAE82F23605AB04CB5A424,063-000-001,22222222,PAYMENT GATEWAY CBA,50.31,0,1157875.27,DR,REF460293,CBA,Savings
09-09-2025 08:48,CBA9FD9ECD64C91490093CB,063-000-001,22222222,HARVEY NORMAN CBA,74.4,0,1157800.87,DR,REF517935,CBA,Savings
09-09-2025 09:21,CBA73D6102A338343DFAB6F,063-000-001,22222222,DOMINO'S PIZZA CBA,152.8,0,1157648.07,DR,REF737830,CBA,Savings
09-09-2025 09:27,CBA44A9AC73E730444DA458,063-000-001,22222222,JB HI-FI CBA,90.44,0,1157557.63,DR,REF333732,CBA,Savings
09-09-2025 09:36,CBA65609B0C18FE4627B468,063-000-001,22222222,BANK FEE CBA,47.95,0,1157509.68,DR,REF758199,CBA,Savings
09-09-2025 10:06,CBA5633C497BD8046188D28,063-000-001,22222222,PAY - SALARY CBA,0,4745.8,1162255.48,CR,REF613891,CBA,Savings
09-09-2025 10:14,CBA32A4A9C6B29643399D2C,063-000-001,22222222,INTERNET TRANSFER CBA,139.5,0,1162115.98,DR,REF521023,CBA,Savings
09-09-2025 10:28,CBAC7BA002E52354EFFBD48,063-000-001,22222222,7-ELEVEN CBA,29.84,0,1162086.14,DR,REF832697,CBA,Savings
09-09-2025 10:29,CBA69BF904C4B2F4F2DADC2,063-000-001,22222222,TAFE BOOKSHOP CBA,13.67,0,1162072.47,DR,REF436646,CBA,Savings
09-09-2025 11:09,CBAFC8AFC1ED0AD4422B9EA,063-000-001,22222222,KFC CBA,145.85,0,1161926.62,DR,REF676788,CBA,Savings
09-09-2025 11:15,CBAC2D6E36FF3914FED9CAF,063-000-001,22222222,BANK FEE CBA,9.47,0,1161917.15,DR,REF253534,CBA,Savings
09-09-2025 11:38,CBAE92E03182E5D41D8A427,063-000-001,22222222,BANK FEE CBA,95.48,0,1161821.67,DR,REF282840,CBA,Savings
09-09-2025 12:38,CBA41977AF7F54B41EFAC44,063-000-001,22222222,ZOOM CBA,15.85,0,1161805.82,DR,REF700409,CBA,Savings
09-09-2025 12:49,CBAAADDA740839C4CFEAFB9,063-000-001,22222222,KFC CBA,122.05,0,1161683.77,DR,REF210258,CBA,Savings
09-09-2025 13:31,CBA9AE574F1353D4D14A062,063-000-001,22222222,TAFE BOOKSHOP CBA,25.77,0,1161658,DR,REF902277,CBA,Savings
09-09-2025 14:55,CBA35ECE72FEF2244B79DCC,063-000-001,22222222,BANK FEE CBA,77.2,0,1161580.8,DR,REF824034,CBA,Savings
09-09-2025 15:20,CBA2C6B884C2ABC49FD9C30,063-000-001,22222222,AMAZON AU CBA,156.08,0,1161424.72,DR,REF805831,CBA,Savings
09-09-2025 15:25,CBA5E971C38FD0844158CD9,063-000-001,22222222,COMPANY PAYROLL CBA,0,864.89,1162289.61,CR,REF360291,CBA,Savings
09-09-2025 15:53,CBA623965B1E7AC4EA993C4,063-000-001,22222222,BP CBA,43.41,0,1162246.2,DR,REF810089,CBA,Savings
09-09-2025 15:53,CBAF0CD65CEB5754C6EBFF1,063-000-001,22222222,BWS CBA,27.78,0,1162218.42,DR,REF843267,CBA,Savings
09-09-2025 15:59,CBA3D493BE8245F4365A9CC,063-000-001,22222222,BANK FEE CBA,17.66,0,1162200.76,DR,REF192613,CBA,Savings
09-09-2025 16:05,CBAD703CEA9FF224CF1BEFD,063-000-001,22222222,BWS CBA,40.45,0,1162160.31,DR,REF361022,CBA,Savings
09-09-2025 16:06,CBAA98DE3B522AA4DEB8082,063-000-001,22222222,APPLE CBA,22.67,0,1162137.64,DR,REF429278,CBA,Savings
09-09-2025 16:06,CBAB4448BFBF17A4095947F,063-000-001,22222222,HARVEY NORMAN CBA,5.04,0,1162132.6,DR,REF866564,CBA,Savings
09-09-2025 16:31,CBA3BDF5CB2EF834357B378,063-000-001,22222222,STARBUCKS CBA,166.61,0,1161965.99,DR,REF906894,CBA,Savings
09-09-2025 16:46,CBAE09C93DD46A34911B4F0,063-000-001,22222222,MCDONALDS CBA,67.02,0,1161898.97,DR,REF554185,CBA,Savings
09-09-2025 16:55,CBA1BDABD805BD44FD1AC28,063-000-001,22222222,INTERNET TRANSFER CBA,3.62,0,1161895.35,DR,REF563131,CBA,Savings
09-09-2025 17:43,CBA9570D6F1A69D4C8D8BFE,063-000-001,22222222,MENULOG CBA,171.85,0,1161723.5,DR,REF597986,CBA,Savings
09-09-2025 18:06,CBA9CBE2146711146809217,063-000-001,22222222,CITYLINK CBA,39.44,0,1161684.06,DR,REF350357,CBA,Savings
09-09-2025 18:12,CBA70F0FAA6C02247309475,063-000-001,22222222,BIGW CBA,14.81,0,1161669.25,DR,REF832760,CBA,Savings
09-09-2025 18:17,CBA4B672FC8CFDC4CCB9556,063-000-001,22222222,MCDONALDS CBA,16.83,0,1161652.42,DR,REF329758,CBA,Savings
09-09-2025 18:45,CBAB92D5E943DAD429E9D6F,063-000-001,22222222,UBER EATS CBA,15.46,0,1161636.96,DR,REF571345,CBA,Savings
09-09-2025 19:09,CBA872C538214FB49969527,063-000-001,22222222,RAILWAY STATION CBA,187.77,0,1161449.19,DR,REF159764,CBA,Savings
09-09-2025 19:13,CBA928D54E055374C8F8751,063-000-001,22222222,BIGW CBA,4.72,0,1161444.47,DR,REF520363,CBA,Savings
09-09-2025 19:33,CBA177265BEDB3F4EFC91DB,063-000-001,22222222,SPOTIFY CBA,31.24,0,1161413.23,DR,REF898602,CBA,Savings
09-09-2025 19:48,INT113F8BC6BC054BB2940C,063-000-001,22222222,TRANSFER FROM CBA 33333333,0,887.76,1162300.99,CR,INT-40627,CBA,Savings
09-09-2025 20:01,CBA96F03F30B9324D1F84EF,063-000-001,22222222,FLIXBUS CBA,73.03,0,1162227.96,DR,REF682027,CBA,Savings
09-09-2025 20:08,CBA79F1A0CC05084EDEB29E,063-000-001,22222222,KFC CBA,88.77,0,1162139.19,DR,REF968582,CBA,Savings
09-09-2025 20:25,CBA8556F5FDB2A14F10AC15,063-000-001,22222222,7-ELEVEN CBA,72.57,0,1162066.62,DR,REF633131,CBA,Savings
09-09-2025 20:55,INTA5E5E123642545C9AF62,063-000-001,22222222,TRANSFER FROM NAB 44444444,0,786.33,1162852.95,CR,INT-70654,CBA,Savings
09-09-2025 21:25,CBA8EF1D7D3AACC4DCE9C75,063-000-001,22222222,STARBUCKS CBA,58.8,0,1162794.15,DR,REF265156,CBA,Savings
09-09-2025 21:33,CBA5B507026806D42708402,063-000-001,22222222,APPLE CBA,68.83,0,1162725.32,DR,REF913349,CBA,Savings
09-09-2025 21:55,CBA9E0B13C17C9C48378519,063-000-001,22222222,ALDI CBA,75.75,0,1162649.57,DR,REF245375,CBA,Savings
09-09-2025 22:23,CBA6F72D01333E74ADB9D4D,063-000-001,22222222,PAYPAL *NETFLIX CBA,43.94,0,1162605.63,DR,REF426836,CBA,Savings
09-09-2025 22:26,CBA8826482CE850430483E3,063-000-001,22222222,UBER EATS CBA,82.4,0,1162523.23,DR,REF901686,CBA,Savings
09-09-2025 22:27,CBAE9888CCBFC0A41069DA5,063-000-001,22222222,STARBUCKS CBA,59.24,0,1162463.99,DR,REF848643,CBA,Savings
09-09-2025 22:56,CBA2ADFE04571374E18B23D,063-000-001,22222222,ZOOM CBA,11.43,0,1162452.56,DR,REF147674,CBA,Savings
09-09-2025 23:28,CBA742EB98A184140CE82EE,063-000-001,22222222,PAYROLL CREDIT CBA,0,3210.28,1165662.84,CR,REF428122,CBA,Savings
10-09-2025 00:12,CBAAAD06CFB735F46C48329,063-000-001,22222222,MCDONALDS CBA,11.04,0,1165651.8,DR,REF897313,CBA,Savings
10-09-2025 00:39,CBAE45B3D00F2CC4565B2B0,063-000-001,22222222,BWS CBA,26.02,0,1165625.78,DR,REF607298,CBA,Savings
10-09-2025 00:59,CBAAEAF61C4B9044015B308,063-000-001,22222222,CITYLINK CBA,148.22,0,1165477.56,DR,REF218295,CBA,Savings
10-09-2025 01:34,CBAF73C72D87BFD4857B420,063-000-001,22222222,BIGW CBA,42.19,0,1165435.37,DR,REF523776,CBA,Savings
10-09-2025 01:43,CBA31F9F1E6125149B288B2,063-000-001,22222222,BANK FEE CBA,28.61,0,1165406.76,DR,REF952003,CBA,Savings
10-09-2025 01:47,CBA70A083E5BFBA4ED3B507,063-000-001,22222222,BWS CBA,48.62,0,1165358.14,DR,REF141013,CBA,Savings
10-09-2025 02:01,CBAD0927B9EDF7040EABE4A,063-000-001,22222222,APPLE CBA,23.33,0,1165334.81,DR,REF641839,CBA,Savings
10-09-2025 02:11,CBAD33D6D201BD6446780EE,063-000-001,22222222,ALDI CBA,29.75,0,1165305.06,DR,REF783988,CBA,Savings
10-09-2025 02:17,CBA24DD7FE5DCAB4581BB20,063-000-001,22222222,COLES CBA,18.39,0,1165286.67,DR,REF821248,CBA,Savings
10-09-2025 02:40,CBAAF403AD4CE524DFD93A6,063-000-001,22222222,PAY - SALARY CBA,0,7473.79,1172760.46,CR,REF721725,CBA,Savings
10-09-2025 02:41,CBAF030E2EB566643C998F3,063-000-001,22222222,COLES CBA,70.41,0,1172690.05,DR,REF725591,CBA,Savings
10-09-2025 03:02,INTF06199C10F014DFEADF0,063-000-001,22222222,TRANSFER FROM ANZ 11111111,0,1951.3,1174641.35,CR,INT-79326,CBA,Savings
10-09-2025 03:19,CBA9CE5593999AE419897EE,063-000-001,22222222,PAY - SALARY CBA,0,6953.75,1181595.1,CR,REF394331,CBA,Savings
10-09-2025 03:36,CBACA55038749614647AEC7,063-000-001,22222222,HARVEY NORMAN CBA,5.25,0,1181589.85,DR,REF748529,CBA,Savings
10-09-2025 03:49,CBA18DE63AA67FF46668A8E,063-000-001,22222222,BIGW CBA,62.4,0,1181527.45,DR,REF709056,CBA,Savings
10-09-2025 04:21,CBAE21F3E8787A34FDCA46E,063-000-001,22222222,BIGW CBA,46.78,0,1181480.67,DR,REF275068,CBA,Savings
10-09-2025 04:24,CBA9B545BEBD0954A83AEAC,063-000-001,22222222,SALARY PAYMENT CBA,0,5193.51,1186674.18,CR,REF184634,CBA,Savings
10-09-2025 04:36,CBA2A282FC643EF4D8F98F2,063-000-001,22222222,PAYMENT GATEWAY CBA,115.96,0,1186558.22,DR,REF944781,CBA,Savings
10-09-2025 04:59,CBA8D581D61A40647C79948,063-000-001,22222222,UBER EATS CBA,35.4,0,1186522.82,DR,REF434146,CBA,Savings
10-09-2025 05:36,CBAF74CDC2D4AD34958A0AA,063-000-001,22222222,BANK FEE CBA,8.29,0,1186514.53,DR,REF373876,CBA,Savings
10-09-2025 05:44,CBAD955968F79364A96ABDA,063-000-001,22222222,FLIXBUS CBA,48.09,0,1186466.44,DR,REF681051,CBA,Savings
10-09-2025 06:03,CBA8228147E856549A69FD5,063-000-001,22222222,SALARY PAYMENT CBA,0,497.15,1186963.59,CR,REF415515,CBA,Savings
10-09-2025 06:15,CBA35A1FE1A0F5D468BB838,063-000-001,22222222,WAGES CREDIT CBA,0,636.5,1187600.09,CR,REF399294,CBA,Savings
10-09-2025 06:35,CBA981B1D3AC6594D4CAC4E,063-000-001,22222222,BWS CBA,68.29,0,1187531.8,DR,REF669680,CBA,Savings
10-09-2025 06:44,CBA6CEE850C131C4D99A090,063-000-001,22222222,ALDI CBA,64.68,0,1187467.12,DR,REF768105,CBA,Savings
10-09-2025 06:51,CBA4F8975A3AEFC487D88A8,063-000-001,22222222,AMAZON AU CBA,91.42,0,1187375.7,DR,REF491667,CBA,Savings
10-09-2025 07:23,CBA3989A8F38AFE476C9F97,063-000-001,22222222,SALARY PAYMENT CBA,0,1066.32,1188442.02,CR,REF397785,CBA,Savings
10-09-2025 08:38,CBACA6EABF89B524E52A7A8,063-000-001,22222222,HARVEY NORMAN CBA,60.65,0,1188381.37,DR,REF424329,CBA,Savings
10-09-2025 08:42,CBAA8A903D7C3EF4724B524,063-000-001,22222222,BP CBA,52.38,0,1188328.99,DR,REF880008,CBA,Savings
10-09-2025 08:48,CBA5AB0CAAD8648445C8C55,063-000-001,22222222,ALDI CBA,118.08,0,1188210.91,DR,REF584292,CBA,Savings
10-09-2025 09:15,CBA4D9517899ABF42D98381,063-000-001,22222222,TAFE BOOKSHOP CBA,41.03,0,1188169.88,DR,REF548642,CBA,Savings
10-09-2025 09:47,CBA51C695FFAC424A5A97BA,063-000-001,22222222,RAILWAY STATION CBA,15.14,0,1188154.74,DR,REF830169,CBA,Savings
10-09-2025 09:47,INT8F7C695AA07746808355,063-000-001,22222222,TRANSFER TO CBA 33333333,161.98,0,1187992.76,DR,INT-39188,CBA,Savings
10-09-2025 10:16,CBA8565EC5C21964DE9BA0B,063-000-001,22222222,BP CBA,15.73,0,1187977.03,DR,REF843364,CBA,Savings
10-09-2025 10:44,CBAE729F9DC4D0741448B32,063-000-001,22222222,KFC CBA,85.47,0,1187891.56,DR,REF169519,CBA,Savings
10-09-2025 11:13,CBA2688BA3FDC654D8D939C,063-000-001,22222222,RAILWAY STATION CBA,10.23,0,1187881.33,DR,REF705039,CBA,Savings
10-09-2025 11:26,CBAA26BAD9AB2BC4790B1FB,063-000-001,22222222,PAYMENT GATEWAY CBA,34.39,0,1187846.94,DR,REF784994,CBA,Savings
10-09-2025 12:31,CBAB281CB1D01DE48988309,063-000-001,22222222,BIGW CBA,96.42,0,1187750.52,DR,REF432544,CBA,Savings
10-09-2025 12:37,CBA9ADA027D2B3048E0A3B7,063-000-001,22222222,PAYROLL CREDIT CBA,0,3207.71,1190958.23,CR,REF384013,CBA,Savings
10-09-2025 12:51,CBAF0ECFD347A684E00B4D4,063-000-001,22222222,COLES CBA,6.78,0,1190951.45,DR,REF626120,CBA,Savings
10-09-2025 12:51,CBA034DB708598741C0BD03,063-000-001,22222222,MENULOG CBA,29.25,0,1190922.2,DR,REF337189,CBA,Savings
10-09-2025 13:46,CBAA92F528E0055478FB1FB,063-000-001,22222222,LIQUORLAND CBA,162.5,0,1190759.7,DR,REF278874,CBA,Savings
10-09-2025 14:41,CBA67D7CC9CAAEE4C3B83E6,063-000-001,22222222,INTERNET TRANSFER CBA,95.07,0,1190664.63,DR,REF668913,CBA,Savings
10-09-2025 15:41,CBA674C56DC21A54A7FA279,063-000-001,22222222,LIQUORLAND CBA,71.7,0,1190592.93,DR,REF808761,CBA,Savings
10-09-2025 15:48,CBA4CD4A810B3124EAE9642,063-000-001,22222222,FLIXBUS CBA,11.11,0,1190581.82,DR,REF440721,CBA,Savings
10-09-2025 16:14,CBA7AF82E9C799A494CA574,063-000-001,22222222,PAY - SALARY CBA,0,7602.7,1198184.52,CR,REF966219,CBA,Savings
10-09-2025 16:17,CBA36C0B27BEAE04FE6A7DA,063-000-001,22222222,RAILWAY STATION CBA,26.48,0,1198158.04,DR,REF174022,CBA,Savings
10-09-2025 16:23,CBAF52A9762B0FA4AD08BB8,063-000-001,22222222,UBER EATS CBA,24.39,0,1198133.65,DR,REF763694,CBA,Savings
10-09-2025 16:31,CBA23CCA6E56F834E77BFAE,063-000-001,22222222,BWS CBA,5.55,0,1198128.1,DR,REF344305,CBA,Savings
10-09-2025 16:45,INTEC138C70ECA94DA888A1,063-000-001,22222222,TRANSFER FROM CBA 33333333,0,1379.26,1199507.36,CR,INT-28693,CBA,Savings
10-09-2025 16:55,CBAFEC0AB341F9B46E298E1,063-000-001,22222222,MCDONALDS CBA,49.98,0,1199457.38,DR,REF302923,CBA,Savings
10-09-2025 17:27,CBA2D9E83FF511F4CCC8017,063-000-001,22222222,UBER EATS CBA,17.88,0,1199439.5,DR,REF301485,CBA,Savings
10-09-2025 17:33,CBA75FDA0E4B09F437E815A,063-000-001,22222222,WAGES CREDIT CBA,0,284.97,1199724.47,CR,REF329709,CBA,Savings
10-09-2025 18:17,CBAB37FFD6CC3F748158648,063-000-001,22222222,AMAZON AU CBA,22.69,0,1199701.78,DR,REF659326,CBA,Savings
10-09-2025 18:51,CBA7C77CB05DF684FA9A1B9,063-000-001,22222222,BWS CBA,117.62,0,1199584.16,DR,REF756760,CBA,Savings
10-09-2025 18:51,CBA8A24F6287E6343CCAE00,063-000-001,22222222,APPLE CBA,8.81,0,1199575.35,DR,REF742494,CBA,Savings
10-09-2025 18:55,CBA90038ACB0DAD447A8054,063-000-001,22222222,UBER EATS CBA,37.19,0,1199538.16,DR,REF154571,CBA,Savings
10-09-2025 19:17,CBADBB96A0C2C474C66B2B8,063-000-001,22222222,WOOLWORTHS CBA,11.04,0,1199527.12,DR,REF496741,CBA,Savings
10-09-2025 19:40,CBAE6AE0B71E132491CA112,063-000-001,22222222,LIQUORLAND CBA,78.2,0,1199448.92,DR,REF611970,CBA,Savings
10-09-2025 19:51,CBAE6485570765045DE8883,063-000-001,22222222,COLES CBA,51.8,0,1199397.12,DR,REF589329,CBA,Savings
10-09-2025 19:53,CBA6CFC45ECE2F14AEAAD38,063-000-001,22222222,LIQUORLAND CBA,64.12,0,1199333,DR,REF411912,CBA,Savings
10-09-2025 20:00,CBA12818DA496A44695A201,063-000-001,22222222,STARBUCKS CBA,86.45,0,1199246.55,DR,REF372072,CBA,Savings
10-09-2025 20:10,CBA750A1486CB8E4873BAED,063-000-001,22222222,PAYROLL CREDIT CBA,0,147.43,1199393.98,CR,REF528024,CBA,Savings
10-09-2025 20:12,CBAF3D3891740D142C3B986,063-000-001,22222222,SHELL CBA,12.57,0,1199381.41,DR,REF444470,CBA,Savings
10-09-2025 21:14,CBA1D0D076E6B2F4104A5FF,063-000-001,22222222,COLES CBA,53.23,0,1199328.18,DR,REF944094,CBA,Savings
10-09-2025 21:23,CBA97D3DF7CEFD243978A5A,063-000-001,22222222,7-ELEVEN CBA,33.77,0,1199294.41,DR,REF541475,CBA,Savings
10-09-2025 21:50,INT604690CEE8AE4EADBED9,063-000-001,22222222,TRANSFER FROM CBA 33333333,0,417.76,1199712.17,CR,INT-80563,CBA,Savings
10-09-2025 21:57,CBA174295BE61264F90BD42,063-000-001,22222222,ALDI CBA,12.27,0,1199699.9,DR,REF868099,CBA,Savings
10-09-2025 22:10,CBAC91461210F2940E8BED5,063-000-001,22222222,TAFE BOOKSHOP CBA,216.83,0,1199483.07,DR,REF646339,CBA,Savings
10-09-2025 23:07,CBAFCA7EF7D67BD4DFFA722,063-000-001,22222222,HARVEY NORMAN CBA,7.3,0,1199475.77,DR,REF288785,CBA,Savings
10-09-2025 23:31,CBA89CA9B4BFFD4469A9399,063-000-001,22222222,ZOOM CBA,104.22,0,1199371.55,DR,REF647287,CBA,Savings
10-09-2025 23:41,CBAB0C8116252114508B588,063-000-001,22222222,PAYROLL CREDIT CBA,0,211.71,1199583.26,CR,REF470223,CBA,Savings
10-09-2025 23:43,CBA06FC70A0E7FE4D8D814C,063-000-001,22222222,SALARY PAYMENT CBA,0,2516.23,1202099.49,CR,REF561277,CBA,Savings
10-09-2025 23:54,CBACEDAD925180D4286B158,063-000-001,22222222,ZOOM CBA,5.88,0,1202093.61,DR,REF225942,CBA,Savings
11-09-2025 00:23,CBA71D54520AC83402D8D4D,063-000-001,22222222,MENULOG CBA,18.49,0,1202075.12,DR,REF952959,CBA,Savings
11-09-2025 00:23,CBA1B45933C98B24A289C67,063-000-001,22222222,PAYPAL *NETFLIX CBA,68.75,0,1202006.37,DR,REF729753,CBA,Savings
11-09-2025 00:28,CBAD43E107BF97C45A8BF82,063-000-001,22222222,ALDI CBA,28.59,0,1201977.78,DR,REF465572,CBA,Savings
11-09-2025 00:36,CBA2E5E09F3D9A049D8AEA6,063-000-001,22222222,COLES CBA,38.73,0,1201939.05,DR,REF547012,CBA,Savings
11-09-2025 00:48,CBA938F63166D6C441EABBF,063-000-001,22222222,ALDI CBA,18.72,0,1201920.33,DR,REF339856,CBA,Savings
11-09-2025 00:50,CBA4DA3D8212FBC475FAD14,063-000-001,22222222,MENULOG CBA,312.71,0,1201607.62,DR,REF704372,CBA,Savings
11-09-2025 01:06,CBAEE4351EA98B44D63B8D3,063-000-001,22222222,SPOTIFY CBA,10.4,0,1201597.22,DR,REF374776,CBA,Savings
11-09-2025 01:23,CBA2C110909EF4C461B8DE6,063-000-001,22222222,AMAZON AU CBA,93.63,0,1201503.59,DR,REF587332,CBA,Savings
11-09-2025 01:36,CBA7385DA0C610849FDBC3D,063-000-001,22222222,ZOOM CBA,10.92,0,1201492.67,DR,REF601170,CBA,Savings
11-09-2025 01:47,CBA46F076DACE7E40F6832B,063-000-001,22222222,UBER EATS CBA,80.3,0,1201412.37,DR,REF287309,CBA,Savings
11-09-2025 01:48,CBA38EA670DDBD14ED1846B,063-000-001,22222222,SPOTIFY CBA,93.32,0,1201319.05,DR,REF944717,CBA,Savings
11-09-2025 04:06,INT3FAD6C273BCF443296C6,063-000-001,22222222,TRANSFER FROM ANZ 11111111,0,290.81,1201609.86,CR,INT-48487,CBA,Savings
11-09-2025 04:25,CBAC6D6500D58FE4FB48029,063-000-001,22222222,PAYPAL *NETFLIX CBA,47.28,0,1201562.58,DR,REF809172,CBA,Savings
11-09-2025 04:39,CBA998477B9712C4B9891A9,063-000-001,22222222,AMAZON AU CBA,9.98,0,1201552.6,DR,REF941259,CBA,Savings
11-09-2025 04:40,CBA3E528A3DDE2E4415800D,063-000-001,22222222,UBER EATS CBA,37.49,0,1201515.11,DR,REF790980,CBA,Savings
11-09-2025 04:58,CBAF60C2452FA454FE9ACC2,063-000-001,22222222,CITYLINK CBA,15.44,0,1201499.67,DR,REF553705,CBA,Savings
11-09-2025 05:03,CBA8EB72A2FCAD14DC598B2,063-000-001,22222222,TAFE BOOKSHOP CBA,125.88,0,1201373.79,DR,REF293855,CBA,Savings
11-09-2025 05:12,CBA4E963D1D979C428D835A,063-000-001,22222222,CITYLINK CBA,51.67,0,1201322.12,DR,REF923782,CBA,Savings
11-09-2025 05:30,CBA98863D95F973443980C4,063-000-001,22222222,PAYPAL *NETFLIX CBA,20.67,0,1201301.45,DR,REF721809,CBA,Savings
11-09-2025 05:54,INT3DF1629030CF4B22A43B,063-000-001,22222222,TRANSFER FROM CBA 33333333,0,807.61,1202109.06,CR,INT-60298,CBA,Savings
11-09-2025 05:56,CBA8FB0EC07FD7049298A87,063-000-001,22222222,ZOOM CBA,15.12,0,1202093.94,DR,REF909125,CBA,Savings
11-09-2025 06:02,CBACF97D65CC51D4DCF9700,063-000-001,22222222,WAGES CREDIT CBA,0,231.88,1202325.82,CR,REF923888,CBA,Savings
11-09-2025 06:23,CBABF84B22B4CF5463FB9B2,063-000-001,22222222,DOMINO'S PIZZA CBA,7.76,0,1202318.06,DR,REF808168,CBA,Savings
11-09-2025 06:35,CBAA51A7D0AD19B47539F0F,063-000-001,22222222,HARVEY NORMAN CBA,36.41,0,1202281.65,DR,REF856613,CBA,Savings
11-09-2025 07:12,CBA98CE4FFD67144D0192F1,063-000-001,22222222,SPOTIFY CBA,123.14,0,1202158.51,DR,REF559722,CBA,Savings
11-09-2025 07:48,CBA92FED30476FF42CE8FF6,063-000-001,22222222,WOOLWORTHS CBA,44.05,0,1202114.46,DR,REF652474,CBA,Savings
11-09-2025 07:56,CBA10104A5FE14248FAB4C6,063-000-001,22222222,AMAZON AU CBA,75.72,0,1202038.74,DR,REF276274,CBA,Savings
11-09-2025 08:10,CBA68AB3174FBB34F8F8AB7,063-000-001,22222222,BANK FEE CBA,18.04,0,1202020.7,DR,REF146942,CBA,Savings
11-09-2025 08:30,CBA69BB956FA1C340AD8EBE,063-000-001,22222222,BIGW CBA,97.74,0,1201922.96,DR,REF982771,CBA,Savings
11-09-2025 08:40,CBADC5347F759754FE58220,063-000-001,22222222,AMAZON AU CBA,68.68,0,1201854.28,DR,REF329550,CBA,Savings
11-09-2025 08:43,CBA6C570FD3C0B6412CB267,063-000-001,22222222,AMAZON AU CBA,72.17,0,1201782.11,DR,REF300167,CBA,Savings
11-09-2025 08:47,CBA6F66355D390E4629954D,063-000-001,22222222,7-ELEVEN CBA,64.79,0,1201717.32,DR,REF219259,CBA,Savings
11-09-2025 09:43,CBA11D0DD95D2B94A8E9417,063-000-001,22222222,APPLE CBA,171.41,0,1201545.91,DR,REF556427,CBA,Savings
11-09-2025 10:04,CBA8A8EF46A658141868758,063-000-001,22222222,BANK FEE CBA,50.23,0,1201495.68,DR,REF495219,CBA,Savings
11-09-2025 10:13,CBA960F37DAE1C84F0BADE5,063-000-001,22222222,BP CBA,6.51,0,1201489.17,DR,REF943085,CBA,Savings
11-09-2025 10:14,CBA94CC5553323E44ACA516,063-000-001,22222222,RAILWAY STATION CBA,183.2,0,1201305.97,DR,REF407555,CBA,Savings
11-09-2025 10:17,CBA3D954816C42242918CA5,063-000-001,22222222,ZOOM CBA,16.04,0,1201289.93,DR,REF906765,CBA,Savings
11-09-2025 10:30,CBA71EF9585CC4E4351BE59,063-000-001,22222222,APPLE CBA,12.47,0,1201277.46,DR,REF929701,CBA,Savings
11-09-2025 10:53,CBA7132D5CC00E34C36A58D,063-000-001,22222222,RAILWAY STATION CBA,10.59,0,1201266.87,DR,REF463779,CBA,Savings
11-09-2025 10:54,CBA13F6653F0D7E490487BC,063-000-001,22222222,FLIXBUS CBA,8.31,0,1201258.56,DR,REF865933,CBA,Savings
11-09-2025 10:56,CBA93016D25F5394C0BB079,063-000-001,22222222,APPLE CBA,80.94,0,1201177.62,DR,REF612027,CBA,Savings
11-09-2025 11:19,INTF7FF60F530594FC18E6D,063-000-001,22222222,TRANSFER FROM NAB 44444444,0,866.32,1202043.94,CR,INT-88593,CBA,Savings
11-09-2025 11:28,CBAADAD4DF45C85459AAB46,063-000-001,22222222,DOMINO'S PIZZA CBA,87.37,0,1201956.57,DR,REF553562,CBA,Savings
11-09-2025 12:46,CBAC41D02EC89F24D219BEA,063-000-001,22222222,STARBUCKS CBA,10.33,0,1201946.24,DR,REF880972,CBA,Savings
11-09-2025 12:47,CBAFAC5714AAAB74460BE11,063-000-001,22222222,ZOOM CBA,29.5,0,1201916.74,DR,REF757159,CBA,Savings
11-09-2025 13:29,CBAC2358F9405E24536913A,063-000-001,22222222,AMAZON AU CBA,37.36,0,1201879.38,DR,REF615776,CBA,Savings
11-09-2025 13:32,CBABE7829ACE754435EA957,063-000-001,22222222,HARVEY NORMAN CBA,179.72,0,1201699.66,DR,REF375909,CBA,Savings
11-09-2025 13:57,CBA48D8326ECB384E9DB6CC,063-000-001,22222222,KFC CBA,259.7,0,1201439.96,DR,REF821136,CBA,Savings
11-09-2025 13:59,CBAC2685AF5A5E4438F80F2,063-000-001,22222222,SPOTIFY CBA,43.81,0,1201396.15,DR,REF415334,CBA,Savings
11-09-2025 14:21,CBA29371314BF834C23985E,063-000-001,22222222,BIGW CBA,25.75,0,1201370.4,DR,REF760223,CBA,Savings
11-09-2025 14:24,CBA54E31DB0B651455293B8,063-000-001,22222222,PAY - SALARY CBA,0,775.88,1202146.28,CR,REF614875,CBA,Savings
11-09-2025 14:30,CBA2A2D1846AE0D4D2AA86B,063-000-001,22222222,UBER EATS CBA,30.63,0,1202115.65,DR,REF744937,CBA,Savings
11-09-2025 14:30,CBAC2C2CAE5E97F41E49C72,063-000-001,22222222,ALDI CBA,45.42,0,1202070.23,DR,REF648368,CBA,Savings
11-09-2025 14:35,CBAD677AB88B2A0412B9B1D,063-000-001,22222222,AMAZON AU CBA,84.13,0,1201986.1,DR,REF568447,CBA,Savings
11-09-2025 14:50,CBA64DDE24B799847629DCA,063-000-001,22222222,BP CBA,11.72,0,1201974.38,DR,REF851373,CBA,Savings
11-09-2025 15:25,CBAA32474F560F64EF4BAC4,063-000-001,22222222,PAYPAL *NETFLIX CBA,15.61,0,1201958.77,DR,REF479408,CBA,Savings
11-09-2025 15:34,INTD93F705F2380498EAF59,063-000-001,22222222,TRANSFER TO ANZ 11111111,1217.1,0,1200741.67,DR,INT-49270,CBA,Savings
11-09-2025 15:36,CBA12D4B785E0584B6084F0,063-000-001,22222222,7-ELEVEN CBA,31.12,0,1200710.55,DR,REF857440,CBA,Savings
11-09-2025 15:50,CBA75AA29AFDBB74A6A915C,063-000-001,22222222,SHELL CBA,58.82,0,1200651.73,DR,REF870548,CBA,Savings
11-09-2025 16:38,CBA821D04ACE18A4FC49CE2,063-000-001,22222222,KFC CBA,75.39,0,1200576.34,DR,REF194389,CBA,Savings
11-09-2025 16:40,CBA21FF25988220477F8683,063-000-001,22222222,TAFE BOOKSHOP CBA,21.91,0,1200554.43,DR,REF192995,CBA,Savings
11-09-2025 17:30,CBAC7E35358998B4E138B7F,063-000-001,22222222,PAYPAL *NETFLIX CBA,29.47,0,1200524.96,DR,REF915395,CBA,Savings
11-09-2025 17:34,INT554F2F29CD9C4F9281DF,063-000-001,22222222,TRANSFER FROM NAB 44444444,0,266.11,1200791.07,CR,INT-71677,CBA,Savings
11-09-2025 17:37,CBA1D9A673A39FA403EB031,063-000-001,22222222,7-ELEVEN CBA,23.88,0,1200767.19,DR,REF991889,CBA,Savings
11-09-2025 17:52,CBAF91C96939F8B482D997F,063-000-001,22222222,MENULOG CBA,30.97,0,1200736.22,DR,REF878549,CBA,Savings
11-09-2025 18:09,CBA3DF3B454FC844394913A,063-000-001,22222222,ALDI CBA,56.53,0,1200679.69,DR,REF978708,CBA,Savings
11-09-2025 18:54,CBA6F23CBB22CF7475FA880,063-000-001,22222222,STARBUCKS CBA,113.04,0,1200566.65,DR,REF885013,CBA,Savings
11-09-2025 19:01,CBA2B5E13AC6CD345629ECF,063-000-001,22222222,PAYPAL *NETFLIX CBA,14.09,0,1200552.56,DR,REF957654,CBA,Savings
11-09-2025 19:10,CBAFEBC8DCD87BF408B9282,063-000-001,22222222,KFC CBA,28.57,0,1200523.99,DR,REF343109,CBA,Savings
11-09-2025 19:26,INT672EF895AB14458ABE8B,063-000-001,22222222,TRANSFER FROM CBA 33333333,0,1549.29,1202073.28,CR,INT-78340,CBA,Savings
11-09-2025 20:21,CBA7FF9AE43CB464EEB8D18,063-000-001,22222222,LIQUORLAND CBA,17.64,0,1202055.64,DR,REF814121,CBA,Savings
11-09-2025 20:22,CBA2D6EFAE3AE76464B92F7,063-000-001,22222222,FLIXBUS CBA,15.46,0,1202040.18,DR,REF330766,CBA,Savings
11-09-2025 20:39,INT3B2FBD9E61634A08A801,063-000-001,22222222,TRANSFER FROM ANZ 11111111,0,714.21,1202754.39,CR,INT-62999,CBA,Savings
11-09-2025 21:47,CBA6513FAA2D50145CA90BC,063-000-001,22222222,RAILWAY STATION CBA,11.16,0,1202743.23,DR,REF594305,CBA,Savings
11-09-2025 22:08,CBAA71555318247485485CA,063-000-001,22222222,COLES CBA,47.42,0,1202695.81,DR,REF442776,CBA,Savings
11-09-2025 22:17,CBAE41DF9FD2C3544EA88E6,063-000-001,22222222,JB HI-FI CBA,31.82,0,1202663.99,DR,REF724715,CBA,Savings
11-09-2025 22:51,CBA4D9AF7CC58FF45A78B86,063-000-001,22222222,TAFE BOOKSHOP CBA,14.47,0,1202649.52,DR,REF803020,CBA,Savings
11-09-2025 23:09,CBAD4E7A2C304C64BD1B837,063-000-001,22222222,JB HI-FI CBA,31.47,0,1202618.05,DR,REF991712,CBA,Savings
11-09-2025 23:14,CBAFE4ECF878B5741ECBFB5,063-000-001,22222222,MENULOG CBA,52.74,0,1202565.31,DR,REF380666,CBA,Savings
11-09-2025 23:28,CBA45341903E068480B983A,063-000-001,22222222,AMAZON AU CBA,46.09,0,1202519.22,DR,REF460180,CBA,Savings
11-09-2025 23:42,CBA9875133B5F0443409D0F,063-000-001,22222222,BP CBA,43.75,0,1202475.47,DR,REF124614,CBA,Savings
12-09-2025 00:13,INTFB7A00B61B294DA49426,063-000-001,22222222,TRANSFER FROM ANZ 11111111,0,1107.55,1203583.02,CR,INT-60368,CBA,Savings
12-09-2025 00:45,CBAD7CCB9EED0F640B78BAD,063-000-001,22222222,PAY - SALARY CBA,0,6741.22,1210324.24,CR,REF823079,CBA,Savings
12-09-2025 00:56,CBABEF58F5127304A58885C,063-000-001,22222222,PAYROLL CREDIT CBA,0,4173.88,1214498.12,CR,REF876439,CBA,Savings
12-09-2025 01:00,CBAF4547BDFECF44BF2B8FD,063-000-001,22222222,COMPANY PAYROLL CBA,0,922.37,1215420.49,CR,REF144901,CBA,Savings
12-09-2025 01:01,CBAC55736D1B3254F109100,063-000-001,22222222,COLES CBA,42.25,0,1215378.24,DR,REF953269,CBA,Savings
12-09-2025 01:14,CBAE123C8A60523430CB45E,063-000-001,22222222,INTERNET TRANSFER CBA,2.25,0,1215375.99,DR,REF223898,CBA,Savings
12-09-2025 01:15,CBA757DF20B0CEC420985C3,063-000-001,22222222,BP CBA,18.85,0,1215357.14,DR,REF549547,CBA,Savings
12-09-2025 01:34,INT80490E81705849B9ACD7,063-000-001,22222222,TRANSFER FROM CBA 33333333,0,1625.65,1216982.79,CR,INT-39429,CBA,Savings
12-09-2025 02:53,CBA2BC041495A9A46D2AEAD,063-000-001,22222222,BP CBA,8.2,0,1216974.59,DR,REF220510,CBA,Savings
12-09-2025 03:05,CBAA040FFC98F6F4D688B62,063-000-001,22222222,FLIXBUS CBA,38.69,0,1216935.9,DR,REF958222,CBA,Savings
12-09-2025 04:01,CBA7AA4575EBDDC4E369343,063-000-001,22222222,BANK FEE CBA,40.84,0,1216895.06,DR,REF834074,CBA,Savings
12-09-2025 04:38,CBAACF4290B88CE45138E59,063-000-001,22222222,HARVEY NORMAN CBA,37.03,0,1216858.03,DR,REF847964,CBA,Savings
12-09-2025 05:14,CBA882982C5F4CF4304A9D5,063-000-001,22222222,BANK FEE CBA,10.53,0,1216847.5,DR,REF538550,CBA,Savings
12-09-2025 05:34,CBAEE3B764AEAF444939CE7,063-000-001,22222222,COLES CBA,44.28,0,1216803.22,DR,REF217550,CBA,Savings
12-09-2025 05:35,CBAA5E3A1D640954712AB57,063-000-001,22222222,JB HI-FI CBA,33.52,0,1216769.7,DR,REF315523,CBA,Savings
12-09-2025 05:40,CBAE66ED27A19BD461E9E6E,063-000-001,22222222,COMPANY PAYROLL CBA,0,806.78,1217576.48,CR,REF960625,CBA,Savings
12-09-2025 05:43,CBAF460F112F0B14B148B01,063-000-001,22222222,WAGES CREDIT CBA,0,470.1,1218046.58,CR,REF557736,CBA,Savings
12-09-2025 05:59,CBA848447F2AC164FE4947B,063-000-001,22222222,KFC CBA,8.67,0,1218037.91,DR,REF522875,CBA,Savings
12-09-2025 06:14,CBACCE5142F563B44289643,063-000-001,22222222,RAILWAY STATION CBA,45.02,0,1217992.89,DR,REF894132,CBA,Savings
12-09-2025 06:26,CBA50B9E1E3ED67449A851E,063-000-001,22222222,APPLE CBA,20.83,0,1217972.06,DR,REF139785,CBA,Savings
12-09-2025 06:26,CBABA32060D934F4D5095A5,063-000-001,22222222,SPOTIFY CBA,22.59,0,1217949.47,DR,REF382979,CBA,Savings
12-09-2025 06:44,CBA50B896D641BD4B52B0E0,063-000-001,22222222,BANK FEE CBA,3.27,0,1217946.2,DR,REF813392,CBA,Savings
12-09-2025 07:00,CBAB88AD5C7E3324C07A7ED,063-000-001,22222222,MENULOG CBA,38.28,0,1217907.92,DR,REF354491,CBA,Savings
12-09-2025 07:13,CBAA02B6F049710476AA69D,063-000-001,22222222,AMAZON AU CBA,35.77,0,1217872.15,DR,REF487600,CBA,Savings
12-09-2025 07:18,CBACE20E59B5F4A471D9C83,063-000-001,22222222,SALARY PAYMENT CBA,0,3635.9,1221508.05,CR,REF616644,CBA,Savings
12-09-2025 07:50,CBA0050107E1A654E99AEF4,063-000-001,22222222,BWS CBA,44.11,0,1221463.94,DR,REF591552,CBA,Savings
12-09-2025 09:04,CBAA9CD63CBD7D64CB29D3E,063-000-001,22222222,FLIXBUS CBA,69.24,0,1221394.7,DR,REF130049,CBA,Savings
12-09-2025 09:21,CBA148B6E0AF5334C75B063,063-000-001,22222222,BWS CBA,26.34,0,1221368.36,DR,REF750914,CBA,Savings
12-09-2025 09:48,CBA24DCEFE9EA7541D08601,063-000-001,22222222,FLIXBUS CBA,89.67,0,1221278.69,DR,REF690682,CBA,Savings
12-09-2025 10:31,CBA202123F0BA9B4544A1C3,063-000-001,22222222,BIGW CBA,53.39,0,1221225.3,DR,REF607613,CBA,Savings
12-09-2025 11:11,CBA32F78E56291946E8A248,063-000-001,22222222,RAILWAY STATION CBA,12.62,0,1221212.68,DR,REF632255,CBA,Savings
12-09-2025 11:37,CBA963B1E90FC2B4D9F885E,063-000-001,22222222,FLIXBUS CBA,22.18,0,1221190.5,DR,REF382896,CBA,Savings
12-09-2025 11:41,CBAF3CB698E7CB64334BCCC,063-000-001,22222222,TAFE BOOKSHOP CBA,41.28,0,1221149.22,DR,REF777588,CBA,Savings
12-09-2025 12:03,INT2E29DE1D464D4B5B84DB,063-000-001,22222222,TRANSFER FROM ANZ 11111111,0,555,1221704.22,CR,INT-63578,CBA,Savings
12-09-2025 12:37,CBAF16ADCC702264D41809A,063-000-001,22222222,PAYMENT GATEWAY CBA,8.86,0,1221695.36,DR,REF549832,CBA,Savings
12-09-2025 12:53,CBA7B70E6B62180482E929D,063-000-001,22222222,TAFE BOOKSHOP CBA,14.96,0,1221680.4,DR,REF172899,CBA,Savings
12-09-2025 13:00,CBAE12D9F3AF3B64927A536,063-000-001,22222222,ALDI CBA,7.18,0,1221673.22,DR,REF416426,CBA,Savings
12-09-2025 13:08,CBAE8314FF0F6064D58949F,063-000-001,22222222,KFC CBA,48.6,0,1221624.62,DR,REF714741,CBA,Savings
12-09-2025 13:52,CBAF465455D10BA41EDB83B,063-000-001,22222222,COLES CBA,23.78,0,1221600.84,DR,REF880007,CBA,Savings
12-09-2025 14:07,CBAF76D8BF5AF084918B89D,063-000-001,22222222,SPOTIFY CBA,31.02,0,1221569.82,DR,REF673802,CBA,Savings
12-09-2025 14:18,CBAE98DE68266924F2CB644,063-000-001,22222222,ZOOM CBA,8.79,0,1221561.03,DR,REF362913,CBA,Savings
12-09-2025 14:54,CBA8042CF90CFFA44FCAD2C,063-000-001,22222222,SPOTIFY CBA,48.62,0,1221512.41,DR,REF692776,CBA,Savings
12-09-2025 15:13,CBAD5481ACD7DE541CB9CBE,063-000-001,22222222,ZOOM CBA,168.77,0,1221343.64,DR,REF180892,CBA,Savings
12-09-2025 15:27,CBA0ED1522928074C16A1B7,063-000-001,22222222,WAGES CREDIT CBA,0,893.55,1222237.19,CR,REF970322,CBA,Savings
12-09-2025 15:28,INTE7CD14BF4A1348599C62,063-000-001,22222222,TRANSFER TO ANZ 11111111,1158.69,0,1221078.5,DR,INT-13382,CBA,Savings
12-09-2025 15:30,CBAFFBFF89FA6284CF88EB0,063-000-001,22222222,PAYMENT GATEWAY CBA,38.05,0,1221040.45,DR,REF142429,CBA,Savings
12-09-2025 16:24,CBAEF0AB8D682F342EB8E9C,063-000-001,22222222,HARVEY NORMAN CBA,33.99,0,1221006.46,DR,REF650573,CBA,Savings
12-09-2025 17:18,CBAE2526A93FD9B446C97A6,063-000-001,22222222,7-ELEVEN CBA,44.25,0,1220962.21,DR,REF864053,CBA,Savings
12-09-2025 17:27,CBA4A1BC3A7213D40D89B6F,063-000-001,22222222,LIQUORLAND CBA,132.47,0,1220829.74,DR,REF297217,CBA,Savings
12-09-2025 18:20,CBA1251C61AC3F5447183A2,063-000-001,22222222,TAFE BOOKSHOP CBA,160.13,0,1220669.61,DR,REF258790,CBA,Savings
12-09-2025 18:22,CBACFCD18F5460C4DF9BCC0,063-000-001,22222222,7-ELEVEN CBA,48.76,0,1220620.85,DR,REF418302,CBA,Savings
12-09-2025 18:29,CBA3A6DD2D8FFEB4F8DA379,063-000-001,22222222,7-ELEVEN CBA,5.01,0,1220615.84,DR,REF917139,CBA,Savings
12-09-2025 18:54,CBAB22D1FE80A2F4D7D92C6,063-000-001,22222222,MCDONALDS CBA,62.82,0,1220553.02,DR,REF632903,CBA,Savings
12-09-2025 19:01,CBA7BB48E43C0C842EF86C3,063-000-001,22222222,DOMINO'S PIZZA CBA,72.18,0,1220480.84,DR,REF868803,CBA,Savings
12-09-2025 19:05,CBA197EE5CBA15941A4A6F6,063-000-001,22222222,7-ELEVEN CBA,40.71,0,1220440.13,DR,REF393195,CBA,Savings
12-09-2025 19:15,CBA7638FF039E71461598FD,063-000-001,22222222,RAILWAY STATION CBA,199.26,0,1220240.87,DR,REF622341,CBA,Savings
12-09-2025 19:24,CBAC5FA6ECF924C4B708504,063-000-001,22222222,COLES CBA,131.73,0,1220109.14,DR,REF828239,CBA,Savings
12-09-2025 19:49,CBACA617AE70C3B4AE5B410,063-000-001,22222222,PAY - SALARY CBA,0,851.71,1220960.85,CR,REF266274,CBA,Savings
12-09-2025 20:07,CBA685201EFB550475190F7,063-000-001,22222222,JB HI-FI CBA,24.28,0,1220936.57,DR,REF832978,CBA,Savings
12-09-2025 20:11,CBA48E5A36261E94FF6A4F2,063-000-001,22222222,PAYPAL *NETFLIX CBA,20.51,0,1220916.06,DR,REF982489,CBA,Savings
12-09-2025 20:15,CBAADE376A90995451FB662,063-000-001,22222222,PAYMENT GATEWAY CBA,17.49,0,1220898.57,DR,REF905272,CBA,Savings
12-09-2025 20:29,CBAD5E60166AC8B46EDA0B5,063-000-001,22222222,BANK FEE CBA,10.91,0,1220887.66,DR,REF213273,CBA,Savings
12-09-2025 20:35,CBA36318E8DC6D6444B9B6C,063-000-001,22222222,MCDONALDS CBA,20.43,0,1220867.23,DR,REF981149,CBA,Savings
12-09-2025 20:38,CBA28EB9DAEBA4F4C22AF1C,063-000-001,22222222,RAILWAY STATION CBA,54.08,0,1220813.15,DR,REF414369,CBA,Savings
12-09-2025 20:45,CBA1A7744CC8C0C4CF6981A,063-000-001,22222222,INTERNET TRANSFER CBA,12.72,0,1220800.43,DR,REF466516,CBA,Savings
12-09-2025 20:54,CBA2EF55356D4C24CBC81F8,063-000-001,22222222,DOMINO'S PIZZA CBA,25.39,0,1220775.04,DR,REF609511,CBA,Savings
12-09-2025 21:25,CBA4311C4726669429E9359,063-000-001,22222222,PAYMENT GATEWAY CBA,54.62,0,1220720.42,DR,REF201249,CBA,Savings
12-09-2025 21:27,CBA7BBCAB3B9C0C48558649,063-000-001,22222222,MCDONALDS CBA,199.74,0,1220520.68,DR,REF810876,CBA,Savings
12-09-2025 22:25,CBA48A8C15D83204CA69064,063-000-001,22222222,BP CBA,47.56,0,1220473.12,DR,REF881119,CBA,Savings
12-09-2025 22:27,CBA468B9F50994845A5BEB9,063-000-001,22222222,UBER EATS CBA,48.62,0,1220424.5,DR,REF955201,CBA,Savings
12-09-2025 23:01,CBA79C2A8746B014B27B635,063-000-001,22222222,SALARY PAYMENT CBA,0,2395.26,1222819.76,CR,REF200450,CBA,Savings
12-09-2025 23:28,CBA54B66B1C12654FD98F54,063-000-001,22222222,SPOTIFY CBA,7.63,0,1222812.13,DR,REF248367,CBA,Savings
12-09-2025 23:29,INT132A0A7DFE15478F8891,063-000-001,22222222,TRANSFER FROM CBA 33333333,0,1419.03,1224231.16,CR,INT-84628,CBA,Savings
12-09-2025 23:42,CBACF83EADF77CF4DCA94C0,063-000-001,22222222,BWS CBA,24.51,0,1224206.65,DR,REF471662,CBA,Savings
13-09-2025 00:43,CBAA3B980EBB1714EBCB290,063-000-001,22222222,TAFE BOOKSHOP CBA,6.01,0,1224200.64,DR,REF286411,CBA,Savings
13-09-2025 00:47,INTE753F86B376A467C8FCC,063-000-001,22222222,TRANSFER TO CBA 33333333,1985.11,0,1222215.53,DR,INT-36787,CBA,Savings
13-09-2025 00:52,CBAD330E22CC2AF4D51BE75,063-000-001,22222222,PAYPAL *NETFLIX CBA,15.25,0,1222200.28,DR,REF177862,CBA,Savings
13-09-2025 01:01,CBAF91D57BC7770407FA48A,063-000-001,22222222,COLES CBA,52.34,0,1222147.94,DR,REF695368,CBA,Savings
13-09-2025 01:07,CBABD49440FB7134190A67D,063-000-001,22222222,WOOLWORTHS CBA,71.76,0,1222076.18,DR,REF254561,CBA,Savings
13-09-2025 01:34,CBA90B445BBFD254592BABF,063-000-001,22222222,BWS CBA,6.88,0,1222069.3,DR,REF825777,CBA,Savings
13-09-2025 01:56,CBA63C327164554417D9AD1,063-000-001,22222222,RAILWAY STATION CBA,9.32,0,1222059.98,DR,REF179861,CBA,Savings
13-09-2025 02:21,CBA0B6BBF03BA744DC1AA2B,063-000-001,22222222,SALARY PAYMENT CBA,0,50.83,1222110.81,CR,REF206926,CBA,Savings
13-09-2025 02:42,CBA59319EB9D30543F8AF3B,063-000-001,22222222,ALDI CBA,25.8,0,1222085.01,DR,REF755956,CBA,Savings
13-09-2025 02:53,CBAC347580B4E0B4452962A,063-000-001,22222222,WOOLWORTHS CBA,5.63,0,1222079.38,DR,REF751413,CBA,Savings
13-09-2025 03:40,CBAC29681DBCEED451A9A49,063-000-001,22222222,PAYMENT GATEWAY CBA,140.21,0,1221939.17,DR,REF526947,CBA,Savings
13-09-2025 03:44,CBABAB8F7495DD04CC88518,063-000-001,22222222,BP CBA,11.22,0,1221927.95,DR,REF598154,CBA,Savings
13-09-2025 03:55,INTD5D05DC3E83241A78FA2,063-000-001,22222222,TRANSFER TO NAB 44444444,1922.18,0,1220005.77,DR,INT-13561,CBA,Savings
13-09-2025 04:03,CBA328D474E28ED438C9951,063-000-001,22222222,CITYLINK CBA,11.22,0,1219994.55,DR,REF168824,CBA,Savings
13-09-2025 04:13,CBA1621A534279D4298AF08,063-000-001,22222222,WAGES CREDIT CBA,0,6282.67,1226277.22,CR,REF813718,CBA,Savings
13-09-2025 04:30,CBA3D602BEEA65E465A9E63,063-000-001,22222222,LIQUORLAND CBA,66.8,0,1226210.42,DR,REF407476,CBA,Savings
13-09-2025 04:46,CBAA57850CE04C74E50A5F2,063-000-001,22222222,BWS CBA,18.17,0,1226192.25,DR,REF923697,CBA,Savings
13-09-2025 05:23,CBA355CDD455B3C44CEAA32,063-000-001,22222222,ALDI CBA,103.31,0,1226088.94,DR,REF952975,CBA,Savings
13-09-2025 05:24,CBA59B9E1ACABB64FAD87F5,063-000-001,22222222,WAGES CREDIT CBA,0,341.37,1226430.31,CR,REF246671,CBA,Savings
13-09-2025 05:26,CBAC34F952C3FFD4F498815,063-000-001,22222222,TAFE BOOKSHOP CBA,46.72,0,1226383.59,DR,REF123064,CBA,Savings
13-09-2025 05:54,CBAB9B19F1B2C854A958DAA,063-000-001,22222222,LIQUORLAND CBA,16.95,0,1226366.64,DR,REF816772,CBA,Savings
13-09-2025 05:58,CBA527864BC58BF4CFE9144,063-000-001,22222222,JB HI-FI CBA,73.01,0,1226293.63,DR,REF271493,CBA,Savings
13-09-2025 06:06,CBA934E38D00A9243ACA56F,063-000-001,22222222,SALARY PAYMENT CBA,0,2548.08,1228841.71,CR,REF371000,CBA,Savings
13-09-2025 06:43,CBAFD332139A6984BD8A6B3,063-000-001,22222222,FLIXBUS CBA,9.02,0,1228832.69,DR,REF144175,CBA,Savings
13-09-2025 06:43,CBAA98319D4D82E49CF9097,063-000-001,22222222,APPLE CBA,16.84,0,1228815.85,DR,REF241279,CBA,Savings
13-09-2025 06:56,CBA68A21015DF574EB8A921,063-000-001,22222222,BIGW CBA,21.25,0,1228794.6,DR,REF455829,CBA,Savings
13-09-2025 07:38,CBADB2C069843AD427DAAC4,063-000-001,22222222,TAFE BOOKSHOP CBA,49.77,0,1228744.83,DR,REF934687,CBA,Savings
13-09-2025 07:38,CBABF7AF63BAC8A41078032,063-000-001,22222222,CITYLINK CBA,91.5,0,1228653.33,DR,REF123349,CBA,Savings
13-09-2025 07:55,CBA540AC6E35AF742FFAA91,063-000-001,22222222,APPLE CBA,126.43,0,1228526.9,DR,REF581963,CBA,Savings
13-09-2025 08:00,CBAD6A028FEC45143FDA84C,063-000-001,22222222,COLES CBA,236.67,0,1228290.23,DR,REF218504,CBA,Savings
13-09-2025 08:38,CBACAF320946804425C9049,063-000-001,22222222,APPLE CBA,17.08,0,1228273.15,DR,REF522971,CBA,Savings
13-09-2025 08:39,CBA9455586432804370A554,063-000-001,22222222,PAYPAL *NETFLIX CBA,45.96,0,1228227.19,DR,REF925116,CBA,Savings
13-09-2025 08:40,CBA8EBA9386CCF84C25A244,063-000-001,22222222,SHELL CBA,1.97,0,1228225.22,DR,REF139791,CBA,Savings
13-09-2025 08:56,CBAF1FE3381243847D2B551,063-000-001,22222222,FLIXBUS CBA,5.69,0,1228219.53,DR,REF262853,CBA,Savings
13-09-2025 09:20,CBA8DE5F360B3774F6AA71B,063-000-001,22222222,DOMINO'S PIZZA CBA,84.43,0,1228135.1,DR,REF448698,CBA,Savings
13-09-2025 09:33,CBA9C77B42762694553B6E1,063-000-001,22222222,PAYPAL *NETFLIX CBA,16.9,0,1228118.2,DR,REF659332,CBA,Savings
13-09-2025 09:42,CBA29F7F2930F374C8AB3B0,063-000-001,22222222,PAYROLL CREDIT CBA,0,4680.8,1232799,CR,REF139066,CBA,Savings
13-09-2025 09:48,CBAC564FE630E90456DA71E,063-000-001,22222222,JB HI-FI CBA,37.95,0,1232761.05,DR,REF319792,CBA,Savings
13-09-2025 09:56,CBAB9225AD4F5A842A3A30B,063-000-001,22222222,BWS CBA,112.34,0,1232648.71,DR,REF973966,CBA,Savings
13-09-2025 10:24,CBAA9E936B5D77744AA8A55,063-000-001,22222222,MCDONALDS CBA,56.55,0,1232592.16,DR,REF902199,CBA,Savings
13-09-2025 10:32,CBAA4D6FCBBCF604611B5F2,063-000-001,22222222,PAY - SALARY CBA,0,4413.33,1237005.49,CR,REF590980,CBA,Savings
13-09-2025 12:20,CBA465F8CD89028420FBFD1,063-000-001,22222222,STARBUCKS CBA,44.08,0,1236961.41,DR,REF945892,CBA,Savings
13-09-2025 13:20,CBAED84D6F0FF524C24BBEB,063-000-001,22222222,BP CBA,13.24,0,1236948.17,DR,REF621402,CBA,Savings
13-09-2025 13:52,CBA5328BE42F33F4CF88CE3,063-000-001,22222222,CITYLINK CBA,17.38,0,1236930.79,DR,REF641401,CBA,Savings
13-09-2025 14:03,CBAD5644A15C6B844E393AA,063-000-001,22222222,COLES CBA,20.96,0,1236909.83,DR,REF250712,CBA,Savings
13-09-2025 14:10,CBA66ADA88DBA7F46E4958E,063-000-001,22222222,7-ELEVEN CBA,26.4,0,1236883.43,DR,REF983257,CBA,Savings
13-09-2025 14:13,CBA4CE9235E0AD8451BB044,063-000-001,22222222,PAYROLL CREDIT CBA,0,333.28,1237216.71,CR,REF159907,CBA,Savings
13-09-2025 14:46,CBA6991C88D3C4147BFBA2D,063-000-001,22222222,AMAZON AU CBA,63.47,0,1237153.24,DR,REF297173,CBA,Savings
13-09-2025 14:58,CBAD1DE1DE1278A48BB8FD2,063-000-001,22222222,BANK FEE CBA,55.05,0,1237098.19,DR,REF202776,CBA,Savings
13-09-2025 15:16,CBA6518CA11CBE040EA971F,063-000-001,22222222,MENULOG CBA,6.08,0,1237092.11,DR,REF189342,CBA,Savings
13-09-2025 15:21,CBAF5AAC44197234A5D80DB,063-000-001,22222222,HARVEY NORMAN CBA,141.31,0,1236950.8,DR,REF653957,CBA,Savings
13-09-2025 15:21,CBAA632435ED9F34AE1ABC5,063-000-001,22222222,INTERNET TRANSFER CBA,4.14,0,1236946.66,DR,REF616949,CBA,Savings
13-09-2025 15:27,CBA90CC54326B1540F38C44,063-000-001,22222222,BANK FEE CBA,21.94,0,1236924.72,DR,REF570155,CBA,Savings
13-09-2025 15:33,CBADBEDB246CA084462BCCF,063-000-001,22222222,RAILWAY STATION CBA,84.57,0,1236840.15,DR,REF134592,CBA,Savings
13-09-2025 15:47,CBA271EF47ACD6E4C27BE9A,063-000-001,22222222,PAY - SALARY CBA,0,510.03,1237350.18,CR,REF529605,CBA,Savings
13-09-2025 15:50,CBAC122435371014DFD9A44,063-000-001,22222222,KFC CBA,28.39,0,1237321.79,DR,REF962404,CBA,Savings
13-09-2025 16:01,CBAF0D168A1C2E64439A661,063-000-001,22222222,RAILWAY STATION CBA,11.69,0,1237310.1,DR,REF174082,CBA,Savings
13-09-2025 16:06,CBAF7B308642C594569B092,063-000-001,22222222,INTERNET TRANSFER CBA,105.73,0,1237204.37,DR,REF895082,CBA,Savings
13-09-2025 16:21,CBA644948B32B384D1A938A,063-000-001,22222222,INTERNET TRANSFER CBA,21.12,0,1237183.25,DR,REF478861,CBA,Savings
13-09-2025 16:26,CBAAF7B6DA3E1A84DAAAE9E,063-000-001,22222222,MCDONALDS CBA,8.14,0,1237175.11,DR,REF125755,CBA,Savings
13-09-2025 16:58,CBAD090B240CAA94B27AD7F,063-000-001,22222222,STARBUCKS CBA,25.45,0,1237149.66,DR,REF776044,CBA,Savings
13-09-2025 17:15,CBABC1307831BDD4C9890F9,063-000-001,22222222,WAGES CREDIT CBA,0,895.8,1238045.46,CR,REF139041,CBA,Savings
13-09-2025 17:28,CBA64C1038AB7EF4932AECF,063-000-001,22222222,DOMINO'S PIZZA CBA,76.66,0,1237968.8,DR,REF460921,CBA,Savings
13-09-2025 18:03,CBA6FAB8D077DDE4C31AD17,063-000-001,22222222,BIGW CBA,105.52,0,1237863.28,DR,REF839274,CBA,Savings
13-09-2025 18:18,CBA75E49DAB158B4CFFBF4D,063-000-001,22222222,MENULOG CBA,69.76,0,1237793.52,DR,REF261053,CBA,Savings
13-09-2025 18:27,CBAE14B93B8BD494043A810,063-000-001,22222222,PAYMENT GATEWAY CBA,192.33,0,1237601.19,DR,REF719636,CBA,Savings
13-09-2025 18:51,CBA2B0FF42FD79A45EBB340,063-000-001,22222222,TAFE BOOKSHOP CBA,132.32,0,1237468.87,DR,REF502658,CBA,Savings
13-09-2025 19:07,CBA71460DB2F1714D809F8C,063-000-001,22222222,RAILWAY STATION CBA,56.24,0,1237412.63,DR,REF838362,CBA,Savings
13-09-2025 19:27,CBA2FA30121A1A544D9BCBE,063-000-001,22222222,SHELL CBA,39.22,0,1237373.41,DR,REF665111,CBA,Savings
13-09-2025 19:59,INT47C67B38C1AD462F9152,063-000-001,22222222,TRANSFER FROM ANZ 11111111,0,399.37,1237772.78,CR,INT-82824,CBA,Savings
13-09-2025 20:42,CBA0BB79C84CFA64488A3C3,063-000-001,22222222,SALARY PAYMENT CBA,0,3074.8,1240847.58,CR,REF188716,CBA,Savings
13-09-2025 21:29,CBA2D717FBF675D4F21AA2D,063-000-001,22222222,PAYPAL *NETFLIX CBA,21.15,0,1240826.43,DR,REF728741,CBA,Savings
13-09-2025 21:29,CBA9D3592319ED242CFBD45,063-000-001,22222222,DOMINO'S PIZZA CBA,45.64,0,1240780.79,DR,REF918662,CBA,Savings
13-09-2025 21:38,CBAB1CBDFD9C06A481098B9,063-000-001,22222222,INTERNET TRANSFER CBA,43.12,0,1240737.67,DR,REF425414,CBA,Savings
13-09-2025 21:45,CBABA7C72CBB7CE444B9303,063-000-001,22222222,SALARY PAYMENT CBA,0,4363.07,1245100.74,CR,REF176301,CBA,Savings
13-09-2025 22:07,CBA7FABD8947A1549349671,063-000-001,22222222,JB HI-FI CBA,85.59,0,1245015.15,DR,REF132658,CBA,Savings
13-09-2025 22:16,CBABFBD2D9A99064753BFCA,063-000-001,22222222,AMAZON AU CBA,22.37,0,1244992.78,DR,REF719493,CBA,Savings
13-09-2025 23:40,CBAF569A32F53A048DFAD64,063-000-001,22222222,BIGW CBA,10.36,0,1244982.42,DR,REF164206,CBA,Savings
13-09-2025 23:44,CBA0F388D06F87E481886E4,063-000-001,22222222,TAFE BOOKSHOP CBA,34.79,0,1244947.63,DR,REF330841,CBA,Savings
13-09-2025 23:47,CBA54710F574C1C4B8E9FCE,063-000-001,22222222,COMPANY PAYROLL CBA,0,4395.68,1249343.31,CR,REF344270,CBA,Savings
14-09-2025 00:01,CBA875D7760B7304D7DACA2,063-000-001,22222222,LIQUORLAND CBA,71.83,0,1249271.48,DR,REF131155,CBA,Savings
14-09-2025 00:02,CBAEE550C83BF0B49E99326,063-000-001,22222222,SPOTIFY CBA,59.99,0,1249211.49,DR,REF537231,CBA,Savings
14-09-2025 00:27,CBA0E31F43AEB334001B4EE,063-000-001,22222222,BWS CBA,150.72,0,1249060.77,DR,REF290932,CBA,Savings
14-09-2025 00:49,CBAE514CD7524474750AA71,063-000-001,22222222,INTERNET TRANSFER CBA,10.17,0,1249050.6,DR,REF355794,CBA,Savings
14-09-2025 00:52,CBACB4ADFC2F52744DE938E,063-000-001,22222222,BWS CBA,97.74,0,1248952.86,DR,REF403267,CBA,Savings
14-09-2025 01:38,CBAF074CD75248744BBB306,063-000-001,22222222,FLIXBUS CBA,64.85,0,1248888.01,DR,REF966113,CBA,Savings
14-09-2025 01:41,CBA28700FF13FDE442BBF5C,063-000-001,22222222,BWS CBA,5.77,0,1248882.24,DR,REF472739,CBA,Savings
14-09-2025 01:46,CBAE388B448560B42009713,063-000-001,22222222,ALDI CBA,39.38,0,1248842.86,DR,REF735290,CBA,Savings
14-09-2025 01:52,CBAF3B320CF8C594B3F8CAC,063-000-001,22222222,BP CBA,11.63,0,1248831.23,DR,REF959840,CBA,Savings
14-09-2025 02:42,CBA5AD39DD5924A49AC8CD2,063-000-001,22222222,PAYROLL CREDIT CBA,0,4104.02,1252935.25,CR,REF914439,CBA,Savings
14-09-2025 02:46,CBA9A06042750C04BE98341,063-000-001,22222222,SHELL CBA,21.04,0,1252914.21,DR,REF178015,CBA,Savings
14-09-2025 02:48,CBA26C30C845FBC47ADB33C,063-000-001,22222222,AMAZON AU CBA,23.14,0,1252891.07,DR,REF227609,CBA,Savings
14-09-2025 03:17,CBAA94CD18C7AEE4BB8A188,063-000-001,22222222,PAY - SALARY CBA,0,5543.06,1258434.13,CR,REF621285,CBA,Savings
14-09-2025 03:24,INT90A1553399CE4D79B260,063-000-001,22222222,TRANSFER FROM ANZ 11111111,0,956.67,1259390.8,CR,INT-40190,CBA,Savings
14-09-2025 04:12,CBA129D4F538EF8494E8B1A,063-000-001,22222222,WOOLWORTHS CBA,20.11,0,1259370.69,DR,REF786471,CBA,Savings
14-09-2025 04:25,CBAEB71C1F488B543C29812,063-000-001,22222222,CITYLINK CBA,186.1,0,1259184.59,DR,REF578327,CBA,Savings
14-09-2025 04:29,CBAE977C993CF834228A631,063-000-001,22222222,KFC CBA,66.09,0,1259118.5,DR,REF107238,CBA,Savings
14-09-2025 05:05,CBACCC8C15DF33F4757BD41,063-000-001,22222222,MCDONALDS CBA,63.89,0,1259054.61,DR,REF895476,CBA,Savings
14-09-2025 05:19,CBA4D0A3556574F498A82A3,063-000-001,22222222,SPOTIFY CBA,168.53,0,1258886.08,DR,REF741336,CBA,Savings
14-09-2025 05:25,CBA5A693802FAB94B398950,063-000-001,22222222,SPOTIFY CBA,73.97,0,1258812.11,DR,REF828799,CBA,Savings
14-09-2025 06:01,CBA5DE7A996C787440CB550,063-000-001,22222222,WOOLWORTHS CBA,58.43,0,1258753.68,DR,REF380143,CBA,Savings
14-09-2025 06:02,CBAAC98529C3A60477AB854,063-000-001,22222222,PAYMENT GATEWAY CBA,51.97,0,1258701.71,DR,REF858232,CBA,Savings
14-09-2025 06:13,CBA0ADBD26862C3426EA80B,063-000-001,22222222,UBER EATS CBA,22.49,0,1258679.22,DR,REF141155,CBA,Savings
14-09-2025 06:15,CBA15026955CF774DB3B18C,063-000-001,22222222,PAYROLL CREDIT CBA,0,6580.29,1265259.51,CR,REF903773,CBA,Savings
14-09-2025 06:18,CBAD861C7832F0145C88FC8,063-000-001,22222222,SHELL CBA,40.29,0,1265219.22,DR,REF456924,CBA,Savings
14-09-2025 06:21,CBA5D79E26CB2364E70B0C5,063-000-001,22222222,RAILWAY STATION CBA,92.08,0,1265127.14,DR,REF375135,CBA,Savings
14-09-2025 06:23,CBA45EA5B60D47049088691,063-000-001,22222222,FLIXBUS CBA,12.24,0,1265114.9,DR,REF280051,CBA,Savings
14-09-2025 06:28,CBA5DD24B860C3445C286F8,063-000-001,22222222,INTERNET TRANSFER CBA,6.3,0,1265108.6,DR,REF451378,CBA,Savings
14-09-2025 07:05,CBA267D951CBED248028E44,063-000-001,22222222,COMPANY PAYROLL CBA,0,7003.43,1272112.03,CR,REF520899,CBA,Savings
14-09-2025 07:31,CBA5A33853A1A204E6B8FF3,063-000-001,22222222,BWS CBA,58.42,0,1272053.61,DR,REF559111,CBA,Savings
14-09-2025 08:47,CBA80D8E6FDC2664D55840E,063-000-001,22222222,LIQUORLAND CBA,57.17,0,1271996.44,DR,REF190644,CBA,Savings
14-09-2025 09:23,CBA8F2ADD9BE5274F658978,063-000-001,22222222,PAYMENT GATEWAY CBA,6.15,0,1271990.29,DR,REF363924,CBA,Savings
14-09-2025 09:40,CBADA303ED381944BA7AA0F,063-000-001,22222222,KFC CBA,21.78,0,1271968.51,DR,REF310396,CBA,Savings
14-09-2025 10:54,CBA9294A3BB1BFE4A5AB219,063-000-001,22222222,PAYROLL CREDIT CBA,0,943.09,1272911.6,CR,REF836847,CBA,Savings
14-09-2025 11:04,INTD1E01334714E4A11B56F,063-000-001,22222222,TRANSFER TO CBA 33333333,1560.64,0,1271350.96,DR,INT-39280,CBA,Savings
14-09-2025 11:24,CBAEF117C99C6F24E168C34,063-000-001,22222222,ALDI CBA,9.33,0,1271341.63,DR,REF911836,CBA,Savings
14-09-2025 12:03,CBA7FB493EA096141F0A412,063-000-001,22222222,BWS CBA,5.84,0,1271335.79,DR,REF573914,CBA,Savings
14-09-2025 12:19,CBA19AE13B2F65B4104A715,063-000-001,22222222,MENULOG CBA,99.03,0,1271236.76,DR,REF318779,CBA,Savings
14-09-2025 12:37,CBAF87C07B8239E40D5A472,063-000-001,22222222,CITYLINK CBA,78.82,0,1271157.94,DR,REF240317,CBA,Savings
14-09-2025 12:41,CBA335CB5334C234FBFB46F,063-000-001,22222222,CITYLINK CBA,4.14,0,1271153.8,DR,REF283563,CBA,Savings
14-09-2025 13:11,CBA3E9F733722A34A119000,063-000-001,22222222,RAILWAY STATION CBA,131.87,0,1271021.93,DR,REF935988,CBA,Savings
14-09-2025 13:52,CBA290777C6C29B4FA2B624,063-000-001,22222222,TAFE BOOKSHOP CBA,12.9,0,1271009.03,DR,REF509034,CBA,Savings
14-09-2025 14:32,CBA78D9DA90CB8A43559B9E,063-000-001,22222222,CITYLINK CBA,41.24,0,1270967.79,DR,REF558701,CBA,Savings
14-09-2025 15:43,CBA1013A111F1E04EDB92E5,063-000-001,22222222,SHELL CBA,45.46,0,1270922.33,DR,REF528135,CBA,Savings
14-09-2025 15:56,CBA0EC47EA32824428BAA97,063-000-001,22222222,UBER EATS CBA,54.25,0,1270868.08,DR,REF952742,CBA,Savings
14-09-2025 16:25,CBAA5AEBA14B95944E1A2E9,063-000-001,22222222,UBER EATS CBA,4.78,0,1270863.3,DR,REF414881,CBA,Savings
14-09-2025 16:32,CBACA1AE2AAE2454CB2BCAF,063-000-001,22222222,RAILWAY STATION CBA,15.37,0,1270847.93,DR,REF898691,CBA,Savings
14-09-2025 16:38,INT3249B877B9E4434EB27E,063-000-001,22222222,TRANSFER TO NAB 44444444,281.82,0,1270566.11,DR,INT-99115,CBA,Savings
14-09-2025 16:38,INTBCBB5DE53F8949ABA117,063-000-001,22222222,TRANSFER TO ANZ 11111111,493.55,0,1270072.56,DR,INT-12960,CBA,Savings
14-09-2025 16:49,CBA49DAB285889D470BA729,063-000-001,22222222,PAYPAL *NETFLIX CBA,34.78,0,1270037.78,DR,REF722175,CBA,Savings
14-09-2025 17:11,CBAB1F5540CB19E4400A9F4,063-000-001,22222222,PAYMENT GATEWAY CBA,6.88,0,1270030.9,DR,REF454829,CBA,Savings
14-09-2025 17:30,CBA67AC3539DFFF4772890C,063-000-001,22222222,FLIXBUS CBA,55.35,0,1269975.55,DR,REF146026,CBA,Savings
14-09-2025 17:39,CBAFEC93178BE3A4C1FA7D4,063-000-001,22222222,LIQUORLAND CBA,41.87,0,1269933.68,DR,REF999982,CBA,Savings
14-09-2025 17:46,CBA6C9DBE7377D748B2AD0F,063-000-001,22222222,7-ELEVEN CBA,8.29,0,1269925.39,DR,REF279075,CBA,Savings
14-09-2025 17:52,CBA48DA9D5BF42A464E8F39,063-000-001,22222222,AMAZON AU CBA,42.79,0,1269882.6,DR,REF439389,CBA,Savings
14-09-2025 18:11,CBAB6913132610D40D38262,063-000-001,22222222,COLES CBA,23.36,0,1269859.24,DR,REF660869,CBA,Savings
14-09-2025 18:22,CBAFC922FC5814E4EB3AE22,063-000-001,22222222,ALDI CBA,53.47,0,1269805.77,DR,REF920726,CBA,Savings
14-09-2025 19:03,CBA4F2DB36331AC45FD8114,063-000-001,22222222,MCDONALDS CBA,24.7,0,1269781.07,DR,REF554623,CBA,Savings
14-09-2025 19:04,CBA460B633066C24960B150,063-000-001,22222222,AMAZON AU CBA,8.93,0,1269772.14,DR,REF464506,CBA,Savings
14-09-2025 19:05,CBABC13A3CA01974E0EB30C,063-000-001,22222222,SHELL CBA,9.72,0,1269762.42,DR,REF861033,CBA,Savings
14-09-2025 19:23,CBA3F3B4211042C4297912B,063-000-001,22222222,BIGW CBA,52.74,0,1269709.68,DR,REF204127,CBA,Savings
14-09-2025 19:46,CBA6E3B73420A324CD494BF,063-000-001,22222222,SPOTIFY CBA,163.32,0,1269546.36,DR,REF304323,CBA,Savings
14-09-2025 20:21,CBAD306EB4125BF4BD4B909,063-000-001,22222222,LIQUORLAND CBA,12.02,0,1269534.34,DR,REF908204,CBA,Savings
14-09-2025 20:28,CBA29E76C55C1B5453EB27A,063-000-001,22222222,APPLE CBA,77.6,0,1269456.74,DR,REF257629,CBA,Savings
14-09-2025 20:36,CBAF96CE8AE90BE4FE4A8F5,063-000-001,22222222,WOOLWORTHS CBA,7.84,0,1269448.9,DR,REF408813,CBA,Savings
14-09-2025 21:08,CBA867F03986EEA409CA985,063-000-001,22222222,LIQUORLAND CBA,47.17,0,1269401.73,DR,REF261056,CBA,Savings
14-09-2025 21:15,CBAD385A8E942FB42B6A765,063-000-001,22222222,INTERNET TRANSFER CBA,159.23,0,1269242.5,DR,REF446788,CBA,Savings
14-09-2025 21:48,CBAAAF01F6D4D4A496DAD85,063-000-001,22222222,7-ELEVEN CBA,13.88,0,1269228.62,DR,REF518622,CBA,Savings
14-09-2025 22:29,CBA656AAD0009D049DF93E0,063-000-001,22222222,SHELL CBA,15.43,0,1269213.19,DR,REF428813,CBA,Savings
14-09-2025 22:30,CBA977E08456056482A915D,063-000-001,22222222,PAYPAL *NETFLIX CBA,34.12,0,1269179.07,DR,REF337370,CBA,Savings
14-09-2025 23:00,CBA87FF867617D748479A40,063-000-001,22222222,WAGES CREDIT CBA,0,3808.52,1272987.59,CR,REF174177,CBA,Savings
14-09-2025 23:06,CBA2D59C652F8CF421FB2DB,063-000-001,22222222,PAY - SALARY CBA,0,7652.21,1280639.8,CR,REF252368,CBA,Savings
14-09-2025 23:18,INTFAB7634B07674B338663,063-000-001,22222222,TRANSFER FROM NAB 44444444,0,907.14,1281546.94,CR,INT-29904,CBA,Savings
14-09-2025 23:23,CBA37DFDED0D71647E48BA4,063-000-001,22222222,ZOOM CBA,11.75,0,1281535.19,DR,REF206407,CBA,Savings
15-09-2025 01:08,CBA8219313DD0AB4B64B17D,063-000-001,22222222,MENULOG CBA,34.68,0,1281500.51,DR,REF114244,CBA,Savings
15-09-2025 01:10,CBA748168521AC14EB485A6,063-000-001,22222222,ZOOM CBA,74.13,0,1281426.38,DR,REF354820,CBA,Savings
15-09-2025 01:25,CBAEB8B032843D9403485EA,063-000-001,22222222,LIQUORLAND CBA,117.45,0,1281308.93,DR,REF110173,CBA,Savings
15-09-2025 01:47,CBAC084B3A879A947FB9899,063-000-001,22222222,TAFE BOOKSHOP CBA,3.55,0,1281305.38,DR,REF918739,CBA,Savings
15-09-2025 02:44,CBA1FC8800F9A4E450CB62E,063-000-001,22222222,ZOOM CBA,94.19,0,1281211.19,DR,REF894096,CBA,Savings
15-09-2025 02:47,CBA5149A6C60F6146F8B77E,063-000-001,22222222,WOOLWORTHS CBA,38.19,0,1281173,DR,REF919113,CBA,Savings
15-09-2025 02:55,CBA57985147647945A19562,063-000-001,22222222,WOOLWORTHS CBA,101.59,0,1281071.41,DR,REF396386,CBA,Savings
15-09-2025 03:29,CBA0DEAE324A6F541F9B5BF,063-000-001,22222222,WAGES CREDIT CBA,0,1828.76,1282900.17,CR,REF742023,CBA,Savings
15-09-2025 03:40,CBABBE259EB36564C759548,063-000-001,22222222,JB HI-FI CBA,6.65,0,1282893.52,DR,REF249319,CBA,Savings
15-09-2025 03:48,CBADC91D434EE5042FDAE05,063-000-001,22222222,PAYPAL *NETFLIX CBA,8.48,0,1282885.04,DR,REF931085,CBA,Savings
15-09-2025 04:13,CBA72263246D5194C0F8CBE,063-000-001,22222222,APPLE CBA,35.81,0,1282849.23,DR,REF611284,CBA,Savings
15-09-2025 04:17,CBA21F53BBEC35E4BD9AF0C,063-000-001,22222222,CITYLINK CBA,8.71,0,1282840.52,DR,REF692331,CBA,Savings
15-09-2025 04:26,CBAE41BDE9DA38548CEA359,063-000-001,22222222,HARVEY NORMAN CBA,25.63,0,1282814.89,DR,REF321840,CBA,Savings
15-09-2025 04:38,CBA1C7D9F2E493646049FB5,063-000-001,22222222,BANK FEE CBA,143.37,0,1282671.52,DR,REF820970,CBA,Savings
15-09-2025 05:05,CBACE3119D8C81944E5859F,063-000-001,22222222,BWS CBA,4.53,0,1282666.99,DR,REF537827,CBA,Savings
15-09-2025 05:09,INT60577AF602D24F3AAF07,063-000-001,22222222,TRANSFER FROM CBA 33333333,0,1317.2,1283984.19,CR,INT-45363,CBA,Savings
15-09-2025 05:40,CBADD9BA7AF51E24DF4BC84,063-000-001,22222222,7-ELEVEN CBA,19.64,0,1283964.55,DR,REF524148,CBA,Savings
15-09-2025 05:57,CBA9D87390EB1C34A48B11F,063-000-001,22222222,STARBUCKS CBA,92.17,0,1283872.38,DR,REF648546,CBA,Savings
15-09-2025 06:16,CBAEA103683FE084B9797EF,063-000-001,22222222,ALDI CBA,101.16,0,1283771.22,DR,REF375772,CBA,Savings
15-09-2025 06:29,CBA562A4589556946799D1C,063-000-001,22222222,COLES CBA,28.72,0,1283742.5,DR,REF569864,CBA,Savings
15-09-2025 07:10,CBA455A8A02FAC54B5CAF65,063-000-001,22222222,MCDONALDS CBA,12.13,0,1283730.37,DR,REF272533,CBA,Savings
15-09-2025 07:14,CBAEA5BBE3CEA234C8AB975,063-000-001,22222222,STARBUCKS CBA,80.22,0,1283650.15,DR,REF713896,CBA,Savings
15-09-2025 07:15,CBA36E28E20E2E24DA09BA0,063-000-001,22222222,PAY - SALARY CBA,0,1181.35,1284831.5,CR,REF645800,CBA,Savings
15-09-2025 07:22,CBAE7ACE1B6780248E080F0,063-000-001,22222222,LIQUORLAND CBA,59.64,0,1284771.86,DR,REF623595,CBA,Savings
15-09-2025 07:49,INTEDF4C6F8BD7F4A7283E9,063-000-001,22222222,TRANSFER FROM NAB 44444444,0,1237.57,1286009.43,CR,INT-41715,CBA,Savings
15-09-2025 08:49,CBA22152918A6A14B6AB528,063-000-001,22222222,BWS CBA,37.72,0,1285971.71,DR,REF816872,CBA,Savings
15-09-2025 08:49,CBACAA3857ECBA445A5980A,063-000-001,22222222,7-ELEVEN CBA,96.26,0,1285875.45,DR,REF458897,CBA,Savings
15-09-2025 08:58,CBA4BA8ED36C02949AA84E5,063-000-001,22222222,WOOLWORTHS CBA,96.88,0,1285778.57,DR,REF598729,CBA,Savings
15-09-2025 09:26,CBA66249A608FE94462873C,063-000-001,22222222,APPLE CBA,64.65,0,1285713.92,DR,REF625133,CBA,Savings
15-09-2025 09:33,CBAAC243005DDFF4F7CA983,063-000-001,22222222,DOMINO'S PIZZA CBA,14.52,0,1285699.4,DR,REF248916,CBA,Savings
15-09-2025 10:34,CBA1FA64D4EEE5442A1B793,063-000-001,22222222,COLES CBA,15.67,0,1285683.73,DR,REF832397,CBA,Savings
15-09-2025 10:40,CBAB116C14085E746E68E5C,063-000-001,22222222,SPOTIFY CBA,82.53,0,1285601.2,DR,REF186668,CBA,Savings
15-09-2025 10:52,CBAE4370D80F0CF417397BB,063-000-001,22222222,WAGES CREDIT CBA,0,1134.31,1286735.51,CR,REF952208,CBA,Savings
15-09-2025 11:00,CBAE34B630601474F8CBE02,063-000-001,22222222,TAFE BOOKSHOP CBA,93.68,0,1286641.83,DR,REF941678,CBA,Savings
15-09-2025 11:04,CBA2A0CCA0142D04547ABD1,063-000-001,22222222,BIGW CBA,65.25,0,1286576.58,DR,REF473951,CBA,Savings
15-09-2025 12:01,CBA27BB8096C1A1448FBD32,063-000-001,22222222,7-ELEVEN CBA,164.51,0,1286412.07,DR,REF736536,CBA,Savings
15-09-2025 12:06,CBA7E50AAABE8834D49B415,063-000-001,22222222,BP CBA,47.5,0,1286364.57,DR,REF905130,CBA,Savings
15-09-2025 12:06,INTF16939C1E1E6444DACD5,063-000-001,22222222,TRANSFER TO ANZ 11111111,1711.14,0,1284653.43,DR,INT-23993,CBA,Savings
15-09-2025 12:33,CBA0DEF0433CD0E45D6909C,063-000-001,22222222,ALDI CBA,23.28,0,1284630.15,DR,REF962250,CBA,Savings
15-09-2025 12:45,CBA8BFED3CF3C7C4A28B42B,063-000-001,22222222,APPLE CBA,2.48,0,1284627.67,DR,REF191361,CBA,Savings
15-09-2025 12:55,CBACD1AF8E469A64A6F9908,063-000-001,22222222,BP CBA,22.76,0,1284604.91,DR,REF721319,CBA,Savings
15-09-2025 13:27,CBA9A085AB700C249E4B1BA,063-000-001,22222222,STARBUCKS CBA,88.96,0,1284515.95,DR,REF976273,CBA,Savings
15-09-2025 13:42,CBA55B43FA3AB1C40F99FB9,063-000-001,22222222,WOOLWORTHS CBA,14.99,0,1284500.96,DR,REF805185,CBA,Savings
15-09-2025 13:42,CBA1982C6C6CBF24CB59D30,063-000-001,22222222,UBER EATS CBA,97.69,0,1284403.27,DR,REF224414,CBA,Savings
15-09-2025 13:50,CBA509EC36FB016463C8199,063-000-001,22222222,FLIXBUS CBA,11.9,0,1284391.37,DR,REF168840,CBA,Savings
15-09-2025 13:53,CBA20798768FC6A48EDB2D6,063-000-001,22222222,ALDI CBA,79.51,0,1284311.86,DR,REF897729,CBA,Savings
15-09-2025 14:00,CBA077D1061F3D24C4B8F9D,063-000-001,22222222,COLES CBA,28.71,0,1284283.15,DR,REF422509,CBA,Savings
15-09-2025 14:08,CBAEF06E0DA3F9B4ED88B82,063-000-001,22222222,PAYPAL *NETFLIX CBA,11.31,0,1284271.84,DR,REF540117,CBA,Savings
15-09-2025 14:19,CBA3B52A0326DE445F08944,063-000-001,22222222,AMAZON AU CBA,56.09,0,1284215.75,DR,REF654327,CBA,Savings
15-09-2025 15:04,CBAF465E1B3FBC149D2B124,063-000-001,22222222,LIQUORLAND CBA,20.53,0,1284195.22,DR,REF526798,CBA,Savings
15-09-2025 16:02,CBAA0D0416CF65F4F5E921D,063-000-001,22222222,PAYPAL *NETFLIX CBA,71.27,0,1284123.95,DR,REF720834,CBA,Savings
15-09-2025 16:09,CBAFDAF42D91CAD43DB91BF,063-000-001,22222222,PAYMENT GATEWAY CBA,15.16,0,1284108.79,DR,REF798467,CBA,Savings
15-09-2025 17:03,CBAC47E374C70C242E8800F,063-000-001,22222222,AMAZON AU CBA,21.14,0,1284087.65,DR,REF481879,CBA,Savings
15-09-2025 17:21,CBA0FC25D3667054F009BEA,063-000-001,22222222,BP CBA,24.27,0,1284063.38,DR,REF800904,CBA,Savings
15-09-2025 17:45,CBAC6029085C3C345FABCAF,063-000-001,22222222,FLIXBUS CBA,85.31,0,1283978.07,DR,REF150021,CBA,Savings
15-09-2025 17:58,CBA23D5177088924273A4C8,063-000-001,22222222,SHELL CBA,23.42,0,1283954.65,DR,REF468975,CBA,Savings
15-09-2025 18:06,CBA30F941E845274AA89E43,063-000-001,22222222,INTERNET TRANSFER CBA,71.45,0,1283883.2,DR,REF903997,CBA,Savings
15-09-2025 18:37,CBAC4D8CB90002C40C3A479,063-000-001,22222222,AMAZON AU CBA,181.18,0,1283702.02,DR,REF118082,CBA,Savings
15-09-2025 18:39,CBA5119E471D30B4FA48C3E,063-000-001,22222222,7-ELEVEN CBA,6.19,0,1283695.83,DR,REF881865,CBA,Savings
15-09-2025 18:48,CBA33C8C9935A704EE7B33B,063-000-001,22222222,BP CBA,75.46,0,1283620.37,DR,REF672492,CBA,Savings
15-09-2025 19:22,CBACAE00F69D6F5454591F8,063-000-001,22222222,KFC CBA,57.15,0,1283563.22,DR,REF308333,CBA,Savings
15-09-2025 19:42,CBA700871BAEBB7467FB123,063-000-001,22222222,7-ELEVEN CBA,54.14,0,1283509.08,DR,REF254279,CBA,Savings
15-09-2025 19:44,CBACDF32E24E7BB4ED69FED,063-000-001,22222222,BIGW CBA,50.87,0,1283458.21,DR,REF445659,CBA,Savings
15-09-2025 20:01,CBABB6A1EC215C84B979C04,063-000-001,22222222,PAYROLL CREDIT CBA,0,2923.17,1286381.38,CR,REF160531,CBA,Savings
15-09-2025 20:06,CBA8D103536C58B4BD1AC25,063-000-001,22222222,UBER EATS CBA,71.02,0,1286310.36,DR,REF852979,CBA,Savings
15-09-2025 20:07,CBAFA31434961304CA28880,063-000-001,22222222,SPOTIFY CBA,28.77,0,1286281.59,DR,REF403600,CBA,Savings
15-09-2025 20:11,CBA4CA2D46F8CE64B49868A,063-000-001,22222222,SHELL CBA,16.23,0,1286265.36,DR,REF198593,CBA,Savings
15-09-2025 21:06,CBAD1E3AEE960C547C2B61D,063-000-001,22222222,INTERNET TRANSFER CBA,91.58,0,1286173.78,DR,REF585593,CBA,Savings
15-09-2025 21:08,CBA9057FDFAB6D04F748E85,063-000-001,22222222,COMPANY PAYROLL CBA,0,4091.98,1290265.76,CR,REF442756,CBA,Savings
15-09-2025 21:50,CBAE84190E2473547A5820E,063-000-001,22222222,BANK FEE CBA,10.17,0,1290255.59,DR,REF900462,CBA,Savings
15-09-2025 21:55,CBA6B82D9C1B84E46F8AA7E,063-000-001,22222222,MCDONALDS CBA,38.76,0,1290216.83,DR,REF644193,CBA,Savings
15-09-2025 22:13,CBA9D91D43401854A0AB57B,063-000-001,22222222,BIGW CBA,21,0,1290195.83,DR,REF315324,CBA,Savings
15-09-2025 22:15,CBAAC25CA08D66142B0A27F,063-000-001,22222222,APPLE CBA,54.09,0,1290141.74,DR,REF817037,CBA,Savings
15-09-2025 22:16,CBA8B7F33DA68264177BBB5,063-000-001,22222222,DOMINO'S PIZZA CBA,66.5,0,1290075.24,DR,REF252676,CBA,Savings
15-09-2025 22:46,CBAEC3EF3E920B843F7BD04,063-000-001,22222222,WOOLWORTHS CBA,50.12,0,1290025.12,DR,REF614844,CBA,Savings
15-09-2025 22:48,CBA75A119F9EA31447EA9DE,063-000-001,22222222,RAILWAY STATION CBA,19.49,0,1290005.63,DR,REF934593,CBA,Savings
15-09-2025 23:35,CBAF00116A9406341ED8AB6,063-000-001,22222222,APPLE CBA,31.44,0,1289974.19,DR,REF558820,CBA,Savings
15-09-2025 23:47,CBA3A1D98EB07DB42F58C9D,063-000-001,22222222,LIQUORLAND CBA,57.79,0,1289916.4,DR,REF571945,CBA,Savings
15-09-2025 23:55,CBA1E65F9C1CD9D4E4C92BA,063-000-001,22222222,PAY - SALARY CBA,0,2139.92,1292056.32,CR,REF973428,CBA,Savings
16-09-2025 00:02,CBAC99CA3D9E9EC40DBAA4A,063-000-001,22222222,WAGES CREDIT CBA,0,4144.11,1296200.43,CR,REF899898,CBA,Savings
16-09-2025 00:03,CBAB69C18EB125143B8B0DF,063-000-001,22222222,TAFE BOOKSHOP CBA,7.54,0,1296192.89,DR,REF106933,CBA,Savings
16-09-2025 00:47,CBAF97FA8F8F1F44FFAABB0,063-000-001,22222222,ALDI CBA,16.87,0,1296176.02,DR,REF411043,CBA,Savings
16-09-2025 00:59,CBA5BF4E2644CA647B98B83,063-000-001,22222222,BIGW CBA,23.02,0,1296153,DR,REF560075,CBA,Savings
16-09-2025 01:00,CBA928C7932FBD74C1BA85E,063-000-001,22222222,DOMINO'S PIZZA CBA,17.61,0,1296135.39,DR,REF523735,CBA,Savings
16-09-2025 01:06,CBA871DD929E3DD41B3A042,063-000-001,22222222,BP CBA,82.93,0,1296052.46,DR,REF781569,CBA,Savings
16-09-2025 01:16,CBA0977A612028345408D6E,063-000-001,22222222,PAY - SALARY CBA,0,526.43,1296578.89,CR,REF596451,CBA,Savings
16-09-2025 01:46,CBA78C486B809294988B2C0,063-000-001,22222222,TAFE BOOKSHOP CBA,139.06,0,1296439.83,DR,REF869605,CBA,Savings
16-09-2025 02:03,CBA0CF44015AA5A4E759F20,063-000-001,22222222,RAILWAY STATION CBA,64.49,0,1296375.34,DR,REF706754,CBA,Savings
16-09-2025 02:40,CBA18AF0BF1BA8E460693ED,063-000-001,22222222,PAYMENT GATEWAY CBA,26.56,0,1296348.78,DR,REF811203,CBA,Savings
16-09-2025 02:48,CBA8F68F8763AF84197B05C,063-000-001,22222222,AMAZON AU CBA,20.28,0,1296328.5,DR,REF795360,CBA,Savings
16-09-2025 02:55,CBA067B81A1935E44F695F6,063-000-001,22222222,APPLE CBA,49.34,0,1296279.16,DR,REF337417,CBA,Savings
16-09-2025 02:59,CBAA34B6C2B783E40E78B0B,063-000-001,22222222,MENULOG CBA,223.54,0,1296055.62,DR,REF786039,CBA,Savings
16-09-2025 03:06,CBA68E02D5B920D43188B96,063-000-001,22222222,BP CBA,11.92,0,1296043.7,DR,REF125125,CBA,Savings
16-09-2025 03:44,CBAE726137FB94443D4B09D,063-000-001,22222222,APPLE CBA,64.76,0,1295978.94,DR,REF949494,CBA,Savings
16-09-2025 03:44,CBA5E266119DD654C5FBDF9,063-000-001,22222222,PAYMENT GATEWAY CBA,138.75,0,1295840.19,DR,REF669138,CBA,Savings
16-09-2025 04:09,CBAD84481A98F0242BC9D9F,063-000-001,22222222,WAGES CREDIT CBA,0,705.4,1296545.59,CR,REF104843,CBA,Savings
16-09-2025 04:13,CBAB07B2A958EAB40009639,063-000-001,22222222,HARVEY NORMAN CBA,26.99,0,1296518.6,DR,REF530434,CBA,Savings
16-09-2025 04:16,CBAB7D21005D3374890A5F5,063-000-001,22222222,COLES CBA,40.77,0,1296477.83,DR,REF819843,CBA,Savings
16-09-2025 04:23,CBA57E0C8B5B8884F94840E,063-000-001,22222222,PAYPAL *NETFLIX CBA,91.8,0,1296386.03,DR,REF664948,CBA,Savings
16-09-2025 04:38,CBAE185F43C6E68407FAF0B,063-000-001,22222222,WOOLWORTHS CBA,34.15,0,1296351.88,DR,REF378071,CBA,Savings
16-09-2025 04:54,CBA30F409DA7E0D4B0F90C2,063-000-001,22222222,RAILWAY STATION CBA,27.93,0,1296323.95,DR,REF697354,CBA,Savings
16-09-2025 05:02,CBA99EB821E509D4984AAD6,063-000-001,22222222,MCDONALDS CBA,28.89,0,1296295.06,DR,REF661335,CBA,Savings
16-09-2025 05:17,CBA1705FE2B3F364D21AE88,063-000-001,22222222,KFC CBA,120.66,0,1296174.4,DR,REF607558,CBA,Savings
16-09-2025 05:38,CBA58B54B1D309947E1AAC1,063-000-001,22222222,BANK FEE CBA,53.55,0,1296120.85,DR,REF463870,CBA,Savings
16-09-2025 06:25,CBAC3094BE908364E319905,063-000-001,22222222,MENULOG CBA,14.18,0,1296106.67,DR,REF395739,CBA,Savings
16-09-2025 06:55,CBA5A0E081A39B040C1A7DF,063-000-001,22222222,INTERNET TRANSFER CBA,46.37,0,1296060.3,DR,REF222481,CBA,Savings
16-09-2025 07:09,CBAE925642DD9844BE98B76,063-000-001,22222222,PAY - SALARY CBA,0,6415.43,1302475.73,CR,REF626046,CBA,Savings
16-09-2025 07:11,INT6C5C54A8C0D54B4D9572,063-000-001,22222222,TRANSFER TO NAB 44444444,704.45,0,1301771.28,DR,INT-45067,CBA,Savings
16-09-2025 07:24,CBA34A9E46414124E8A8CEC,063-000-001,22222222,SPOTIFY CBA,27.25,0,1301744.03,DR,REF809306,CBA,Savings
16-09-2025 07:44,CBA351E9F92399A4C45859C,063-000-001,22222222,MENULOG CBA,115.83,0,1301628.2,DR,REF107975,CBA,Savings
16-09-2025 07:49,CBA55C913CD8CD4453DA1C7,063-000-001,22222222,STARBUCKS CBA,19.15,0,1301609.05,DR,REF444265,CBA,Savings
16-09-2025 08:11,CBA357ADD9C1CAE44D9BFF9,063-000-001,22222222,PAYROLL CREDIT CBA,0,814.37,1302423.42,CR,REF496117,CBA,Savings
16-09-2025 08:20,CBA5C17D3C9F31742CDA234,063-000-001,22222222,INTERNET TRANSFER CBA,96.77,0,1302326.65,DR,REF680118,CBA,Savings
16-09-2025 09:03,CBAF4CC8A6026134D13BACA,063-000-001,22222222,FLIXBUS CBA,5.52,0,1302321.13,DR,REF201713,CBA,Savings
16-09-2025 09:36,CBA29527E90970743D59958,063-000-001,22222222,ALDI CBA,14.94,0,1302306.19,DR,REF714405,CBA,Savings
16-09-2025 09:41,CBA58E5299C90264F5E8F99,063-000-001,22222222,STARBUCKS CBA,39.58,0,1302266.61,DR,REF186563,CBA,Savings
16-09-2025 09:52,CBA482DED3E7D1A482ABF12,063-000-001,22222222,MENULOG CBA,18.67,0,1302247.94,DR,REF710261,CBA,Savings
16-09-2025 10:01,CBA295951653BB549109BBE,063-000-001,22222222,BP CBA,45.82,0,1302202.12,DR,REF798878,CBA,Savings
16-09-2025 10:05,CBA7F10F985ABF04BB08461,063-000-001,22222222,ALDI CBA,22.75,0,1302179.37,DR,REF149074,CBA,Savings
16-09-2025 10:07,CBA3414880458C0490B956D,063-000-001,22222222,SPOTIFY CBA,31.74,0,1302147.63,DR,REF114131,CBA,Savings
16-09-2025 10:26,CBAE53ED3A3E8244673A68C,063-000-001,22222222,JB HI-FI CBA,41.89,0,1302105.74,DR,REF851784,CBA,Savings
16-09-2025 10:33,CBAE2027A0C7EA54BCB86F6,063-000-001,22222222,RAILWAY STATION CBA,34.67,0,1302071.07,DR,REF542185,CBA,Savings
16-09-2025 10:36,CBAC7547F78E72A4BB888AE,063-000-001,22222222,BP CBA,100.72,0,1301970.35,DR,REF347020,CBA,Savings
16-09-2025 10:58,CBA5E1567142DA740459B40,063-000-001,22222222,PAYPAL *NETFLIX CBA,8.28,0,1301962.07,DR,REF936204,CBA,Savings
16-09-2025 11:10,CBAF3BC86B454D642249952,063-000-001,22222222,STARBUCKS CBA,69.33,0,1301892.74,DR,REF410873,CBA,Savings
16-09-2025 11:14,CBAF7C2DA42CDB64C5F8528,063-000-001,22222222,HARVEY NORMAN CBA,30.16,0,1301862.58,DR,REF808088,CBA,Savings
16-09-2025 11:16,CBA42A36C3D5DA7413CA51B,063-000-001,22222222,MENULOG CBA,17.37,0,1301845.21,DR,REF631340,CBA,Savings
16-09-2025 11:18,CBA796194435C4445789023,063-000-001,22222222,COLES CBA,41.19,0,1301804.02,DR,REF188762,CBA,Savings
16-09-2025 11:22,CBA688B9538D6954631BBA1,063-000-001,22222222,ALDI CBA,62.02,0,1301742,DR,REF912272,CBA,Savings
16-09-2025 11:26,CBA18583EB889E748CAB7EB,063-000-001,22222222,HARVEY NORMAN CBA,19.71,0,1301722.29,DR,REF853929,CBA,Savings
16-09-2025 12:00,CBA42D012EA5A5247508466,063-000-001,22222222,MENULOG CBA,41.24,0,1301681.05,DR,REF876224,CBA,Savings
16-09-2025 12:37,CBAC2D128F08E884B4DB590,063-000-001,22222222,ALDI CBA,19.34,0,1301661.71,DR,REF813339,CBA,Savings
16-09-2025 12:40,CBABAB7244E7C1648C0B7C0,063-000-001,22222222,MENULOG CBA,6.69,0,1301655.02,DR,REF871231,CBA,Savings
16-09-2025 12:47,CBA6C3FBE0BD30D4D8FA8BE,063-000-001,22222222,KFC CBA,68.35,0,1301586.67,DR,REF120667,CBA,Savings
16-09-2025 13:17,CBAE1041B20E6A047E8A74B,063-000-001,22222222,UBER EATS CBA,40.31,0,1301546.36,DR,REF632951,CBA,Savings
16-09-2025 13:30,CBAC0396DD5C4CB46BAA6DD,063-000-001,22222222,ZOOM CBA,24.83,0,1301521.53,DR,REF173478,CBA,Savings
16-09-2025 13:31,CBA3827080AD27846C4ABF6,063-000-001,22222222,PAYPAL *NETFLIX CBA,134.81,0,1301386.72,DR,REF271076,CBA,Savings
16-09-2025 14:05,CBA7EA48C63C8DF4D1A8D34,063-000-001,22222222,BIGW CBA,118.49,0,1301268.23,DR,REF247564,CBA,Savings
16-09-2025 14:23,CBAE51E8C9904F64EF7B061,063-000-001,22222222,BWS CBA,37.94,0,1301230.29,DR,REF309724,CBA,Savings
16-09-2025 14:25,CBAFFB34507107E4D6389FE,063-000-001,22222222,INTERNET TRANSFER CBA,53.46,0,1301176.83,DR,REF508419,CBA,Savings
16-09-2025 14:33,CBA52C25973BE7D42DDACC2,063-000-001,22222222,DOMINO'S PIZZA CBA,37.2,0,1301139.63,DR,REF412441,CBA,Savings
16-09-2025 14:34,CBA26EB913740204BDF9AF6,063-000-001,22222222,PAYPAL *NETFLIX CBA,10.21,0,1301129.42,DR,REF234206,CBA,Savings
16-09-2025 15:05,CBAD0EF7C8ADBC34ADB8346,063-000-001,22222222,APPLE CBA,61.23,0,1301068.19,DR,REF371870,CBA,Savings
16-09-2025 15:30,CBAAD46468D0EBD4FC1BBFE,063-000-001,22222222,BWS CBA,94.15,0,1300974.04,DR,REF513081,CBA,Savings
16-09-2025 15:42,CBA38812430DAC0438A8E5D,063-000-001,22222222,SPOTIFY CBA,61.49,0,1300912.55,DR,REF888704,CBA,Savings
16-09-2025 16:06,CBA67F2CC4D34AE4FC694B7,063-000-001,22222222,SHELL CBA,55.42,0,1300857.13,DR,REF149052,CBA,Savings
16-09-2025 16:11,CBA8DF15568B75C4A20BFB3,063-000-001,22222222,7-ELEVEN CBA,59.6,0,1300797.53,DR,REF916507,CBA,Savings
16-09-2025 16:16,CBA24D74CEA2E214A359344,063-000-001,22222222,BANK FEE CBA,34.1,0,1300763.43,DR,REF527720,CBA,Savings
16-09-2025 16:45,CBA4F03E50D58864DD992E1,063-000-001,22222222,SPOTIFY CBA,67.48,0,1300695.95,DR,REF771175,CBA,Savings
16-09-2025 17:21,CBA48CF8078744D48948697,063-000-001,22222222,MCDONALDS CBA,14.38,0,1300681.57,DR,REF317545,CBA,Savings
16-09-2025 18:01,CBA5B49E1B629FE468881F3,063-000-001,22222222,SPOTIFY CBA,20.91,0,1300660.66,DR,REF484065,CBA,Savings
16-09-2025 18:06,CBA7A9877BBD4B64A388AF8,063-000-001,22222222,JB HI-FI CBA,172.76,0,1300487.9,DR,REF911701,CBA,Savings
16-09-2025 18:12,CBAF7ABDE9BEA154FE6B1B4,063-000-001,22222222,BWS CBA,10.91,0,1300476.99,DR,REF712450,CBA,Savings
16-09-2025 18:20,CBABAEA84BDB46F4FE6AFE3,063-000-001,22222222,7-ELEVEN CBA,44.93,0,1300432.06,DR,REF825717,CBA,Savings
16-09-2025 18:42,CBA3F71AAF25E954F7E8DF6,063-000-001,22222222,PAY - SALARY CBA,0,854.15,1301286.21,CR,REF112126,CBA,Savings
16-09-2025 19:00,CBAAF3159B85E974B6C9B57,063-000-001,22222222,PAYROLL CREDIT CBA,0,773.67,1302059.88,CR,REF890530,CBA,Savings
16-09-2025 19:04,CBA5DF704007623466BABB2,063-000-001,22222222,7-ELEVEN CBA,17.56,0,1302042.32,DR,REF497250,CBA,Savings
16-09-2025 19:22,CBA7BBB51FDE5734B429A76,063-000-001,22222222,ZOOM CBA,46.92,0,1301995.4,DR,REF939273,CBA,Savings
16-09-2025 19:25,CBA7F91ACF5C40C48D5BCDD,063-000-001,22222222,COLES CBA,147.85,0,1301847.55,DR,REF766198,CBA,Savings
16-09-2025 19:36,CBA68EC00D7B6C84CB5A51F,063-000-001,22222222,APPLE CBA,38.16,0,1301809.39,DR,REF774898,CBA,Savings
16-09-2025 19:58,CBA71892CB7BBDE43F1A275,063-000-001,22222222,MCDONALDS CBA,78.95,0,1301730.44,DR,REF472217,CBA,Savings
16-09-2025 20:15,CBA2C52E8CEBEA045D9BE41,063-000-001,22222222,MENULOG CBA,88.11,0,1301642.33,DR,REF755755,CBA,Savings
16-09-2025 21:10,INTFA7005DE4F574CE0BAE0,063-000-001,22222222,TRANSFER TO NAB 44444444,814.6,0,1300827.73,DR,INT-58596,CBA,Savings
16-09-2025 21:32,CBA553881E35965436EBFE6,063-000-001,22222222,7-ELEVEN CBA,54.26,0,1300773.47,DR,REF518799,CBA,Savings
16-09-2025 21:50,CBAFDA45C4A04F24BB4BC95,063-000-001,22222222,DOMINO'S PIZZA CBA,131.93,0,1300641.54,DR,REF132803,CBA,Savings
16-09-2025 22:13,CBA20E657F90E0D4F53B7B7,063-000-001,22222222,PAYPAL *NETFLIX CBA,17.34,0,1300624.2,DR,REF579918,CBA,Savings
16-09-2025 22:18,CBA6E3918CFAF4F409CBAD5,063-000-001,22222222,BIGW CBA,71.76,0,1300552.44,DR,REF752790,CBA,Savings
16-09-2025 22:39,CBA585C0C604902462583EB,063-000-001,22222222,UBER EATS CBA,16.59,0,1300535.85,DR,REF908132,CBA,Savings
16-09-2025 23:54,CBACBB8ACBC86B9410BB8DF,063-000-001,22222222,HARVEY NORMAN CBA,99.19,0,1300436.66,DR,REF682082,CBA,Savings
17-09-2025 00:11,CBADE9E50DD5CD74EDD8C6C,063-000-001,22222222,SHELL CBA,21.51,0,1300415.15,DR,REF709112,CBA,Savings
17-09-2025 00:27,CBAACF053E6EF5E426C92CF,063-000-001,22222222,PAYROLL CREDIT CBA,0,1123.11,1301538.26,CR,REF632446,CBA,Savings
17-09-2025 00:34,CBA61985E6C941A4E0A9E0F,063-000-001,22222222,ZOOM CBA,16.99,0,1301521.27,DR,REF450058,CBA,Savings
17-09-2025 00:34,CBACDFD8AF329F649039C40,063-000-001,22222222,HARVEY NORMAN CBA,15.14,0,1301506.13,DR,REF197837,CBA,Savings
17-09-2025 00:34,CBAE994C92A103E4DBEA2A4,063-000-001,22222222,FLIXBUS CBA,43.94,0,1301462.19,DR,REF174996,CBA,Savings
17-09-2025 00:39,CBAC5D08CE44A5049059A6D,063-000-001,22222222,UBER EATS CBA,61.77,0,1301400.42,DR,REF483589,CBA,Savings
17-09-2025 02:26,CBA2670B46A9E1D42448358,063-000-001,22222222,COLES CBA,26.74,0,1301373.68,DR,REF684075,CBA,Savings
17-09-2025 02:30,CBAEAEC7CEEA9164926BD33,063-000-001,22222222,WOOLWORTHS CBA,42.77,0,1301330.91,DR,REF466160,CBA,Savings
17-09-2025 02:36,CBA5471197CB711454DB0D5,063-000-001,22222222,CITYLINK CBA,48.72,0,1301282.19,DR,REF336596,CBA,Savings
17-09-2025 02:36,CBAAB0B873458B04820B777,063-000-001,22222222,WAGES CREDIT CBA,0,7053.48,1308335.67,CR,REF712960,CBA,Savings
17-09-2025 02:41,CBA9669C06E70CF4B808930,063-000-001,22222222,DOMINO'S PIZZA CBA,47.4,0,1308288.27,DR,REF796465,CBA,Savings
17-09-2025 03:06,CBA7164F6E336244EB1A199,063-000-001,22222222,FLIXBUS CBA,90.14,0,1308198.13,DR,REF939793,CBA,Savings
17-09-2025 03:13,CBA245E051287AD47889A66,063-000-001,22222222,ZOOM CBA,26.31,0,1308171.82,DR,REF503472,CBA,Savings
17-09-2025 03:25,CBAB1ED1CA9188A451B848A,063-000-001,22222222,PAY - SALARY CBA,0,6468.47,1314640.29,CR,REF315361,CBA,Savings
17-09-2025 03:46,CBAC293923ECC9C42D7A2C5,063-000-001,22222222,BIGW CBA,33.7,0,1314606.59,DR,REF269080,CBA,Savings
17-09-2025 04:12,CBA3C937A44BFB840648691,063-000-001,22222222,STARBUCKS CBA,19.53,0,1314587.06,DR,REF575808,CBA,Savings
17-09-2025 04:17,CBAF77172682A7A448CBBB7,063-000-001,22222222,LIQUORLAND CBA,54.98,0,1314532.08,DR,REF847573,CBA,Savings
17-09-2025 04:18,CBA27B61A1641B743E788B0,063-000-001,22222222,UBER EATS CBA,77.67,0,1314454.41,DR,REF253850,CBA,Savings
17-09-2025 04:43,CBA2184A158F74047BD8598,063-000-001,22222222,BP CBA,59.03,0,1314395.38,DR,REF121649,CBA,Savings
17-09-2025 04:47,CBA4ABEABE86EAE4A53A22B,063-000-001,22222222,SPOTIFY CBA,45.43,0,1314349.95,DR,REF439911,CBA,Savings
17-09-2025 05:36,CBA3DC3C43DD430450A9A4C,063-000-001,22222222,FLIXBUS CBA,186.12,0,1314163.83,DR,REF291792,CBA,Savings
17-09-2025 06:16,CBA1A2CA0743A4B40BC9471,063-000-001,22222222,CITYLINK CBA,141.78,0,1314022.05,DR,REF491835,CBA,Savings
17-09-2025 06:20,CBA6EA7F2C230274BA4AAB1,063-000-001,22222222,BP CBA,54.15,0,1313967.9,DR,REF554594,CBA,Savings
17-09-2025 06:21,CBA2A54ACBAE3EA40E0A326,063-000-001,22222222,COLES CBA,30.92,0,1313936.98,DR,REF723055,CBA,Savings
17-09-2025 06:22,CBA5534B25BB33B43A68CC5,063-000-001,22222222,JB HI-FI CBA,27.32,0,1313909.66,DR,REF747888,CBA,Savings
17-09-2025 06:36,CBAFE29ED936DFD4385A8D1,063-000-001,22222222,WOOLWORTHS CBA,13.11,0,1313896.55,DR,REF710531,CBA,Savings
17-09-2025 07:20,INT1D3D12C2C45B4260B397,063-000-001,22222222,TRANSFER TO CBA 33333333,1823.75,0,1312072.8,DR,INT-65058,CBA,Savings
17-09-2025 07:28,CBA40D64FDC8AEC4BF8AA30,063-000-001,22222222,UBER EATS CBA,110.07,0,1311962.73,DR,REF649763,CBA,Savings
17-09-2025 07:31,CBA3B50C1B25FDB430BA538,063-000-001,22222222,CITYLINK CBA,6.21,0,1311956.52,DR,REF476829,CBA,Savings
17-09-2025 07:38,CBA7171CCA68E5E4FDEB697,063-000-001,22222222,STARBUCKS CBA,31.61,0,1311924.91,DR,REF869329,CBA,Savings
17-09-2025 07:45,CBAA9A570C79C8D4901BF87,063-000-001,22222222,PAYMENT GATEWAY CBA,46.75,0,1311878.16,DR,REF262104,CBA,Savings
17-09-2025 08:15,CBA7277C628B35D4E14AE37,063-000-001,22222222,ALDI CBA,16.7,0,1311861.46,DR,REF863266,CBA,Savings
17-09-2025 08:19,CBA868B08D67EAD414EBB99,063-000-001,22222222,UBER EATS CBA,171.06,0,1311690.4,DR,REF505990,CBA,Savings
17-09-2025 09:20,CBA7B5070FD7CDD4E8BB74B,063-000-001,22222222,KFC CBA,9.79,0,1311680.61,DR,REF312809,CBA,Savings
17-09-2025 10:31,INTF82A7B7EAF85445E935B,063-000-001,22222222,TRANSFER TO ANZ 11111111,201.17,0,1311479.44,DR,INT-15306,CBA,Savings
17-09-2025 11:06,CBA8C8337EEFB02447B9BEA,063-000-001,22222222,AMAZON AU CBA,41.18,0,1311438.26,DR,REF185571,CBA,Savings
17-09-2025 11:09,CBA6BDFA92AF5A74963AB0F,063-000-001,22222222,BANK FEE CBA,35.47,0,1311402.79,DR,REF259805,CBA,Savings
17-09-2025 11:27,CBA9F1894AB750348658F1D,063-000-001,22222222,PAYMENT GATEWAY CBA,65.09,0,1311337.7,DR,REF529077,CBA,Savings
17-09-2025 11:52,CBAFC7548988B414D2992CF,063-000-001,22222222,RAILWAY STATION CBA,75.03,0,1311262.67,DR,REF276490,CBA,Savings
17-09-2025 11:57,CBAA1624D7969804386B391,063-000-001,22222222,STARBUCKS CBA,148.64,0,1311114.03,DR,REF722081,CBA,Savings
17-09-2025 12:16,CBA24A79918A2FA4B0099C5,063-000-001,22222222,CITYLINK CBA,44.93,0,1311069.1,DR,REF137476,CBA,Savings
17-09-2025 12:37,CBA5C7F977717364902B390,063-000-001,22222222,COMPANY PAYROLL CBA,0,4911.42,1315980.52,CR,REF265639,CBA,Savings
17-09-2025 13:23,CBA6654BB81A14A46FBAD93,063-000-001,22222222,TAFE BOOKSHOP CBA,195.27,0,1315785.25,DR,REF748126,CBA,Savings
17-09-2025 13:24,INT0B7B495E81E24891BC7E,063-000-001,22222222,TRANSFER FROM NAB 44444444,0,1179.91,1316965.16,CR,INT-80038,CBA,Savings
17-09-2025 13:29,CBAEE559A62D35A4DBE8767,063-000-001,22222222,BIGW CBA,5.59,0,1316959.57,DR,REF665875,CBA,Savings
17-09-2025 13:30,CBAAAC62C95B75C46D8BF95,063-000-001,22222222,BWS CBA,17.35,0,1316942.22,DR,REF979470,CBA,Savings
17-09-2025 14:06,CBAE96775F000F54DD8B389,063-000-001,22222222,FLIXBUS CBA,8.13,0,1316934.09,DR,REF988696,CBA,Savings
17-09-2025 14:19,CBAADBA0EB5E3064C9E9171,063-000-001,22222222,SALARY PAYMENT CBA,0,6399.56,1323333.65,CR,REF789975,CBA,Savings
17-09-2025 15:03,CBA1C69F155E39F47C18FC1,063-000-001,22222222,RAILWAY STATION CBA,51.91,0,1323281.74,DR,REF577799,CBA,Savings
17-09-2025 15:12,CBAFBD8C03B49CD47E39140,063-000-001,22222222,WAGES CREDIT CBA,0,5859.89,1329141.63,CR,REF785609,CBA,Savings
17-09-2025 15:37,CBAA8DCCD03E03849509FE3,063-000-001,22222222,PAYMENT GATEWAY CBA,2.72,0,1329138.91,DR,REF203852,CBA,Savings
17-09-2025 15:37,CBAA285EE6639DE4EA6A987,063-000-001,22222222,ZOOM CBA,5.12,0,1329133.79,DR,REF842993,CBA,Savings
17-09-2025 15:51,INT28C1C1B9BE9843BA822F,063-000-001,22222222,TRANSFER FROM NAB 44444444,0,725.57,1329859.36,CR,INT-71285,CBA,Savings
17-09-2025 15:54,CBA849A42B423C8494984ED,063-000-001,22222222,TAFE BOOKSHOP CBA,244.84,0,1329614.52,DR,REF837681,CBA,Savings
17-09-2025 16:16,CBAA520356C841244558BBA,063-000-001,22222222,BWS CBA,47.27,0,1329567.25,DR,REF272809,CBA,Savings
17-09-2025 16:34,CBAF42ED4C90B904D80AF5E,063-000-001,22222222,BANK FEE CBA,13.53,0,1329553.72,DR,REF297557,CBA,Savings
17-09-2025 16:48,CBA9E412794ADA245928BA3,063-000-001,22222222,BIGW CBA,53.78,0,1329499.94,DR,REF461695,CBA,Savings
17-09-2025 17:13,CBA63BD74649C704C709BB9,063-000-001,22222222,TAFE BOOKSHOP CBA,44.85,0,1329455.09,DR,REF918882,CBA,Savings
17-09-2025 18:11,CBAED6E4C833A714676AF9F,063-000-001,22222222,WAGES CREDIT CBA,0,3508.51,1332963.6,CR,REF926025,CBA,Savings
17-09-2025 18:46,CBAAEF2FD8858454C51929E,063-000-001,22222222,FLIXBUS CBA,24.62,0,1332938.98,DR,REF950616,CBA,Savings
17-09-2025 19:05,CBAA2C917144ECE4F74AA9C,063-000-001,22222222,BP CBA,68.27,0,1332870.71,DR,REF546560,CBA,Savings
17-09-2025 19:10,CBADE192014E0EB469FAC8F,063-000-001,22222222,STARBUCKS CBA,44.03,0,1332826.68,DR,REF246899,CBA,Savings
17-09-2025 19:18,CBA76D385C80F2B49069901,063-000-001,22222222,MENULOG CBA,21.02,0,1332805.66,DR,REF192877,CBA,Savings
17-09-2025 19:27,CBA67E0C7543A8947E6B757,063-000-001,22222222,ZOOM CBA,3.89,0,1332801.77,DR,REF845997,CBA,Savings
17-09-2025 20:09,CBA3323821E7336407496CE,063-000-001,22222222,SHELL CBA,54.72,0,1332747.05,DR,REF831889,CBA,Savings
17-09-2025 20:10,CBA5156724D6FB4410AA2EA,063-000-001,22222222,APPLE CBA,33.65,0,1332713.4,DR,REF997043,CBA,Savings
17-09-2025 20:23,CBA261892ACD07A4594A880,063-000-001,22222222,LIQUORLAND CBA,15.33,0,1332698.07,DR,REF184782,CBA,Savings
17-09-2025 20:34,CBA66C6632D97034EDFB042,063-000-001,22222222,INTERNET TRANSFER CBA,61.01,0,1332637.06,DR,REF785565,CBA,Savings
17-09-2025 20:40,CBAF0CC5162E1E2425686F4,063-000-001,22222222,BWS CBA,23.39,0,1332613.67,DR,REF711853,CBA,Savings
17-09-2025 20:42,CBA771C43BF78C944B7B8A8,063-000-001,22222222,STARBUCKS CBA,35.92,0,1332577.75,DR,REF817332,CBA,Savings
17-09-2025 20:51,CBABA9AF0D1CFA44245A49F,063-000-001,22222222,ALDI CBA,47.44,0,1332530.31,DR,REF795928,CBA,Savings
17-09-2025 21:06,CBA9423E6136F52445C9277,063-000-001,22222222,SALARY PAYMENT CBA,0,3352.41,1335882.72,CR,REF511891,CBA,Savings
17-09-2025 21:36,INTD7946FF16E8D4C5E9703,063-000-001,22222222,TRANSFER TO CBA 33333333,500.72,0,1335382,DR,INT-22550,CBA,Savings
17-09-2025 21:48,INTBCF96BB6A7194598A36C,063-000-001,22222222,TRANSFER FROM NAB 44444444,0,705.15,1336087.15,CR,INT-31385,CBA,Savings
17-09-2025 21:50,INTD4B0A4A1E7374DDD9A19,063-000-001,22222222,TRANSFER TO ANZ 11111111,1205.46,0,1334881.69,DR,INT-56963,CBA,Savings
17-09-2025 22:36,CBAFB60D46E51634555BCB2,063-000-001,22222222,PAYMENT GATEWAY CBA,6.4,0,1334875.29,DR,REF466908,CBA,Savings
17-09-2025 22:49,CBA35D5925B81CF4C7EA7A1,063-000-001,22222222,FLIXBUS CBA,92.88,0,1334782.41,DR,REF469067,CBA,Savings
17-09-2025 23:06,CBAB81276FCC0744526B7A4,063-000-001,22222222,TAFE BOOKSHOP CBA,30.32,0,1334752.09,DR,REF976333,CBA,Savings
17-09-2025 23:17,CBA03733619DDFC40758579,063-000-001,22222222,PAYMENT GATEWAY CBA,28.98,0,1334723.11,DR,REF254418,CBA,Savings
17-09-2025 23:18,CBAB08F9DECA04F4C6B8897,063-000-001,22222222,KFC CBA,56.29,0,1334666.82,DR,REF582165,CBA,Savings
17-09-2025 23:29,CBA09FB10C0B6DC46A28F3F,063-000-001,22222222,LIQUORLAND CBA,30.97,0,1334635.85,DR,REF404624,CBA,Savings
17-09-2025 23:51,CBA51FC5B1B3BDD486F977E,063-000-001,22222222,MENULOG CBA,175.85,0,1334460,DR,REF371271,CBA,Savings
18-09-2025 00:02,CBA35BAFF18172E4252AD40,063-000-001,22222222,BWS CBA,9.77,0,1334450.23,DR,REF767081,CBA,Savings
18-09-2025 00:20,CBA7B6FFB78507A4AC4B5C4,063-000-001,22222222,JB HI-FI CBA,10.34,0,1334439.89,DR,REF830542,CBA,Savings
18-09-2025 00:30,CBA5C7BCEFC162A4B088C8C,063-000-001,22222222,HARVEY NORMAN CBA,58.35,0,1334381.54,DR,REF483186,CBA,Savings
18-09-2025 00:33,CBAEE73A4B6B18A47278843,063-000-001,22222222,ZOOM CBA,182.83,0,1334198.71,DR,REF157547,CBA,Savings
18-09-2025 01:15,INTADCB4E97B61845ED84F6,063-000-001,22222222,TRANSFER FROM CBA 33333333,0,225.03,1334423.74,CR,INT-10351,CBA,Savings
18-09-2025 01:22,CBA4C51ADB78BA04785B5B5,063-000-001,22222222,SHELL CBA,5.13,0,1334418.61,DR,REF236591,CBA,Savings
18-09-2025 01:28,CBAE36C178FFF944BC1A84D,063-000-001,22222222,TAFE BOOKSHOP CBA,2.52,0,1334416.09,DR,REF730619,CBA,Savings
18-09-2025 01:41,CBA43879E7362A74B9A9877,063-000-001,22222222,MCDONALDS CBA,83.41,0,1334332.68,DR,REF591270,CBA,Savings
18-09-2025 01:45,CBAA50F9B1B983E40C298FC,063-000-001,22222222,LIQUORLAND CBA,52.01,0,1334280.67,DR,REF850399,CBA,Savings
18-09-2025 01:45,CBAD10C8D7FAF2149E5BD6C,063-000-001,22222222,INTERNET TRANSFER CBA,45.51,0,1334235.16,DR,REF424918,CBA,Savings
18-09-2025 01:48,CBAEAEDA4D0953648B5927C,063-000-001,22222222,SALARY PAYMENT CBA,0,7353.86,1341589.02,CR,REF507793,CBA,Savings
18-09-2025 01:50,CBA4AB53D9B49FA417E95AE,063-000-001,22222222,AMAZON AU CBA,44.67,0,1341544.35,DR,REF544892,CBA,Savings
18-09-2025 01:53,CBA14B3A8D2B66046498F3C,063-000-001,22222222,TAFE BOOKSHOP CBA,97.98,0,1341446.37,DR,REF289465,CBA,Savings
18-09-2025 01:56,CBA5AB965E53D6D4B5B90CC,063-000-001,22222222,COMPANY PAYROLL CBA,0,351.91,1341798.28,CR,REF238180,CBA,Savings
18-09-2025 01:56,CBA4E0F59769F0C49959B64,063-000-001,22222222,ALDI CBA,26.48,0,1341771.8,DR,REF163210,CBA,Savings
18-09-2025 02:12,CBADEF6CF5DBF9A4B1682FF,063-000-001,22222222,AMAZON AU CBA,58.95,0,1341712.85,DR,REF980872,CBA,Savings
18-09-2025 02:44,CBA9216687414DE441E8630,063-000-001,22222222,INTERNET TRANSFER CBA,40.79,0,1341672.06,DR,REF166858,CBA,Savings
18-09-2025 03:06,CBA0CA5844EDF464CA0880B,063-000-001,22222222,PAYPAL *NETFLIX CBA,59.63,0,1341612.43,DR,REF588285,CBA,Savings
18-09-2025 03:33,CBA0182775F8F3244EC812B,063-000-001,22222222,WAGES CREDIT CBA,0,3478.48,1345090.91,CR,REF745271,CBA,Savings
18-09-2025 03:41,CBA370176CDAEED4788A51D,063-000-001,22222222,WAGES CREDIT CBA,0,1052.07,1346142.98,CR,REF268051,CBA,Savings
18-09-2025 03:57,CBA1C676B3C9BA647BFB96C,063-000-001,22222222,PAYMENT GATEWAY CBA,162.84,0,1345980.14,DR,REF713396,CBA,Savings
18-09-2025 04:00,CBA21A59E3633984D7DACEE,063-000-001,22222222,TAFE BOOKSHOP CBA,165.27,0,1345814.87,DR,REF819654,CBA,Savings
18-09-2025 04:02,CBAF5575C1139A74566A7E3,063-000-001,22222222,APPLE CBA,28.06,0,1345786.81,DR,REF670967,CBA,Savings
18-09-2025 04:06,CBA2DB48596DD0F4819B782,063-000-001,22222222,WAGES CREDIT CBA,0,3172.65,1348959.46,CR,REF845279,CBA,Savings
18-09-2025 04:09,CBA6305390299824DF59E3E,063-000-001,22222222,7-ELEVEN CBA,6.92,0,1348952.54,DR,REF425787,CBA,Savings
18-09-2025 04:16,CBA068994C15D9D467F8DDA,063-000-001,22222222,BANK FEE CBA,10.61,0,1348941.93,DR,REF458946,CBA,Savings
18-09-2025 04:36,CBA79CAC4A999584D8EB4F0,063-000-001,22222222,DOMINO'S PIZZA CBA,75.16,0,1348866.77,DR,REF975886,CBA,Savings
18-09-2025 04:57,CBA48A968781AD74432A030,063-000-001,22222222,RAILWAY STATION CBA,22.68,0,1348844.09,DR,REF234995,CBA,Savings
18-09-2025 05:50,CBA1E6A00ACEB2A4A21874E,063-000-001,22222222,PAYMENT GATEWAY CBA,44.01,0,1348800.08,DR,REF647869,CBA,Savings
18-09-2025 05:55,CBA4E1771DCBA70495AA1AD,063-000-001,22222222,UBER EATS CBA,7.64,0,1348792.44,DR,REF149313,CBA,Savings
18-09-2025 06:08,CBA6CC6784EEED746648ECE,063-000-001,22222222,PAY - SALARY CBA,0,5966.88,1354759.32,CR,REF582396,CBA,Savings
18-09-2025 06:18,CBA87BED97D65AB4348BC48,063-000-001,22222222,PAYMENT GATEWAY CBA,9.73,0,1354749.59,DR,REF253042,CBA,Savings
18-09-2025 06:28,CBADCA08D73995046549686,063-000-001,22222222,KFC CBA,20.06,0,1354729.53,DR,REF243748,CBA,Savings
18-09-2025 07:27,CBA38528C5A380C4735BDDF,063-000-001,22222222,CITYLINK CBA,42.36,0,1354687.17,DR,REF681689,CBA,Savings
18-09-2025 07:35,CBAA813F20D981E45EEB253,063-000-001,22222222,SALARY PAYMENT CBA,0,1030.41,1355717.58,CR,REF571812,CBA,Savings
18-09-2025 07:39,CBA83A88ADB98364ECF9748,063-000-001,22222222,SALARY PAYMENT CBA,0,7587,1363304.58,CR,REF569943,CBA,Savings
18-09-2025 07:43,CBA12E63CFCEE2242CABF08,063-000-001,22222222,UBER EATS CBA,60.6,0,1363243.98,DR,REF466906,CBA,Savings
18-09-2025 07:51,CBAC4E074E5F53C4227A805,063-000-001,22222222,MCDONALDS CBA,51.14,0,1363192.84,DR,REF641878,CBA,Savings
18-09-2025 08:01,CBA8AA69167E4CD462AA7ED,063-000-001,22222222,BANK FEE CBA,64.64,0,1363128.2,DR,REF943460,CBA,Savings
18-09-2025 08:10,CBABBF666FB1D67432C87FD,063-000-001,22222222,COMPANY PAYROLL CBA,0,4483.07,1367611.27,CR,REF986469,CBA,Savings
18-09-2025 08:47,CBA7884746D9CFB4940A5F6,063-000-001,22222222,INTERNET TRANSFER CBA,69.29,0,1367541.98,DR,REF515651,CBA,Savings
18-09-2025 09:14,CBABBEE14FDFAC94289BB0C,063-000-001,22222222,SPOTIFY CBA,50.71,0,1367491.27,DR,REF292635,CBA,Savings
18-09-2025 10:04,CBA9B4F026601DF43BE9742,063-000-001,22222222,SHELL CBA,94.23,0,1367397.04,DR,REF290501,CBA,Savings
18-09-2025 10:05,CBAD481866BFD0E4ECFBDDA,063-000-001,22222222,WAGES CREDIT CBA,0,7726.61,1375123.65,CR,REF347695,CBA,Savings
18-09-2025 10:29,CBAF8FA1082D06E4ADCA8AF,063-000-001,22222222,WOOLWORTHS CBA,17.32,0,1375106.33,DR,REF446859,CBA,Savings
18-09-2025 11:01,CBAD8EFE13ADCFB4A66954A,063-000-001,22222222,RAILWAY STATION CBA,43.31,0,1375063.02,DR,REF536247,CBA,Savings
18-09-2025 11:01,CBA402675B2DB7E413197FE,063-000-001,22222222,DOMINO'S PIZZA CBA,58.87,0,1375004.15,DR,REF732520,CBA,Savings
18-09-2025 11:16,CBAFC2D79DC32D246B4864E,063-000-001,22222222,SPOTIFY CBA,25.58,0,1374978.57,DR,REF848372,CBA,Savings
18-09-2025 11:19,CBA65BA2E84249648C9AF4E,063-000-001,22222222,JB HI-FI CBA,60.1,0,1374918.47,DR,REF191011,CBA,Savings
18-09-2025 11:34,CBAA0F29398FB5649168B90,063-000-001,22222222,STARBUCKS CBA,15.26,0,1374903.21,DR,REF462771,CBA,Savings
18-09-2025 11:37,CBA47858BF650CB469DB626,063-000-001,22222222,MCDONALDS CBA,48.63,0,1374854.58,DR,REF149260,CBA,Savings
18-09-2025 12:09,CBA67D54D0488AA492EAC99,063-000-001,22222222,PAYMENT GATEWAY CBA,3.85,0,1374850.73,DR,REF976703,CBA,Savings
18-09-2025 12:23,CBAE32D16F361C64A999226,063-000-001,22222222,BIGW CBA,27.14,0,1374823.59,DR,REF963762,CBA,Savings
18-09-2025 12:25,CBA9EB907249DB44C9ABF31,063-000-001,22222222,PAY - SALARY CBA,0,5682.32,1380505.91,CR,REF369490,CBA,Savings
18-09-2025 12:53,CBAF40156C34FC04E0EA2CD,063-000-001,22222222,ZOOM CBA,66.63,0,1380439.28,DR,REF229230,CBA,Savings
18-09-2025 12:55,CBA4BF3331A33E34EA38ACF,063-000-001,22222222,UBER EATS CBA,51.43,0,1380387.85,DR,REF801507,CBA,Savings
18-09-2025 13:42,CBA393C37BDE2CC4FAE88B9,063-000-001,22222222,LIQUORLAND CBA,14.56,0,1380373.29,DR,REF238339,CBA,Savings
18-09-2025 13:45,CBA61813F032D5B478489FE,063-000-001,22222222,BANK FEE CBA,73.25,0,1380300.04,DR,REF537254,CBA,Savings
18-09-2025 13:46,CBA6D7B3F065ED14306BB6D,063-000-001,22222222,INTERNET TRANSFER CBA,24.98,0,1380275.06,DR,REF434128,CBA,Savings
18-09-2025 13:52,CBA29B7D008FF1A41F19148,063-000-001,22222222,SALARY PAYMENT CBA,0,345.3,1380620.36,CR,REF986471,CBA,Savings
18-09-2025 13:56,CBA471382F1E0AC46979374,063-000-001,22222222,SALARY PAYMENT CBA,0,6337.3,1386957.66,CR,REF591497,CBA,Savings
18-09-2025 14:18,CBA2F0CB5635CF94EF4ABA0,063-000-001,22222222,COLES CBA,35.75,0,1386921.91,DR,REF780783,CBA,Savings
18-09-2025 14:29,CBA6B29A00C376C437FB8AB,063-000-001,22222222,SHELL CBA,118.93,0,1386802.98,DR,REF326706,CBA,Savings
18-09-2025 15:18,CBA39B7BE39D3DD4355A97D,063-000-001,22222222,HARVEY NORMAN CBA,7.94,0,1386795.04,DR,REF499219,CBA,Savings
18-09-2025 15:21,CBADDA88528753140F7B9AB,063-000-001,22222222,7-ELEVEN CBA,24.38,0,1386770.66,DR,REF375657,CBA,Savings
18-09-2025 15:54,CBAD96C242CC022483FAAF0,063-000-001,22222222,UBER EATS CBA,11.38,0,1386759.28,DR,REF505226,CBA,Savings
18-09-2025 15:56,CBA7F2AD1A1F79F43F78FC8,063-000-001,22222222,HARVEY NORMAN CBA,67.36,0,1386691.92,DR,REF512195,CBA,Savings
18-09-2025 16:19,CBAA11E600078934CC19039,063-000-001,22222222,7-ELEVEN CBA,119.28,0,1386572.64,DR,REF867040,CBA,Savings
18-09-2025 16:25,CBA652DA5FE1BBD4DE4A1B0,063-000-001,22222222,KFC CBA,11.95,0,1386560.69,DR,REF174299,CBA,Savings
18-09-2025 17:03,CBA9E6180DB330E489AAF6C,063-000-001,22222222,DOMINO'S PIZZA CBA,57.18,0,1386503.51,DR,REF148032,CBA,Savings
18-09-2025 17:50,CBA1D4C38942FD449ED86AF,063-000-001,22222222,MENULOG CBA,57.73,0,1386445.78,DR,REF470130,CBA,Savings
18-09-2025 18:20,CBA5707DA0BF92246B081A3,063-000-001,22222222,SALARY PAYMENT CBA,0,258.83,1386704.61,CR,REF442589,CBA,Savings
18-09-2025 18:49,CBA876906DF64544B898A27,063-000-001,22222222,CITYLINK CBA,154.75,0,1386549.86,DR,REF843850,CBA,Savings
18-09-2025 19:16,CBA8DBCAB6872EE49DFA58E,063-000-001,22222222,SHELL CBA,92.89,0,1386456.97,DR,REF781397,CBA,Savings
18-09-2025 19:53,CBA7F805395CF794751BE36,063-000-001,22222222,MENULOG CBA,6.46,0,1386450.51,DR,REF436884,CBA,Savings
18-09-2025 19:55,CBA5CB9E2A8E9CA4D278B83,063-000-001,22222222,WOOLWORTHS CBA,109.59,0,1386340.92,DR,REF305861,CBA,Savings
18-09-2025 20:07,CBA0C19F906F61849F38745,063-000-001,22222222,BWS CBA,25.22,0,1386315.7,DR,REF314747,CBA,Savings
18-09-2025 20:56,CBA1C6765CD41EC47B7B636,063-000-001,22222222,UBER EATS CBA,12.91,0,1386302.79,DR,REF320274,CBA,Savings
18-09-2025 21:01,CBAB6D413267C5F4F4DB3C7,063-000-001,22222222,RAILWAY STATION CBA,52.09,0,1386250.7,DR,REF366652,CBA,Savings
18-09-2025 21:09,CBA7A2350581D3E4CFBBA27,063-000-001,22222222,LIQUORLAND CBA,18.73,0,1386231.97,DR,REF303447,CBA,Savings
18-09-2025 21:21,CBA0D55A9100A38426DB8EF,063-000-001,22222222,COLES CBA,7.62,0,1386224.35,DR,REF439790,CBA,Savings
18-09-2025 21:24,CBA54ABE33244344B55BA81,063-000-001,22222222,PAY - SALARY CBA,0,432.13,1386656.48,CR,REF320316,CBA,Savings
18-09-2025 21:36,CBA0E3D1FE1132240A5AB95,063-000-001,22222222,FLIXBUS CBA,14.24,0,1386642.24,DR,REF329038,CBA,Savings
18-09-2025 21:57,CBA24403D4518FF4FDD8F9C,063-000-001,22222222,WOOLWORTHS CBA,4.89,0,1386637.35,DR,REF343424,CBA,Savings
18-09-2025 22:02,CBAFD16F71DF0F44F3688F9,063-000-001,22222222,SHELL CBA,52.49,0,1386584.86,DR,REF653521,CBA,Savings
18-09-2025 22:19,CBABF1B0770C96F458C8BE2,063-000-001,22222222,TAFE BOOKSHOP CBA,90.26,0,1386494.6,DR,REF203042,CBA,Savings
18-09-2025 22:29,CBA528B4406A12F421EB22A,063-000-001,22222222,LIQUORLAND CBA,2.8,0,1386491.8,DR,REF473685,CBA,Savings
18-09-2025 22:32,CBA73E548AE6D6342FC88FC,063-000-001,22222222,UBER EATS CBA,201.62,0,1386290.18,DR,REF158083,CBA,Savings
18-09-2025 22:39,CBAD977EAB31FEF45B8AA95,063-000-001,22222222,BANK FEE CBA,7.2,0,1386282.98,DR,REF990117,CBA,Savings
18-09-2025 22:45,CBA68D241E0FC374368AF14,063-000-001,22222222,ALDI CBA,7.23,0,1386275.75,DR,REF377511,CBA,Savings
18-09-2025 22:45,CBA05002B969FD24DE4A834,063-000-001,22222222,BIGW CBA,26.22,0,1386249.53,DR,REF274699,CBA,Savings
18-09-2025 23:24,CBA589A1BE002B94E948811,063-000-001,22222222,COMPANY PAYROLL CBA,0,352.58,1386602.11,CR,REF516234,CBA,Savings
18-09-2025 23:45,CBA8B1240945D6E47668B6C,063-000-001,22222222,MENULOG CBA,118.36,0,1386483.75,DR,REF491138,CBA,Savings
19-09-2025 00:01,CBA03CD0503E2A64D25A999,063-000-001,22222222,FLIXBUS CBA,30.75,0,1386453,DR,REF893816,CBA,Savings
19-09-2025 00:05,CBA92CF20343C2B4EFF804B,063-000-001,22222222,DOMINO'S PIZZA CBA,11.73,0,1386441.27,DR,REF789198,CBA,Savings
19-09-2025 00:09,CBA9EEAC22D28DF4A549872,063-000-001,22222222,PAYMENT GATEWAY CBA,69.03,0,1386372.24,DR,REF756464,CBA,Savings
19-09-2025 00:35,CBA9AEF872825D844C194ED,063-000-001,22222222,APPLE CBA,60.59,0,1386311.65,DR,REF681500,CBA,Savings
19-09-2025 00:52,CBA4EA1DF89230341939BFB,063-000-001,22222222,COMPANY PAYROLL CBA,0,842.46,1387154.11,CR,REF714028,CBA,Savings
19-09-2025 00:55,CBAC6A6602CD1B0404188A7,063-000-001,22222222,ALDI CBA,46.94,0,1387107.17,DR,REF696857,CBA,Savings
19-09-2025 01:03,CBA3D0D4469C5E341C1B0DF,063-000-001,22222222,HARVEY NORMAN CBA,68.05,0,1387039.12,DR,REF729173,CBA,Savings
19-09-2025 01:16,CBA4C015587E9114F73849E,063-000-001,22222222,PAY - SALARY CBA,0,741.3,1387780.42,CR,REF802032,CBA,Savings
19-09-2025 02:08,CBA2593F87448F7406A9EAA,063-000-001,22222222,MCDONALDS CBA,42.6,0,1387737.82,DR,REF154820,CBA,Savings
19-09-2025 02:15,CBAA0604B4B695F4370A78E,063-000-001,22222222,BANK FEE CBA,150.21,0,1387587.61,DR,REF110349,CBA,Savings
19-09-2025 02:31,CBA881B9E0F6CFA4285BB82,063-000-001,22222222,BIGW CBA,54.71,0,1387532.9,DR,REF901157,CBA,Savings
19-09-2025 02:44,CBA5D5E8A8035544EB68FA8,063-000-001,22222222,SALARY PAYMENT CBA,0,7278.9,1394811.8,CR,REF618855,CBA,Savings
19-09-2025 02:45,INT8D445601F6E040A7BE16,063-000-001,22222222,TRANSFER TO CBA 33333333,1514.49,0,1393297.31,DR,INT-74839,CBA,Savings
19-09-2025 02:48,CBA476C669C05914B1584EE,063-000-001,22222222,MCDONALDS CBA,54.65,0,1393242.66,DR,REF965237,CBA,Savings
19-09-2025 02:50,CBAA9D55912C778456D932D,063-000-001,22222222,MENULOG CBA,74.25,0,1393168.41,DR,REF149812,CBA,Savings
19-09-2025 03:42,CBAAB2427C5218842B784F7,063-000-001,22222222,ALDI CBA,16.89,0,1393151.52,DR,REF792938,CBA,Savings
19-09-2025 03:52,CBA26E7590D38FC48A4B149,063-000-001,22222222,7-ELEVEN CBA,118.74,0,1393032.78,DR,REF266810,CBA,Savings
19-09-2025 03:55,CBA05D26D5A04C1460C9CA7,063-000-001,22222222,MENULOG CBA,68.63,0,1392964.15,DR,REF945577,CBA,Savings
19-09-2025 03:59,CBA04762509AFE24B71BDF7,063-000-001,22222222,RAILWAY STATION CBA,240.07,0,1392724.08,DR,REF702385,CBA,Savings
19-09-2025 04:44,CBADDEB0FE1F250446BB726,063-000-001,22222222,UBER EATS CBA,32.31,0,1392691.77,DR,REF911910,CBA,Savings
19-09-2025 04:48,CBA4090ECEC3F6D476CBCF5,063-000-001,22222222,DOMINO'S PIZZA CBA,165.5,0,1392526.27,DR,REF466932,CBA,Savings
19-09-2025 05:09,INT73DB3E50D00847858D1C,063-000-001,22222222,TRANSFER TO NAB 44444444,148.21,0,1392378.06,DR,INT-13645,CBA,Savings
19-09-2025 05:24,CBA76C9C75A2A2549788A84,063-000-001,22222222,ZOOM CBA,58.45,0,1392319.61,DR,REF394136,CBA,Savings
19-09-2025 05:39,CBA0FBEBACA82B94C8C98ED,063-000-001,22222222,BP CBA,37.45,0,1392282.16,DR,REF990520,CBA,Savings
19-09-2025 06:08,CBA2F7A461B7F354E5BB837,063-000-001,22222222,PAY - SALARY CBA,0,872.82,1393154.98,CR,REF817951,CBA,Savings
19-09-2025 06:10,INT65A43EB2E1A14B5D906B,063-000-001,22222222,TRANSFER FROM CBA 33333333,0,874.2,1394029.18,CR,INT-39662,CBA,Savings
19-09-2025 06:31,CBAD12A3D743C9142F6BB2F,063-000-001,22222222,UBER EATS CBA,143.84,0,1393885.34,DR,REF169754,CBA,Savings
19-09-2025 06:33,CBA7E13B0D9C97945229F7E,063-000-001,22222222,STARBUCKS CBA,5.17,0,1393880.17,DR,REF375583,CBA,Savings
19-09-2025 06:53,CBA01BE45405A734D3E95EC,063-000-001,22222222,MENULOG CBA,17.76,0,1393862.41,DR,REF623131,CBA,Savings
19-09-2025 06:59,CBA5916B3CF6EE64C8C8BEF,063-000-001,22222222,PAYMENT GATEWAY CBA,6.44,0,1393855.97,DR,REF180863,CBA,Savings
19-09-2025 07:09,CBAB3507E3AD4E74D48B2EA,063-000-001,22222222,APPLE CBA,10.15,0,1393845.82,DR,REF125495,CBA,Savings
19-09-2025 07:56,CBABF94FD858C4E4A268EE3,063-000-001,22222222,COMPANY PAYROLL CBA,0,1065.46,1394911.28,CR,REF794075,CBA,Savings
19-09-2025 08:00,CBAEB66A4E4713E42CF8749,063-000-001,22222222,BANK FEE CBA,11.91,0,1394899.37,DR,REF105966,CBA,Savings
19-09-2025 08:13,CBA8BE504E7717340B3BAE0,063-000-001,22222222,PAY - SALARY CBA,0,6.82,1394906.19,CR,REF874380,CBA,Savings
19-09-2025 08:31,CBAA3E7F7A93B7B427BAA7D,063-000-001,22222222,CITYLINK CBA,26.01,0,1394880.18,DR,REF993143,CBA,Savings
19-09-2025 09:11,CBAC387A44D8A7D49C19C2F,063-000-001,22222222,WOOLWORTHS CBA,62.39,0,1394817.79,DR,REF677788,CBA,Savings
19-09-2025 09:12,CBA5223E3CBB6464131B566,063-000-001,22222222,COMPANY PAYROLL CBA,0,4707.52,1399525.31,CR,REF753029,CBA,Savings
19-09-2025 09:14,CBAD7436886DEA748CC9E7F,063-000-001,22222222,DOMINO'S PIZZA CBA,31.25,0,1399494.06,DR,REF288174,CBA,Savings
19-09-2025 09:22,CBA308971DB98244B65B7AB,063-000-001,22222222,STARBUCKS CBA,21.23,0,1399472.83,DR,REF656052,CBA,Savings
19-09-2025 09:44,CBA92B2CDC1D44049798449,063-000-001,22222222,MENULOG CBA,8.72,0,1399464.11,DR,REF531100,CBA,Savings
19-09-2025 09:57,CBAD796256F2D67472CBB38,063-000-001,22222222,COMPANY PAYROLL CBA,0,6374.62,1405838.73,CR,REF526507,CBA,Savings
19-09-2025 10:06,CBA3239084654AB4873B687,063-000-001,22222222,LIQUORLAND CBA,45.95,0,1405792.78,DR,REF333196,CBA,Savings
19-09-2025 10:29,CBAE6288232FE0648E48191,063-000-001,22222222,7-ELEVEN CBA,7.92,0,1405784.86,DR,REF479445,CBA,Savings
19-09-2025 10:46,CBAD4696CB680D847AA902D,063-000-001,22222222,COLES CBA,56.68,0,1405728.18,DR,REF316735,CBA,Savings
19-09-2025 11:15,CBAD39AAB80E27743F59586,063-000-001,22222222,ZOOM CBA,14.95,0,1405713.23,DR,REF384583,CBA,Savings
19-09-2025 11:16,CBA8D3330A9BDBB46A69AA4,063-000-001,22222222,7-ELEVEN CBA,55.22,0,1405658.01,DR,REF497569,CBA,Savings
19-09-2025 11:52,CBAA6A7862747E94745A1C7,063-000-001,22222222,BANK FEE CBA,21.5,0,1405636.51,DR,REF747146,CBA,Savings
19-09-2025 12:56,CBA2BB6F6DEA4794524B161,063-000-001,22222222,MENULOG CBA,20.58,0,1405615.93,DR,REF586203,CBA,Savings
19-09-2025 13:15,CBA05CFA226AE96469A97C5,063-000-001,22222222,PAYMENT GATEWAY CBA,295.59,0,1405320.34,DR,REF601231,CBA,Savings
19-09-2025 13:25,CBA696F5D277C5B4D64B777,063-000-001,22222222,TAFE BOOKSHOP CBA,51.27,0,1405269.07,DR,REF176545,CBA,Savings
19-09-2025 13:25,CBA3AF83F886E4A405BAF4E,063-000-001,22222222,BANK FEE CBA,27.96,0,1405241.11,DR,REF190808,CBA,Savings
19-09-2025 13:43,CBAEB1D5C0156D6443B9C00,063-000-001,22222222,SHELL CBA,16.65,0,1405224.46,DR,REF250626,CBA,Savings
19-09-2025 13:52,CBA27718B5F17324150B296,063-000-001,22222222,WAGES CREDIT CBA,0,333.53,1405557.99,CR,REF946660,CBA,Savings
19-09-2025 13:53,CBA439F6A85B99B47ADA0EE,063-000-001,22222222,FLIXBUS CBA,56.1,0,1405501.89,DR,REF995428,CBA,Savings
19-09-2025 14:13,CBAE8D32EFFC4694336A696,063-000-001,22222222,SPOTIFY CBA,100.64,0,1405401.25,DR,REF361125,CBA,Savings
19-09-2025 15:00,CBA5DBBC887E9A346D2AA41,063-000-001,22222222,INTERNET TRANSFER CBA,95.33,0,1405305.92,DR,REF273787,CBA,Savings
19-09-2025 16:10,CBA8964D07C48B348B788EF,063-000-001,22222222,SHELL CBA,50.53,0,1405255.39,DR,REF379937,CBA,Savings
19-09-2025 16:44,CBAE06403FDDBED4E93A846,063-000-001,22222222,COMPANY PAYROLL CBA,0,2887.01,1408142.4,CR,REF749567,CBA,Savings
19-09-2025 16:46,CBAC3FCBBFE209A4540B6FC,063-000-001,22222222,BIGW CBA,18.35,0,1408124.05,DR,REF458942,CBA,Savings
19-09-2025 16:47,CBAB97371056B42429AA265,063-000-001,22222222,INTERNET TRANSFER CBA,77.28,0,1408046.77,DR,REF888354,CBA,Savings
19-09-2025 16:50,CBA6291DA3A0DA2455C8004,063-000-001,22222222,MENULOG CBA,24.6,0,1408022.17,DR,REF579545,CBA,Savings
19-09-2025 17:45,CBAC0CA8D9510A34425BF66,063-000-001,22222222,UBER EATS CBA,10.33,0,1408011.84,DR,REF794406,CBA,Savings
19-09-2025 18:03,CBA1C49FAB48FF4469ABB96,063-000-001,22222222,KFC CBA,88.82,0,1407923.02,DR,REF508899,CBA,Savings
19-09-2025 18:08,CBA0CC7919E3A1A41CBBF6E,063-000-001,22222222,APPLE CBA,104.74,0,1407818.28,DR,REF552008,CBA,Savings
19-09-2025 18:26,CBADEB24E411E214D21A370,063-000-001,22222222,7-ELEVEN CBA,104.16,0,1407714.12,DR,REF196292,CBA,Savings
19-09-2025 18:55,CBA84A739B98AA043858F31,063-000-001,22222222,JB HI-FI CBA,76.49,0,1407637.63,DR,REF999405,CBA,Savings
19-09-2025 19:52,CBA8C9C160EEB3342F2B30C,063-000-001,22222222,RAILWAY STATION CBA,40.74,0,1407596.89,DR,REF640294,CBA,Savings
19-09-2025 20:15,INTBCBE806CC7804684AB66,063-000-001,22222222,TRANSFER TO ANZ 11111111,88.83,0,1407508.06,DR,INT-57339,CBA,Savings
19-09-2025 20:18,CBA91FCEABFA6B8417ABF42,063-000-001,22222222,AMAZON AU CBA,136.93,0,1407371.13,DR,REF506552,CBA,Savings
19-09-2025 20:20,CBA8045FBCD6FDE4BF4AE0C,063-000-001,22222222,APPLE CBA,68.55,0,1407302.58,DR,REF815237,CBA,Savings
19-09-2025 21:00,CBA8BC10AFD174E4F0DB4B2,063-000-001,22222222,ALDI CBA,20.36,0,1407282.22,DR,REF564274,CBA,Savings
19-09-2025 21:26,CBA404DAC32D3CC4BD081FC,063-000-001,22222222,JB HI-FI CBA,67.79,0,1407214.43,DR,REF173264,CBA,Savings
19-09-2025 21:34,CBAEEEB841039EA40578DED,063-000-001,22222222,STARBUCKS CBA,78.28,0,1407136.15,DR,REF232433,CBA,Savings
19-09-2025 21:52,CBA8C84B33FFA37415FA840,063-000-001,22222222,PAY - SALARY CBA,0,627.64,1407763.79,CR,REF367776,CBA,Savings
19-09-2025 21:55,CBA6FD24D1516774348890E,063-000-001,22222222,ZOOM CBA,16.4,0,1407747.39,DR,REF261748,CBA,Savings
19-09-2025 22:10,CBAB7E088C0A9494914B685,063-000-001,22222222,ALDI CBA,74.19,0,1407673.2,DR,REF820852,CBA,Savings
19-09-2025 22:26,CBA2B33003E0AD643B2A654,063-000-001,22222222,MCDONALDS CBA,3.21,0,1407669.99,DR,REF412531,CBA,Savings
19-09-2025 22:39,CBA229023B514D3478BAD8D,063-000-001,22222222,BWS CBA,23.91,0,1407646.08,DR,REF827127,CBA,Savings
19-09-2025 22:56,CBAC3DDEAE65CF34F3DAA39,063-000-001,22222222,WOOLWORTHS CBA,43.61,0,1407602.47,DR,REF110005,CBA,Savings
19-09-2025 22:57,CBA2958A0C3210146B496B2,063-000-001,22222222,PAYPAL *NETFLIX CBA,28.95,0,1407573.52,DR,REF927040,CBA,Savings
19-09-2025 23:34,CBA285C7F4EF7CA49E2936F,063-000-001,22222222,WOOLWORTHS CBA,13.65,0,1407559.87,DR,REF425917,CBA,Savings
19-09-2025 23:58,CBAB5E67A9021244FB6B316,063-000-001,22222222,AMAZON AU CBA,60.89,0,1407498.98,DR,REF158423,CBA,Savings
20-09-2025 00:25,CBAF7CD5BFED29C412581D1,063-000-001,22222222,ALDI CBA,14.89,0,1407484.09,DR,REF347586,CBA,Savings
20-09-2025 00:26,CBADCED5ABBE73B4BF78D1D,063-000-001,22222222,SHELL CBA,8.85,0,1407475.24,DR,REF918094,CBA,Savings
20-09-2025 00:34,CBA6D5C2C3D629C4E17854E,063-000-001,22222222,RAILWAY STATION CBA,77.39,0,1407397.85,DR,REF871452,CBA,Savings
20-09-2025 00:59,CBA4EC3E0D9B5704A7486F6,063-000-001,22222222,SALARY PAYMENT CBA,0,387.43,1407785.28,CR,REF918438,CBA,Savings
20-09-2025 01:06,CBAC1CD8460B021495FA5C3,063-000-001,22222222,SPOTIFY CBA,31.64,0,1407753.64,DR,REF683554,CBA,Savings
20-09-2025 01:27,CBAB131A02624BC45C8B958,063-000-001,22222222,7-ELEVEN CBA,96.09,0,1407657.55,DR,REF281148,CBA,Savings
20-09-2025 02:19,CBA944F122EEFAD4A5CA983,063-000-001,22222222,DOMINO'S PIZZA CBA,50.32,0,1407607.23,DR,REF132089,CBA,Savings
20-09-2025 02:40,CBA57041A12A7B04647A43A,063-000-001,22222222,PAYROLL CREDIT CBA,0,4005.91,1411613.14,CR,REF492215,CBA,Savings
20-09-2025 02:41,CBA526B4A2F9046493BB688,063-000-001,22222222,JB HI-FI CBA,7.82,0,1411605.32,DR,REF200740,CBA,Savings
20-09-2025 02:54,CBA187B6B9A95A4481D9D34,063-000-001,22222222,WOOLWORTHS CBA,21,0,1411584.32,DR,REF690448,CBA,Savings
20-09-2025 03:13,CBA4E16B9595C844E8DB45F,063-000-001,22222222,7-ELEVEN CBA,6,0,1411578.32,DR,REF245241,CBA,Savings
20-09-2025 03:15,CBAD7534BBD624547518D0D,063-000-001,22222222,PAYMENT GATEWAY CBA,81.5,0,1411496.82,DR,REF989392,CBA,Savings
20-09-2025 03:27,CBA8D95AE5E0DA04143B282,063-000-001,22222222,CITYLINK CBA,25.35,0,1411471.47,DR,REF820596,CBA,Savings
20-09-2025 03:43,CBA453AE9189E9F4A0D9215,063-000-001,22222222,COLES CBA,40.74,0,1411430.73,DR,REF907648,CBA,Savings
20-09-2025 03:51,CBAAB08B45EB0694314BAC7,063-000-001,22222222,BIGW CBA,5.74,0,1411424.99,DR,REF554063,CBA,Savings
20-09-2025 04:12,CBAB3748D1C102A4D8E8618,063-000-001,22222222,WOOLWORTHS CBA,58.99,0,1411366,DR,REF139031,CBA,Savings
20-09-2025 04:49,INT6F1716CB788440EE8110,063-000-001,22222222,TRANSFER TO CBA 33333333,188.1,0,1411177.9,DR,INT-55287,CBA,Savings
20-09-2025 05:31,CBA2AB22525777B4E0BA97C,063-000-001,22222222,PAYMENT GATEWAY CBA,27.14,0,1411150.76,DR,REF231564,CBA,Savings
20-09-2025 06:01,CBA19C3442A11394AB6AAB3,063-000-001,22222222,ALDI CBA,37.03,0,1411113.73,DR,REF157875,CBA,Savings
20-09-2025 06:01,CBA537DF8CC6A9E447890EE,063-000-001,22222222,MENULOG CBA,78.01,0,1411035.72,DR,REF304364,CBA,Savings
20-09-2025 06:45,CBA437CC364CFFE42509F8A,063-000-001,22222222,AMAZON AU CBA,61.65,0,1410974.07,DR,REF998759,CBA,Savings
20-09-2025 07:04,CBABB2CA3D7C49344E78A66,063-000-001,22222222,COMPANY PAYROLL CBA,0,5340.95,1416315.02,CR,REF441085,CBA,Savings
20-09-2025 07:29,CBA82FE33321FE0435AB16A,063-000-001,22222222,HARVEY NORMAN CBA,95.13,0,1416219.89,DR,REF683845,CBA,Savings
20-09-2025 07:39,CBA57448293C5C048319361,063-000-001,22222222,MCDONALDS CBA,69.89,0,1416150,DR,REF857123,CBA,Savings
20-09-2025 07:56,CBA8B119CCB9AE2404BA031,063-000-001,22222222,UBER EATS CBA,21.71,0,1416128.29,DR,REF879336,CBA,Savings
20-09-2025 08:01,CBA706BBD2C381C4A0C9B59,063-000-001,22222222,APPLE CBA,49.71,0,1416078.58,DR,REF597640,CBA,Savings
20-09-2025 08:21,CBAB20E3B5412164111B962,063-000-001,22222222,COLES CBA,10.01,0,1416068.57,DR,REF459286,CBA,Savings
20-09-2025 08:22,CBAC08B1BFC9C5D4782A3BE,063-000-001,22222222,SHELL CBA,18.07,0,1416050.5,DR,REF819693,CBA,Savings
20-09-2025 09:30,CBAFA6864ADB9CE4B50967C,063-000-001,22222222,BANK FEE CBA,52.23,0,1415998.27,DR,REF297393,CBA,Savings
20-09-2025 09:36,CBA1708A9E05CD54CBC97B7,063-000-001,22222222,HARVEY NORMAN CBA,45.09,0,1415953.18,DR,REF688586,CBA,Savings
20-09-2025 09:49,CBA81C033DB91D5451DAE48,063-000-001,22222222,BANK FEE CBA,4.24,0,1415948.94,DR,REF548191,CBA,Savings
20-09-2025 10:03,CBA826202406A7F407288B4,063-000-001,22222222,SPOTIFY CBA,6.44,0,1415942.5,DR,REF825398,CBA,Savings
20-09-2025 10:21,CBAA144276FFFC64853A2A6,063-000-001,22222222,ZOOM CBA,5.91,0,1415936.59,DR,REF334344,CBA,Savings
20-09-2025 10:31,CBABA1BEA2EDC5D40BC8C12,063-000-001,22222222,MCDONALDS CBA,27.53,0,1415909.06,DR,REF788387,CBA,Savings
20-09-2025 10:33,CBA66E66D03CDFC4CE99D38,063-000-001,22222222,WOOLWORTHS CBA,88.96,0,1415820.1,DR,REF823484,CBA,Savings
20-09-2025 11:28,CBA13B3294FC95F4DA0873E,063-000-001,22222222,BANK FEE CBA,5.36,0,1415814.74,DR,REF994339,CBA,Savings
20-09-2025 11:31,CBAE86B9B10BBEF49CDBE29,063-000-001,22222222,JB HI-FI CBA,17.88,0,1415796.86,DR,REF471275,CBA,Savings
20-09-2025 11:59,CBAE88A135FE7594F6DA9AA,063-000-001,22222222,APPLE CBA,17.51,0,1415779.35,DR,REF732050,CBA,Savings
20-09-2025 12:11,CBA0AACCF79D89C46C5BEFB,063-000-001,22222222,7-ELEVEN CBA,168.82,0,1415610.53,DR,REF441367,CBA,Savings
20-09-2025 12:19,CBAE0EC0C01932241DF9D77,063-000-001,22222222,DOMINO'S PIZZA CBA,62.65,0,1415547.88,DR,REF818580,CBA,Savings
20-09-2025 12:26,CBA9C2343150FE446A9BDD4,063-000-001,22222222,APPLE CBA,92.08,0,1415455.8,DR,REF202546,CBA,Savings
20-09-2025 12:29,CBA8BDA5597F25842ACB284,063-000-001,22222222,WOOLWORTHS CBA,8.52,0,1415447.28,DR,REF502758,CBA,Savings
20-09-2025 13:57,CBAB04BB7F33A3D4A63AB19,063-000-001,22222222,TAFE BOOKSHOP CBA,56.94,0,1415390.34,DR,REF471361,CBA,Savings
20-09-2025 14:27,CBACBDD74A163F4464DA126,063-000-001,22222222,RAILWAY STATION CBA,24.75,0,1415365.59,DR,REF724355,CBA,Savings
20-09-2025 14:27,CBA87588445B00C4B689DDA,063-000-001,22222222,APPLE CBA,24.34,0,1415341.25,DR,REF688322,CBA,Savings
20-09-2025 14:56,CBAC943DBF774264743880A,063-000-001,22222222,SPOTIFY CBA,40.73,0,1415300.52,DR,REF928437,CBA,Savings
20-09-2025 15:23,CBA8017DEF54E4E452DA64C,063-000-001,22222222,BP CBA,11.23,0,1415289.29,DR,REF246670,CBA,Savings
20-09-2025 16:30,CBAC4439C93D4E24EE09537,063-000-001,22222222,DOMINO'S PIZZA CBA,34.12,0,1415255.17,DR,REF206138,CBA,Savings
20-09-2025 16:34,CBAA14DA5FBA80A46DA87B6,063-000-001,22222222,ALDI CBA,141.43,0,1415113.74,DR,REF692767,CBA,Savings
20-09-2025 16:41,CBA8574F5B001B94BAA9038,063-000-001,22222222,SHELL CBA,80.81,0,1415032.93,DR,REF871094,CBA,Savings
20-09-2025 16:45,CBA68DEBA6BAEF94B3EA70C,063-000-001,22222222,KFC CBA,7.55,0,1415025.38,DR,REF507661,CBA,Savings
20-09-2025 16:45,CBA2E0A5EC865614E52B580,063-000-001,22222222,WOOLWORTHS CBA,217.71,0,1414807.67,DR,REF832357,CBA,Savings
20-09-2025 17:01,CBAA479227446BE49019B5D,063-000-001,22222222,INTERNET TRANSFER CBA,114.31,0,1414693.36,DR,REF246769,CBA,Savings
20-09-2025 17:10,CBA496AEC6F59BC410C8F0F,063-000-001,22222222,WOOLWORTHS CBA,81.26,0,1414612.1,DR,REF305551,CBA,Savings
20-09-2025 17:15,CBA5F8A327D931348A0BFC0,063-000-001,22222222,SHELL CBA,46.84,0,1414565.26,DR,REF176015,CBA,Savings
20-09-2025 17:20,CBACF6A62477C714EF0B39E,063-000-001,22222222,BIGW CBA,131.79,0,1414433.47,DR,REF545093,CBA,Savings
20-09-2025 17:53,CBA702F5BDB71E0422EB8B0,063-000-001,22222222,RAILWAY STATION CBA,83.87,0,1414349.6,DR,REF967972,CBA,Savings
20-09-2025 17:57,CBAA995AF60D3CE4616B5FE,063-000-001,22222222,HARVEY NORMAN CBA,55.5,0,1414294.1,DR,REF633466,CBA,Savings
20-09-2025 18:02,CBAE7FF186EB48C4DAF82A1,063-000-001,22222222,BP CBA,23.13,0,1414270.97,DR,REF160438,CBA,Savings
20-09-2025 18:24,CBA4ACBAD8F4B8F42CF9914,063-000-001,22222222,BIGW CBA,154.85,0,1414116.12,DR,REF634880,CBA,Savings
20-09-2025 18:50,CBA254D371F47644833ADF1,063-000-001,22222222,KFC CBA,65.88,0,1414050.24,DR,REF727805,CBA,Savings
20-09-2025 19:03,CBA561852DAC52B43EF96D7,063-000-001,22222222,STARBUCKS CBA,5.66,0,1414044.58,DR,REF306557,CBA,Savings
20-09-2025 19:20,CBA49A19FC442B54330A14C,063-000-001,22222222,BP CBA,39.38,0,1414005.2,DR,REF624306,CBA,Savings
20-09-2025 19:45,CBA1968573AA17A46D2B397,063-000-001,22222222,COMPANY PAYROLL CBA,0,277.57,1414282.77,CR,REF476640,CBA,Savings
20-09-2025 19:48,CBA3DDAB47B682D46DE98F0,063-000-001,22222222,WOOLWORTHS CBA,19.36,0,1414263.41,DR,REF924147,CBA,Savings
20-09-2025 19:52,CBADD09EB9D7FC34770BE8E,063-000-001,22222222,COLES CBA,59.84,0,1414203.57,DR,REF517653,CBA,Savings
20-09-2025 20:10,INTFE1208A3866B48619EC1,063-000-001,22222222,TRANSFER TO NAB 44444444,1196.29,0,1413007.28,DR,INT-71294,CBA,Savings
20-09-2025 21:17,CBA36DFAE509EEE4C018198,063-000-001,22222222,BWS CBA,130.02,0,1412877.26,DR,REF953567,CBA,Savings
20-09-2025 21:22,CBAA3557AD95ECA4D18BC41,063-000-001,22222222,MCDONALDS CBA,133.64,0,1412743.62,DR,REF451565,CBA,Savings
20-09-2025 21:23,CBAF970A51282CE41F2AF2A,063-000-001,22222222,WOOLWORTHS CBA,21.35,0,1412722.27,DR,REF708034,CBA,Savings
20-09-2025 21:48,CBA1910B1E303504845B6BC,063-000-001,22222222,WOOLWORTHS CBA,53.28,0,1412668.99,DR,REF280878,CBA,Savings
20-09-2025 22:57,CBA527930CE0AA04CA9B7FC,063-000-001,22222222,MCDONALDS CBA,17.79,0,1412651.2,DR,REF132897,CBA,Savings
20-09-2025 23:25,CBAF0FC8AC3414F42318057,063-000-001,22222222,TAFE BOOKSHOP CBA,50.21,0,1412600.99,DR,REF472350,CBA,Savings
20-09-2025 23:25,CBAD651E33FC604438AA343,063-000-001,22222222,STARBUCKS CBA,110.75,0,1412490.24,DR,REF911679,CBA,Savings
20-09-2025 23:35,CBA244E3AA4240F4DD0A9A2,063-000-001,22222222,APPLE CBA,29.8,0,1412460.44,DR,REF471062,CBA,Savings
20-09-2025 23:51,CBACAED924969A043E498ED,063-000-001,22222222,PAYPAL *NETFLIX CBA,23.85,0,1412436.59,DR,REF327274,CBA,Savings
21-09-2025 00:15,CBAA9A332E59C30454A9A2E,063-000-001,22222222,ALDI CBA,24.98,0,1412411.61,DR,REF444640,CBA,Savings
21-09-2025 00:32,CBA61D76EAD638B46A78DF5,063-000-001,22222222,BP CBA,6.96,0,1412404.65,DR,REF687952,CBA,Savings
21-09-2025 00:40,CBA1EDC70D0C4FD44B4890C,063-000-001,22222222,BANK FEE CBA,69.48,0,1412335.17,DR,REF315553,CBA,Savings
21-09-2025 01:02,INT7FF5E8E24F7F4A81BBE6,063-000-001,22222222,TRANSFER FROM CBA 33333333,0,873.39,1413208.56,CR,INT-26831,CBA,Savings
21-09-2025 01:22,INT4D8F2A518D9040D3A994,063-000-001,22222222,TRANSFER TO NAB 44444444,1178.93,0,1412029.63,DR,INT-62069,CBA,Savings
21-09-2025 02:12,CBAD9F958063C2B451F9CC6,063-000-001,22222222,MENULOG CBA,11.47,0,1412018.16,DR,REF560079,CBA,Savings
21-09-2025 02:22,CBAB52DADC096034A0FBAAB,063-000-001,22222222,7-ELEVEN CBA,39.79,0,1411978.37,DR,REF216899,CBA,Savings
21-09-2025 02:28,CBA89728A6722DE49DCB9A3,063-000-001,22222222,KFC CBA,69.42,0,1411908.95,DR,REF576544,CBA,Savings
21-09-2025 02:33,CBADDFEFA74D0A041FAAD09,063-000-001,22222222,UBER EATS CBA,60.79,0,1411848.16,DR,REF186111,CBA,Savings
21-09-2025 02:40,CBAFC60D1F8B05D49518175,063-000-001,22222222,BP CBA,132.85,0,1411715.31,DR,REF684742,CBA,Savings
21-09-2025 02:46,CBA48E30B245A174A4ABD4D,063-000-001,22222222,BIGW CBA,58.45,0,1411656.86,DR,REF768651,CBA,Savings
21-09-2025 02:54,CBA5DC8FDBE2109499F8F51,063-000-001,22222222,BIGW CBA,34.03,0,1411622.83,DR,REF586826,CBA,Savings
21-09-2025 02:58,CBA80D756483FE041909A43,063-000-001,22222222,SALARY PAYMENT CBA,0,4953.96,1416576.79,CR,REF855708,CBA,Savings
21-09-2025 04:19,CBAC10FA2BD605043568CE5,063-000-001,22222222,SPOTIFY CBA,60,0,1416516.79,DR,REF882884,CBA,Savings
21-09-2025 05:02,CBA3B65C0CAA4A144169A10,063-000-001,22222222,COLES CBA,37.9,0,1416478.89,DR,REF874280,CBA,Savings
21-09-2025 05:06,INTDB8DD04AF82E453B8D68,063-000-001,22222222,TRANSFER TO ANZ 11111111,998.97,0,1415479.92,DR,INT-43881,CBA,Savings
21-09-2025 05:21,CBAE2982125D7CE47EFBA68,063-000-001,22222222,BWS CBA,96.47,0,1415383.45,DR,REF478992,CBA,Savings
21-09-2025 05:26,CBA3F27105CD63C491BA5DD,063-000-001,22222222,PAYPAL *NETFLIX CBA,208.7,0,1415174.75,DR,REF920254,CBA,Savings
21-09-2025 06:39,CBA1771F2CCC11D4D9AA81B,063-000-001,22222222,RAILWAY STATION CBA,47.45,0,1415127.3,DR,REF331999,CBA,Savings
21-09-2025 06:52,CBA53C27B07798B4B6EB6CB,063-000-001,22222222,COLES CBA,27.21,0,1415100.09,DR,REF245591,CBA,Savings
21-09-2025 07:25,CBA028572671B2C45218F5C,063-000-001,22222222,KFC CBA,100.4,0,1414999.69,DR,REF328466,CBA,Savings
21-09-2025 07:36,CBA3BB2D7B1A9ED4670A683,063-000-001,22222222,JB HI-FI CBA,139.04,0,1414860.65,DR,REF333253,CBA,Savings
21-09-2025 08:00,CBA7E6E3E53E19E4EDBA216,063-000-001,22222222,SALARY PAYMENT CBA,0,7530.53,1422391.18,CR,REF723639,CBA,Savings
21-09-2025 08:15,CBA149612F12F774E9FA7D5,063-000-001,22222222,BANK FEE CBA,45.59,0,1422345.59,DR,REF477167,CBA,Savings
21-09-2025 08:21,CBAD1D4953A12AC438BB4AF,063-000-001,22222222,PAYPAL *NETFLIX CBA,113.85,0,1422231.74,DR,REF646504,CBA,Savings
21-09-2025 08:34,INTCFA3BA0A8BE441CAAC52,063-000-001,22222222,TRANSFER FROM NAB 44444444,0,1338.69,1423570.43,CR,INT-83464,CBA,Savings
21-09-2025 08:36,CBADAAC14AF32994C20B722,063-000-001,22222222,COLES CBA,73.45,0,1423496.98,DR,REF125339,CBA,Savings
21-09-2025 08:38,CBA72463946408B4BC0BE79,063-000-001,22222222,PAYPAL *NETFLIX CBA,88.71,0,1423408.27,DR,REF188397,CBA,Savings
21-09-2025 08:48,CBA38C56D1CFA8D47289DC6,063-000-001,22222222,7-ELEVEN CBA,163.8,0,1423244.47,DR,REF273449,CBA,Savings
21-09-2025 09:00,CBAEACA5767E93A4251801D,063-000-001,22222222,JB HI-FI CBA,48.75,0,1423195.72,DR,REF136070,CBA,Savings
21-09-2025 10:10,CBAB621C6B9C20341038BFF,063-000-001,22222222,ALDI CBA,11.42,0,1423184.3,DR,REF491890,CBA,Savings
21-09-2025 10:44,CBA95ED1DCE0F6A4F7F9BDB,063-000-001,22222222,APPLE CBA,62.92,0,1423121.38,DR,REF379874,CBA,Savings
21-09-2025 10:49,CBA8FCB8C632EEF431093B8,063-000-001,22222222,COLES CBA,18.48,0,1423102.9,DR,REF836957,CBA,Savings
21-09-2025 10:56,CBABADE436D6F084441B455,063-000-001,22222222,JB HI-FI CBA,34.52,0,1423068.38,DR,REF419328,CBA,Savings
21-09-2025 11:26,CBA358DF3280D3D4DB18D43,063-000-001,22222222,SHELL CBA,24.25,0,1423044.13,DR,REF319518,CBA,Savings
21-09-2025 11:41,CBA9B204711A271463EB885,063-000-001,22222222,CITYLINK CBA,5.81,0,1423038.32,DR,REF806399,CBA,Savings
21-09-2025 12:06,CBAF0BFEC26527C4A43A1BE,063-000-001,22222222,WOOLWORTHS CBA,57.51,0,1422980.81,DR,REF842724,CBA,Savings
21-09-2025 12:55,CBA78524558DF7847FB833A,063-000-001,22222222,PAYPAL *NETFLIX CBA,108.33,0,1422872.48,DR,REF447109,CBA,Savings
21-09-2025 13:01,INT0319BFEDA2174C8C82E7,063-000-001,22222222,TRANSFER TO ANZ 11111111,255.39,0,1422617.09,DR,INT-84456,CBA,Savings
21-09-2025 13:08,CBAD8AFDF49C63E48C7B407,063-000-001,22222222,PAY - SALARY CBA,0,3177.66,1425794.75,CR,REF206895,CBA,Savings
21-09-2025 13:25,INTFC438BF4F634497BBFAA,063-000-001,22222222,TRANSFER TO NAB 44444444,1162.93,0,1424631.82,DR,INT-35346,CBA,Savings
21-09-2025 13:30,CBA74C38FD09FB04E77BBA1,063-000-001,22222222,WAGES CREDIT CBA,0,4996.1,1429627.92,CR,REF245366,CBA,Savings
21-09-2025 13:56,CBA39415D6FB2AB4229B012,063-000-001,22222222,APPLE CBA,27.76,0,1429600.16,DR,REF912391,CBA,Savings
21-09-2025 14:12,CBA0EE4F765877D446FB36E,063-000-001,22222222,BIGW CBA,56.67,0,1429543.49,DR,REF112462,CBA,Savings
21-09-2025 14:15,CBA1D90EDF57DB64C2CBB41,063-000-001,22222222,ALDI CBA,17.99,0,1429525.5,DR,REF456731,CBA,Savings
21-09-2025 14:17,CBA1D2BBA79D52241939DBE,063-000-001,22222222,KFC CBA,51.53,0,1429473.97,DR,REF265684,CBA,Savings
21-09-2025 14:28,CBAF9530F47EDAD46309A52,063-000-001,22222222,STARBUCKS CBA,8.14,0,1429465.83,DR,REF344351,CBA,Savings
21-09-2025 14:28,CBAAFC272A62E194BD89C50,063-000-001,22222222,LIQUORLAND CBA,59.32,0,1429406.51,DR,REF691279,CBA,Savings
21-09-2025 15:28,CBAB009BADC0CFF432FB5B6,063-000-001,22222222,7-ELEVEN CBA,134.78,0,1429271.73,DR,REF719133,CBA,Savings
21-09-2025 15:41,CBA48799C7B79234EB888AE,063-000-001,22222222,AMAZON AU CBA,12,0,1429259.73,DR,REF600990,CBA,Savings
21-09-2025 15:42,CBAED382A4A6F2D494195E3,063-000-001,22222222,ZOOM CBA,14.01,0,1429245.72,DR,REF385375,CBA,Savings
21-09-2025 16:18,CBA1EA8575F2C05438C921C,063-000-001,22222222,MCDONALDS CBA,84.55,0,1429161.17,DR,REF677250,CBA,Savings
21-09-2025 16:36,CBA2B29D0D28C2C4D2092D9,063-000-001,22222222,INTERNET TRANSFER CBA,23.95,0,1429137.22,DR,REF790667,CBA,Savings
21-09-2025 17:50,CBA2684023F586245778C74,063-000-001,22222222,FLIXBUS CBA,256.29,0,1428880.93,DR,REF491023,CBA,Savings
21-09-2025 17:51,CBA1F932677AE62435C82A5,063-000-001,22222222,ZOOM CBA,35.4,0,1428845.53,DR,REF687140,CBA,Savings
21-09-2025 18:17,CBA9D24AF858C3945669591,063-000-001,22222222,WAGES CREDIT CBA,0,5256.13,1434101.66,CR,REF331573,CBA,Savings
21-09-2025 18:36,CBAC97C4E4992FE444B910F,063-000-001,22222222,RAILWAY STATION CBA,59.31,0,1434042.35,DR,REF453106,CBA,Savings
21-09-2025 18:47,CBA73C5A5D6B0814107A64D,063-000-001,22222222,COMPANY PAYROLL CBA,0,2941.36,1436983.71,CR,REF725294,CBA,Savings
21-09-2025 19:14,CBA01DAE8D020FC410FB525,063-000-001,22222222,MENULOG CBA,102.87,0,1436880.84,DR,REF624864,CBA,Savings
21-09-2025 19:24,CBA8E214169B7FD49CA842E,063-000-001,22222222,BIGW CBA,23.52,0,1436857.32,DR,REF811054,CBA,Savings
21-09-2025 19:30,CBA620DC4D7C46649C4A579,063-000-001,22222222,BIGW CBA,56.72,0,1436800.6,DR,REF810672,CBA,Savings
21-09-2025 20:35,CBADBDC33D011134FFF886D,063-000-001,22222222,ZOOM CBA,30.56,0,1436770.04,DR,REF919661,CBA,Savings
21-09-2025 20:42,CBA05229B463AA149E8A09D,063-000-001,22222222,STARBUCKS CBA,9.19,0,1436760.85,DR,REF672381,CBA,Savings
21-09-2025 21:18,CBA57EF25C34945425C8727,063-000-001,22222222,BP CBA,136.64,0,1436624.21,DR,REF650249,CBA,Savings
21-09-2025 21:19,CBA4230C00507464B91A32F,063-000-001,22222222,COMPANY PAYROLL CBA,0,3500.09,1440124.3,CR,REF531617,CBA,Savings
21-09-2025 21:20,CBA6C08A0A4D15A4ABBBDA2,063-000-001,22222222,APPLE CBA,7.56,0,1440116.74,DR,REF658151,CBA,Savings
21-09-2025 22:06,CBA89264DA444084CE2B27D,063-000-001,22222222,ZOOM CBA,21.52,0,1440095.22,DR,REF562681,CBA,Savings
21-09-2025 22:07,CBA0BB0D147554D43C991C3,063-000-001,22222222,AMAZON AU CBA,12.57,0,1440082.65,DR,REF184485,CBA,Savings
21-09-2025 22:16,CBA79E5E7866BC048179587,063-000-001,22222222,WOOLWORTHS CBA,12.69,0,1440069.96,DR,REF192407,CBA,Savings
21-09-2025 22:26,CBAF596CA55990F481BABDD,063-000-001,22222222,COLES CBA,19.22,0,1440050.74,DR,REF682506,CBA,Savings
21-09-2025 22:31,CBA635C29DC326A43A2BBAB,063-000-001,22222222,BANK FEE CBA,11.81,0,1440038.93,DR,REF970307,CBA,Savings
21-09-2025 22:55,CBA645DC8E07EF64CC18272,063-000-001,22222222,HARVEY NORMAN CBA,29.04,0,1440009.89,DR,REF634393,CBA,Savings
21-09-2025 23:16,CBA20DC8038CDC049B68382,063-000-001,22222222,PAYMENT GATEWAY CBA,68.04,0,1439941.85,DR,REF547381,CBA,Savings
21-09-2025 23:19,CBA614E0AB046B34ECEB171,063-000-001,22222222,SHELL CBA,39.56,0,1439902.29,DR,REF822846,CBA,Savings
21-09-2025 23:37,CBAE0AAD2994E2547558800,063-000-001,22222222,WAGES CREDIT CBA,0,3368.63,1443270.92,CR,REF717885,CBA,Savings
22-09-2025 00:15,CBACCEA796092E54B4BB779,063-000-001,22222222,BP CBA,107.65,0,1443163.27,DR,REF674117,CBA,Savings
22-09-2025 00:32,CBA9CF80861A05B469695A1,063-000-001,22222222,PAYROLL CREDIT CBA,0,4951.21,1448114.48,CR,REF697603,CBA,Savings
22-09-2025 00:41,CBA6254DC4CE4ED4027BC5A,063-000-001,22222222,DOMINO'S PIZZA CBA,99.09,0,1448015.39,DR,REF749095,CBA,Savings
22-09-2025 00:44,CBADE0083BB366F410CA121,063-000-001,22222222,SALARY PAYMENT CBA,0,4452.72,1452468.11,CR,REF620863,CBA,Savings
22-09-2025 01:00,CBA3923CAB26D6E487C9DCD,063-000-001,22222222,PAY - SALARY CBA,0,1516.26,1453984.37,CR,REF619218,CBA,Savings
22-09-2025 01:14,CBA7406A61D28D14347BD83,063-000-001,22222222,PAYROLL CREDIT CBA,0,5939.64,1459924.01,CR,REF937669,CBA,Savings
22-09-2025 01:50,CBADDE6C940D92C494D9184,063-000-001,22222222,COLES CBA,67.5,0,1459856.51,DR,REF590574,CBA,Savings
22-09-2025 02:26,CBA92D0442421114C9C9E1A,063-000-001,22222222,KFC CBA,31.62,0,1459824.89,DR,REF320543,CBA,Savings
22-09-2025 03:05,CBA54ECB6891AE84C0AB4D2,063-000-001,22222222,SPOTIFY CBA,26.71,0,1459798.18,DR,REF593987,CBA,Savings
22-09-2025 03:49,CBA3A0FD11151D14A609257,063-000-001,22222222,SHELL CBA,145.82,0,1459652.36,DR,REF360133,CBA,Savings
22-09-2025 04:08,CBA765AE158C42B4B40B724,063-000-001,22222222,FLIXBUS CBA,14.63,0,1459637.73,DR,REF518910,CBA,Savings
22-09-2025 04:11,CBA2474B7D5923E430D8A02,063-000-001,22222222,RAILWAY STATION CBA,83.78,0,1459553.95,DR,REF995570,CBA,Savings
22-09-2025 04:44,CBAA626D6E8C905421881BE,063-000-001,22222222,APPLE CBA,12.7,0,1459541.25,DR,REF510488,CBA,Savings
22-09-2025 05:14,INT0A44DBAB1223459098B8,063-000-001,22222222,TRANSFER FROM ANZ 11111111,0,1872.51,1461413.76,CR,INT-62691,CBA,Savings
22-09-2025 05:25,CBAA473DBE066384B5AA4A0,063-000-001,22222222,AMAZON AU CBA,61.71,0,1461352.05,DR,REF475504,CBA,Savings
22-09-2025 05:49,CBA18C447ADDF70439BB50D,063-000-001,22222222,BWS CBA,168.09,0,1461183.96,DR,REF679898,CBA,Savings
22-09-2025 06:04,CBA44A5C47BD66B41828811,063-000-001,22222222,COMPANY PAYROLL CBA,0,6055.3,1467239.26,CR,REF863466,CBA,Savings
22-09-2025 07:10,CBAC995725C26D44684B8A5,063-000-001,22222222,SHELL CBA,132.82,0,1467106.44,DR,REF184834,CBA,Savings
22-09-2025 07:51,CBA54574C91F3D74529BBDC,063-000-001,22222222,BIGW CBA,25.77,0,1467080.67,DR,REF979153,CBA,Savings
22-09-2025 08:28,CBAEEA1FBE4AE864A118EFB,063-000-001,22222222,RAILWAY STATION CBA,64.49,0,1467016.18,DR,REF317520,CBA,Savings
22-09-2025 08:34,INT89F84F70243A419FAEE8,063-000-001,22222222,TRANSFER FROM CBA 33333333,0,1986.89,1469003.07,CR,INT-37500,CBA,Savings
22-09-2025 08:38,CBA42F222A86EEA437FBB7D,063-000-001,22222222,PAYMENT GATEWAY CBA,134.77,0,1468868.3,DR,REF121161,CBA,Savings
22-09-2025 08:45,CBAB56623F1E6274B598133,063-000-001,22222222,BIGW CBA,15.8,0,1468852.5,DR,REF336545,CBA,Savings
22-09-2025 08:50,CBA8C5241BC694D4AFA90A9,063-000-001,22222222,STARBUCKS CBA,64.39,0,1468788.11,DR,REF538488,CBA,Savings
22-09-2025 08:57,CBA57C37A1AAA8A4F47A76E,063-000-001,22222222,JB HI-FI CBA,45.58,0,1468742.53,DR,REF391966,CBA,Savings
22-09-2025 08:59,CBAF5C4F8E643C7436BA86D,063-000-001,22222222,PAYMENT GATEWAY CBA,45.54,0,1468696.99,DR,REF873431,CBA,Savings
22-09-2025 09:57,CBAB4599E2FD23F4E0DAD92,063-000-001,22222222,APPLE CBA,84.44,0,1468612.55,DR,REF450679,CBA,Savings
22-09-2025 10:18,CBA53C0DA97EB034A14AB81,063-000-001,22222222,RAILWAY STATION CBA,15.36,0,1468597.19,DR,REF589582,CBA,Savings
22-09-2025 10:36,CBAF8AF15C66B6B46FA8271,063-000-001,22222222,STARBUCKS CBA,41.97,0,1468555.22,DR,REF660846,CBA,Savings
22-09-2025 10:46,CBA4F411CE7B13C4BEDBAA6,063-000-001,22222222,SALARY PAYMENT CBA,0,4177.68,1472732.9,CR,REF884716,CBA,Savings
22-09-2025 10:49,CBA284D99B019E244AE8E9B,063-000-001,22222222,INTERNET TRANSFER CBA,82.04,0,1472650.86,DR,REF724688,CBA,Savings
22-09-2025 10:50,CBA71461D3DDAC4461A9EB1,063-000-001,22222222,SHELL CBA,47.36,0,1472603.5,DR,REF341276,CBA,Savings
22-09-2025 10:52,CBA7B9FB30E33D14DF3BCA5,063-000-001,22222222,BP CBA,171.9,0,1472431.6,DR,REF569955,CBA,Savings
22-09-2025 11:19,CBA377EDC2CBFE84D76BD83,063-000-001,22222222,INTERNET TRANSFER CBA,64.33,0,1472367.27,DR,REF978506,CBA,Savings
22-09-2025 11:31,CBA7CFF043BC6B84536B57C,063-000-001,22222222,KFC CBA,13.94,0,1472353.33,DR,REF671386,CBA,Savings
22-09-2025 11:42,CBAC72C774751104CFBB5A9,063-000-001,22222222,MCDONALDS CBA,36.92,0,1472316.41,DR,REF785598,CBA,Savings
22-09-2025 11:49,CBA21517C7C129341F5B1DB,063-000-001,22222222,SPOTIFY CBA,58.64,0,1472257.77,DR,REF535719,CBA,Savings
22-09-2025 12:48,CBAEBD76480B49A44B9B940,063-000-001,22222222,MENULOG CBA,13.72,0,1472244.05,DR,REF975752,CBA,Savings
22-09-2025 13:00,CBA9DFDE9E7B1DB47E6B113,063-000-001,22222222,COMPANY PAYROLL CBA,0,3971.53,1476215.58,CR,REF390039,CBA,Savings
22-09-2025 13:02,CBA88787B4D930B4F8CBD36,063-000-001,22222222,SHELL CBA,129.11,0,1476086.47,DR,REF972276,CBA,Savings
22-09-2025 13:04,CBA74D1DE387DF54EC49C7E,063-000-001,22222222,MENULOG CBA,56.31,0,1476030.16,DR,REF823381,CBA,Savings
22-09-2025 13:07,CBA199865F9C2534A80B217,063-000-001,22222222,RAILWAY STATION CBA,137.26,0,1475892.9,DR,REF198401,CBA,Savings
22-09-2025 13:21,CBADE77056474944849978E,063-000-001,22222222,APPLE CBA,78.99,0,1475813.91,DR,REF570856,CBA,Savings
22-09-2025 13:23,CBA47D79AA3E97E4FE0B912,063-000-001,22222222,CITYLINK CBA,5.25,0,1475808.66,DR,REF784984,CBA,Savings
22-09-2025 13:40,CBAD133B5A7DC6D4EF3AC35,063-000-001,22222222,AMAZON AU CBA,4.85,0,1475803.81,DR,REF300377,CBA,Savings
22-09-2025 14:34,CBAE1CC482436C24689B6A2,063-000-001,22222222,UBER EATS CBA,22.77,0,1475781.04,DR,REF284006,CBA,Savings
22-09-2025 14:39,CBA64047DE9C1774BEC92C8,063-000-001,22222222,RAILWAY STATION CBA,19.32,0,1475761.72,DR,REF513344,CBA,Savings
22-09-2025 14:41,CBAE7E28EDD455740669D67,063-000-001,22222222,INTERNET TRANSFER CBA,46.03,0,1475715.69,DR,REF851061,CBA,Savings
22-09-2025 15:11,CBA757EC629094F4B4E96EF,063-000-001,22222222,RAILWAY STATION CBA,20.97,0,1475694.72,DR,REF219675,CBA,Savings
22-09-2025 16:09,INTEC08794CEAA84592AA7F,063-000-001,22222222,TRANSFER FROM NAB 44444444,0,538.09,1476232.81,CR,INT-26911,CBA,Savings
22-09-2025 16:24,CBA5F19EC60C75E4165B1C1,063-000-001,22222222,RAILWAY STATION CBA,78.32,0,1476154.49,DR,REF986696,CBA,Savings
22-09-2025 17:03,CBA8F4716A48CA340A888A2,063-000-001,22222222,SHELL CBA,17.47,0,1476137.02,DR,REF392208,CBA,Savings
22-09-2025 17:42,CBA8D5087387AE34AEAB892,063-000-001,22222222,BWS CBA,29.23,0,1476107.79,DR,REF954819,CBA,Savings
22-09-2025 18:13,CBA09368A45D18A4BF496F6,063-000-001,22222222,TAFE BOOKSHOP CBA,50.58,0,1476057.21,DR,REF978936,CBA,Savings
22-09-2025 18:22,CBAC70E1CBB5FBD48238EBA,063-000-001,22222222,MCDONALDS CBA,179.34,0,1475877.87,DR,REF754376,CBA,Savings
22-09-2025 18:25,CBA9B8C8E306911477C8831,063-000-001,22222222,BP CBA,20.28,0,1475857.59,DR,REF823471,CBA,Savings
22-09-2025 18:38,CBA85BA5F3C3D81439DAC49,063-000-001,22222222,SALARY PAYMENT CBA,0,5733.26,1481590.85,CR,REF665632,CBA,Savings
22-09-2025 18:46,CBA6DE0E5F8FA074382B639,063-000-001,22222222,FLIXBUS CBA,13.71,0,1481577.14,DR,REF416767,CBA,Savings
22-09-2025 18:50,CBAF36F0A4AA34D4B1F883D,063-000-001,22222222,KFC CBA,18.3,0,1481558.84,DR,REF279727,CBA,Savings
22-09-2025 18:51,CBA6774831F145349A58CEA,063-000-001,22222222,ALDI CBA,12.08,0,1481546.76,DR,REF452114,CBA,Savings
22-09-2025 19:16,CBA03D8781B34D24BB3AB26,063-000-001,22222222,BWS CBA,45.07,0,1481501.69,DR,REF826895,CBA,Savings
22-09-2025 20:27,CBAC4BEC376C4C14495B5FA,063-000-001,22222222,LIQUORLAND CBA,20.25,0,1481481.44,DR,REF823799,CBA,Savings
22-09-2025 20:46,CBAF426B309EB2E42749B9E,063-000-001,22222222,STARBUCKS CBA,53.09,0,1481428.35,DR,REF584160,CBA,Savings
22-09-2025 21:27,CBA42EEC3434372492A89BC,063-000-001,22222222,BANK FEE CBA,17.95,0,1481410.4,DR,REF352903,CBA,Savings
22-09-2025 22:57,CBA7865F29BCA2249A28A07,063-000-001,22222222,SHELL CBA,5.07,0,1481405.33,DR,REF461322,CBA,Savings
22-09-2025 23:03,CBA110249281A064F81914F,063-000-001,22222222,LIQUORLAND CBA,20.05,0,1481385.28,DR,REF284180,CBA,Savings
22-09-2025 23:04,CBA02ECE39D738C42D2A8F7,063-000-001,22222222,7-ELEVEN CBA,147.43,0,1481237.85,DR,REF572946,CBA,Savings
22-09-2025 23:17,CBA47B8E68E656848A1BFF4,063-000-001,22222222,JB HI-FI CBA,11.93,0,1481225.92,DR,REF639947,CBA,Savings
22-09-2025 23:34,CBAB5CC3CB911124A15A6AC,063-000-001,22222222,SPOTIFY CBA,82.23,0,1481143.69,DR,REF673690,CBA,Savings
22-09-2025 23:51,CBA7613C4A57A3B43C38A2B,063-000-001,22222222,BWS CBA,32.44,0,1481111.25,DR,REF442886,CBA,Savings
23-09-2025 00:43,CBAD125CA7EEBAD48169EF5,063-000-001,22222222,SPOTIFY CBA,54.07,0,1481057.18,DR,REF705577,CBA,Savings
23-09-2025 00:50,CBA533B7C0C15EE4EFEBC15,063-000-001,22222222,BIGW CBA,37.09,0,1481020.09,DR,REF800940,CBA,Savings
23-09-2025 01:18,CBA695C917F71964EF78CC1,063-000-001,22222222,MCDONALDS CBA,23.2,0,1480996.89,DR,REF412688,CBA,Savings
23-09-2025 01:39,CBA62DE96DEBBDE4268A494,063-000-001,22222222,COMPANY PAYROLL CBA,0,5832.84,1486829.73,CR,REF571700,CBA,Savings
23-09-2025 01:41,CBA74A7693528D1423EB544,063-000-001,22222222,KFC CBA,38.61,0,1486791.12,DR,REF380832,CBA,Savings
23-09-2025 01:56,CBA13648CE4576A4B2F99CC,063-000-001,22222222,MCDONALDS CBA,55.2,0,1486735.92,DR,REF180960,CBA,Savings
23-09-2025 02:12,CBA9BF7C999B2FA4326A7AB,063-000-001,22222222,INTERNET TRANSFER CBA,29.92,0,1486706,DR,REF126393,CBA,Savings
23-09-2025 02:20,CBA878F1412B17441CBA088,063-000-001,22222222,KFC CBA,8.26,0,1486697.74,DR,REF460793,CBA,Savings
23-09-2025 02:31,CBA6A5C232331494388AE92,063-000-001,22222222,7-ELEVEN CBA,5.68,0,1486692.06,DR,REF167107,CBA,Savings
23-09-2025 04:14,CBA34A97193D8C345169D0F,063-000-001,22222222,MCDONALDS CBA,84.82,0,1486607.24,DR,REF326321,CBA,Savings
23-09-2025 04:16,CBAC06D0FA33D3746FEB609,063-000-001,22222222,WOOLWORTHS CBA,35.42,0,1486571.82,DR,REF420671,CBA,Savings
23-09-2025 05:12,CBA73E74A31152B42AC9BD5,063-000-001,22222222,KFC CBA,85.43,0,1486486.39,DR,REF163904,CBA,Savings
23-09-2025 05:44,CBA024E90FFCD6B4A329AAB,063-000-001,22222222,PAYPAL *NETFLIX CBA,114.8,0,1486371.59,DR,REF888595,CBA,Savings
23-09-2025 05:45,CBAADB0C696ED13464C8469,063-000-001,22222222,COMPANY PAYROLL CBA,0,2103.57,1488475.16,CR,REF268674,CBA,Savings
23-09-2025 06:13,CBA1F41E70D61E341A9A177,063-000-001,22222222,WAGES CREDIT CBA,0,4913.87,1493389.03,CR,REF423882,CBA,Savings
23-09-2025 06:20,CBAE54C88648DD74796B3FD,063-000-001,22222222,ALDI CBA,90.66,0,1493298.37,DR,REF152739,CBA,Savings
23-09-2025 06:40,CBA0A6F57A1FD304B7D9938,063-000-001,22222222,MCDONALDS CBA,1.37,0,1493297,DR,REF725796,CBA,Savings
23-09-2025 07:15,CBACA2891D3161646B6A2A7,063-000-001,22222222,SPOTIFY CBA,86.61,0,1493210.39,DR,REF183017,CBA,Savings
23-09-2025 07:17,CBA3B339111C6534CA1BAE8,063-000-001,22222222,COLES CBA,131.93,0,1493078.46,DR,REF163638,CBA,Savings
23-09-2025 07:59,CBA64B50FB677904EF4952E,063-000-001,22222222,DOMINO'S PIZZA CBA,43.68,0,1493034.78,DR,REF455688,CBA,Savings
23-09-2025 08:26,CBABCA53E6B882343CFB6DA,063-000-001,22222222,KFC CBA,24.63,0,1493010.15,DR,REF516991,CBA,Savings
23-09-2025 08:44,CBAF70EFA18FAAB4C729F69,063-000-001,22222222,AMAZON AU CBA,51.84,0,1492958.31,DR,REF690202,CBA,Savings
23-09-2025 09:06,CBAD5573BEFB68F4942AC79,063-000-001,22222222,JB HI-FI CBA,45.26,0,1492913.05,DR,REF541696,CBA,Savings
23-09-2025 09:59,CBA99454DDD43774801A3F8,063-000-001,22222222,COLES CBA,19.68,0,1492893.37,DR,REF611571,CBA,Savings
23-09-2025 11:01,INT9F8BF671CC854367AC8B,063-000-001,22222222,TRANSFER FROM NAB 44444444,0,1642.57,1494535.94,CR,INT-96053,CBA,Savings
23-09-2025 11:12,CBA405653B620F44E6F8813,063-000-001,22222222,TAFE BOOKSHOP CBA,42.2,0,1494493.74,DR,REF149225,CBA,Savings
23-09-2025 11:16,CBAC1A5469ED6A94165887C,063-000-001,22222222,UBER EATS CBA,78.03,0,1494415.71,DR,REF738221,CBA,Savings
23-09-2025 11:28,CBAA1B0794E5A8948F39D9E,063-000-001,22222222,LIQUORLAND CBA,6.45,0,1494409.26,DR,REF400459,CBA,Savings
23-09-2025 12:41,CBACE097E87C6C747B8B1B2,063-000-001,22222222,PAYPAL *NETFLIX CBA,67.46,0,1494341.8,DR,REF691844,CBA,Savings
23-09-2025 13:03,CBA3F758CE3DE114B2B8171,063-000-001,22222222,TAFE BOOKSHOP CBA,54.15,0,1494287.65,DR,REF152216,CBA,Savings
23-09-2025 13:13,CBADD35F198B2A240338ACC,063-000-001,22222222,LIQUORLAND CBA,7.36,0,1494280.29,DR,REF540267,CBA,Savings
23-09-2025 13:27,CBA7122B896F8E6409DB55B,063-000-001,22222222,UBER EATS CBA,26.07,0,1494254.22,DR,REF975767,CBA,Savings
23-09-2025 14:10,CBA60AA80B7FD0A4FDC8CBA,063-000-001,22222222,LIQUORLAND CBA,60.38,0,1494193.84,DR,REF195789,CBA,Savings
23-09-2025 14:23,CBA4CEDAB4A24DE43738ACE,063-000-001,22222222,BANK FEE CBA,11.52,0,1494182.32,DR,REF970413,CBA,Savings
23-09-2025 16:14,CBA47E08CA764DB4E30A3CA,063-000-001,22222222,HARVEY NORMAN CBA,7.81,0,1494174.51,DR,REF832594,CBA,Savings
23-09-2025 16:24,CBA3D9A2EDB4CFA46DA8782,063-000-001,22222222,TAFE BOOKSHOP CBA,28.13,0,1494146.38,DR,REF453978,CBA,Savings
23-09-2025 16:24,CBAC69AC1B1812E458786A8,063-000-001,22222222,PAYROLL CREDIT CBA,0,6667.13,1500813.51,CR,REF368701,CBA,Savings
23-09-2025 17:35,CBA1DF029CC0AF74184AF38,063-000-001,22222222,BANK FEE CBA,39.18,0,1500774.33,DR,REF351467,CBA,Savings
23-09-2025 17:40,CBA8A939B3FC84345D4A163,063-000-001,22222222,AMAZON AU CBA,27.43,0,1500746.9,DR,REF934819,CBA,Savings
23-09-2025 18:23,CBA7DD7B2216BEF407CBCEC,063-000-001,22222222,DOMINO'S PIZZA CBA,31.08,0,1500715.82,DR,REF212291,CBA,Savings
23-09-2025 18:42,CBAC1CD5834DA0046D39DFD,063-000-001,22222222,TAFE BOOKSHOP CBA,51.89,0,1500663.93,DR,REF794339,CBA,Savings
23-09-2025 19:14,CBA8E53B25DFC044B69B07C,063-000-001,22222222,ZOOM CBA,42.17,0,1500621.76,DR,REF727055,CBA,Savings
23-09-2025 19:23,CBAFC083E2F57E74F5EAB7F,063-000-001,22222222,PAYMENT GATEWAY CBA,79.23,0,1500542.53,DR,REF337892,CBA,Savings
23-09-2025 19:49,CBA6B92FF8315B343F4A252,063-000-001,22222222,FLIXBUS CBA,8.9,0,1500533.63,DR,REF651673,CBA,Savings
23-09-2025 19:59,CBA2A3B7F31274F4D6987A6,063-000-001,22222222,STARBUCKS CBA,72.51,0,1500461.12,DR,REF698386,CBA,Savings
23-09-2025 20:21,CBAEA23470088A649CE8F44,063-000-001,22222222,SALARY PAYMENT CBA,0,5956.51,1506417.63,CR,REF146078,CBA,Savings
23-09-2025 20:28,CBAA9530F3FB25B4741ABCC,063-000-001,22222222,TAFE BOOKSHOP CBA,115.22,0,1506302.41,DR,REF364472,CBA,Savings
23-09-2025 21:11,CBA45CFCD4B6582485298E1,063-000-001,22222222,PAYMENT GATEWAY CBA,61.7,0,1506240.71,DR,REF696502,CBA,Savings
23-09-2025 21:37,CBABD5F99B73A6A488C96A7,063-000-001,22222222,SPOTIFY CBA,102.53,0,1506138.18,DR,REF872818,CBA,Savings
23-09-2025 21:46,CBA0A6FE18E6F7B4784985A,063-000-001,22222222,STARBUCKS CBA,52.91,0,1506085.27,DR,REF978154,CBA,Savings
23-09-2025 21:48,CBA2C7DC87AF1DF4433A9F4,063-000-001,22222222,COMPANY PAYROLL CBA,0,3481.54,1509566.81,CR,REF596060,CBA,Savings
23-09-2025 22:22,CBA8D89C3637DA84AA1AE55,063-000-001,22222222,BIGW CBA,91.83,0,1509474.98,DR,REF914690,CBA,Savings
23-09-2025 22:41,CBA1AD137A613434FD4A343,063-000-001,22222222,PAYMENT GATEWAY CBA,95.47,0,1509379.51,DR,REF152890,CBA,Savings
23-09-2025 22:46,CBA377BC8345C814FBE80DD,063-000-001,22222222,PAYPAL *NETFLIX CBA,48.51,0,1509331,DR,REF528066,CBA,Savings
23-09-2025 23:25,CBA56BC16530CEE4EC4BF89,063-000-001,22222222,RAILWAY STATION CBA,40.3,0,1509290.7,DR,REF742946,CBA,Savings
23-09-2025 23:39,CBA9A345624C1274719A61C,063-000-001,22222222,PAYPAL *NETFLIX CBA,25.5,0,1509265.2,DR,REF104040,CBA,Savings
23-09-2025 23:55,CBA53FAEFFBA4824ACCB727,063-000-001,22222222,PAYMENT GATEWAY CBA,46.39,0,1509218.81,DR,REF378029,CBA,Savings
24-09-2025 00:06,CBADE497B69E8EA42338DB1,063-000-001,22222222,COLES CBA,88,0,1509130.81,DR,REF404985,CBA,Savings
24-09-2025 00:26,CBAEC1B9AA6121043BFAE2F,063-000-001,22222222,COLES CBA,144.22,0,1508986.59,DR,REF377361,CBA,Savings
24-09-2025 00:36,CBAAE92D0EC7AB344AEB60D,063-000-001,22222222,STARBUCKS CBA,24.59,0,1508962,DR,REF882317,CBA,Savings
24-09-2025 01:19,CBA172BF17FF43148E197AC,063-000-001,22222222,BIGW CBA,40.33,0,1508921.67,DR,REF610122,CBA,Savings
24-09-2025 01:46,CBAF9D6B14F205043FEB139,063-000-001,22222222,CITYLINK CBA,17.73,0,1508903.94,DR,REF309379,CBA,Savings
24-09-2025 02:16,CBA6D6109B623A742A1B555,063-000-001,22222222,BIGW CBA,24.33,0,1508879.61,DR,REF749156,CBA,Savings
24-09-2025 02:25,CBA296ED07BE48640F6A6FF,063-000-001,22222222,BANK FEE CBA,123.55,0,1508756.06,DR,REF760041,CBA,Savings
24-09-2025 03:37,CBA6415B00ED5844E73BD37,063-000-001,22222222,APPLE CBA,81.34,0,1508674.72,DR,REF723749,CBA,Savings
24-09-2025 03:56,CBAF210B38ABF884247BB7B,063-000-001,22222222,AMAZON AU CBA,52.86,0,1508621.86,DR,REF411757,CBA,Savings
24-09-2025 03:58,CBA1DAC78E16D88409CB5FA,063-000-001,22222222,SALARY PAYMENT CBA,0,1633.16,1510255.02,CR,REF894876,CBA,Savings
24-09-2025 04:24,CBA4971F8B8E1E44285A08F,063-000-001,22222222,RAILWAY STATION CBA,24.03,0,1510230.99,DR,REF828219,CBA,Savings
24-09-2025 04:31,CBA25AC30E9DA0E4501BE2A,063-000-001,22222222,AMAZON AU CBA,8.31,0,1510222.68,DR,REF999516,CBA,Savings
24-09-2025 05:02,CBAB1495C8EEA7C443CAA49,063-000-001,22222222,TAFE BOOKSHOP CBA,82.18,0,1510140.5,DR,REF995534,CBA,Savings
24-09-2025 05:06,CBA3E14E2E6D65F42F084C3,063-000-001,22222222,FLIXBUS CBA,1.81,0,1510138.69,DR,REF327575,CBA,Savings
24-09-2025 05:37,INT64E29D8F3F504B7AA121,063-000-001,22222222,TRANSFER TO ANZ 11111111,286.41,0,1509852.28,DR,INT-68822,CBA,Savings
24-09-2025 05:44,CBACBE30E1ABFBD43C7A48C,063-000-001,22222222,MENULOG CBA,55.8,0,1509796.48,DR,REF326456,CBA,Savings
24-09-2025 05:51,CBA33743AB8B9984114AF17,063-000-001,22222222,FLIXBUS CBA,59.08,0,1509737.4,DR,REF836386,CBA,Savings
24-09-2025 06:17,CBA3BE58954F94A4353AE7C,063-000-001,22222222,BIGW CBA,117.14,0,1509620.26,DR,REF216953,CBA,Savings
24-09-2025 06:18,INTC3F17C9FC65E4D41B6CA,063-000-001,22222222,TRANSFER FROM ANZ 11111111,0,366.44,1509986.7,CR,INT-23984,CBA,Savings
24-09-2025 06:23,CBA8774CD5ECCC54A9EBB3F,063-000-001,22222222,WOOLWORTHS CBA,111.29,0,1509875.41,DR,REF196369,CBA,Savings
24-09-2025 06:29,CBA05730BEAB9084FE19E06,063-000-001,22222222,JB HI-FI CBA,148.41,0,1509727,DR,REF175518,CBA,Savings
24-09-2025 06:30,CBA8E3E4B77278F4F298012,063-000-001,22222222,HARVEY NORMAN CBA,63.27,0,1509663.73,DR,REF466277,CBA,Savings
24-09-2025 06:41,CBA57B60AB437BF4B41BDB7,063-000-001,22222222,TAFE BOOKSHOP CBA,65.23,0,1509598.5,DR,REF789956,CBA,Savings
24-09-2025 06:48,CBA3462EE4041204CD798EE,063-000-001,22222222,WOOLWORTHS CBA,73.9,0,1509524.6,DR,REF539190,CBA,Savings
24-09-2025 07:22,CBA7E4A1E8CF9D547BDACA7,063-000-001,22222222,SPOTIFY CBA,15.98,0,1509508.62,DR,REF853653,CBA,Savings
24-09-2025 07:34,CBA6B01066153D54AF99A41,063-000-001,22222222,SPOTIFY CBA,51.56,0,1509457.06,DR,REF377219,CBA,Savings
24-09-2025 09:24,CBAA02546EA78C54BB3ADAF,063-000-001,22222222,APPLE CBA,194.14,0,1509262.92,DR,REF228544,CBA,Savings
24-09-2025 09:29,CBA3E7C51DE50BB4AFF96F2,063-000-001,22222222,MCDONALDS CBA,154.62,0,1509108.3,DR,REF636377,CBA,Savings
24-09-2025 09:51,CBACBC887A95D1D42469278,063-000-001,22222222,SPOTIFY CBA,17.48,0,1509090.82,DR,REF503286,CBA,Savings
24-09-2025 10:05,INTCD4666AF8F0F47079989,063-000-001,22222222,TRANSFER FROM CBA 33333333,0,329.43,1509420.25,CR,INT-62647,CBA,Savings
24-09-2025 10:09,CBA867A82522F174CAEAEFE,063-000-001,22222222,HARVEY NORMAN CBA,1.72,0,1509418.53,DR,REF210005,CBA,Savings
24-09-2025 10:14,CBA9AC5F5D1A57C4AE6A84B,063-000-001,22222222,PAYPAL *NETFLIX CBA,59.35,0,1509359.18,DR,REF362933,CBA,Savings
24-09-2025 10:21,CBACE2D44996FB54AE3B4CE,063-000-001,22222222,WAGES CREDIT CBA,0,5583.09,1514942.27,CR,REF849128,CBA,Savings
24-09-2025 10:24,CBACCE30FB6730E45D0947F,063-000-001,22222222,APPLE CBA,14.02,0,1514928.25,DR,REF555692,CBA,Savings
24-09-2025 10:26,CBA060A9D94C8404B6BB6E4,063-000-001,22222222,PAYROLL CREDIT CBA,0,7021.35,1521949.6,CR,REF547032,CBA,Savings
24-09-2025 10:34,CBAEA66D8E2F76743548923,063-000-001,22222222,SPOTIFY CBA,33.96,0,1521915.64,DR,REF122821,CBA,Savings
24-09-2025 10:54,CBAF1B8E2CE25B44CC696BB,063-000-001,22222222,RAILWAY STATION CBA,217.19,0,1521698.45,DR,REF993349,CBA,Savings
24-09-2025 11:22,CBA81881C29A4694FA78A58,063-000-001,22222222,JB HI-FI CBA,10.6,0,1521687.85,DR,REF669101,CBA,Savings
24-09-2025 11:22,CBA1E4B2E7F28B54FB4B765,063-000-001,22222222,RAILWAY STATION CBA,5.25,0,1521682.6,DR,REF954130,CBA,Savings
24-09-2025 11:27,CBADC8BFFD7A4E040EB8E60,063-000-001,22222222,HARVEY NORMAN CBA,26.95,0,1521655.65,DR,REF330338,CBA,Savings
24-09-2025 11:32,CBA7AF5A53EED28461FBCA2,063-000-001,22222222,ZOOM CBA,15.14,0,1521640.51,DR,REF327355,CBA,Savings
24-09-2025 12:20,CBA846A67BA2A0C4BE7BB16,063-000-001,22222222,WAGES CREDIT CBA,0,756.11,1522396.62,CR,REF533368,CBA,Savings
24-09-2025 12:25,CBAF0081798A0A64B4199DD,063-000-001,22222222,BIGW CBA,34.36,0,1522362.26,DR,REF312119,CBA,Savings
24-09-2025 12:39,CBA47A7F333FDC8420DAB56,063-000-001,22222222,TAFE BOOKSHOP CBA,71.65,0,1522290.61,DR,REF677148,CBA,Savings
24-09-2025 15:02,CBAA68C902D01724B39B747,063-000-001,22222222,MENULOG CBA,52.3,0,1522238.31,DR,REF745782,CBA,Savings
24-09-2025 15:07,CBAB96302D228E840E39EC7,063-000-001,22222222,KFC CBA,20.76,0,1522217.55,DR,REF835479,CBA,Savings
24-09-2025 15:10,CBAF150196C7C83487C99D2,063-000-001,22222222,BP CBA,118.13,0,1522099.42,DR,REF624302,CBA,Savings
24-09-2025 15:13,INTB3270D6D8C8F43019525,063-000-001,22222222,TRANSFER FROM ANZ 11111111,0,1518.69,1523618.11,CR,INT-72691,CBA,Savings
24-09-2025 15:35,CBA103A73EC6EBF41808EBB,063-000-001,22222222,SALARY PAYMENT CBA,0,1849.1,1525467.21,CR,REF874465,CBA,Savings
24-09-2025 15:51,CBA4D9249BA07E348A39D1F,063-000-001,22222222,UBER EATS CBA,152.21,0,1525315,DR,REF379543,CBA,Savings
24-09-2025 16:07,CBA3D975E02FC4B414FBF18,063-000-001,22222222,UBER EATS CBA,53.16,0,1525261.84,DR,REF352406,CBA,Savings
24-09-2025 16:25,INT2E2B634A047645A3A390,063-000-001,22222222,TRANSFER FROM CBA 33333333,0,1232.84,1526494.68,CR,INT-62433,CBA,Savings
24-09-2025 17:18,CBAAEE6911F000B4A5EB9A5,063-000-001,22222222,SHELL CBA,10.27,0,1526484.41,DR,REF474299,CBA,Savings
24-09-2025 17:25,CBA06220050142E47B3854B,063-000-001,22222222,TAFE BOOKSHOP CBA,6.89,0,1526477.52,DR,REF448760,CBA,Savings
24-09-2025 17:41,CBA12750D0B8DD94A20B9B9,063-000-001,22222222,COMPANY PAYROLL CBA,0,1024.36,1527501.88,CR,REF677862,CBA,Savings
24-09-2025 19:28,CBA81F8230524D74B17AF8D,063-000-001,22222222,PAYROLL CREDIT CBA,0,2288.5,1529790.38,CR,REF360036,CBA,Savings
24-09-2025 20:02,CBA11B6C0962F7A457CB1BE,063-000-001,22222222,7-ELEVEN CBA,56,0,1529734.38,DR,REF983695,CBA,Savings
24-09-2025 20:14,CBA059E3703DE25492F96A7,063-000-001,22222222,BP CBA,7.58,0,1529726.8,DR,REF110556,CBA,Savings
24-09-2025 21:33,INT13E40973288745F0AA4A,063-000-001,22222222,TRANSFER TO ANZ 11111111,499.04,0,1529227.76,DR,INT-86309,CBA,Savings
24-09-2025 21:35,CBA96063C9204714C7FA9C9,063-000-001,22222222,LIQUORLAND CBA,15.02,0,1529212.74,DR,REF392571,CBA,Savings
24-09-2025 21:44,CBA53D9960B04024ACCB0AA,063-000-001,22222222,LIQUORLAND CBA,44.75,0,1529167.99,DR,REF788489,CBA,Savings
24-09-2025 21:48,CBA714E3A7DE98F4C72A2B3,063-000-001,22222222,7-ELEVEN CBA,7.43,0,1529160.56,DR,REF944957,CBA,Savings
24-09-2025 21:52,CBA9BC06AA69E1E4FD4AF56,063-000-001,22222222,FLIXBUS CBA,86.52,0,1529074.04,DR,REF844043,CBA,Savings
24-09-2025 22:06,CBAA3DF5F5B55BF49D6B4B8,063-000-001,22222222,COMPANY PAYROLL CBA,0,2395.09,1531469.13,CR,REF256491,CBA,Savings
24-09-2025 22:27,CBAE5ACC92EB7D643B5BFE8,063-000-001,22222222,SPOTIFY CBA,3.92,0,1531465.21,DR,REF363021,CBA,Savings
24-09-2025 22:56,INT809602D5783B4E649D9F,063-000-001,22222222,TRANSFER TO CBA 33333333,305.27,0,1531159.94,DR,INT-99105,CBA,Savings
24-09-2025 23:31,CBA26B112FC33104558AE50,063-000-001,22222222,UBER EATS CBA,68.44,0,1531091.5,DR,REF770338,CBA,Savings
24-09-2025 23:33,CBA24E5601AAF48410AA9C9,063-000-001,22222222,PAY - SALARY CBA,0,7112.39,1538203.89,CR,REF237410,CBA,Savings
25-09-2025 01:01,INT42566CE092FF4D8F8237,063-000-001,22222222,TRANSFER TO ANZ 11111111,1290.18,0,1536913.71,DR,INT-40527,CBA,Savings
25-09-2025 01:04,CBA4121846D0BB64280AE36,063-000-001,22222222,COLES CBA,137.49,0,1536776.22,DR,REF858109,CBA,Savings
25-09-2025 01:09,CBA801907963E7D40EF9740,063-000-001,22222222,JB HI-FI CBA,81.77,0,1536694.45,DR,REF576347,CBA,Savings
25-09-2025 01:17,CBAC355D521F9E6436E9C8E,063-000-001,22222222,TAFE BOOKSHOP CBA,45.42,0,1536649.03,DR,REF166366,CBA,Savings
25-09-2025 01:22,CBA2B9C1E0709A743908EF6,063-000-001,22222222,TAFE BOOKSHOP CBA,65.83,0,1536583.2,DR,REF132623,CBA,Savings
25-09-2025 01:35,CBACB13CC065F634C8DB99D,063-000-001,22222222,KFC CBA,11.19,0,1536572.01,DR,REF911061,CBA,Savings
25-09-2025 01:37,CBAD9651433106B46DABB62,063-000-001,22222222,PAYMENT GATEWAY CBA,257.63,0,1536314.38,DR,REF870352,CBA,Savings
25-09-2025 01:38,CBA25A1865C3A0243469DDA,063-000-001,22222222,STARBUCKS CBA,63.04,0,1536251.34,DR,REF268050,CBA,Savings
25-09-2025 01:54,CBA3FE3F67EFF6D41A4A9DC,063-000-001,22222222,WAGES CREDIT CBA,0,5500.73,1541752.07,CR,REF403519,CBA,Savings
25-09-2025 02:01,CBA3466182FA1554D4EA6F9,063-000-001,22222222,UBER EATS CBA,27.82,0,1541724.25,DR,REF587352,CBA,Savings
25-09-2025 02:23,CBAE034086BF1BF41D393CA,063-000-001,22222222,MENULOG CBA,24.54,0,1541699.71,DR,REF504427,CBA,Savings
25-09-2025 02:27,INTB99DA17F4A7541FAA683,063-000-001,22222222,TRANSFER FROM NAB 44444444,0,167.59,1541867.3,CR,INT-52840,CBA,Savings
25-09-2025 02:40,CBA9EFC63E5E287441488D5,063-000-001,22222222,WOOLWORTHS CBA,33.64,0,1541833.66,DR,REF466554,CBA,Savings
25-09-2025 02:45,CBA493E04B0EF974F759BAE,063-000-001,22222222,SHELL CBA,3.13,0,1541830.53,DR,REF458940,CBA,Savings
25-09-2025 03:55,CBA2E73DD0ED9224867B01D,063-000-001,22222222,STARBUCKS CBA,177.4,0,1541653.13,DR,REF643539,CBA,Savings
25-09-2025 04:03,INT7A645BA7F299402391E8,063-000-001,22222222,TRANSFER FROM ANZ 11111111,0,580.52,1542233.65,CR,INT-35856,CBA,Savings
25-09-2025 04:10,CBA7068A865D74946748AE5,063-000-001,22222222,AMAZON AU CBA,94.75,0,1542138.9,DR,REF320767,CBA,Savings
25-09-2025 04:25,CBA0094199FADD4453A9EC9,063-000-001,22222222,SALARY PAYMENT CBA,0,2424.26,1544563.16,CR,REF364849,CBA,Savings
25-09-2025 04:37,CBA8E88B54E855248689C2B,063-000-001,22222222,PAYMENT GATEWAY CBA,46.46,0,1544516.7,DR,REF406891,CBA,Savings
25-09-2025 04:43,CBA839967740941498A9AEF,063-000-001,22222222,MENULOG CBA,54.7,0,1544462,DR,REF677491,CBA,Savings
25-09-2025 04:48,CBA790DE53F06BC4CFE8388,063-000-001,22222222,STARBUCKS CBA,82.59,0,1544379.41,DR,REF248465,CBA,Savings
25-09-2025 04:54,CBA4A6C6A2A4EC44C4BAC9E,063-000-001,22222222,BANK FEE CBA,84.03,0,1544295.38,DR,REF795400,CBA,Savings
25-09-2025 05:04,INT582753569E87406E9760,063-000-001,22222222,TRANSFER FROM NAB 44444444,0,1055.13,1545350.51,CR,INT-36644,CBA,Savings
25-09-2025 06:01,CBA52795FD72D84481AB153,063-000-001,22222222,PAYROLL CREDIT CBA,0,7880.53,1553231.04,CR,REF426841,CBA,Savings
25-09-2025 06:23,CBA529B311203474E78B824,063-000-001,22222222,LIQUORLAND CBA,40.03,0,1553191.01,DR,REF182558,CBA,Savings
25-09-2025 07:23,CBAA62EC1892C3E4A9DBB96,063-000-001,22222222,PAYPAL *NETFLIX CBA,45.04,0,1553145.97,DR,REF320247,CBA,Savings
25-09-2025 07:29,CBA7446EF25896F49C9AD83,063-000-001,22222222,WAGES CREDIT CBA,0,7917.52,1561063.49,CR,REF884216,CBA,Savings
25-09-2025 07:33,CBAFAFA9A527EF84C08971F,063-000-001,22222222,COMPANY PAYROLL CBA,0,2749.05,1563812.54,CR,REF277050,CBA,Savings
25-09-2025 07:42,CBAD1FCB305FCBC43D5A06D,063-000-001,22222222,SPOTIFY CBA,49.41,0,1563763.13,DR,REF739442,CBA,Savings
25-09-2025 07:45,CBA82A0747CFA6F442786B6,063-000-001,22222222,MCDONALDS CBA,45.35,0,1563717.78,DR,REF239440,CBA,Savings
25-09-2025 07:53,CBAA294FF918322435CAEA0,063-000-001,22222222,KFC CBA,99.09,0,1563618.69,DR,REF933754,CBA,Savings
25-09-2025 08:20,CBA2431382952FE4C359DE1,063-000-001,22222222,SHELL CBA,25.61,0,1563593.08,DR,REF931790,CBA,Savings
25-09-2025 08:49,CBA2CD072DA555A48B48093,063-000-001,22222222,UBER EATS CBA,28.63,0,1563564.45,DR,REF563818,CBA,Savings
25-09-2025 09:10,INT33B1D9335A394153A97D,063-000-001,22222222,TRANSFER TO ANZ 11111111,1883.7,0,1561680.75,DR,INT-27600,CBA,Savings
25-09-2025 09:24,CBAE0F26D7DDB184F0D9136,063-000-001,22222222,PAYMENT GATEWAY CBA,80.29,0,1561600.46,DR,REF480658,CBA,Savings
25-09-2025 09:45,CBA44E2D9E2E152435C8800,063-000-001,22222222,FLIXBUS CBA,170.53,0,1561429.93,DR,REF144872,CBA,Savings
25-09-2025 10:16,CBA1F4C737F7E0F43A18500,063-000-001,22222222,MCDONALDS CBA,16.27,0,1561413.66,DR,REF277568,CBA,Savings
25-09-2025 10:59,CBA77E96419BD8F4EF78A45,063-000-001,22222222,PAY - SALARY CBA,0,681.26,1562094.92,CR,REF159381,CBA,Savings
25-09-2025 11:14,CBAA7377D4A0E4541FEA52F,063-000-001,22222222,SHELL CBA,50.3,0,1562044.62,DR,REF115393,CBA,Savings
25-09-2025 11:18,CBA6396C9BAA3B244F39488,063-000-001,22222222,LIQUORLAND CBA,13.33,0,1562031.29,DR,REF460241,CBA,Savings
25-09-2025 11:34,CBA53BCD28A5B374581A392,063-000-001,22222222,SALARY PAYMENT CBA,0,2982.24,1565013.53,CR,REF906037,CBA,Savings
25-09-2025 12:07,CBAA2015014589A493A946D,063-000-001,22222222,CITYLINK CBA,189.12,0,1564824.41,DR,REF386656,CBA,Savings
25-09-2025 12:07,CBADA8DFD11156A401CB590,063-000-001,22222222,RAILWAY STATION CBA,50.34,0,1564774.07,DR,REF958242,CBA,Savings
25-09-2025 12:44,CBADE73FE5789724602B764,063-000-001,22222222,PAYPAL *NETFLIX CBA,7.3,0,1564766.77,DR,REF333243,CBA,Savings
25-09-2025 13:41,CBAFE233A86B24340C7A7D2,063-000-001,22222222,JB HI-FI CBA,67.22,0,1564699.55,DR,REF451945,CBA,Savings
25-09-2025 14:02,CBAA255EAB8D4AF4C2993E8,063-000-001,22222222,MCDONALDS CBA,102.3,0,1564597.25,DR,REF383670,CBA,Savings
25-09-2025 14:02,CBA475AF92037B143E8BA0E,063-000-001,22222222,SALARY PAYMENT CBA,0,6518.43,1571115.68,CR,REF724561,CBA,Savings
25-09-2025 14:57,CBA23959442D2C048C18235,063-000-001,22222222,MCDONALDS CBA,9.6,0,1571106.08,DR,REF878083,CBA,Savings
25-09-2025 14:57,CBAF8E70BDCE702488B8CE1,063-000-001,22222222,BANK FEE CBA,9.43,0,1571096.65,DR,REF570118,CBA,Savings
25-09-2025 15:06,CBA4C2ABD66DE7B404CB8FF,063-000-001,22222222,JB HI-FI CBA,8.21,0,1571088.44,DR,REF844407,CBA,Savings
25-09-2025 15:41,CBAF28A5198FDE145B183CC,063-000-001,22222222,PAYROLL CREDIT CBA,0,3517.47,1574605.91,CR,REF252481,CBA,Savings
25-09-2025 15:54,CBA13400416BCF24C608300,063-000-001,22222222,CITYLINK CBA,37.43,0,1574568.48,DR,REF521292,CBA,Savings
25-09-2025 15:59,CBAA39E5568396E4483A174,063-000-001,22222222,STARBUCKS CBA,60.88,0,1574507.6,DR,REF505341,CBA,Savings
25-09-2025 15:59,CBA56DE52E7B12B4BE1813A,063-000-001,22222222,ALDI CBA,137.47,0,1574370.13,DR,REF179049,CBA,Savings
25-09-2025 16:32,CBAEA9B032940E04F40A83F,063-000-001,22222222,AMAZON AU CBA,76.23,0,1574293.9,DR,REF376129,CBA,Savings
25-09-2025 16:36,CBA9975B412AD374B7FA952,063-000-001,22222222,BP CBA,126.57,0,1574167.33,DR,REF958549,CBA,Savings
25-09-2025 16:46,CBAA7EF9F3927394E0DA304,063-000-001,22222222,ALDI CBA,5.13,0,1574162.2,DR,REF144730,CBA,Savings
25-09-2025 17:07,CBAA0629CAE08234874BB18,063-000-001,22222222,INTERNET TRANSFER CBA,7.68,0,1574154.52,DR,REF899222,CBA,Savings
25-09-2025 17:14,CBAEDB2A625E46A447B8115,063-000-001,22222222,PAYMENT GATEWAY CBA,47.4,0,1574107.12,DR,REF475251,CBA,Savings
25-09-2025 17:40,CBAB2AF569E695541F285B6,063-000-001,22222222,RAILWAY STATION CBA,12.97,0,1574094.15,DR,REF171371,CBA,Savings
25-09-2025 17:48,CBABA40EDB891A3435592D3,063-000-001,22222222,CITYLINK CBA,86.51,0,1574007.64,DR,REF770947,CBA,Savings
25-09-2025 17:49,CBA14B5F08873504D5E9770,063-000-001,22222222,MENULOG CBA,70.68,0,1573936.96,DR,REF588800,CBA,Savings
25-09-2025 17:58,CBA5536B4D324624A66A77B,063-000-001,22222222,SHELL CBA,8.2,0,1573928.76,DR,REF999444,CBA,Savings
25-09-2025 18:01,CBAD2CE282B34FD4DCC999B,063-000-001,22222222,TAFE BOOKSHOP CBA,43.04,0,1573885.72,DR,REF289238,CBA,Savings
25-09-2025 18:05,CBA6F47A296469741FF88D9,063-000-001,22222222,PAYPAL *NETFLIX CBA,96.39,0,1573789.33,DR,REF959407,CBA,Savings
25-09-2025 18:30,CBAF0978D3FF0EA41078D26,063-000-001,22222222,RAILWAY STATION CBA,140.93,0,1573648.4,DR,REF485459,CBA,Savings
25-09-2025 18:35,CBA81101D6C0FDD428DA28F,063-000-001,22222222,WAGES CREDIT CBA,0,744.23,1574392.63,CR,REF279259,CBA,Savings
25-09-2025 19:23,CBA179B9B89B95D4265AB4F,063-000-001,22222222,PAYMENT GATEWAY CBA,28.37,0,1574364.26,DR,REF687429,CBA,Savings
25-09-2025 19:24,CBADBD9CD2D79364CCE8DFC,063-000-001,22222222,JB HI-FI CBA,85.88,0,1574278.38,DR,REF403059,CBA,Savings
25-09-2025 19:24,CBA73720DB73AC9496682B6,063-000-001,22222222,INTERNET TRANSFER CBA,57.19,0,1574221.19,DR,REF339627,CBA,Savings
25-09-2025 19:29,CBAFDC5B0FCA5CD413D9920,063-000-001,22222222,LIQUORLAND CBA,7.05,0,1574214.14,DR,REF409336,CBA,Savings
25-09-2025 19:36,CBA5E9835417B4F434FB0B7,063-000-001,22222222,SALARY PAYMENT CBA,0,7489.27,1581703.41,CR,REF260494,CBA,Savings
25-09-2025 19:40,CBA9D69EAF050834441998B,063-000-001,22222222,BANK FEE CBA,33.13,0,1581670.28,DR,REF291437,CBA,Savings
25-09-2025 19:40,CBA22D4BB0979484AD5920A,063-000-001,22222222,DOMINO'S PIZZA CBA,97.85,0,1581572.43,DR,REF651550,CBA,Savings
25-09-2025 19:41,CBAC9A142BE156E463793E1,063-000-001,22222222,BP CBA,6.59,0,1581565.84,DR,REF859727,CBA,Savings
25-09-2025 19:57,CBAEFB04D193F084EA29CF1,063-000-001,22222222,APPLE CBA,76.52,0,1581489.32,DR,REF128924,CBA,Savings
25-09-2025 20:07,CBA7F56FC445DAE41CEBD06,063-000-001,22222222,BP CBA,78.43,0,1581410.89,DR,REF807454,CBA,Savings
25-09-2025 20:08,CBA697E97A7F7CA4BBC9E58,063-000-001,22222222,STARBUCKS CBA,59.47,0,1581351.42,DR,REF983955,CBA,Savings
25-09-2025 21:26,INT680B37CD88F546E3A33C,063-000-001,22222222,TRANSFER TO ANZ 11111111,557.86,0,1580793.56,DR,INT-97521,CBA,Savings
25-09-2025 21:53,CBA07FFDCCE1F224E3D9DCC,063-000-001,22222222,KFC CBA,27.8,0,1580765.76,DR,REF623519,CBA,Savings
25-09-2025 22:08,CBA7FA739CC8D3D4BB1B047,063-000-001,22222222,BWS CBA,35.28,0,1580730.48,DR,REF167006,CBA,Savings
25-09-2025 22:18,CBAA15FFA5126484A2995F9,063-000-001,22222222,BWS CBA,151.7,0,1580578.78,DR,REF125701,CBA,Savings
25-09-2025 23:05,CBA6319D0C54EFB47D7AB55,063-000-001,22222222,COLES CBA,24.48,0,1580554.3,DR,REF513609,CBA,Savings
25-09-2025 23:11,CBA39CD54999D91406E8400,063-000-001,22222222,PAYROLL CREDIT CBA,0,7207.26,1587761.56,CR,REF939113,CBA,Savings
25-09-2025 23:34,CBA4C279E178E924F4D8EBA,063-000-001,22222222,LIQUORLAND CBA,35.74,0,1587725.82,DR,REF723755,CBA,Savings
25-09-2025 23:51,CBABB2FDE12B436449296CF,063-000-001,22222222,AMAZON AU CBA,38.81,0,1587687.01,DR,REF506095,CBA,Savings
26-09-2025 00:13,CBAE8E86C9F9B3B43BD8511,063-000-001,22222222,TAFE BOOKSHOP CBA,1.63,0,1587685.38,DR,REF402621,CBA,Savings
26-09-2025 00:14,CBAAA452C9CF1BF45D98E97,063-000-001,22222222,CITYLINK CBA,107.95,0,1587577.43,DR,REF329752,CBA,Savings
26-09-2025 00:19,CBA314360E580BB49F49739,063-000-001,22222222,BIGW CBA,11.03,0,1587566.4,DR,REF540112,CBA,Savings
26-09-2025 00:40,CBA7056684A12E7400590B2,063-000-001,22222222,PAYROLL CREDIT CBA,0,4444.73,1592011.13,CR,REF732848,CBA,Savings
26-09-2025 00:42,CBAC525B60AFC6541FFB10F,063-000-001,22222222,HARVEY NORMAN CBA,26.77,0,1591984.36,DR,REF134157,CBA,Savings
26-09-2025 00:55,CBAB9EC79B2C654426C8361,063-000-001,22222222,PAY - SALARY CBA,0,3316.67,1595301.03,CR,REF465280,CBA,Savings
26-09-2025 00:58,CBA3E9935ECA569439FA8B5,063-000-001,22222222,CITYLINK CBA,78.16,0,1595222.87,DR,REF520603,CBA,Savings
26-09-2025 01:18,CBA7028652001754745A381,063-000-001,22222222,RAILWAY STATION CBA,120.45,0,1595102.42,DR,REF874697,CBA,Savings
26-09-2025 01:55,CBA6B6B53B9ACCB42AD9D77,063-000-001,22222222,DOMINO'S PIZZA CBA,39.54,0,1595062.88,DR,REF117629,CBA,Savings
26-09-2025 02:06,CBA546A3E58FAF142E4A640,063-000-001,22222222,BIGW CBA,35.45,0,1595027.43,DR,REF340287,CBA,Savings
26-09-2025 03:12,CBAA77A486F3A634B999A91,063-000-001,22222222,INTERNET TRANSFER CBA,28.89,0,1594998.54,DR,REF580304,CBA,Savings
26-09-2025 03:15,CBAF61FFA285AE84B0CAD9F,063-000-001,22222222,AMAZON AU CBA,5.16,0,1594993.38,DR,REF461546,CBA,Savings
26-09-2025 03:35,CBA4BC7CD2D38C1428EA283,063-000-001,22222222,SALARY PAYMENT CBA,0,568.83,1595562.21,CR,REF685839,CBA,Savings
26-09-2025 04:03,CBAE494C5221A00472FA135,063-000-001,22222222,PAYROLL CREDIT CBA,0,301.45,1595863.66,CR,REF558630,CBA,Savings
26-09-2025 04:08,CBA4F854EC8FF1E453096B5,063-000-001,22222222,WOOLWORTHS CBA,101.1,0,1595762.56,DR,REF777561,CBA,Savings
26-09-2025 04:18,CBACE11A950E9554E6C84F5,063-000-001,22222222,SHELL CBA,18.89,0,1595743.67,DR,REF887984,CBA,Savings
26-09-2025 05:10,CBA2F7532F787774B5AB34B,063-000-001,22222222,WAGES CREDIT CBA,0,400.93,1596144.6,CR,REF196730,CBA,Savings
26-09-2025 05:14,CBAB87461483D56470E9090,063-000-001,22222222,ALDI CBA,7.87,0,1596136.73,DR,REF755944,CBA,Savings
26-09-2025 06:01,CBA45E59CF1FCE541E49B2A,063-000-001,22222222,SPOTIFY CBA,99.11,0,1596037.62,DR,REF529259,CBA,Savings
26-09-2025 06:21,CBAC0A816992D6D45B49877,063-000-001,22222222,DOMINO'S PIZZA CBA,64.95,0,1595972.67,DR,REF244031,CBA,Savings
26-09-2025 06:48,CBA9C807D5EB3F5432AA322,063-000-001,22222222,BIGW CBA,3.74,0,1595968.93,DR,REF472250,CBA,Savings
26-09-2025 06:54,CBA75A75348E28342ACB232,063-000-001,22222222,SHELL CBA,5.3,0,1595963.63,DR,REF734960,CBA,Savings
26-09-2025 07:06,CBA4642ED2FC6C647D181EC,063-000-001,22222222,UBER EATS CBA,38.9,0,1595924.73,DR,REF105355,CBA,Savings
26-09-2025 07:26,CBA517D8E24B5964755BB22,063-000-001,22222222,ZOOM CBA,11.64,0,1595913.09,DR,REF131316,CBA,Savings
26-09-2025 08:03,CBA5969D849EDF84D62AA7F,063-000-001,22222222,MCDONALDS CBA,20.38,0,1595892.71,DR,REF695304,CBA,Savings
26-09-2025 08:09,CBA299DE7CB676B4749BEDC,063-000-001,22222222,STARBUCKS CBA,11.33,0,1595881.38,DR,REF147083,CBA,Savings
26-09-2025 08:31,CBA79BF48FAEF054AD2835C,063-000-001,22222222,COMPANY PAYROLL CBA,0,5675.52,1601556.9,CR,REF242535,CBA,Savings
26-09-2025 09:01,CBA0DEFD2010A8947B09C28,063-000-001,22222222,PAY - SALARY CBA,0,1032.93,1602589.83,CR,REF932238,CBA,Savings
26-09-2025 09:08,CBA46CED094F08B4A8E8BA3,063-000-001,22222222,ALDI CBA,22.48,0,1602567.35,DR,REF604586,CBA,Savings
26-09-2025 09:58,CBA0DF0D1353C2B4C34A248,063-000-001,22222222,WAGES CREDIT CBA,0,6318.15,1608885.5,CR,REF310016,CBA,Savings
26-09-2025 10:11,CBAFAF96D1524EF4C6F8A82,063-000-001,22222222,KFC CBA,69.44,0,1608816.06,DR,REF612426,CBA,Savings
26-09-2025 11:11,CBA7F8AD02D896D43F6BC4A,063-000-001,22222222,KFC CBA,34.03,0,1608782.03,DR,REF503392,CBA,Savings
26-09-2025 11:35,CBA15515B84061E464D8477,063-000-001,22222222,HARVEY NORMAN CBA,30.47,0,1608751.56,DR,REF873326,CBA,Savings
26-09-2025 11:47,CBA59184DC84CDC4A28BB3C,063-000-001,22222222,APPLE CBA,189.26,0,1608562.3,DR,REF767335,CBA,Savings
26-09-2025 12:03,INT1E585024F98346749C98,063-000-001,22222222,TRANSFER FROM ANZ 11111111,0,620.53,1609182.83,CR,INT-53173,CBA,Savings
26-09-2025 12:22,CBA876F56443BD3435F8660,063-000-001,22222222,STARBUCKS CBA,21.69,0,1609161.14,DR,REF784751,CBA,Savings
26-09-2025 12:24,CBA63C5964547524730B385,063-000-001,22222222,COMPANY PAYROLL CBA,0,5666.94,1614828.08,CR,REF376952,CBA,Savings
26-09-2025 12:56,CBAF68AF16E2F054E91AC31,063-000-001,22222222,7-ELEVEN CBA,43.62,0,1614784.46,DR,REF567810,CBA,Savings
26-09-2025 13:05,CBAB4C5EFF6E2104D439C10,063-000-001,22222222,PAYMENT GATEWAY CBA,58.69,0,1614725.77,DR,REF956056,CBA,Savings
26-09-2025 13:09,CBAFF3985FF792F499791FB,063-000-001,22222222,WOOLWORTHS CBA,2.53,0,1614723.24,DR,REF216739,CBA,Savings
26-09-2025 13:23,CBA9DFD3E7D2C0246C1823E,063-000-001,22222222,LIQUORLAND CBA,61.4,0,1614661.84,DR,REF635970,CBA,Savings
26-09-2025 13:32,CBACC677D96AFB9453F9827,063-000-001,22222222,PAYROLL CREDIT CBA,0,4187.02,1618848.86,CR,REF805639,CBA,Savings
26-09-2025 14:09,CBA77954ED53A5B47FDBA7A,063-000-001,22222222,INTERNET TRANSFER CBA,38.17,0,1618810.69,DR,REF143271,CBA,Savings
26-09-2025 14:24,CBA77E61A5C77EB4DABBAF0,063-000-001,22222222,RAILWAY STATION CBA,15.86,0,1618794.83,DR,REF248270,CBA,Savings
26-09-2025 14:40,CBAD45EA9532CDB45E1B9B1,063-000-001,22222222,SHELL CBA,57.5,0,1618737.33,DR,REF777155,CBA,Savings
26-09-2025 14:41,CBA25925D2E648740D98DE7,063-000-001,22222222,SALARY PAYMENT CBA,0,6174.96,1624912.29,CR,REF830955,CBA,Savings
26-09-2025 16:15,CBA70DD1EF533C84502A3A2,063-000-001,22222222,MENULOG CBA,32.95,0,1624879.34,DR,REF392573,CBA,Savings
26-09-2025 16:34,CBAFC5622B75F384FFFAB5D,063-000-001,22222222,BIGW CBA,61.52,0,1624817.82,DR,REF583923,CBA,Savings
26-09-2025 16:54,CBA384A9A96E45A4ABD93DD,063-000-001,22222222,MENULOG CBA,39,0,1624778.82,DR,REF532277,CBA,Savings
26-09-2025 17:10,CBABCADCE792BD048C29415,063-000-001,22222222,ZOOM CBA,19.13,0,1624759.69,DR,REF125937,CBA,Savings
26-09-2025 17:52,CBA743A922DF6F542DC9C93,063-000-001,22222222,AMAZON AU CBA,263.43,0,1624496.26,DR,REF574063,CBA,Savings
26-09-2025 17:54,CBA8908046ADC13485AA643,063-000-001,22222222,TAFE BOOKSHOP CBA,43.13,0,1624453.13,DR,REF991897,CBA,Savings
26-09-2025 18:19,CBA299441FA30B049F48107,063-000-001,22222222,JB HI-FI CBA,55.39,0,1624397.74,DR,REF134415,CBA,Savings
26-09-2025 19:05,INT464502D977774CADBEBF,063-000-001,22222222,TRANSFER FROM ANZ 11111111,0,304.5,1624702.24,CR,INT-48246,CBA,Savings
26-09-2025 19:19,CBA22665739E8704568B6F3,063-000-001,22222222,DOMINO'S PIZZA CBA,5.89,0,1624696.35,DR,REF392835,CBA,Savings
26-09-2025 19:34,CBAA4C14DBECED747F3AB52,063-000-001,22222222,UBER EATS CBA,33.16,0,1624663.19,DR,REF492572,CBA,Savings
26-09-2025 19:57,CBAF3382C3FEBD34C3F87AD,063-000-001,22222222,SPOTIFY CBA,179.46,0,1624483.73,DR,REF288182,CBA,Savings
26-09-2025 20:00,CBAEA5F6C76A75A40BBA340,063-000-001,22222222,RAILWAY STATION CBA,41.53,0,1624442.2,DR,REF915847,CBA,Savings
26-09-2025 20:31,CBA52DE565C04E74A77A557,063-000-001,22222222,MCDONALDS CBA,15.39,0,1624426.81,DR,REF902309,CBA,Savings
26-09-2025 20:33,CBA34657A1825B246AA869C,063-000-001,22222222,BWS CBA,35.29,0,1624391.52,DR,REF336748,CBA,Savings
26-09-2025 20:34,CBA9FEA092470684202BFBF,063-000-001,22222222,LIQUORLAND CBA,30.69,0,1624360.83,DR,REF630412,CBA,Savings
26-09-2025 20:49,CBAA45B9DAD92454FB1B2CD,063-000-001,22222222,MENULOG CBA,76.21,0,1624284.62,DR,REF845142,CBA,Savings
26-09-2025 21:20,INT3C5A2836DE2F43F294B6,063-000-001,22222222,TRANSFER TO CBA 33333333,1076.11,0,1623208.51,DR,INT-12977,CBA,Savings
26-09-2025 21:26,CBAE830E6F079EE4D6E86E7,063-000-001,22222222,SALARY PAYMENT CBA,0,112.97,1623321.48,CR,REF433699,CBA,Savings
26-09-2025 21:37,CBA2D1FD28D914048109B9B,063-000-001,22222222,PAYROLL CREDIT CBA,0,4812.66,1628134.14,CR,REF611993,CBA,Savings
26-09-2025 22:00,CBA670BDDC3A69B46789815,063-000-001,22222222,SPOTIFY CBA,52.87,0,1628081.27,DR,REF748120,CBA,Savings
26-09-2025 22:20,CBAAA50294768F74E918E0C,063-000-001,22222222,WAGES CREDIT CBA,0,2474.58,1630555.85,CR,REF841452,CBA,Savings
26-09-2025 22:27,CBA800076C9EBF04CDBB630,063-000-001,22222222,FLIXBUS CBA,31.48,0,1630524.37,DR,REF258576,CBA,Savings
26-09-2025 22:50,CBA1FE0A0A14C1F45A9B807,063-000-001,22222222,SHELL CBA,22.97,0,1630501.4,DR,REF490711,CBA,Savings
26-09-2025 23:06,CBA953B7FB6B78E41AF91E3,063-000-001,22222222,PAYPAL *NETFLIX CBA,52.78,0,1630448.62,DR,REF545826,CBA,Savings
26-09-2025 23:25,CBAE9B8E26E355A404E81D5,063-000-001,22222222,7-ELEVEN CBA,12.72,0,1630435.9,DR,REF862085,CBA,Savings
26-09-2025 23:29,CBAC26C7A320E3A46C488D7,063-000-001,22222222,SALARY PAYMENT CBA,0,379.95,1630815.85,CR,REF379643,CBA,Savings
26-09-2025 23:44,INTF4021448D2DD477C94BE,063-000-001,22222222,TRANSFER TO CBA 33333333,1485.02,0,1629330.83,DR,INT-15873,CBA,Savings
26-09-2025 23:48,CBAEA919AD1CCA34F68964A,063-000-001,22222222,SALARY PAYMENT CBA,0,6888.87,1636219.7,CR,REF762605,CBA,Savings
27-09-2025 00:19,CBAB9AF86BCF02641A0B64C,063-000-001,22222222,BANK FEE CBA,22.49,0,1636197.21,DR,REF934644,CBA,Savings
27-09-2025 00:35,INT7B2B8BF2795446628AC4,063-000-001,22222222,TRANSFER FROM CBA 33333333,0,1336.7,1637533.91,CR,INT-78440,CBA,Savings
27-09-2025 00:44,CBA67D4E667C8ED44888B02,063-000-001,22222222,7-ELEVEN CBA,60.11,0,1637473.8,DR,REF287602,CBA,Savings
27-09-2025 00:59,CBAAEDCCF0A3701478FA669,063-000-001,22222222,RAILWAY STATION CBA,59.91,0,1637413.89,DR,REF710883,CBA,Savings
27-09-2025 01:07,CBA8CD59903FDED48C792ED,063-000-001,22222222,PAYPAL *NETFLIX CBA,14.03,0,1637399.86,DR,REF626892,CBA,Savings
27-09-2025 01:34,CBAFC08B2E2E5F9406793F6,063-000-001,22222222,RAILWAY STATION CBA,5.69,0,1637394.17,DR,REF601061,CBA,Savings
27-09-2025 01:48,CBAC3E8AEC3104A440BAA8C,063-000-001,22222222,HARVEY NORMAN CBA,24.56,0,1637369.61,DR,REF175467,CBA,Savings
27-09-2025 02:13,CBAB6F21ABA70284BE1AC41,063-000-001,22222222,MENULOG CBA,105.19,0,1637264.42,DR,REF389851,CBA,Savings
27-09-2025 02:24,CBA3F9D224EE67C40C6BF3B,063-000-001,22222222,ALDI CBA,1.99,0,1637262.43,DR,REF996544,CBA,Savings
27-09-2025 03:10,CBAF9D8F96487894F73AF0F,063-000-001,22222222,DOMINO'S PIZZA CBA,69.56,0,1637192.87,DR,REF730265,CBA,Savings
27-09-2025 03:18,CBA73B909483A9E42A98499,063-000-001,22222222,TAFE BOOKSHOP CBA,21.78,0,1637171.09,DR,REF243113,CBA,Savings
27-09-2025 03:36,CBA064DCEA9AF7B404CAC69,063-000-001,22222222,SHELL CBA,30.18,0,1637140.91,DR,REF431245,CBA,Savings
27-09-2025 03:36,CBA034684C9A0184F0D8DAA,063-000-001,22222222,SHELL CBA,70.76,0,1637070.15,DR,REF963662,CBA,Savings
27-09-2025 03:38,CBA3B9EEBAFA5324EEF946D,063-000-001,22222222,COLES CBA,25.56,0,1637044.59,DR,REF967707,CBA,Savings
27-09-2025 04:53,CBADAD76F876A574D6ABA0E,063-000-001,22222222,HARVEY NORMAN CBA,226.75,0,1636817.84,DR,REF606728,CBA,Savings
27-09-2025 05:06,CBA105C83E2FA2342958A5A,063-000-001,22222222,TAFE BOOKSHOP CBA,26.67,0,1636791.17,DR,REF612285,CBA,Savings
27-09-2025 05:08,CBA11EF664ADB7044139F4F,063-000-001,22222222,BP CBA,11.39,0,1636779.78,DR,REF184249,CBA,Savings
27-09-2025 05:18,CBA626A8754CDE44B82B365,063-000-001,22222222,SHELL CBA,41.66,0,1636738.12,DR,REF142652,CBA,Savings
27-09-2025 05:39,CBA5DB2A5F1104E4BDFAF51,063-000-001,22222222,BP CBA,88.16,0,1636649.96,DR,REF493656,CBA,Savings
27-09-2025 05:42,CBAC249A20055E741649274,063-000-001,22222222,JB HI-FI CBA,97.62,0,1636552.34,DR,REF625440,CBA,Savings
27-09-2025 06:17,CBA7CEED48A5A9E41BAA9EA,063-000-001,22222222,INTERNET TRANSFER CBA,4.18,0,1636548.16,DR,REF734732,CBA,Savings
27-09-2025 06:23,CBA2C604AD8CDA344BA801D,063-000-001,22222222,DOMINO'S PIZZA CBA,92.45,0,1636455.71,DR,REF439617,CBA,Savings
27-09-2025 06:44,CBAFCCA62C6913742D788D3,063-000-001,22222222,BP CBA,33.67,0,1636422.04,DR,REF999576,CBA,Savings
27-09-2025 07:25,CBA35C94B0B657543419A4A,063-000-001,22222222,MCDONALDS CBA,92.27,0,1636329.77,DR,REF501906,CBA,Savings
27-09-2025 07:45,CBA6BA90659EDDD444CA557,063-000-001,22222222,SHELL CBA,22.9,0,1636306.87,DR,REF347300,CBA,Savings
27-09-2025 07:59,CBAF09366770D0F46EFA40B,063-000-001,22222222,SALARY PAYMENT CBA,0,6632.35,1642939.22,CR,REF948457,CBA,Savings
27-09-2025 08:02,CBA385D7AACD4B740B0B152,063-000-001,22222222,LIQUORLAND CBA,169.53,0,1642769.69,DR,REF551676,CBA,Savings
27-09-2025 08:27,CBAEB1E4912C68A4CDC8042,063-000-001,22222222,LIQUORLAND CBA,9.68,0,1642760.01,DR,REF771551,CBA,Savings
27-09-2025 08:33,CBA4CB913293A4C45A4A521,063-000-001,22222222,COMPANY PAYROLL CBA,0,5055.81,1647815.82,CR,REF946295,CBA,Savings
27-09-2025 09:12,CBAD5BCBB6F8F734B7EB02A,063-000-001,22222222,AMAZON AU CBA,29.43,0,1647786.39,DR,REF233777,CBA,Savings
27-09-2025 09:19,CBABBDB7C21922B4E6BA7D4,063-000-001,22222222,TAFE BOOKSHOP CBA,7.04,0,1647779.35,DR,REF794074,CBA,Savings
27-09-2025 09:39,INT2B852977D4C04D739E68,063-000-001,22222222,TRANSFER FROM NAB 44444444,0,363.06,1648142.41,CR,INT-49008,CBA,Savings
27-09-2025 09:46,CBAC8E0ADBD3F834203AA21,063-000-001,22222222,WAGES CREDIT CBA,0,4229.49,1652371.9,CR,REF285802,CBA,Savings
27-09-2025 09:54,CBAC0E4F35D84C545E8BB82,063-000-001,22222222,FLIXBUS CBA,70.86,0,1652301.04,DR,REF471662,CBA,Savings
27-09-2025 09:56,CBA08A35EE9C754496894FF,063-000-001,22222222,PAYROLL CREDIT CBA,0,1601.87,1653902.91,CR,REF527362,CBA,Savings
27-09-2025 10:13,CBAD959B006322542D2A8E8,063-000-001,22222222,TAFE BOOKSHOP CBA,66.62,0,1653836.29,DR,REF962698,CBA,Savings
27-09-2025 10:31,CBA7DC37A9D5ABA430DA800,063-000-001,22222222,BP CBA,190.24,0,1653646.05,DR,REF143126,CBA,Savings
27-09-2025 10:39,CBA8BF8AF9665014777B9D8,063-000-001,22222222,FLIXBUS CBA,76.68,0,1653569.37,DR,REF541434,CBA,Savings
27-09-2025 10:56,CBAE8C2756CB5D1452D8122,063-000-001,22222222,WOOLWORTHS CBA,33.58,0,1653535.79,DR,REF288777,CBA,Savings
27-09-2025 11:34,CBAC4D9197456D445D2BC07,063-000-001,22222222,SPOTIFY CBA,23.29,0,1653512.5,DR,REF997649,CBA,Savings
27-09-2025 11:47,CBAD34229A3DEF9423CA8F7,063-000-001,22222222,BP CBA,41.39,0,1653471.11,DR,REF753545,CBA,Savings
27-09-2025 12:34,CBA3EC66CC952664AF987D0,063-000-001,22222222,RAILWAY STATION CBA,105.26,0,1653365.85,DR,REF594015,CBA,Savings
27-09-2025 12:34,CBA7C0C66B527364AB3B162,063-000-001,22222222,BIGW CBA,177.33,0,1653188.52,DR,REF955341,CBA,Savings
27-09-2025 12:35,CBA1384FF35D1014CE99683,063-000-001,22222222,APPLE CBA,4.11,0,1653184.41,DR,REF407215,CBA,Savings
27-09-2025 12:51,CBAAE526061BEA64CBDA378,063-000-001,22222222,UBER EATS CBA,23.11,0,1653161.3,DR,REF536649,CBA,Savings
27-09-2025 12:59,CBAA0C08B0DF8AE48E8BB21,063-000-001,22222222,DOMINO'S PIZZA CBA,52.16,0,1653109.14,DR,REF716664,CBA,Savings
27-09-2025 13:30,CBA0A155FE5464448118723,063-000-001,22222222,BWS CBA,24.38,0,1653084.76,DR,REF594381,CBA,Savings
27-09-2025 14:34,CBAA6BE43B470F14FB58213,063-000-001,22222222,BANK FEE CBA,158.56,0,1652926.2,DR,REF950468,CBA,Savings
27-09-2025 15:27,CBAC0799F6D1A2F419DB6AE,063-000-001,22222222,FLIXBUS CBA,11.43,0,1652914.77,DR,REF903434,CBA,Savings
27-09-2025 15:38,CBA179378AE929941B6B0B6,063-000-001,22222222,PAYROLL CREDIT CBA,0,2961.26,1655876.03,CR,REF946556,CBA,Savings
27-09-2025 15:41,CBAF5D5517317004D8DA3C3,063-000-001,22222222,STARBUCKS CBA,45.35,0,1655830.68,DR,REF223436,CBA,Savings
27-09-2025 16:10,CBAFAF05D6B026C4FE6A663,063-000-001,22222222,LIQUORLAND CBA,36.11,0,1655794.57,DR,REF387670,CBA,Savings
27-09-2025 17:02,CBA41438B4E3D7E4B559D74,063-000-001,22222222,SPOTIFY CBA,27.71,0,1655766.86,DR,REF647800,CBA,Savings
27-09-2025 17:09,CBA22D81DB5DA234946BF24,063-000-001,22222222,LIQUORLAND CBA,135.2,0,1655631.66,DR,REF184379,CBA,Savings
27-09-2025 17:44,CBA4BB83D1A5BED436E859B,063-000-001,22222222,ALDI CBA,7.96,0,1655623.7,DR,REF422151,CBA,Savings
27-09-2025 17:58,CBA715176B156684A17A38F,063-000-001,22222222,7-ELEVEN CBA,70.43,0,1655553.27,DR,REF480066,CBA,Savings
27-09-2025 18:14,CBA0A7064D97FA947F4B2C0,063-000-001,22222222,DOMINO'S PIZZA CBA,70.24,0,1655483.03,DR,REF768996,CBA,Savings
27-09-2025 18:14,CBA311B3F7027944F4C817D,063-000-001,22222222,RAILWAY STATION CBA,89.55,0,1655393.48,DR,REF886687,CBA,Savings
27-09-2025 20:10,CBA7350E4F9356743319136,063-000-001,22222222,UBER EATS CBA,3.94,0,1655389.54,DR,REF212981,CBA,Savings
27-09-2025 20:31,CBAB06041C1DB4147189AD1,063-000-001,22222222,JB HI-FI CBA,6,0,1655383.54,DR,REF624268,CBA,Savings
27-09-2025 20:34,CBA95D9C0F246CE4A94A104,063-000-001,22222222,MENULOG CBA,10.01,0,1655373.53,DR,REF107391,CBA,Savings
27-09-2025 20:46,CBA2C8E622570F941A2A317,063-000-001,22222222,UBER EATS CBA,31.19,0,1655342.34,DR,REF427613,CBA,Savings
27-09-2025 21:56,CBA1B5D9F0DA75C42A48377,063-000-001,22222222,7-ELEVEN CBA,106.05,0,1655236.29,DR,REF609617,CBA,Savings
27-09-2025 22:44,CBA84AEDC2BD7584E348F22,063-000-001,22222222,BANK FEE CBA,31.97,0,1655204.32,DR,REF489396,CBA,Savings
27-09-2025 22:44,CBABF7CDB26D76548939BD5,063-000-001,22222222,BIGW CBA,30.16,0,1655174.16,DR,REF566563,CBA,Savings
27-09-2025 23:11,CBA395C3471B5904DB28217,063-000-001,22222222,MENULOG CBA,64.82,0,1655109.34,DR,REF747884,CBA,Savings
27-09-2025 23:39,CBA0E5910149862468DA20D,063-000-001,22222222,INTERNET TRANSFER CBA,19.37,0,1655089.97,DR,REF165823,CBA,Savings
27-09-2025 23:41,CBA5B5C4E9ACE8447E6A335,063-000-001,22222222,LIQUORLAND CBA,34.57,0,1655055.4,DR,REF715898,CBA,Savings
27-09-2025 23:59,CBA11D00CA35D6C4B6E849F,063-000-001,22222222,7-ELEVEN CBA,12.22,0,1655043.18,DR,REF539186,CBA,Savings
28-09-2025 00:16,CBA12AC060461CF47F6BF9F,063-000-001,22222222,COLES CBA,87.16,0,1654956.02,DR,REF632396,CBA,Savings
28-09-2025 00:22,CBA193B209A473B426A9ABD,063-000-001,22222222,PAYPAL *NETFLIX CBA,41.21,0,1654914.81,DR,REF378674,CBA,Savings
28-09-2025 00:41,INTC93CA426E05D438EA084,063-000-001,22222222,TRANSFER FROM NAB 44444444,0,693.89,1655608.7,CR,INT-54504,CBA,Savings
28-09-2025 00:45,CBA2DDB0070CDBE468584E2,063-000-001,22222222,COLES CBA,52.28,0,1655556.42,DR,REF897296,CBA,Savings
28-09-2025 01:09,CBACC110BC9BDC640CAA0EA,063-000-001,22222222,AMAZON AU CBA,113.18,0,1655443.24,DR,REF407547,CBA,Savings
28-09-2025 01:27,CBA4B397C2C1E44433B8D47,063-000-001,22222222,KFC CBA,16.37,0,1655426.87,DR,REF672819,CBA,Savings
28-09-2025 01:42,CBA3BF09703FD5343CB816E,063-000-001,22222222,COMPANY PAYROLL CBA,0,4468.95,1659895.82,CR,REF527405,CBA,Savings
28-09-2025 02:40,CBA98F6A335DF6744C58162,063-000-001,22222222,LIQUORLAND CBA,217.59,0,1659678.23,DR,REF751555,CBA,Savings
28-09-2025 02:48,INT059A60224356476BA2A2,063-000-001,22222222,TRANSFER TO CBA 33333333,801.8,0,1658876.43,DR,INT-48486,CBA,Savings
28-09-2025 02:54,CBAFD42E58FD4324F53B6DE,063-000-001,22222222,PAYPAL *NETFLIX CBA,10.68,0,1658865.75,DR,REF720927,CBA,Savings
28-09-2025 02:56,CBA22611DD3062F401C931A,063-000-001,22222222,MENULOG CBA,25.96,0,1658839.79,DR,REF291998,CBA,Savings
28-09-2025 03:13,CBAA0223A7C72C84BAD88AD,063-000-001,22222222,INTERNET TRANSFER CBA,105,0,1658734.79,DR,REF320935,CBA,Savings
28-09-2025 03:33,CBA0EDCEFC4DB0840E8944A,063-000-001,22222222,SPOTIFY CBA,7.65,0,1658727.14,DR,REF328416,CBA,Savings
28-09-2025 03:35,CBAC867BF8E49904E459995,063-000-001,22222222,PAYROLL CREDIT CBA,0,60.3,1658787.44,CR,REF916903,CBA,Savings
28-09-2025 03:42,CBA7C2AECB6163745BEA1B2,063-000-001,22222222,7-ELEVEN CBA,28.64,0,1658758.8,DR,REF538209,CBA,Savings
28-09-2025 04:58,CBA4FAE7471D59145A6A3A7,063-000-001,22222222,BP CBA,58.86,0,1658699.94,DR,REF240987,CBA,Savings
28-09-2025 05:02,CBAC6D9441E8AAD497F862D,063-000-001,22222222,COMPANY PAYROLL CBA,0,7696.66,1666396.6,CR,REF166118,CBA,Savings
28-09-2025 06:25,CBA82FE165C850C49669F08,063-000-001,22222222,WOOLWORTHS CBA,63.02,0,1666333.58,DR,REF364103,CBA,Savings
28-09-2025 06:30,CBA77D96A2089204997B5BB,063-000-001,22222222,STARBUCKS CBA,26.22,0,1666307.36,DR,REF725526,CBA,Savings
28-09-2025 06:39,CBA10CD8A06963E43B2AAEC,063-000-001,22222222,PAY - SALARY CBA,0,5311.55,1671618.91,CR,REF399919,CBA,Savings
28-09-2025 07:17,CBAE6A76E03065343E8843B,063-000-001,22222222,MENULOG CBA,96.81,0,1671522.1,DR,REF372458,CBA,Savings
28-09-2025 07:20,CBA7AFF232A87C8459891A8,063-000-001,22222222,LIQUORLAND CBA,28.46,0,1671493.64,DR,REF588320,CBA,Savings
28-09-2025 07:31,CBAFC99EE7E8B3C4E3EA68A,063-000-001,22222222,7-ELEVEN CBA,20.42,0,1671473.22,DR,REF411138,CBA,Savings
28-09-2025 07:34,CBA0F2928551A6E49E1A53B,063-000-001,22222222,APPLE CBA,18.76,0,1671454.46,DR,REF473727,CBA,Savings
28-09-2025 07:42,CBA2439C09C181E4E6EBE08,063-000-001,22222222,PAYMENT GATEWAY CBA,56.59,0,1671397.87,DR,REF804293,CBA,Savings
28-09-2025 08:06,CBAC20C604D0CEA4A62A78D,063-000-001,22222222,WAGES CREDIT CBA,0,388.19,1671786.06,CR,REF257513,CBA,Savings
28-09-2025 08:28,CBA7200E8DDB98442E39641,063-000-001,22222222,BWS CBA,8.54,0,1671777.52,DR,REF481879,CBA,Savings
28-09-2025 08:41,CBADC646ED96F584309B198,063-000-001,22222222,BIGW CBA,3.94,0,1671773.58,DR,REF342634,CBA,Savings
28-09-2025 08:56,CBA577484DDA5614C4BBCFF,063-000-001,22222222,COMPANY PAYROLL CBA,0,3069.09,1674842.67,CR,REF583616,CBA,Savings
28-09-2025 09:17,CBADB31F7BB17E7404B943A,063-000-001,22222222,MENULOG CBA,63.31,0,1674779.36,DR,REF267493,CBA,Savings
28-09-2025 09:41,CBAECAFE16AE74B4C8D9A32,063-000-001,22222222,RAILWAY STATION CBA,57.38,0,1674721.98,DR,REF947855,CBA,Savings
28-09-2025 10:13,CBAC7E5DE40D86D4823BF14,063-000-001,22222222,LIQUORLAND CBA,63.48,0,1674658.5,DR,REF694009,CBA,Savings
28-09-2025 11:10,CBAE70FFC16067A46F2839C,063-000-001,22222222,PAYPAL *NETFLIX CBA,78.75,0,1674579.75,DR,REF149341,CBA,Savings
28-09-2025 11:21,CBA3C0758C99EFD4606A242,063-000-001,22222222,COMPANY PAYROLL CBA,0,7751.72,1682331.47,CR,REF991398,CBA,Savings
28-09-2025 11:47,CBADC6A1BBA23BD4DCB9460,063-000-001,22222222,PAYMENT GATEWAY CBA,77.02,0,1682254.45,DR,REF334690,CBA,Savings
28-09-2025 11:52,CBA6DD173E49B5F4539B4B1,063-000-001,22222222,FLIXBUS CBA,76.22,0,1682178.23,DR,REF617592,CBA,Savings
28-09-2025 12:08,CBA2587EE82E626497CB7D3,063-000-001,22222222,BANK FEE CBA,8.44,0,1682169.79,DR,REF217375,CBA,Savings
28-09-2025 12:32,CBA0B85D24A45484879A212,063-000-001,22222222,WAGES CREDIT CBA,0,3676.51,1685846.3,CR,REF899399,CBA,Savings
28-09-2025 12:38,CBA3CDB755D23FC4DF1A1D5,063-000-001,22222222,HARVEY NORMAN CBA,80.9,0,1685765.4,DR,REF185976,CBA,Savings
28-09-2025 12:47,CBA2F28915A4EA54B35837B,063-000-001,22222222,TAFE BOOKSHOP CBA,82.06,0,1685683.34,DR,REF528767,CBA,Savings
28-09-2025 12:55,CBA8FB6427719254851901C,063-000-001,22222222,RAILWAY STATION CBA,126.82,0,1685556.52,DR,REF811911,CBA,Savings
28-09-2025 13:03,CBA80F924C7F9E148E9867D,063-000-001,22222222,COLES CBA,38.42,0,1685518.1,DR,REF769755,CBA,Savings
28-09-2025 13:11,CBA325A7915EC814B09AC8A,063-000-001,22222222,FLIXBUS CBA,10.9,0,1685507.2,DR,REF531482,CBA,Savings
28-09-2025 13:56,CBA8873FC750FEA4BF29770,063-000-001,22222222,DOMINO'S PIZZA CBA,55.35,0,1685451.85,DR,REF676089,CBA,Savings
28-09-2025 14:03,CBAE13FD4F5B9EC4EECAD79,063-000-001,22222222,ALDI CBA,49.09,0,1685402.76,DR,REF151202,CBA,Savings
28-09-2025 14:40,CBA52B7137957554498AA62,063-000-001,22222222,KFC CBA,18.11,0,1685384.65,DR,REF468463,CBA,Savings
28-09-2025 14:43,CBA6646FDF1513F4E8AA475,063-000-001,22222222,AMAZON AU CBA,33.24,0,1685351.41,DR,REF727360,CBA,Savings
28-09-2025 15:09,CBAE2A0BCB85DA148DA8EA2,063-000-001,22222222,AMAZON AU CBA,32.83,0,1685318.58,DR,REF514358,CBA,Savings
28-09-2025 15:21,CBA6F68FC792C2C49C39576,063-000-001,22222222,CITYLINK CBA,52.05,0,1685266.53,DR,REF490470,CBA,Savings
28-09-2025 15:37,CBAB329C47DB3BA4A08985B,063-000-001,22222222,AMAZON AU CBA,90.24,0,1685176.29,DR,REF909998,CBA,Savings
28-09-2025 15:48,CBA98E4BAFBB23544FDAD49,063-000-001,22222222,STARBUCKS CBA,57.36,0,1685118.93,DR,REF410733,CBA,Savings
28-09-2025 16:36,CBAEFB5A9C8861E46EBAF7C,063-000-001,22222222,MCDONALDS CBA,7.59,0,1685111.34,DR,REF542277,CBA,Savings
28-09-2025 17:33,CBAE0241E2690194AC0871E,063-000-001,22222222,WAGES CREDIT CBA,0,2285.82,1687397.16,CR,REF203646,CBA,Savings
28-09-2025 18:12,INT195F018525A44AFDA1D7,063-000-001,22222222,TRANSFER FROM NAB 44444444,0,1661.61,1689058.77,CR,INT-21927,CBA,Savings
28-09-2025 18:36,CBAFE4590E9B28849C3BF02,063-000-001,22222222,CITYLINK CBA,44.34,0,1689014.43,DR,REF871231,CBA,Savings
28-09-2025 18:54,CBA0DCCCE95AA404E41877A,063-000-001,22222222,COMPANY PAYROLL CBA,0,298.12,1689312.55,CR,REF663013,CBA,Savings
28-09-2025 18:55,CBA3C08A92CBB684124B9EA,063-000-001,22222222,MENULOG CBA,36.93,0,1689275.62,DR,REF930460,CBA,Savings
28-09-2025 19:32,CBA7B81D4A61A964DF8923B,063-000-001,22222222,SPOTIFY CBA,111.99,0,1689163.63,DR,REF191544,CBA,Savings
28-09-2025 19:38,CBA4BFB2968B11C45DFBFF0,063-000-001,22222222,KFC CBA,40.29,0,1689123.34,DR,REF694797,CBA,Savings
28-09-2025 19:43,CBA8ADCBACF95A0448E8A1F,063-000-001,22222222,ZOOM CBA,71.6,0,1689051.74,DR,REF908301,CBA,Savings
28-09-2025 20:03,CBA6EDF346D04B945E3807E,063-000-001,22222222,KFC CBA,5.79,0,1689045.95,DR,REF550570,CBA,Savings
28-09-2025 20:14,CBA4F54DD19933043CD8E12,063-000-001,22222222,PAYMENT GATEWAY CBA,28.44,0,1689017.51,DR,REF673889,CBA,Savings
28-09-2025 20:14,CBAE944362951174FF998A2,063-000-001,22222222,UBER EATS CBA,41.72,0,1688975.79,DR,REF831725,CBA,Savings
28-09-2025 20:27,CBAA6BF363A18A3487CB155,063-000-001,22222222,SHELL CBA,21.14,0,1688954.65,DR,REF706609,CBA,Savings
28-09-2025 20:27,CBAAB8AA6BCA0D94242B55D,063-000-001,22222222,COMPANY PAYROLL CBA,0,933.49,1689888.14,CR,REF401689,CBA,Savings
28-09-2025 21:15,CBAE8B3974B1F8F4AF889B5,063-000-001,22222222,HARVEY NORMAN CBA,9.08,0,1689879.06,DR,REF822684,CBA,Savings
28-09-2025 21:29,INT7015CC22612940D0A00C,063-000-001,22222222,TRANSFER FROM NAB 44444444,0,842.96,1690722.02,CR,INT-25622,CBA,Savings
28-09-2025 21:40,CBAB4BE4EBA5B5D409FB4CD,063-000-001,22222222,RAILWAY STATION CBA,51.01,0,1690671.01,DR,REF862834,CBA,Savings
28-09-2025 21:44,CBA9F3ADBD1AA3D4A289997,063-000-001,22222222,RAILWAY STATION CBA,24.52,0,1690646.49,DR,REF466036,CBA,Savings
28-09-2025 22:05,CBA0A1759B92C11426E9EFF,063-000-001,22222222,SPOTIFY CBA,142.2,0,1690504.29,DR,REF693078,CBA,Savings
28-09-2025 22:19,CBA694C69486DA0424AB620,063-000-001,22222222,UBER EATS CBA,75.51,0,1690428.78,DR,REF952446,CBA,Savings
28-09-2025 22:20,CBA2E4210666AAA4AF1B2CE,063-000-001,22222222,SPOTIFY CBA,137.83,0,1690290.95,DR,REF396184,CBA,Savings
28-09-2025 23:06,CBA982A806FA16D4C038007,063-000-001,22222222,KFC CBA,80.29,0,1690210.66,DR,REF561430,CBA,Savings
28-09-2025 23:08,CBAD5C72AE1D5574B90A10A,063-000-001,22222222,LIQUORLAND CBA,20.4,0,1690190.26,DR,REF345550,CBA,Savings
28-09-2025 23:17,CBAE578361D43D043A9A4F2,063-000-001,22222222,SPOTIFY CBA,17.62,0,1690172.64,DR,REF400167,CBA,Savings
28-09-2025 23:20,CBA63A11B2D2F7E440FA3E2,063-000-001,22222222,BP CBA,11.38,0,1690161.26,DR,REF172913,CBA,Savings
28-09-2025 23:36,CBAEA1BB18CCD0C4B76B0BA,063-000-001,22222222,KFC CBA,72.91,0,1690088.35,DR,REF497604,CBA,Savings
28-09-2025 23:47,CBA82C922DB6C3E45CC9909,063-000-001,22222222,TAFE BOOKSHOP CBA,6.55,0,1690081.8,DR,REF598811,CBA,Savings
29-09-2025 00:14,CBAA6316FCA6C6B4F9BB7D8,063-000-001,22222222,TAFE BOOKSHOP CBA,93.88,0,1689987.92,DR,REF995959,CBA,Savings
29-09-2025 00:22,CBAA34E3648C873437DB231,063-000-001,22222222,WOOLWORTHS CBA,48.3,0,1689939.62,DR,REF147882,CBA,Savings
29-09-2025 00:39,CBA65D9D14E7A2A47AC8FA3,063-000-001,22222222,BANK FEE CBA,114.78,0,1689824.84,DR,REF451178,CBA,Savings
29-09-2025 00:40,CBAB87A187456C4479AADBC,063-000-001,22222222,MCDONALDS CBA,5.25,0,1689819.59,DR,REF146972,CBA,Savings
29-09-2025 01:23,CBAF32545E396694F6FA4D2,063-000-001,22222222,WOOLWORTHS CBA,98.32,0,1689721.27,DR,REF500885,CBA,Savings
29-09-2025 01:53,CBABD09B9F36CBC4CC6A165,063-000-001,22222222,LIQUORLAND CBA,128.03,0,1689593.24,DR,REF883968,CBA,Savings
29-09-2025 02:01,CBA6604B16DA122430F86EE,063-000-001,22222222,STARBUCKS CBA,67.1,0,1689526.14,DR,REF443502,CBA,Savings
29-09-2025 02:18,CBA4724467CF7B049AFAC5A,063-000-001,22222222,LIQUORLAND CBA,58.9,0,1689467.24,DR,REF763570,CBA,Savings
29-09-2025 02:44,CBA7915AFF7D3CB46D69ED1,063-000-001,22222222,AMAZON AU CBA,13.74,0,1689453.5,DR,REF544157,CBA,Savings
29-09-2025 02:45,CBA3206EE0650BF446E8A91,063-000-001,22222222,ZOOM CBA,80.8,0,1689372.7,DR,REF207970,CBA,Savings
29-09-2025 03:08,CBAC20D78789F704F5693E0,063-000-001,22222222,BANK FEE CBA,81.95,0,1689290.75,DR,REF479435,CBA,Savings
29-09-2025 03:19,INT8AE988FE625E469B80B0,063-000-001,22222222,TRANSFER FROM NAB 44444444,0,901.96,1690192.71,CR,INT-66155,CBA,Savings
29-09-2025 04:00,CBAE10EAAF0724B47F98790,063-000-001,22222222,CITYLINK CBA,65.81,0,1690126.9,DR,REF118455,CBA,Savings
29-09-2025 04:07,CBACBD6296C548E44D789F2,063-000-001,22222222,BP CBA,20.45,0,1690106.45,DR,REF553463,CBA,Savings
29-09-2025 04:18,CBA29BE777D4714485EA77E,063-000-001,22222222,TAFE BOOKSHOP CBA,20.57,0,1690085.88,DR,REF552327,CBA,Savings
29-09-2025 04:25,CBA8E3A147BF1334864889D,063-000-001,22222222,LIQUORLAND CBA,7.51,0,1690078.37,DR,REF645047,CBA,Savings
29-09-2025 04:41,CBAB97CB5C393D248DEADCE,063-000-001,22222222,PAYROLL CREDIT CBA,0,6565.05,1696643.42,CR,REF952207,CBA,Savings
29-09-2025 04:56,CBA961B2A5A9CED4E519D08,063-000-001,22222222,CITYLINK CBA,10.66,0,1696632.76,DR,REF500203,CBA,Savings
29-09-2025 04:57,CBA7D675B8CE48C4D80AD93,063-000-001,22222222,ZOOM CBA,3.61,0,1696629.15,DR,REF504008,CBA,Savings
29-09-2025 05:11,CBA6FFE6408410E4DB88637,063-000-001,22222222,CITYLINK CBA,42.72,0,1696586.43,DR,REF343388,CBA,Savings
29-09-2025 05:12,CBAEB9F0D200A0F4392A9B3,063-000-001,22222222,APPLE CBA,66.53,0,1696519.9,DR,REF153386,CBA,Savings
29-09-2025 05:17,CBAE5428E444EE447BCBFBD,063-000-001,22222222,BANK FEE CBA,7.57,0,1696512.33,DR,REF161479,CBA,Savings
29-09-2025 05:58,CBAE242B6101CDD41818409,063-000-001,22222222,AMAZON AU CBA,62.11,0,1696450.22,DR,REF702330,CBA,Savings
29-09-2025 05:59,CBAAF8106C255D54461963C,063-000-001,22222222,AMAZON AU CBA,20.53,0,1696429.69,DR,REF486553,CBA,Savings
29-09-2025 06:07,CBA25C99D80C17844B3B90A,063-000-001,22222222,TAFE BOOKSHOP CBA,59.49,0,1696370.2,DR,REF476044,CBA,Savings
29-09-2025 06:19,CBAC0913EB837B54F34B4A7,063-000-001,22222222,KFC CBA,39.69,0,1696330.51,DR,REF199988,CBA,Savings
29-09-2025 06:36,CBA622AF28A22564930BDDB,063-000-001,22222222,BIGW CBA,84.56,0,1696245.95,DR,REF808162,CBA,Savings
29-09-2025 07:04,INT769CCB51C52C467883A8,063-000-001,22222222,TRANSFER FROM ANZ 11111111,0,1990.35,1698236.3,CR,INT-34910,CBA,Savings
29-09-2025 07:19,CBAC3D0D134110F483D90CE,063-000-001,22222222,KFC CBA,8.4,0,1698227.9,DR,REF679444,CBA,Savings
29-09-2025 07:23,CBA5FF16517F86C4256A221,063-000-001,22222222,FLIXBUS CBA,78.22,0,1698149.68,DR,REF697470,CBA,Savings
29-09-2025 07:27,CBAE11AD133CEB4417E9F42,063-000-001,22222222,BWS CBA,45.95,0,1698103.73,DR,REF576842,CBA,Savings
29-09-2025 08:02,CBA12803AFC604A49BAA6A7,063-000-001,22222222,JB HI-FI CBA,15.79,0,1698087.94,DR,REF280771,CBA,Savings
29-09-2025 08:17,CBAE37E14D6A84445ACA00E,063-000-001,22222222,PAYMENT GATEWAY CBA,26.15,0,1698061.79,DR,REF465298,CBA,Savings
29-09-2025 08:27,CBABA1B5800A3DE42119B80,063-000-001,22222222,KFC CBA,52.15,0,1698009.64,DR,REF763111,CBA,Savings
29-09-2025 08:38,CBAB509EAFBF0F544449C31,063-000-001,22222222,KFC CBA,48.79,0,1697960.85,DR,REF145780,CBA,Savings
29-09-2025 09:58,CBADA20489AB3254EB6AA27,063-000-001,22222222,SHELL CBA,135.97,0,1697824.88,DR,REF554858,CBA,Savings
29-09-2025 11:05,CBAD0A762DF22B94FB88285,063-000-001,22222222,SHELL CBA,33.24,0,1697791.64,DR,REF750332,CBA,Savings
29-09-2025 11:34,CBA172ADD9F2E3645DA8B89,063-000-001,22222222,BANK FEE CBA,48.55,0,1697743.09,DR,REF543880,CBA,Savings
29-09-2025 11:41,CBAF136B80949454C51ADA5,063-000-001,22222222,PAY - SALARY CBA,0,6832.98,1704576.07,CR,REF151791,CBA,Savings
29-09-2025 11:59,CBAAAF3FCA8B4AB4C449187,063-000-001,22222222,CITYLINK CBA,4.44,0,1704571.63,DR,REF126050,CBA,Savings
29-09-2025 12:11,INT75A69EC76A0344E1A8A8,063-000-001,22222222,TRANSFER TO ANZ 11111111,319.49,0,1704252.14,DR,INT-23332,CBA,Savings
29-09-2025 12:46,CBA2339F792D9FC4436BE15,063-000-001,22222222,PAYROLL CREDIT CBA,0,768.38,1705020.52,CR,REF880789,CBA,Savings
29-09-2025 12:57,CBAFA0C8A836ADB48C78FED,063-000-001,22222222,RAILWAY STATION CBA,66.97,0,1704953.55,DR,REF777245,CBA,Savings
29-09-2025 13:17,CBAF5E9BE20E9534F238B2B,063-000-001,22222222,PAYMENT GATEWAY CBA,31.21,0,1704922.34,DR,REF128566,CBA,Savings
29-09-2025 13:43,CBAB4524ACEFDC74533B599,063-000-001,22222222,DOMINO'S PIZZA CBA,11.1,0,1704911.24,DR,REF533688,CBA,Savings
29-09-2025 14:24,CBA78EE00D7E8BE4EDB966D,063-000-001,22222222,PAYMENT GATEWAY CBA,102.03,0,1704809.21,DR,REF192684,CBA,Savings
29-09-2025 15:23,CBACCB40EC9D8F043A88BF6,063-000-001,22222222,JB HI-FI CBA,32.54,0,1704776.67,DR,REF777579,CBA,Savings
29-09-2025 15:28,CBA403496F08D254863AEBD,063-000-001,22222222,PAYROLL CREDIT CBA,0,5480.59,1710257.26,CR,REF256202,CBA,Savings
29-09-2025 15:53,CBA36E1A525AF22423A85EF,063-000-001,22222222,RAILWAY STATION CBA,16.3,0,1710240.96,DR,REF467790,CBA,Savings
29-09-2025 16:08,CBA7DD2C87F3397485CB072,063-000-001,22222222,RAILWAY STATION CBA,72.09,0,1710168.87,DR,REF403435,CBA,Savings
29-09-2025 16:21,CBA14803AC1A68A4349BA44,063-000-001,22222222,SALARY PAYMENT CBA,0,62.21,1710231.08,CR,REF894952,CBA,Savings
29-09-2025 16:28,CBAB0C4A49C4C1F46AAAF59,063-000-001,22222222,UBER EATS CBA,33.68,0,1710197.4,DR,REF698422,CBA,Savings
29-09-2025 16:41,CBAF0D849D341804D93A420,063-000-001,22222222,JB HI-FI CBA,111.51,0,1710085.89,DR,REF710653,CBA,Savings
29-09-2025 17:19,CBA121BD028DBEA44589A5D,063-000-001,22222222,UBER EATS CBA,136.71,0,1709949.18,DR,REF224314,CBA,Savings
29-09-2025 17:33,CBA3012E9B7A61C4237861D,063-000-001,22222222,ALDI CBA,56.04,0,1709893.14,DR,REF451328,CBA,Savings
29-09-2025 17:44,CBA27AF090D2A104CF5B5B7,063-000-001,22222222,ZOOM CBA,119.38,0,1709773.76,DR,REF512088,CBA,Savings
29-09-2025 18:00,CBA04C4F39464124479862B,063-000-001,22222222,PAYMENT GATEWAY CBA,22.58,0,1709751.18,DR,REF746250,CBA,Savings
29-09-2025 18:00,CBA1AA4A753AF4049DD9102,063-000-001,22222222,MENULOG CBA,8.17,0,1709743.01,DR,REF691980,CBA,Savings
29-09-2025 18:30,CBA6BE3AC89D5B241BA8D29,063-000-001,22222222,MCDONALDS CBA,49.61,0,1709693.4,DR,REF866926,CBA,Savings
29-09-2025 18:32,CBAF17E0074C758440DA11A,063-000-001,22222222,COMPANY PAYROLL CBA,0,7223.76,1716917.16,CR,REF937666,CBA,Savings
29-09-2025 18:40,CBA3B8078299D724B348ADA,063-000-001,22222222,KFC CBA,18.21,0,1716898.95,DR,REF436876,CBA,Savings
29-09-2025 18:46,CBA238425AF72C742BEB40B,063-000-001,22222222,7-ELEVEN CBA,52.1,0,1716846.85,DR,REF207737,CBA,Savings
29-09-2025 19:42,CBA6F15A4F4AF924F47B8EE,063-000-001,22222222,APPLE CBA,28.58,0,1716818.27,DR,REF922210,CBA,Savings
29-09-2025 20:17,CBAC62C4DB317C94B9B947A,063-000-001,22222222,JB HI-FI CBA,5.36,0,1716812.91,DR,REF290046,CBA,Savings
29-09-2025 20:20,CBA45875BDB9EBC4819B4CC,063-000-001,22222222,APPLE CBA,86.54,0,1716726.37,DR,REF526019,CBA,Savings
29-09-2025 20:30,CBAC163FD62F7CE490B9791,063-000-001,22222222,ALDI CBA,55.83,0,1716670.54,DR,REF331688,CBA,Savings
29-09-2025 20:32,CBA3884AEDA32B546569A09,063-000-001,22222222,TAFE BOOKSHOP CBA,29.05,0,1716641.49,DR,REF421582,CBA,Savings
29-09-2025 20:47,CBA36F68E9DF2DB44DBB206,063-000-001,22222222,APPLE CBA,28.54,0,1716612.95,DR,REF941269,CBA,Savings
29-09-2025 21:03,CBAC0CEC1F198954819BB6F,063-000-001,22222222,CITYLINK CBA,76.45,0,1716536.5,DR,REF282030,CBA,Savings
29-09-2025 21:05,CBA1E6CC8B7681D4BD683F7,063-000-001,22222222,BP CBA,26.95,0,1716509.55,DR,REF291217,CBA,Savings
29-09-2025 22:09,CBAB3102742B44044C19056,063-000-001,22222222,COLES CBA,20.22,0,1716489.33,DR,REF549116,CBA,Savings
29-09-2025 22:34,CBA18E14E1AE0764937AF5E,063-000-001,22222222,LIQUORLAND CBA,48.56,0,1716440.77,DR,REF480515,CBA,Savings
29-09-2025 22:49,CBAF927AF99166547B985A9,063-000-001,22222222,COLES CBA,58.57,0,1716382.2,DR,REF193546,CBA,Savings
29-09-2025 23:18,CBA949C108B83744EB59A25,063-000-001,22222222,SHELL CBA,69.05,0,1716313.15,DR,REF527091,CBA,Savings
29-09-2025 23:22,CBA32F05A1AA2384982BAAC,063-000-001,22222222,PAYMENT GATEWAY CBA,14.16,0,1716298.99,DR,REF641840,CBA,Savings
29-09-2025 23:49,CBA29E66384EBC3497EBDFA,063-000-001,22222222,UBER EATS CBA,58.01,0,1716240.98,DR,REF329627,CBA,Savings
29-09-2025 23:51,CBA336A2CF4AA234B919D87,063-000-001,22222222,ALDI CBA,42.74,0,1716198.24,DR,REF265452,CBA,Savings
29-09-2025 23:55,CBA5FE056CF41814431B00B,063-000-001,22222222,APPLE CBA,16.3,0,1716181.94,DR,REF111437,CBA,Savings
29-09-2025 23:58,CBAD551A2995CEE4615B5CC,063-000-001,22222222,BIGW CBA,70.01,0,1716111.93,DR,REF159600,CBA,Savings
30-09-2025 00:14,CBA2C230846C1C14167AB32,063-000-001,22222222,ZOOM CBA,199.95,0,1715911.98,DR,REF108079,CBA,Savings
30-09-2025 01:15,CBAC0EC3B442120490097C6,063-000-001,22222222,JB HI-FI CBA,11.76,0,1715900.22,DR,REF660159,CBA,Savings
30-09-2025 01:24,CBA1EA6C1052594477B9D80,063-000-001,22222222,RAILWAY STATION CBA,62.87,0,1715837.35,DR,REF839998,CBA,Savings
30-09-2025 01:35,CBA40526DD609D74FE6B7CE,063-000-001,22222222,COLES CBA,72.44,0,1715764.91,DR,REF163597,CBA,Savings
30-09-2025 01:36,CBADDC864831FA749D4A389,063-000-001,22222222,INTERNET TRANSFER CBA,24.1,0,1715740.81,DR,REF774082,CBA,Savings
30-09-2025 01:51,CBAB7B4744EE91D40208168,063-000-001,22222222,RAILWAY STATION CBA,12.09,0,1715728.72,DR,REF270056,CBA,Savings
30-09-2025 02:03,CBA4D432805171C42AFB60E,063-000-001,22222222,INTERNET TRANSFER CBA,37.41,0,1715691.31,DR,REF181884,CBA,Savings
30-09-2025 02:58,CBAA49BAA5CB2E3482081BD,063-000-001,22222222,PAYMENT GATEWAY CBA,94.83,0,1715596.48,DR,REF926814,CBA,Savings
30-09-2025 03:14,CBA9177EE9538E747ED8316,063-000-001,22222222,PAYROLL CREDIT CBA,0,6656.99,1722253.47,CR,REF616972,CBA,Savings
30-09-2025 03:20,CBA0A85A168813249508BFE,063-000-001,22222222,MCDONALDS CBA,61.54,0,1722191.93,DR,REF702271,CBA,Savings
30-09-2025 03:45,CBA3AB3B35B25954E38A166,063-000-001,22222222,BWS CBA,9.01,0,1722182.92,DR,REF631060,CBA,Savings
30-09-2025 04:03,CBAEBBC3DC8D4A843AFB0C9,063-000-001,22222222,UBER EATS CBA,14.62,0,1722168.3,DR,REF735645,CBA,Savings
30-09-2025 04:32,CBACE5A1CFDF3414ED2AEFD,063-000-001,22222222,PAYMENT GATEWAY CBA,24.39,0,1722143.91,DR,REF189198,CBA,Savings
30-09-2025 04:48,CBA1874084B9B8642D1A73C,063-000-001,22222222,ALDI CBA,3.73,0,1722140.18,DR,REF401931,CBA,Savings
30-09-2025 05:12,CBA520B1E4D23F440708C32,063-000-001,22222222,MCDONALDS CBA,90.47,0,1722049.71,DR,REF533291,CBA,Savings
30-09-2025 05:21,CBA15A8A6DDB2554EE3995B,063-000-001,22222222,LIQUORLAND CBA,31.03,0,1722018.68,DR,REF650110,CBA,Savings
30-09-2025 05:26,CBAE6613C6C712F4A9FAC98,063-000-001,22222222,TAFE BOOKSHOP CBA,17.58,0,1722001.1,DR,REF562394,CBA,Savings
30-09-2025 05:47,CBA288B4F9F9D0A4BC0836A,063-000-001,22222222,SHELL CBA,13.65,0,1721987.45,DR,REF858625,CBA,Savings
30-09-2025 05:53,CBAE87785506D924E588A46,063-000-001,22222222,KFC CBA,39.92,0,1721947.53,DR,REF945473,CBA,Savings
30-09-2025 05:55,CBA70864292A2784951A3DF,063-000-001,22222222,BWS CBA,16.48,0,1721931.05,DR,REF456410,CBA,Savings
30-09-2025 06:15,CBAD2F42413BBE54A979026,063-000-001,22222222,BANK FEE CBA,43.74,0,1721887.31,DR,REF130902,CBA,Savings
30-09-2025 06:15,CBAF8AE93312A93490488C6,063-000-001,22222222,PAYPAL *NETFLIX CBA,39.53,0,1721847.78,DR,REF498629,CBA,Savings
30-09-2025 06:45,CBAF9CB354C068B4F9FB06C,063-000-001,22222222,SALARY PAYMENT CBA,0,2630.24,1724478.02,CR,REF206451,CBA,Savings
30-09-2025 06:51,INTF322E3DC4CA44E42BB9D,063-000-001,22222222,TRANSFER FROM ANZ 11111111,0,623.26,1725101.28,CR,INT-68271,CBA,Savings
30-09-2025 07:01,CBA011005F7A24B42ADAF4A,063-000-001,22222222,SALARY PAYMENT CBA,0,502.68,1725603.96,CR,REF707439,CBA,Savings
30-09-2025 07:01,CBA6F0BA39EC5DE4AD690F7,063-000-001,22222222,COLES CBA,199.8,0,1725404.16,DR,REF599712,CBA,Savings
30-09-2025 07:26,CBA417E59FD1490435D9D1C,063-000-001,22222222,BWS CBA,31.25,0,1725372.91,DR,REF716009,CBA,Savings
30-09-2025 07:50,CBAE98BFA26D7C14FFFB20E,063-000-001,22222222,COLES CBA,171.23,0,1725201.68,DR,REF969349,CBA,Savings
30-09-2025 08:08,CBA242FB327DEFB4A1E8B6C,063-000-001,22222222,CITYLINK CBA,41.62,0,1725160.06,DR,REF521546,CBA,Savings
30-09-2025 08:09,CBAA4A39E6ADDCF4046A30D,063-000-001,22222222,LIQUORLAND CBA,26.06,0,1725134,DR,REF272574,CBA,Savings
30-09-2025 08:09,CBA6183889541E04CFF8BAE,063-000-001,22222222,AMAZON AU CBA,32.72,0,1725101.28,DR,REF512996,CBA,Savings
30-09-2025 08:28,CBAB5C53CBC12844E60B7AF,063-000-001,22222222,DOMINO'S PIZZA CBA,102.38,0,1724998.9,DR,REF779667,CBA,Savings
30-09-2025 08:29,CBAAA76A9F0EE7746FDA330,063-000-001,22222222,UBER EATS CBA,70.8,0,1724928.1,DR,REF516204,CBA,Savings
30-09-2025 08:31,CBABA633BB106CD45E79280,063-000-001,22222222,PAYMENT GATEWAY CBA,56.39,0,1724871.71,DR,REF813771,CBA,Savings
30-09-2025 08:38,CBA7BB2BA0460DE4DF2981D,063-000-001,22222222,MCDONALDS CBA,31.82,0,1724839.89,DR,REF245236,CBA,Savings
30-09-2025 08:54,CBA56FEF05A693048F7A159,063-000-001,22222222,ALDI CBA,80.08,0,1724759.81,DR,REF161075,CBA,Savings
30-09-2025 08:55,CBACBF6103B9C524CC18575,063-000-001,22222222,WAGES CREDIT CBA,0,6896.57,1731656.38,CR,REF846604,CBA,Savings
30-09-2025 09:05,CBA748C9102471D47258F76,063-000-001,22222222,UBER EATS CBA,34.96,0,1731621.42,DR,REF168106,CBA,Savings
30-09-2025 09:24,CBA0AD0EAA39CC34CA2AE3B,063-000-001,22222222,DOMINO'S PIZZA CBA,203.87,0,1731417.55,DR,REF892373,CBA,Savings
30-09-2025 09:38,CBAD23AC03F5A0E41EF83F1,063-000-001,22222222,PAY - SALARY CBA,0,2058.3,1733475.85,CR,REF567337,CBA,Savings
30-09-2025 10:29,CBA7C10BD6859B54004B0D4,063-000-001,22222222,LIQUORLAND CBA,6.91,0,1733468.94,DR,REF213990,CBA,Savings
30-09-2025 10:31,CBA480FC808670A4F0FB46C,063-000-001,22222222,PAY - SALARY CBA,0,5349.59,1738818.53,CR,REF173761,CBA,Savings
30-09-2025 10:48,CBA13F7A20C2FA24A108EB0,063-000-001,22222222,STARBUCKS CBA,34.6,0,1738783.93,DR,REF846798,CBA,Savings
30-09-2025 11:13,INTA5E32E1AD7F24F27AF8C,063-000-001,22222222,TRANSFER TO ANZ 11111111,1814.27,0,1736969.66,DR,INT-87450,CBA,Savings
30-09-2025 11:23,CBA6A3671EA0A25417FA4C9,063-000-001,22222222,BP CBA,7.79,0,1736961.87,DR,REF161857,CBA,Savings
30-09-2025 11:39,CBA14DDC1ABBCA94C3FA4F4,063-000-001,22222222,PAYMENT GATEWAY CBA,34.81,0,1736927.06,DR,REF224489,CBA,Savings
30-09-2025 11:42,CBAA0A24D596B474BD488AA,063-000-001,22222222,AMAZON AU CBA,51.62,0,1736875.44,DR,REF850598,CBA,Savings
30-09-2025 11:42,CBA8083DF9C2ACB4D67B355,063-000-001,22222222,DOMINO'S PIZZA CBA,8.56,0,1736866.88,DR,REF244694,CBA,Savings
30-09-2025 12:20,CBA67424914503545AB931F,063-000-001,22222222,HARVEY NORMAN CBA,119,0,1736747.88,DR,REF147707,CBA,Savings
30-09-2025 12:59,CBAF9A29E133957448C927D,063-000-001,22222222,STARBUCKS CBA,91.4,0,1736656.48,DR,REF224952,CBA,Savings
30-09-2025 13:06,CBA5B71015F2F8343BDA920,063-000-001,22222222,7-ELEVEN CBA,42.93,0,1736613.55,DR,REF377117,CBA,Savings
30-09-2025 13:10,CBA0BCFB6AB815440FB9BDF,063-000-001,22222222,JB HI-FI CBA,9.43,0,1736604.12,DR,REF517122,CBA,Savings
30-09-2025 13:10,INT2F5A9C3529714411A334,063-000-001,22222222,TRANSFER TO ANZ 11111111,607.67,0,1735996.45,DR,INT-92167,CBA,Savings
30-09-2025 13:32,CBAD5BFB2BBCD5E44AAB852,063-000-001,22222222,CITYLINK CBA,32.82,0,1735963.63,DR,REF117644,CBA,Savings
30-09-2025 13:59,CBAFB964CFA803A488386BD,063-000-001,22222222,LIQUORLAND CBA,62.08,0,1735901.55,DR,REF594054,CBA,Savings
30-09-2025 14:23,CBA73F7C1E7EB5A44219334,063-000-001,22222222,TAFE BOOKSHOP CBA,46.11,0,1735855.44,DR,REF409246,CBA,Savings
30-09-2025 14:45,CBA560C7248193F4C8684FB,063-000-001,22222222,JB HI-FI CBA,98.39,0,1735757.05,DR,REF338533,CBA,Savings
30-09-2025 15:12,CBA48A06C1272734EC2A876,063-000-001,22222222,BIGW CBA,131.23,0,1735625.82,DR,REF233416,CBA,Savings
30-09-2025 15:30,CBADE852219E96D4C648A61,063-000-001,22222222,JB HI-FI CBA,6.19,0,1735619.63,DR,REF724822,CBA,Savings
30-09-2025 15:42,CBA075EA7CC2E53438781E9,063-000-001,22222222,COLES CBA,47,0,1735572.63,DR,REF601688,CBA,Savings
30-09-2025 16:05,CBA7181987CB07749768D5E,063-000-001,22222222,APPLE CBA,32.5,0,1735540.13,DR,REF446553,CBA,Savings
30-09-2025 16:10,CBA3D73B12167364C989740,063-000-001,22222222,7-ELEVEN CBA,59.31,0,1735480.82,DR,REF752142,CBA,Savings
30-09-2025 16:29,INT07739E3F7FA6486DAF3C,063-000-001,22222222,TRANSFER TO ANZ 11111111,533.69,0,1734947.13,DR,INT-86775,CBA,Savings
30-09-2025 17:40,CBAD6AEFA1C75E649868418,063-000-001,22222222,LIQUORLAND CBA,61.5,0,1734885.63,DR,REF106582,CBA,Savings
30-09-2025 18:15,INT5E01AC02A8394C9588E1,063-000-001,22222222,TRANSFER FROM ANZ 11111111,0,1473.34,1736358.97,CR,INT-64674,CBA,Savings
30-09-2025 19:35,CBA26D614F0912A49BA9CE9,063-000-001,22222222,AMAZON AU CBA,63.13,0,1736295.84,DR,REF172572,CBA,Savings
30-09-2025 19:39,CBA62846F29588B4AE0B587,063-000-001,22222222,JB HI-FI CBA,26.56,0,1736269.28,DR,REF584400,CBA,Savings
30-09-2025 19:54,CBAF1FF7D5BEC83477797B9,063-000-001,22222222,JB HI-FI CBA,27.14,0,1736242.14,DR,REF804774,CBA,Savings
30-09-2025 20:05,CBAE9958FCBD7A74D8394BA,063-000-001,22222222,PAYROLL CREDIT CBA,0,2104.17,1738346.31,CR,REF225989,CBA,Savings
30-09-2025 21:01,CBA525F3086B0364A29870D,063-000-001,22222222,RAILWAY STATION CBA,73.43,0,1738272.88,DR,REF198748,CBA,Savings
30-09-2025 21:03,INT47203D9ADD0E4952BABD,063-000-001,22222222,TRANSFER FROM ANZ 11111111,0,239.03,1738511.91,CR,INT-16648,CBA,Savings
30-09-2025 21:38,CBAA366D570051A45FBBFB1,063-000-001,22222222,TAFE BOOKSHOP CBA,21.89,0,1738490.02,DR,REF175197,CBA,Savings
30-09-2025 21:39,CBA46AB032D221D4AEBBDF0,063-000-001,22222222,DOMINO'S PIZZA CBA,70.41,0,1738419.61,DR,REF840849,CBA,Savings
30-09-2025 21:54,CBA99837B8D1D2D4229978F,063-000-001,22222222,BP CBA,110,0,1738309.61,DR,REF574976,CBA,Savings
30-09-2025 22:00,CBA4104097BFD77419FA814,063-000-001,22222222,PAYROLL CREDIT CBA,0,4420.08,1742729.69,CR,REF125448,CBA,Savings
30-09-2025 22:25,CBAF8A61E7FD51149B4B4B6,063-000-001,22222222,DOMINO'S PIZZA CBA,5.67,0,1742724.02,DR,REF121691,CBA,Savings
30-09-2025 22:53,CBAD968ED88FDD44337BAEF,063-000-001,22222222,SHELL CBA,77.24,0,1742646.78,DR,REF620696,CBA,Savings
