Date,TransactionID,BSB,AccountNumber,Description,Debit,Credit,Balance,Type,Reference,Bank,AccountType
01-08-2025 00:02,CBA15EFF896E1EA4BF5A62F,063-000-002,33333333,SALARY PAYMENT CBA,0,836.42,5696.47,CR,REF396533,CBA,Current
01-08-2025 00:03,INTF1C599A1E55B4DB99D86,063-000-002,33333333,TRANSFER FROM NAB 44444444,0,1055.57,6752.04,CR,INT-91580,CBA,Current
01-08-2025 00:19,CBA06C8754EA3C948C1A2C0,063-000-002,33333333,MENULOG CBA,132.16,0,6619.88,DR,REF397562,CBA,Current
01-08-2025 01:07,CBAB849A90D85D9414BB6EB,063-000-002,33333333,SALARY PAYMENT CBA,0,6896.2,13516.08,CR,REF523937,CBA,Current
01-08-2025 01:28,CBA0ED6B828057949FC8850,063-000-002,33333333,WAGES CREDIT CBA,0,4156.1,17672.18,CR,REF186101,CBA,Current
01-08-2025 01:45,CBA05A60657DC2940D296E3,063-000-002,33333333,KFC CBA,14.44,0,17657.74,DR,REF263662,CBA,Current
01-08-2025 01:58,CBA9124AD88183049A689A4,063-000-002,33333333,DOMINO'S PIZZA CBA,18.51,0,17639.23,DR,REF879973,CBA,Current
01-08-2025 02:13,CBA80B460E20D7F4316904B,063-000-002,33333333,WAGES CREDIT CBA,0,3515.87,21155.1,CR,REF770567,CBA,Current
01-08-2025 02:21,CBAC8C468AAF89E4787B93A,063-000-002,33333333,PAYMENT GATEWAY CBA,8.8,0,21146.3,DR,REF284208,CBA,Current
01-08-2025 02:26,CBA59178113000849778C84,063-000-002,33333333,PAY - SALARY CBA,0,2567,23713.3,CR,REF239160,CBA,Current
01-08-2025 02:27,CBAF9C655D328BD49969EE6,063-000-002,33333333,FLIXBUS CBA,5.11,0,23708.19,DR,REF342345,CBA,Current
01-08-2025 04:09,CBACC8FECC2A2D9494091BD,063-000-002,33333333,KFC CBA,37.62,0,23670.57,DR,REF674970,CBA,Current
01-08-2025 04:35,CBA1ACA604EB5654B05A67D,063-000-002,33333333,HARVEY NORMAN CBA,36.82,0,23633.75,DR,REF198646,CBA,Current
01-08-2025 05:01,CBACEF70A0D9EB14F7388CC,063-000-002,33333333,FLIXBUS CBA,40.07,0,23593.68,DR,REF677098,CBA,Current
01-08-2025 05:04,CBA6C264BC9ACA0471BA1CB,063-000-002,33333333,KFC CBA,11.1,0,23582.58,DR,REF426984,CBA,Current
01-08-2025 05:29,CBA3AC1467CF5994DA78614,063-000-002,33333333,7-ELEVEN CBA,66.96,0,23515.62,DR,REF565012,CBA,Current
01-08-2025 05:44,CBA794A23BDFB2546BAA18D,063-000-002,33333333,BP CBA,62.53,0,23453.09,DR,REF843059,CBA,Current
01-08-2025 05:51,CBA7605740C1C0F4AC3AB1C,063-000-002,33333333,BIGW CBA,8.63,0,23444.46,DR,REF822789,CBA,Current
01-08-2025 06:07,CBA59849FDF117745D08F48,063-000-002,33333333,MENULOG CBA,10.29,0,23434.17,DR,REF572028,CBA,Current
01-08-2025 06:32,CBA270CFB5E16D944619236,063-000-002,33333333,BIGW CBA,112.36,0,23321.81,DR,REF508712,CBA,Current
01-08-2025 06:49,CBA34FFBE0BF81A4E5CB54F,063-000-002,33333333,MENULOG CBA,83.19,0,23238.62,DR,REF549476,CBA,Current
01-08-2025 07:13,CBAC12C4CD499D44149B407,063-000-002,33333333,COMPANY PAYROLL CBA,0,1948.43,25187.05,CR,REF578984,CBA,Current
01-08-2025 07:48,CBA294CD1DE6A774ED7820B,063-000-002,33333333,MENULOG CBA,43.4,0,25143.65,DR,REF370859,CBA,Current
01-08-2025 08:04,CBAFC98A46ECC66436E82F9,063-000-002,33333333,TAFE BOOKSHOP CBA,100.42,0,25043.23,DR,REF586315,CBA,Current
01-08-2025 08:32,CBA141593B77837442C81DB,063-000-002,33333333,KFC CBA,15.05,0,25028.18,DR,REF856689,CBA,Current
01-08-2025 09:27,CBA56317D666D474AA99565,063-000-002,33333333,PAYMENT GATEWAY CBA,17.35,0,25010.83,DR,REF458527,CBA,Current
01-08-2025 09:47,CBA0F0D00B6D6DE4D6DABE7,063-000-002,33333333,7-ELEVEN CBA,42.37,0,24968.46,DR,REF282767,CBA,Current
01-08-2025 10:05,CBAA2398453C906430FB290,063-000-002,33333333,HARVEY NORMAN CBA,5.03,0,24963.43,DR,REF814252,CBA,Current
01-08-2025 10:14,CBAD6FABB97A50C4B65BE89,063-000-002,33333333,WAGES CREDIT CBA,0,5245.17,30208.6,CR,REF247752,CBA,Current
01-08-2025 10:14,CBA853D4E03EDD349CE9D37,063-000-002,33333333,AMAZON AU CBA,6.12,0,30202.48,DR,REF272658,CBA,Current
01-08-2025 10:32,CBAEA406F4EB4B5422BABB2,063-000-002,33333333,HARVEY NORMAN CBA,105.12,0,30097.36,DR,REF459515,CBA,Current
01-08-2025 10:58,CBA222A8036B55C41199ADA,063-000-002,33333333,BIGW CBA,3.71,0,30093.65,DR,REF884826,CBA,Current
01-08-2025 11:02,CBA0771CF05D06744E48149,063-000-002,33333333,PAY - SALARY CBA,0,950.28,31043.93,CR,REF890985,CBA,Current
01-08-2025 11:11,CBA4B2ACACC9FE1440B872D,063-000-002,33333333,DOMINO'S PIZZA CBA,48.39,0,30995.54,DR,REF755514,CBA,Current
01-08-2025 11:12,CBA7EF14B4C1A554D669DC3,063-000-002,33333333,KFC CBA,35.95,0,30959.59,DR,REF948949,CBA,Current
01-08-2025 11:13,CBA4AA8B78A870F40DE9485,063-000-002,33333333,BANK FEE CBA,4.72,0,30954.87,DR,REF613066,CBA,Current
01-08-2025 11:19,CBA4AD159903250420C92B2,063-000-002,33333333,UBER EATS CBA,232.21,0,30722.66,DR,REF587563,CBA,Current
01-08-2025 11:43,CBA70D73AAB11AA41E9935C,063-000-002,33333333,UBER EATS CBA,40.83,0,30681.83,DR,REF316040,CBA,Current
01-08-2025 12:22,CBA9A2066E1329D4033A190,063-000-002,33333333,WOOLWORTHS CBA,14.4,0,30667.43,DR,REF387369,CBA,Current
01-08-2025 12:25,CBAF448978AC9404BF3B27C,063-000-002,33333333,SPOTIFY CBA,304.95,0,30362.48,DR,REF741185,CBA,Current
01-08-2025 12:58,CBAB631A5D75B8048399949,063-000-002,33333333,CITYLINK CBA,59.09,0,30303.39,DR,REF383089,CBA,Current
01-08-2025 13:23,CBA7DD6388975884CD2AF16,063-000-002,33333333,STARBUCKS CBA,18.94,0,30284.45,DR,REF882659,CBA,Current
01-08-2025 13:36,CBAE277B203FE0241AC8C07,063-000-002,33333333,ZOOM CBA,51.45,0,30233,DR,REF761374,CBA,Current
01-08-2025 14:15,CBAF04C2EF8920042D6A1EC,063-000-002,33333333,TAFE BOOKSHOP CBA,184.5,0,30048.5,DR,REF599618,CBA,Current
01-08-2025 14:27,CBAE84C24F1861D462CAD33,063-000-002,33333333,WOOLWORTHS CBA,45.06,0,30003.44,DR,REF866650,CBA,Current
01-08-2025 14:43,CBA38ACBBF59A3341DEA19B,063-000-002,33333333,STARBUCKS CBA,20.74,0,29982.7,DR,REF229830,CBA,Current
01-08-2025 14:51,CBA698EB93AF40749D79D64,063-000-002,33333333,APPLE CBA,50.58,0,29932.12,DR,REF605229,CBA,Current
01-08-2025 15:35,CBA2644BBC8CC99474091DE,063-000-002,33333333,SHELL CBA,5.63,0,29926.49,DR,REF764156,CBA,Current
01-08-2025 15:36,INT00390E837ABF447D88BD,063-000-002,33333333,TRANSFER TO ANZ 11111111,243.75,0,29682.74,DR,INT-79238,CBA,Current
01-08-2025 16:26,CBA394D6FB18E384E029536,063-000-002,33333333,MENULOG CBA,25.69,0,29657.05,DR,REF338520,CBA,Current
01-08-2025 16:33,CBABBD77009AF83474F9CA1,063-000-002,33333333,COLES CBA,41.03,0,29616.02,DR,REF231320,CBA,Current
01-08-2025 16:34,CBAB7C78C5298CF4FB09DBE,063-000-002,33333333,DOMINO'S PIZZA CBA,36.4,0,29579.62,DR,REF248797,CBA,Current
01-08-2025 16:40,CBAD81F4DBD7FB44EDCACA3,063-000-002,33333333,MCDONALDS CBA,6.72,0,29572.9,DR,REF935043,CBA,Current
01-08-2025 17:17,CBA33428F656FCA4533A92D,063-000-002,33333333,PAYMENT GATEWAY CBA,30.4,0,29542.5,DR,REF466988,CBA,Current
01-08-2025 17:46,CBA243EF44D77034C0AA2F6,063-000-002,33333333,JB HI-FI CBA,16.32,0,29526.18,DR,REF635160,CBA,Current
01-08-2025 17:49,CBABBE367398CAC4F25BF34,063-000-002,33333333,BIGW CBA,94.2,0,29431.98,DR,REF573774,CBA,Current
01-08-2025 18:38,CBA3B89C5B2FAB84C72B8F5,063-000-002,33333333,CITYLINK CBA,12.77,0,29419.21,DR,REF645566,CBA,Current
01-08-2025 18:40,CBA2F90B1063056446DB024,063-000-002,33333333,COMPANY PAYROLL CBA,0,6733.9,36153.11,CR,REF913630,CBA,Current
01-08-2025 18:45,CBACDE59206195A4935859F,063-000-002,33333333,PAYMENT GATEWAY CBA,28.76,0,36124.35,DR,REF926482,CBA,Current
01-08-2025 18:51,INT676CB31E87F149D4A192,063-000-002,33333333,TRANSFER FROM CBA 22222222,0,349.13,36473.48,CR,INT-77206,CBA,Current
01-08-2025 19:23,CBA045CDD2ABF5A46A4AE23,063-000-002,33333333,MCDONALDS CBA,10.95,0,36462.53,DR,REF472736,CBA,Current
01-08-2025 19:35,CBA824B5C784A224551AE15,063-000-002,33333333,MCDONALDS CBA,70.75,0,36391.78,DR,REF473948,CBA,Current
01-08-2025 20:04,CBAA0A552D03DA84D39846D,063-000-002,33333333,STARBUCKS CBA,32.02,0,36359.76,DR,REF589919,CBA,Current
01-08-2025 20:09,CBA42CC1F66A10447CF8F7E,063-000-002,33333333,BANK FEE CBA,61.68,0,36298.08,DR,REF912983,CBA,Current
01-08-2025 20:13,CBA087F6CC76F89403883B8,063-000-002,33333333,BANK FEE CBA,67.41,0,36230.67,DR,REF670777,CBA,Current
01-08-2025 20:41,CBACA1716F1B1144C9BBF19,063-000-002,33333333,7-ELEVEN CBA,11.02,0,36219.65,DR,REF112872,CBA,Current
01-08-2025 20:52,CBADFFD57B2F22B4F589F62,063-000-002,33333333,MENULOG CBA,53.64,0,36166.01,DR,REF980926,CBA,Current
01-08-2025 21:15,CBA2BDC1F7D694B4902B310,063-000-002,33333333,TAFE BOOKSHOP CBA,9.32,0,36156.69,DR,REF379241,CBA,Current
01-08-2025 21:16,CBA4ACD70505B7C4E6FAC13,063-000-002,33333333,UBER EATS CBA,30.84,0,36125.85,DR,REF749745,CBA,Current
01-08-2025 21:49,CBA3004B5E6E3BA473A9F5C,063-000-002,33333333,SALARY PAYMENT CBA,0,539.89,36665.74,CR,REF889689,CBA,Current
01-08-2025 21:55,CBAFB7FD7040EF24D66AA26,063-000-002,33333333,STARBUCKS CBA,135.41,0,36530.33,DR,REF172418,CBA,Current
01-08-2025 22:07,CBA40D765C1FDDB46D8B395,063-000-002,33333333,SHELL CBA,86.39,0,36443.94,DR,REF955553,CBA,Current
01-08-2025 22:16,CBA1574624D81E14AFE9B68,063-000-002,33333333,HARVEY NORMAN CBA,47.39,0,36396.55,DR,REF293940,CBA,Current
01-08-2025 22:16,CBAFEBF9E10E802431E852B,063-000-002,33333333,MCDONALDS CBA,5.28,0,36391.27,DR,REF629497,CBA,Current
01-08-2025 22:31,CBA5C063FCFDE3A4D0EB1F2,063-000-002,33333333,LIQUORLAND CBA,45.96,0,36345.31,DR,REF579303,CBA,Current
01-08-2025 22:37,CBA59940D5BF19C46BDB657,063-000-002,33333333,SPOTIFY CBA,30.51,0,36314.8,DR,REF820517,CBA,Current
01-08-2025 22:53,CBA3874E26A0DA245829D41,063-000-002,33333333,COMPANY PAYROLL CBA,0,1048.53,37363.33,CR,REF609944,CBA,Current
01-08-2025 23:07,CBAFBF7A4471CD94E58B636,063-000-002,33333333,SHELL CBA,53.66,0,37309.67,DR,REF506307,CBA,Current
01-08-2025 23:14,CBAE75D946774C54C9C9427,063-000-002,33333333,INTERNET TRANSFER CBA,52.04,0,37257.63,DR,REF282155,CBA,Current
01-08-2025 23:26,CBA90EB194FEB8D453CB52B,063-000-002,33333333,CITYLINK CBA,156.06,0,37101.57,DR,REF104678,CBA,Current
01-08-2025 23:50,CBA6CC5159E52E84D4A96EA,063-000-002,33333333,WAGES CREDIT CBA,0,6217.1,43318.67,CR,REF535673,CBA,Current
01-08-2025 23:55,CBA8DE301190ECD4D489CC5,063-000-002,33333333,INTERNET TRANSFER CBA,97.66,0,43221.01,DR,REF610584,CBA,Current
02-08-2025 00:21,CBA12657EEFFC744C13A069,063-000-002,33333333,MCDONALDS CBA,37.19,0,43183.82,DR,REF812486,CBA,Current
02-08-2025 00:28,CBA484BB26CBB8B4C7B8942,063-000-002,33333333,KFC CBA,17.56,0,43166.26,DR,REF236009,CBA,Current
02-08-2025 00:52,CBA6C6BDCB94B8F4395BEA1,063-000-002,33333333,FLIXBUS CBA,38.7,0,43127.56,DR,REF957723,CBA,Current
02-08-2025 00:52,CBA3C661678C265442CBF25,063-000-002,33333333,INTERNET TRANSFER CBA,7.58,0,43119.98,DR,REF254661,CBA,Current
02-08-2025 00:54,CBAEC98B14EABF0422DB610,063-000-002,33333333,JB HI-FI CBA,33.52,0,43086.46,DR,REF578737,CBA,Current
02-08-2025 00:55,CBAAF0D7C07D8804DFBA038,063-000-002,33333333,JB HI-FI CBA,66.96,0,43019.5,DR,REF608658,CBA,Current
02-08-2025 00:57,CBACA42253CD675436D873F,063-000-002,33333333,LIQUORLAND CBA,28.54,0,42990.96,DR,REF530111,CBA,Current
02-08-2025 00:58,CBA4F3E1283ABA54A8FBA11,063-000-002,33333333,ZOOM CBA,44.45,0,42946.51,DR,REF755886,CBA,Current
02-08-2025 01:16,CBA31B63D8B3D9C463DB394,063-000-002,33333333,PAYROLL CREDIT CBA,0,4682.22,47628.73,CR,REF894287,CBA,Current
02-08-2025 01:28,CBAC8FD87E17CDD48CF9AD7,063-000-002,33333333,ALDI CBA,21.68,0,47607.05,DR,REF501883,CBA,Current
02-08-2025 02:01,CBA551F406E5F21478BB72E,063-000-002,33333333,ALDI CBA,33,0,47574.05,DR,REF226330,CBA,Current
02-08-2025 02:44,CBA39B85AEF63A5418DB0AB,063-000-002,33333333,SHELL CBA,78.44,0,47495.61,DR,REF264852,CBA,Current
02-08-2025 02:47,INTC36389A1228C4164809E,063-000-002,33333333,TRANSFER TO ANZ 11111111,851.88,0,46643.73,DR,INT-16334,CBA,Current
02-08-2025 02:56,CBACE98FCA313424A91A442,063-000-002,33333333,7-ELEVEN CBA,44.19,0,46599.54,DR,REF433402,CBA,Current
02-08-2025 03:10,INT7BD18EDE0D3343A3A2B3,063-000-002,33333333,TRANSFER TO NAB 44444444,1666.9,0,44932.64,DR,INT-74689,CBA,Current
02-08-2025 03:17,CBA3D0049C5AB7E444583E0,063-000-002,33333333,FLIXBUS CBA,5.06,0,44927.58,DR,REF589645,CBA,Current
02-08-2025 04:09,CBA9DCC33243A0E4DB7863B,063-000-002,33333333,INTERNET TRANSFER CBA,20.47,0,44907.11,DR,REF956025,CBA,Current
02-08-2025 04:14,CBA2209F3F5632F44688F26,063-000-002,33333333,PAYROLL CREDIT CBA,0,557.6,45464.71,CR,REF439172,CBA,Current
02-08-2025 04:30,CBA1CAB28D12A8344238EA1,063-000-002,33333333,JB HI-FI CBA,99.25,0,45365.46,DR,REF558539,CBA,Current
02-08-2025 04:31,CBA7C1BB1DB231D4383A2F0,063-000-002,33333333,COLES CBA,101.96,0,45263.5,DR,REF255041,CBA,Current
02-08-2025 04:33,CBA1A2602D670894E52B15E,063-000-002,33333333,BANK FEE CBA,11.62,0,45251.88,DR,REF458225,CBA,Current
02-08-2025 04:38,CBA4C761BB67F2B49F8B8FF,063-000-002,33333333,SALARY PAYMENT CBA,0,6898.23,52150.11,CR,REF708936,CBA,Current
02-08-2025 05:09,CBABCC8AF5901734C438A27,063-000-002,33333333,PAYMENT GATEWAY CBA,9.03,0,52141.08,DR,REF629231,CBA,Current
02-08-2025 05:35,CBAD43C801759FE4AF7B4A8,063-000-002,33333333,PAYROLL CREDIT CBA,0,1628.03,53769.11,CR,REF899305,CBA,Current
02-08-2025 06:27,CBA08BCC811195E46229A11,063-000-002,33333333,DOMINO'S PIZZA CBA,27.48,0,53741.63,DR,REF690949,CBA,Current
02-08-2025 06:31,CBA3BCB6602B40C46A99526,063-000-002,33333333,PAYPAL *NETFLIX CBA,11.62,0,53730.01,DR,REF293158,CBA,Current
02-08-2025 07:09,CBA2C9B5AA0C4A44B4AAFCE,063-000-002,33333333,PAYROLL CREDIT CBA,0,6943.82,60673.83,CR,REF529999,CBA,Current
02-08-2025 07:33,CBA8D120217D8C94316B982,063-000-002,33333333,HARVEY NORMAN CBA,31.32,0,60642.51,DR,REF341170,CBA,Current
02-08-2025 07:43,CBAF8D15ABF9BF2457B8EC8,063-000-002,33333333,APPLE CBA,47.14,0,60595.37,DR,REF553221,CBA,Current
02-08-2025 08:23,CBADA610103760E4EEFA949,063-000-002,33333333,BANK FEE CBA,26.71,0,60568.66,DR,REF197235,CBA,Current
02-08-2025 08:26,CBA127F3C78C7274DD5A76E,063-000-002,33333333,MENULOG CBA,11.46,0,60557.2,DR,REF700214,CBA,Current
02-08-2025 08:38,CBA28FA91736745404794E7,063-000-002,33333333,AMAZON AU CBA,25.47,0,60531.73,DR,REF293707,CBA,Current
02-08-2025 09:16,CBAC5841D69FC5147FABE48,063-000-002,33333333,FLIXBUS CBA,39.81,0,60491.92,DR,REF852385,CBA,Current
02-08-2025 09:34,CBA98B27D7E6BEA41B396B0,063-000-002,33333333,CITYLINK CBA,200.82,0,60291.1,DR,REF532392,CBA,Current
02-08-2025 09:35,CBAD659C057875042C4B3D1,063-000-002,33333333,STARBUCKS CBA,3.12,0,60287.98,DR,REF751690,CBA,Current
02-08-2025 09:38,CBAF7BCFD291D1A46D9AF00,063-000-002,33333333,INTERNET TRANSFER CBA,8.56,0,60279.42,DR,REF844474,CBA,Current
02-08-2025 09:38,CBADA4A9DD70B8F44C78893,063-000-002,33333333,HARVEY NORMAN CBA,22.08,0,60257.34,DR,REF707363,CBA,Current
02-08-2025 09:40,CBA8D0A086986D242FD8107,063-000-002,33333333,ALDI CBA,99.27,0,60158.07,DR,REF727511,CBA,Current
02-08-2025 10:50,CBA625C723B653E4A0091DB,063-000-002,33333333,7-ELEVEN CBA,16.27,0,60141.8,DR,REF776732,CBA,Current
02-08-2025 11:02,CBA71124C02E821482F979D,063-000-002,33333333,BWS CBA,24.66,0,60117.14,DR,REF201326,CBA,Current
02-08-2025 11:06,CBAB328CED860C640068439,063-000-002,33333333,PAY - SALARY CBA,0,3608.05,63725.19,CR,REF377710,CBA,Current
02-08-2025 11:14,CBAA16563133518408BBD26,063-000-002,33333333,RAILWAY STATION CBA,8.01,0,63717.18,DR,REF646797,CBA,Current
02-08-2025 11:38,CBA73CC436789E249A0A02F,063-000-002,33333333,COMPANY PAYROLL CBA,0,412.27,64129.45,CR,REF189144,CBA,Current
02-08-2025 12:16,CBAD88445B04BE34EE293E6,063-000-002,33333333,MENULOG CBA,31.75,0,64097.7,DR,REF790404,CBA,Current
02-08-2025 12:48,CBAB233B2032E1649698D01,063-000-002,33333333,WAGES CREDIT CBA,0,6204.72,70302.42,CR,REF732680,CBA,Current
02-08-2025 12:50,INT84F3BC5B9E154E129243,063-000-002,33333333,TRANSFER FROM ANZ 11111111,0,865.31,71167.73,CR,INT-61321,CBA,Current
02-08-2025 12:59,CBA78A54FF314C541C9A3F1,063-000-002,33333333,KFC CBA,44.3,0,71123.43,DR,REF732223,CBA,Current
02-08-2025 13:01,CBA5E0F4C0D15FD465EA5F5,063-000-002,33333333,HARVEY NORMAN CBA,124.51,0,70998.92,DR,REF399770,CBA,Current
02-08-2025 13:24,CBA896D9A4F7F1147C59340,063-000-002,33333333,BANK FEE CBA,21.26,0,70977.66,DR,REF164848,CBA,Current
02-08-2025 13:24,CBA9B019DD2332F4B54831F,063-000-002,33333333,JB HI-FI CBA,125.36,0,70852.3,DR,REF126993,CBA,Current
02-08-2025 13:25,CBAAB1FF1CAA4F8440B8562,063-000-002,33333333,APPLE CBA,117.9,0,70734.4,DR,REF200409,CBA,Current
02-08-2025 13:52,CBAA1642BC6FA404B7981AC,063-000-002,33333333,WOOLWORTHS CBA,60.51,0,70673.89,DR,REF147072,CBA,Current
02-08-2025 14:07,CBADF2D8113B7764DBCBD26,063-000-002,33333333,STARBUCKS CBA,26.57,0,70647.32,DR,REF335958,CBA,Current
02-08-2025 14:13,CBA559EF35DC990400C8F57,063-000-002,33333333,APPLE CBA,38.19,0,70609.13,DR,REF224418,CBA,Current
02-08-2025 14:18,CBA691DEE5AD1F043F5BB44,063-000-002,33333333,WAGES CREDIT CBA,0,862.41,71471.54,CR,REF566571,CBA,Current
02-08-2025 14:44,CBA6A7AF9A4318A49DEAA2C,063-000-002,33333333,INTERNET TRANSFER CBA,13.04,0,71458.5,DR,REF755775,CBA,Current
02-08-2025 14:53,CBA68AC65705F8B4387AE27,063-000-002,33333333,ALDI CBA,46.97,0,71411.53,DR,REF799785,CBA,Current
02-08-2025 14:59,CBA753CE00E8EC04D30A411,063-000-002,33333333,HARVEY NORMAN CBA,8.1,0,71403.43,DR,REF370626,CBA,Current
02-08-2025 15:36,CBA10A42F85FC63413591A2,063-000-002,33333333,INTERNET TRANSFER CBA,10.34,0,71393.09,DR,REF839632,CBA,Current
02-08-2025 15:51,CBA570D43454AF249F9B716,063-000-002,33333333,APPLE CBA,17.96,0,71375.13,DR,REF809170,CBA,Current
02-08-2025 16:00,INT4EB66DCFC4794FEEBDAB,063-000-002,33333333,TRANSFER TO CBA 22222222,316.56,0,71058.57,DR,INT-10533,CBA,Current
02-08-2025 16:03,CBAF9859D2A013545449889,063-000-002,33333333,SHELL CBA,35.75,0,71022.82,DR,REF108661,CBA,Current
02-08-2025 16:25,CBA3557838D3DD842E694FD,063-000-002,33333333,COLES CBA,100.46,0,70922.36,DR,REF406376,CBA,Current
02-08-2025 16:26,CBA93B40905B8814E3BA68E,063-000-002,33333333,WOOLWORTHS CBA,123.06,0,70799.3,DR,REF159963,CBA,Current
02-08-2025 16:42,CBA59C80D3419884547BB45,063-000-002,33333333,SALARY PAYMENT CBA,0,262.45,71061.75,CR,REF778801,CBA,Current
02-08-2025 16:53,CBADACA0527CBAC4BF39B67,063-000-002,33333333,PAYMENT GATEWAY CBA,8.6,0,71053.15,DR,REF401098,CBA,Current
02-08-2025 16:53,CBA4EAC96A036CA4764B940,063-000-002,33333333,UBER EATS CBA,73.33,0,70979.82,DR,REF323237,CBA,Current
02-08-2025 17:07,CBACEE989FB93954340BCA1,063-000-002,33333333,BIGW CBA,23.01,0,70956.81,DR,REF752850,CBA,Current
02-08-2025 17:11,INTFF707EF31F7544799533,063-000-002,33333333,TRANSFER FROM CBA 22222222,0,1033.94,71990.75,CR,INT-23330,CBA,Current
02-08-2025 17:15,CBADF3636C6E2B843EDA155,063-000-002,33333333,UBER EATS CBA,19.97,0,71970.78,DR,REF466692,CBA,Current
02-08-2025 17:44,CBA59E01FC1D40C430BB1DE,063-000-002,33333333,ZOOM CBA,126.53,0,71844.25,DR,REF584214,CBA,Current
02-08-2025 17:51,INTC86F89B15C89448A83DB,063-000-002,33333333,TRANSFER TO ANZ 11111111,891.48,0,70952.77,DR,INT-58757,CBA,Current
02-08-2025 18:18,CBA6B6BC134BF7B442E9114,063-000-002,33333333,ALDI CBA,108.48,0,70844.29,DR,REF678869,CBA,Current
02-08-2025 18:29,CBA39EA7823E2154017B97A,063-000-002,33333333,BIGW CBA,10.85,0,70833.44,DR,REF528244,CBA,Current
02-08-2025 18:50,CBA33AE6F3FBA6E4FE5A174,063-000-002,33333333,MCDONALDS CBA,129.39,0,70704.05,DR,REF476573,CBA,Current
02-08-2025 18:58,CBA0DAB69EB27F848CEA8CF,063-000-002,33333333,SPOTIFY CBA,11.59,0,70692.46,DR,REF459530,CBA,Current
02-08-2025 19:31,CBA02BF091694E54A319FD8,063-000-002,33333333,FLIXBUS CBA,8.49,0,70683.97,DR,REF215735,CBA,Current
02-08-2025 19:48,CBAB82D21F27E5E47CCAC0F,063-000-002,33333333,TAFE BOOKSHOP CBA,21.37,0,70662.6,DR,REF924588,CBA,Current
02-08-2025 20:26,CBAA94034F47DBD46FCA22E,063-000-002,33333333,KFC CBA,8.14,0,70654.46,DR,REF713242,CBA,Current
02-08-2025 21:08,CBAC731D6548C4E4379A230,063-000-002,33333333,SPOTIFY CBA,78.9,0,70575.56,DR,REF789554,CBA,Current
02-08-2025 21:31,CBA726267B4F3A7449F9A9F,063-000-002,33333333,BIGW CBA,179.92,0,70395.64,DR,REF555229,CBA,Current
02-08-2025 21:36,CBA2C9EEF481CBA4855850B,063-000-002,33333333,PAYMENT GATEWAY CBA,6.98,0,70388.66,DR,REF201899,CBA,Current
02-08-2025 21:39,CBAE7F740DEDA5E4A69B651,063-000-002,33333333,JB HI-FI CBA,66.7,0,70321.96,DR,REF365713,CBA,Current
02-08-2025 21:52,CBA97826C110D684864869C,063-000-002,33333333,MENULOG CBA,49.98,0,70271.98,DR,REF749559,CBA,Current
02-08-2025 22:00,CBA98CE4EAA9CCE4C03AB4B,063-000-002,33333333,JB HI-FI CBA,9.96,0,70262.02,DR,REF980530,CBA,Current
02-08-2025 22:09,CBA04C57AFBE5D9497D8482,063-000-002,33333333,CITYLINK CBA,51.61,0,70210.41,DR,REF329137,CBA,Current
02-08-2025 23:02,CBACCBD1A0309994922B74B,063-000-002,33333333,BANK FEE CBA,22.03,0,70188.38,DR,REF347025,CBA,Current
02-08-2025 23:15,CBA531B01C363494D158CA9,063-000-002,33333333,ALDI CBA,26.53,0,70161.85,DR,REF949039,CBA,Current
02-08-2025 23:40,CBA6A76E881DA4F46AC9877,063-000-002,33333333,HARVEY NORMAN CBA,6.33,0,70155.52,DR,REF118433,CBA,Current
02-08-2025 23:54,INT9DFBDBB5869B4E2EB46B,063-000-002,33333333,TRANSFER FROM NAB 44444444,0,351.6,70507.12,CR,INT-28874,CBA,Current
02-08-2025 23:56,CBAB06C18CABED9417EA1AB,063-000-002,33333333,WOOLWORTHS CBA,34.57,0,70472.55,DR,REF778189,CBA,Current
03-08-2025 00:02,CBAF902F8CB2D424DD5813E,063-000-002,33333333,BANK FEE CBA,43.77,0,70428.78,DR,REF472398,CBA,Current
03-08-2025 00:15,CBADD92172A5A5E4E069B6E,063-000-002,33333333,PAY - SALARY CBA,0,4347.02,74775.8,CR,REF504460,CBA,Current
03-08-2025 00:21,CBA96E0D036A51644179E97,063-000-002,33333333,RAILWAY STATION CBA,2.31,0,74773.49,DR,REF411219,CBA,Current
03-08-2025 00:26,CBA45DE2AAD8FE54DF9A0F3,063-000-002,33333333,DOMINO'S PIZZA CBA,132.81,0,74640.68,DR,REF838761,CBA,Current
03-08-2025 00:27,CBA19E4893FD1B64FF89222,063-000-002,33333333,SHELL CBA,92.46,0,74548.22,DR,REF636827,CBA,Current
03-08-2025 00:27,CBA270CABCC39DA4B62BCD1,063-000-002,33333333,PAYMENT GATEWAY CBA,44.11,0,74504.11,DR,REF173029,CBA,Current
03-08-2025 00:31,CBA9B55722722A14984954A,063-000-002,33333333,BWS CBA,26.08,0,74478.03,DR,REF340993,CBA,Current
03-08-2025 01:07,CBAE50972A2D2ED4FE5AB72,063-000-002,33333333,UBER EATS CBA,9.54,0,74468.49,DR,REF734710,CBA,Current
03-08-2025 01:52,CBA60729326A16142DDB070,063-000-002,33333333,ZOOM CBA,124.72,0,74343.77,DR,REF251593,CBA,Current
03-08-2025 01:54,CBA3859286D533E4F2B8151,063-000-002,33333333,BIGW CBA,7.53,0,74336.24,DR,REF540650,CBA,Current
03-08-2025 02:13,CBA47E00745B4B740919EAE,063-000-002,33333333,DOMINO'S PIZZA CBA,151.78,0,74184.46,DR,REF122464,CBA,Current
03-08-2025 03:02,CBAD40C2CED405B40EEB51F,063-000-002,33333333,AMAZON AU CBA,87.28,0,74097.18,DR,REF581796,CBA,Current
03-08-2025 03:18,CBA3789B31D62F644489DDE,063-000-002,33333333,LIQUORLAND CBA,1.72,0,74095.46,DR,REF534552,CBA,Current
03-08-2025 03:19,CBA72F97D0161634F0991FB,063-000-002,33333333,COMPANY PAYROLL CBA,0,672.03,74767.49,CR,REF422879,CBA,Current
03-08-2025 03:51,CBA4CBA11BA5D4D41BD97F0,063-000-002,33333333,PAYMENT GATEWAY CBA,5,0,74762.49,DR,REF809273,CBA,Current
03-08-2025 03:52,CBAB3D778C386014A1381C8,063-000-002,33333333,PAYMENT GATEWAY CBA,12.85,0,74749.64,DR,REF562320,CBA,Current
03-08-2025 04:05,CBA198EADBCA4974091BC82,063-000-002,33333333,STARBUCKS CBA,54.2,0,74695.44,DR,REF116818,CBA,Current
03-08-2025 04:06,CBA9B081D354F02471395B3,063-000-002,33333333,BIGW CBA,14.9,0,74680.54,DR,REF410856,CBA,Current
03-08-2025 04:15,CBAFC57EE52B3834119AE99,063-000-002,33333333,SALARY PAYMENT CBA,0,4524.08,79204.62,CR,REF855259,CBA,Current
03-08-2025 04:21,CBA93F482802F13431CBCB4,063-000-002,33333333,COMPANY PAYROLL CBA,0,375.57,79580.19,CR,REF662101,CBA,Current
03-08-2025 04:50,CBAA4F0AA5AF88B437B973E,063-000-002,33333333,FLIXBUS CBA,94.44,0,79485.75,DR,REF425011,CBA,Current
03-08-2025 05:14,CBA3D301E6EA85846FD81AB,063-000-002,33333333,PAYMENT GATEWAY CBA,8.95,0,79476.8,DR,REF751681,CBA,Current
03-08-2025 06:10,CBA234C84FD214F45EABB6A,063-000-002,33333333,BP CBA,39.36,0,79437.44,DR,REF351844,CBA,Current
03-08-2025 06:17,CBACC09F073B3C249F2B551,063-000-002,33333333,FLIXBUS CBA,50.77,0,79386.67,DR,REF621373,CBA,Current
03-08-2025 06:18,CBA2F7F0B6F6B284E199242,063-000-002,33333333,PAYMENT GATEWAY CBA,3.06,0,79383.61,DR,REF634094,CBA,Current
03-08-2025 06:31,CBA8DCED082A8E940988918,063-000-002,33333333,SHELL CBA,26.53,0,79357.08,DR,REF913543,CBA,Current
03-08-2025 06:57,INTA5DCBE4A6C1B4AFCB3C0,063-000-002,33333333,TRANSFER TO ANZ 11111111,507.52,0,78849.56,DR,INT-64134,CBA,Current
03-08-2025 07:01,CBA93FA23EC79CB494C9EB0,063-000-002,33333333,PAYMENT GATEWAY CBA,14.05,0,78835.51,DR,REF307910,CBA,Current
03-08-2025 07:03,CBA3E5ACA6B55194CD0B6EE,063-000-002,33333333,SPOTIFY CBA,5.68,0,78829.83,DR,REF822690,CBA,Current
03-08-2025 07:03,CBACDD1CF4537664A8F8CA9,063-000-002,33333333,7-ELEVEN CBA,98.02,0,78731.81,DR,REF340525,CBA,Current
03-08-2025 07:32,CBA0D124E5272C44935BB4A,063-000-002,33333333,TAFE BOOKSHOP CBA,27.94,0,78703.87,DR,REF983139,CBA,Current
03-08-2025 07:37,CBA56656266A12546579C4A,063-000-002,33333333,PAY - SALARY CBA,0,4968.91,83672.78,CR,REF920097,CBA,Current
03-08-2025 08:42,CBAF2573B3CCA4B422786F2,063-000-002,33333333,MCDONALDS CBA,4.01,0,83668.77,DR,REF507340,CBA,Current
03-08-2025 08:59,CBA0FD00D63C77B479F8141,063-000-002,33333333,JB HI-FI CBA,23.08,0,83645.69,DR,REF829815,CBA,Current
03-08-2025 09:01,CBA7C9816B4190F4326B9A3,063-000-002,33333333,COLES CBA,43.71,0,83601.98,DR,REF139844,CBA,Current
03-08-2025 10:18,CBA559C4630D4E64B799EA0,063-000-002,33333333,DOMINO'S PIZZA CBA,120.16,0,83481.82,DR,REF962545,CBA,Current
03-08-2025 10:23,INT68D13AD4C1234BE69471,063-000-002,33333333,TRANSFER FROM ANZ 11111111,0,1112.08,84593.9,CR,INT-92971,CBA,Current
03-08-2025 10:36,CBACD05D8FCD2474BB6AC62,063-000-002,33333333,LIQUORLAND CBA,98.37,0,84495.53,DR,REF860428,CBA,Current
03-08-2025 11:05,CBA7A9F3ED61D3640AD9C16,063-000-002,33333333,JB HI-FI CBA,4.17,0,84491.36,DR,REF990882,CBA,Current
03-08-2025 11:18,CBA02E5345CEBA642AD973B,063-000-002,33333333,SPOTIFY CBA,100.62,0,84390.74,DR,REF672393,CBA,Current
03-08-2025 11:41,CBAA34F4CF88DC349B4B0C2,063-000-002,33333333,COLES CBA,64.97,0,84325.77,DR,REF893889,CBA,Current
03-08-2025 12:12,CBA9C8D4C22D9894AF79E81,063-000-002,33333333,PAYMENT GATEWAY CBA,106.4,0,84219.37,DR,REF164558,CBA,Current
03-08-2025 12:18,CBA21FC7719FBD843AEBF03,063-000-002,33333333,MENULOG CBA,67.53,0,84151.84,DR,REF322332,CBA,Current
03-08-2025 13:08,CBA220EB275FE274FDEAC7A,063-000-002,33333333,FLIXBUS CBA,126.24,0,84025.6,DR,REF319654,CBA,Current
03-08-2025 13:36,CBAADE38F6660CB4602886B,063-000-002,33333333,STARBUCKS CBA,15.96,0,84009.64,DR,REF876710,CBA,Current
03-08-2025 13:41,CBA97FE88A98CD844CCB8A1,063-000-002,33333333,CITYLINK CBA,5.88,0,84003.76,DR,REF906837,CBA,Current
03-08-2025 13:57,CBA6E80C0C84E40433F8246,063-000-002,33333333,MCDONALDS CBA,92.53,0,83911.23,DR,REF326369,CBA,Current
03-08-2025 14:02,CBAC4BEB7E4D4D34D159EAF,063-000-002,33333333,INTERNET TRANSFER CBA,34.08,0,83877.15,DR,REF797156,CBA,Current
03-08-2025 14:46,CBA7C97B8469A744FB4A7A1,063-000-002,33333333,STARBUCKS CBA,177.46,0,83699.69,DR,REF181293,CBA,Current
03-08-2025 14:49,CBAAC547E72113641818D35,063-000-002,33333333,WOOLWORTHS CBA,96.3,0,83603.39,DR,REF484219,CBA,Current
03-08-2025 14:49,CBACA18C5C11C844D0C8C80,063-000-002,33333333,MENULOG CBA,65.16,0,83538.23,DR,REF362174,CBA,Current
03-08-2025 14:57,INTA9BA40364EED4CA89F8E,063-000-002,33333333,TRANSFER FROM NAB 44444444,0,1776.73,85314.96,CR,INT-35928,CBA,Current
03-08-2025 15:08,CBAC92F7D66D3B742E588AC,063-000-002,33333333,STARBUCKS CBA,11.53,0,85303.43,DR,REF288794,CBA,Current
03-08-2025 15:21,CBAAB5276851C0F4287B82E,063-000-002,33333333,PAY - SALARY CBA,0,3559.45,88862.88,CR,REF916771,CBA,Current
03-08-2025 15:43,CBAA74D8781D13C4730AC13,063-000-002,33333333,PAYMENT GATEWAY CBA,36.37,0,88826.51,DR,REF349678,CBA,Current
03-08-2025 15:54,CBA5CCEADBC3BC84B20B20A,063-000-002,33333333,SALARY PAYMENT CBA,0,6638.76,95465.27,CR,REF348742,CBA,Current
03-08-2025 16:01,INT60167B1097EC45A991F3,063-000-002,33333333,TRANSFER TO NAB 44444444,67.25,0,95398.02,DR,INT-75497,CBA,Current
03-08-2025 16:10,INT65CFB1495B3B409FA530,063-000-002,33333333,TRANSFER TO NAB 44444444,177.35,0,95220.67,DR,INT-92285,CBA,Current
03-08-2025 16:23,CBA5A8BA112EEE74ABB8DF0,063-000-002,33333333,MCDONALDS CBA,37.88,0,95182.79,DR,REF956089,CBA,Current
03-08-2025 16:38,CBA26732F5354404CE09B2C,063-000-002,33333333,ALDI CBA,6.43,0,95176.36,DR,REF401952,CBA,Current
03-08-2025 16:46,CBA4B79AC2A5BA442B28A12,063-000-002,33333333,ALDI CBA,35.27,0,95141.09,DR,REF808840,CBA,Current
03-08-2025 17:22,CBA271A147F9AD74C4FBC89,063-000-002,33333333,BIGW CBA,9.1,0,95131.99,DR,REF553006,CBA,Current
03-08-2025 17:32,CBA102AC7EB4E574BD18251,063-000-002,33333333,WOOLWORTHS CBA,46.81,0,95085.18,DR,REF984980,CBA,Current
03-08-2025 17:42,CBA12CBCFEE19A3428C86DD,063-000-002,33333333,COLES CBA,36.85,0,95048.33,DR,REF765042,CBA,Current
03-08-2025 18:45,CBAE5266415591F4772BC63,063-000-002,33333333,DOMINO'S PIZZA CBA,48.07,0,95000.26,DR,REF458303,CBA,Current
03-08-2025 19:45,CBA158372D1539749CEBCE5,063-000-002,33333333,SHELL CBA,11.82,0,94988.44,DR,REF914189,CBA,Current
03-08-2025 19:55,CBA01A44BDC2F59457B8141,063-000-002,33333333,KFC CBA,26.06,0,94962.38,DR,REF806329,CBA,Current
03-08-2025 20:11,CBAB815DC9A623D4E808DF3,063-000-002,33333333,SALARY PAYMENT CBA,0,6539.74,101502.12,CR,REF673809,CBA,Current
03-08-2025 20:33,CBAA38995A9739F460C8053,063-000-002,33333333,PAYPAL *NETFLIX CBA,12.59,0,101489.53,DR,REF291095,CBA,Current
03-08-2025 21:05,CBAC00C4EF8A4E5455385DB,063-000-002,33333333,PAYROLL CREDIT CBA,0,833.08,102322.61,CR,REF953378,CBA,Current
03-08-2025 21:31,CBAEA81972FE66B4031A335,063-000-002,33333333,PAYMENT GATEWAY CBA,37.98,0,102284.63,DR,REF364305,CBA,Current
03-08-2025 21:54,CBA7258E1006CED4FA5A0BC,063-000-002,33333333,KFC CBA,8.82,0,102275.81,DR,REF378514,CBA,Current
03-08-2025 21:57,CBAEE53EDA3C59A4FAA96BB,063-000-002,33333333,BP CBA,3.14,0,102272.67,DR,REF590086,CBA,Current
03-08-2025 22:07,CBA34A6812A02964540BB21,063-000-002,33333333,RAILWAY STATION CBA,29.49,0,102243.18,DR,REF642531,CBA,Current
03-08-2025 22:10,CBA2C2AA3BD3E3A4FFB9CB6,063-000-002,33333333,MCDONALDS CBA,40.48,0,102202.7,DR,REF664062,CBA,Current
03-08-2025 22:38,CBAA0B9E0B23DFE41B890C6,063-000-002,33333333,SALARY PAYMENT CBA,0,7026.18,109228.88,CR,REF566168,CBA,Current
03-08-2025 23:42,CBA80BB10989AC54694B60C,063-000-002,33333333,WAGES CREDIT CBA,0,7962.43,117191.31,CR,REF343791,CBA,Current
04-08-2025 00:24,CBA15B8956F6CA34AEF9C99,063-000-002,33333333,PAY - SALARY CBA,0,4385.69,121577,CR,REF231548,CBA,Current
04-08-2025 00:56,CBA77871D4A35934D59BB86,063-000-002,33333333,ALDI CBA,12.32,0,121564.68,DR,REF676527,CBA,Current
04-08-2025 01:01,CBA7BF1BE33480347B9B84C,063-000-002,33333333,WAGES CREDIT CBA,0,2469.15,124033.83,CR,REF547622,CBA,Current
04-08-2025 02:06,CBAE4E7FCDBEDF342799481,063-000-002,33333333,BP CBA,15.07,0,124018.76,DR,REF277329,CBA,Current
04-08-2025 02:37,CBAEB2678C8EEDC405ABD17,063-000-002,33333333,ZOOM CBA,4.07,0,124014.69,DR,REF710010,CBA,Current
04-08-2025 02:38,CBA4BA71E684D77457EA639,063-000-002,33333333,FLIXBUS CBA,27.16,0,123987.53,DR,REF455166,CBA,Current
04-08-2025 02:57,CBAAAAAF732ED304794A420,063-000-002,33333333,AMAZON AU CBA,19.12,0,123968.41,DR,REF992228,CBA,Current
04-08-2025 02:57,INTF1CAD225D41749B5A8D6,063-000-002,33333333,TRANSFER FROM CBA 22222222,0,561.62,124530.03,CR,INT-97968,CBA,Current
04-08-2025 03:21,CBA674D757A1AFC414EAD21,063-000-002,33333333,UBER EATS CBA,167.27,0,124362.76,DR,REF762165,CBA,Current
04-08-2025 03:28,CBA09BA6C6F20AC42DB8669,063-000-002,33333333,LIQUORLAND CBA,50.47,0,124312.29,DR,REF880468,CBA,Current
04-08-2025 03:37,CBA4334A2A5FD7747119A89,063-000-002,33333333,KFC CBA,15.15,0,124297.14,DR,REF659612,CBA,Current
04-08-2025 03:40,CBA5563A0219BC84276BA36,063-000-002,33333333,RAILWAY STATION CBA,7.61,0,124289.53,DR,REF865094,CBA,Current
04-08-2025 04:04,CBA424423C99B1746ED9766,063-000-002,33333333,7-ELEVEN CBA,49.71,0,124239.82,DR,REF697682,CBA,Current
04-08-2025 04:06,CBA278E1DE5AEBC42FB9CE0,063-000-002,33333333,RAILWAY STATION CBA,42.32,0,124197.5,DR,REF970203,CBA,Current
04-08-2025 04:09,CBA0727348B803145EE8A9F,063-000-002,33333333,HARVEY NORMAN CBA,9.91,0,124187.59,DR,REF586806,CBA,Current
04-08-2025 04:23,CBA9A89D0B63A854F328788,063-000-002,33333333,PAYPAL *NETFLIX CBA,47.37,0,124140.22,DR,REF962195,CBA,Current
04-08-2025 05:28,CBAD775E36A0BC247B598E9,063-000-002,33333333,7-ELEVEN CBA,15.81,0,124124.41,DR,REF169921,CBA,Current
04-08-2025 05:46,CBAA48B3D0044AE4074BF67,063-000-002,33333333,WOOLWORTHS CBA,156.43,0,123967.98,DR,REF403767,CBA,Current
04-08-2025 06:15,CBA1B70D7A52CF7474F8434,063-000-002,33333333,BWS CBA,14.83,0,123953.15,DR,REF193214,CBA,Current
04-08-2025 06:23,CBA0F870D79126C4832975D,063-000-002,33333333,UBER EATS CBA,18.79,0,123934.36,DR,REF470534,CBA,Current
04-08-2025 06:45,CBA514515324BA14D8995E7,063-000-002,33333333,CITYLINK CBA,64.8,0,123869.56,DR,REF699485,CBA,Current
04-08-2025 06:56,CBA06492DBAA9524F2498CB,063-000-002,33333333,KFC CBA,15.21,0,123854.35,DR,REF993626,CBA,Current
04-08-2025 06:57,CBADF3D51C1BD704240B8A6,063-000-002,33333333,7-ELEVEN CBA,8.09,0,123846.26,DR,REF717058,CBA,Current
04-08-2025 08:04,CBA82552429422643AC89E3,063-000-002,33333333,CITYLINK CBA,4.33,0,123841.93,DR,REF631285,CBA,Current
04-08-2025 08:13,CBA2E205763C2E842E0AA0C,063-000-002,33333333,PAYMENT GATEWAY CBA,7.96,0,123833.97,DR,REF566037,CBA,Current
04-08-2025 08:26,CBA9D3265169A8F42068F92,063-000-002,33333333,SHELL CBA,34.26,0,123799.71,DR,REF988714,CBA,Current
04-08-2025 08:32,CBAEDA35774B2704BE1889A,063-000-002,33333333,KFC CBA,12.03,0,123787.68,DR,REF856612,CBA,Current
04-08-2025 08:36,CBA02CE349EE8FD4E10B7D4,063-000-002,33333333,TAFE BOOKSHOP CBA,162.63,0,123625.05,DR,REF560558,CBA,Current
04-08-2025 08:51,CBAAAC42B2BEAC945778691,063-000-002,33333333,LIQUORLAND CBA,6.91,0,123618.14,DR,REF421233,CBA,Current
04-08-2025 09:01,CBAE3380CAE75CF45C29459,063-000-002,33333333,PAYPAL *NETFLIX CBA,42.07,0,123576.07,DR,REF787346,CBA,Current
04-08-2025 09:12,CBAE3A60218F8304E74816D,063-000-002,33333333,CITYLINK CBA,2.99,0,123573.08,DR,REF838583,CBA,Current
04-08-2025 09:38,CBAB3CDAAFAE13243EFB4C9,063-000-002,33333333,SPOTIFY CBA,70.33,0,123502.75,DR,REF786248,CBA,Current
04-08-2025 10:23,CBA10843A10120C41A4AAA4,063-000-002,33333333,COMPANY PAYROLL CBA,0,6510.09,130012.84,CR,REF789473,CBA,Current
04-08-2025 10:24,CBA3281B8D29D8D4A91BC20,063-000-002,33333333,COMPANY PAYROLL CBA,0,474.71,130487.55,CR,REF343487,CBA,Current
04-08-2025 10:27,CBA069C78B625734F67A464,063-000-002,33333333,COMPANY PAYROLL CBA,0,1575.19,132062.74,CR,REF589311,CBA,Current
04-08-2025 10:30,CBAC085D6C4FF444D7AA2DF,063-000-002,33333333,STARBUCKS CBA,40.35,0,132022.39,DR,REF946007,CBA,Current
04-08-2025 11:21,CBA731EE3C2EFF545DC8F01,063-000-002,33333333,KFC CBA,80.58,0,131941.81,DR,REF250407,CBA,Current
04-08-2025 11:22,CBA91BAFDE0B7B5420DA7D2,063-000-002,33333333,WAGES CREDIT CBA,0,6798.46,138740.27,CR,REF540257,CBA,Current
04-08-2025 11:25,CBA38D78EB2FE0F4F0FB31A,063-000-002,33333333,PAYMENT GATEWAY CBA,13.39,0,138726.88,DR,REF828026,CBA,Current
04-08-2025 11:27,CBA2EA88331991A41DCB4CE,063-000-002,33333333,RAILWAY STATION CBA,54.69,0,138672.19,DR,REF711709,CBA,Current
04-08-2025 11:29,CBAD5414BB4E32F49CAAAAB,063-000-002,33333333,BP CBA,7.12,0,138665.07,DR,REF583078,CBA,Current
04-08-2025 11:36,CBAB4F13D9B08304478AB74,063-000-002,33333333,BANK FEE CBA,12.52,0,138652.55,DR,REF145251,CBA,Current
04-08-2025 12:48,CBA2936590F829346ED91F1,063-000-002,33333333,TAFE BOOKSHOP CBA,146.99,0,138505.56,DR,REF715230,CBA,Current
04-08-2025 13:22,CBA9A9441A4A8C94675A1F9,063-000-002,33333333,MCDONALDS CBA,23.46,0,138482.1,DR,REF941063,CBA,Current
04-08-2025 13:59,CBA2A1596385D4F448D81C0,063-000-002,33333333,INTERNET TRANSFER CBA,27.04,0,138455.06,DR,REF227602,CBA,Current
04-08-2025 13:59,CBA16FACDB53C2043F194B7,063-000-002,33333333,COMPANY PAYROLL CBA,0,960.11,139415.17,CR,REF664407,CBA,Current
04-08-2025 14:15,CBAC2537D8765A74181B56B,063-000-002,33333333,LIQUORLAND CBA,67.99,0,139347.18,DR,REF771161,CBA,Current
04-08-2025 14:20,INTFE39D78523D64FA3AAA7,063-000-002,33333333,TRANSFER TO NAB 44444444,388.81,0,138958.37,DR,INT-40160,CBA,Current
04-08-2025 14:30,INT92F8B05F3C064BF98E9E,063-000-002,33333333,TRANSFER FROM CBA 22222222,0,1328.6,140286.97,CR,INT-22855,CBA,Current
04-08-2025 15:34,CBA778949E0F77B4224A734,063-000-002,33333333,SALARY PAYMENT CBA,0,6669.05,146956.02,CR,REF571060,CBA,Current
04-08-2025 15:54,CBA00EDDACC08414A7B927D,063-000-002,33333333,HARVEY NORMAN CBA,46.89,0,146909.13,DR,REF487887,CBA,Current
04-08-2025 15:58,CBA454EEC7F55834183A40E,063-000-002,33333333,SPOTIFY CBA,62.83,0,146846.3,DR,REF649416,CBA,Current
04-08-2025 16:17,CBA91D4B7CF026A4F05ABD5,063-000-002,33333333,AMAZON AU CBA,9.63,0,146836.67,DR,REF250958,CBA,Current
04-08-2025 16:49,CBA4A47C2775B8749709912,063-000-002,33333333,ALDI CBA,16.71,0,146819.96,DR,REF457354,CBA,Current
04-08-2025 16:50,CBA90AFE5C9FFB9462EB1C9,063-000-002,33333333,7-ELEVEN CBA,46.73,0,146773.23,DR,REF376015,CBA,Current
04-08-2025 17:00,CBA365D5B35C3064288B6DD,063-000-002,33333333,PAYPAL *NETFLIX CBA,43.06,0,146730.17,DR,REF396944,CBA,Current
04-08-2025 17:03,CBABBD2D359C4D94B6B80F7,063-000-002,33333333,PAYPAL *NETFLIX CBA,73.56,0,146656.61,DR,REF950542,CBA,Current
04-08-2025 17:59,CBA157CB389E19441C4B573,063-000-002,33333333,HARVEY NORMAN CBA,36.65,0,146619.96,DR,REF234125,CBA,Current
04-08-2025 18:40,CBA68F8C466D74B47389D92,063-000-002,33333333,RAILWAY STATION CBA,36.22,0,146583.74,DR,REF463347,CBA,Current
04-08-2025 18:41,CBA3AAF1609D5804244A23B,063-000-002,33333333,MENULOG CBA,76.48,0,146507.26,DR,REF636421,CBA,Current
04-08-2025 18:45,CBA03945A9548A142AC892C,063-000-002,33333333,COLES CBA,85.55,0,146421.71,DR,REF251606,CBA,Current
04-08-2025 18:46,CBA6EF7FE8BE90B4DF8B622,063-000-002,33333333,PAYMENT GATEWAY CBA,12.56,0,146409.15,DR,REF357117,CBA,Current
04-08-2025 18:50,CBAB7702C8EE1D04F86BA2B,063-000-002,33333333,UBER EATS CBA,90.86,0,146318.29,DR,REF686213,CBA,Current
04-08-2025 19:37,CBA3EAC3F3AF26146868164,063-000-002,33333333,MENULOG CBA,183.97,0,146134.32,DR,REF295267,CBA,Current
04-08-2025 19:49,CBA4A6E26D009E8473AB64D,063-000-002,33333333,LIQUORLAND CBA,27.07,0,146107.25,DR,REF428909,CBA,Current
04-08-2025 19:54,CBA030973BF453F4238BDFA,063-000-002,33333333,MENULOG CBA,53.06,0,146054.19,DR,REF545458,CBA,Current
04-08-2025 20:05,CBA74775FDC71514265AC4F,063-000-002,33333333,KFC CBA,19.26,0,146034.93,DR,REF556157,CBA,Current
04-08-2025 20:40,CBAC758A659B66A4D1089C5,063-000-002,33333333,COLES CBA,33.86,0,146001.07,DR,REF990285,CBA,Current
04-08-2025 20:52,CBA5FDFAB0E1E0646C8A393,063-000-002,33333333,BWS CBA,5.11,0,145995.96,DR,REF171834,CBA,Current
04-08-2025 21:23,CBA22931A2622C24319BA10,063-000-002,33333333,KFC CBA,77.45,0,145918.51,DR,REF307238,CBA,Current
04-08-2025 21:53,CBA884A0DB95DAE4C0BB429,063-000-002,33333333,DOMINO'S PIZZA CBA,69.92,0,145848.59,DR,REF207548,CBA,Current
04-08-2025 22:02,CBADB0405F58A6240A0AF91,063-000-002,33333333,7-ELEVEN CBA,78.44,0,145770.15,DR,REF487320,CBA,Current
04-08-2025 22:10,CBAFA39EB05D9414490BD40,063-000-002,33333333,PAYMENT GATEWAY CBA,22.45,0,145747.7,DR,REF351568,CBA,Current
04-08-2025 22:51,CBA3B653508C0BF40798E49,063-000-002,33333333,COMPANY PAYROLL CBA,0,2360.78,148108.48,CR,REF724383,CBA,Current
04-08-2025 22:54,CBACAFEFBE408424862B591,063-000-002,33333333,RAILWAY STATION CBA,10.28,0,148098.2,DR,REF389918,CBA,Current
04-08-2025 23:02,CBAC00F14AB46FB4946B563,063-000-002,33333333,PAYPAL *NETFLIX CBA,136.41,0,147961.79,DR,REF767077,CBA,Current
04-08-2025 23:16,CBA8287C775F60E411D90B1,063-000-002,33333333,COMPANY PAYROLL CBA,0,613.81,148575.6,CR,REF729051,CBA,Current
04-08-2025 23:26,CBA91BC339563544BE798F8,063-000-002,33333333,DOMINO'S PIZZA CBA,15.08,0,148560.52,DR,REF417955,CBA,Current
04-08-2025 23:27,CBA7E6C3EBAA0B3411F921C,063-000-002,33333333,BANK FEE CBA,92.65,0,148467.87,DR,REF193988,CBA,Current
04-08-2025 23:41,CBA4D1EDE0705E84BFC80B7,063-000-002,33333333,PAYPAL *NETFLIX CBA,19.14,0,148448.73,DR,REF661042,CBA,Current
04-08-2025 23:58,CBAA66CF9B724FB4E648F6A,063-000-002,33333333,BANK FEE CBA,87.82,0,148360.91,DR,REF662419,CBA,Current
05-08-2025 00:08,CBA9D645379BE3C4B2FB3CC,063-000-002,33333333,7-ELEVEN CBA,14.82,0,148346.09,DR,REF304660,CBA,Current
05-08-2025 00:10,CBA57DB7E2620E24335909C,063-000-002,33333333,SPOTIFY CBA,34.93,0,148311.16,DR,REF738947,CBA,Current
05-08-2025 00:55,INT72E1A88221A748F68F91,063-000-002,33333333,TRANSFER FROM ANZ 11111111,0,1609.54,149920.7,CR,INT-63803,CBA,Current
05-08-2025 01:00,CBA343E0DB6A54D408BBE34,063-000-002,33333333,KFC CBA,17.53,0,149903.17,DR,REF170463,CBA,Current
05-08-2025 01:09,CBAB9431C805C3246A6A5EC,063-000-002,33333333,UBER EATS CBA,53.78,0,149849.39,DR,REF307836,CBA,Current
05-08-2025 02:35,INT4A1B859C50B74A388F70,063-000-002,33333333,TRANSFER TO NAB 44444444,306.37,0,149543.02,DR,INT-76824,CBA,Current
05-08-2025 02:45,CBA741CD1E093FE4D7BA4C3,063-000-002,33333333,MENULOG CBA,8.37,0,149534.65,DR,REF157256,CBA,Current
05-08-2025 02:55,CBA6CE537B5ECD44A16ABE4,063-000-002,33333333,COLES CBA,19.74,0,149514.91,DR,REF124870,CBA,Current
05-08-2025 03:03,CBA31F328F5D404446EA9CB,063-000-002,33333333,COLES CBA,131.44,0,149383.47,DR,REF821887,CBA,Current
05-08-2025 03:08,CBA46BC5ACB11B64306A2FC,063-000-002,33333333,CITYLINK CBA,66.59,0,149316.88,DR,REF375969,CBA,Current
05-08-2025 03:17,INTC81D4808C38644BFBC64,063-000-002,33333333,TRANSFER FROM NAB 44444444,0,1100.31,150417.19,CR,INT-62432,CBA,Current
05-08-2025 03:18,CBA09688D15B5994A4A84E1,063-000-002,33333333,PAYMENT GATEWAY CBA,49.87,0,150367.32,DR,REF483300,CBA,Current
05-08-2025 03:56,CBA7E57C2176ED24968933B,063-000-002,33333333,BIGW CBA,18.33,0,150348.99,DR,REF303474,CBA,Current
05-08-2025 03:58,CBABD7CCB0918C846CBA43A,063-000-002,33333333,SPOTIFY CBA,40.02,0,150308.97,DR,REF968700,CBA,Current
05-08-2025 04:28,CBA4AF6B115391B49958DC8,063-000-002,33333333,ALDI CBA,108.62,0,150200.35,DR,REF231651,CBA,Current
05-08-2025 04:30,CBA2E8EC2F195B14B59AC95,063-000-002,33333333,BP CBA,21.06,0,150179.29,DR,REF737439,CBA,Current
05-08-2025 04:33,CBA60F4AC092C2B47AF9F3D,063-000-002,33333333,CITYLINK CBA,69.01,0,150110.28,DR,REF186488,CBA,Current
05-08-2025 04:38,CBABF38C2F1F54E4FC0B34C,063-000-002,33333333,HARVEY NORMAN CBA,47.87,0,150062.41,DR,REF537934,CBA,Current
05-08-2025 05:02,CBAB87D7A25B84542BB8E65,063-000-002,33333333,BIGW CBA,64.16,0,149998.25,DR,REF145687,CBA,Current
05-08-2025 05:36,CBA39C9686189A34FDCBAD8,063-000-002,33333333,SPOTIFY CBA,28.55,0,149969.7,DR,REF524348,CBA,Current
05-08-2025 05:50,CBA733B2C6CF6C341F6AFFD,063-000-002,33333333,APPLE CBA,70.15,0,149899.55,DR,REF867928,CBA,Current
05-08-2025 05:58,CBA78354B0DE46E46CDA0DF,063-000-002,33333333,STARBUCKS CBA,37.43,0,149862.12,DR,REF189694,CBA,Current
05-08-2025 06:33,CBADD2059F08C7B4292B0B6,063-000-002,33333333,BIGW CBA,29.51,0,149832.61,DR,REF106688,CBA,Current
05-08-2025 06:48,CBA6E6357D4EC1E47FF8960,063-000-002,33333333,WOOLWORTHS CBA,218.7,0,149613.91,DR,REF349025,CBA,Current
05-08-2025 07:13,CBA7819769C640B49119E9B,063-000-002,33333333,MENULOG CBA,32.64,0,149581.27,DR,REF671339,CBA,Current
05-08-2025 07:17,INT4D45C2FB6A9E4A8584D2,063-000-002,33333333,TRANSFER TO ANZ 11111111,954.42,0,148626.85,DR,INT-94386,CBA,Current
05-08-2025 07:45,CBAB165E88CC94844ECAE07,063-000-002,33333333,DOMINO'S PIZZA CBA,37.08,0,148589.77,DR,REF340348,CBA,Current
05-08-2025 07:57,CBA08C3D49A6EC945328772,063-000-002,33333333,AMAZON AU CBA,25.29,0,148564.48,DR,REF241015,CBA,Current
05-08-2025 07:57,INT0BC33BC187284BEB90EB,063-000-002,33333333,TRANSFER FROM NAB 44444444,0,181.87,148746.35,CR,INT-46432,CBA,Current
05-08-2025 07:58,CBAED3B4700BDB94A4E9C10,063-000-002,33333333,TAFE BOOKSHOP CBA,165.39,0,148580.96,DR,REF568435,CBA,Current
05-08-2025 08:00,CBAB03EA38E65BB4FBD9D34,063-000-002,33333333,INTERNET TRANSFER CBA,23.01,0,148557.95,DR,REF409893,CBA,Current
05-08-2025 08:11,CBAF860F4BE9C79461AB5D2,063-000-002,33333333,PAYROLL CREDIT CBA,0,5682.91,154240.86,CR,REF833512,CBA,Current
05-08-2025 08:19,INT4D085495D57E4A3284F5,063-000-002,33333333,TRANSFER FROM ANZ 11111111,0,77.73,154318.59,CR,INT-39085,CBA,Current
05-08-2025 09:08,CBAF3EDC59FB1A14EECA622,063-000-002,33333333,APPLE CBA,195.96,0,154122.63,DR,REF624805,CBA,Current
05-08-2025 09:19,CBA71DD12B4DA4F4EA08592,063-000-002,33333333,LIQUORLAND CBA,91.87,0,154030.76,DR,REF582889,CBA,Current
05-08-2025 09:43,CBAE32C3A021E4A409AB348,063-000-002,33333333,HARVEY NORMAN CBA,18.85,0,154011.91,DR,REF690123,CBA,Current
05-08-2025 10:02,CBAB7AE1D750ABF4656B0CB,063-000-002,33333333,PAYROLL CREDIT CBA,0,7302.38,161314.29,CR,REF329830,CBA,Current
05-08-2025 10:20,CBA9B3BB173487B474888DB,063-000-002,33333333,COLES CBA,42.68,0,161271.61,DR,REF663074,CBA,Current
05-08-2025 11:19,CBA88F92B63154F4BE19A85,063-000-002,33333333,WOOLWORTHS CBA,42.46,0,161229.15,DR,REF160014,CBA,Current
05-08-2025 11:20,CBABFD4FC15DF3844FCB498,063-000-002,33333333,INTERNET TRANSFER CBA,46.16,0,161182.99,DR,REF550940,CBA,Current
05-08-2025 11:31,CBA9DA1298A3C2642B9A3E7,063-000-002,33333333,BANK FEE CBA,66.09,0,161116.9,DR,REF109370,CBA,Current
05-08-2025 11:41,CBAC319BDB751AF4FD59FF1,063-000-002,33333333,STARBUCKS CBA,146.87,0,160970.03,DR,REF628880,CBA,Current
05-08-2025 11:45,CBA3129E70A0E884FDBBC7F,063-000-002,33333333,STARBUCKS CBA,23.28,0,160946.75,DR,REF432816,CBA,Current
05-08-2025 12:25,INTEB791CED75114F71A46D,063-000-002,33333333,TRANSFER TO CBA 22222222,1689.09,0,159257.66,DR,INT-81507,CBA,Current
05-08-2025 12:42,CBAFB6A12F1FD9E48AA856D,063-000-002,33333333,WAGES CREDIT CBA,0,2177.13,161434.79,CR,REF984027,CBA,Current
05-08-2025 12:55,CBA31EAFE6A272742B99600,063-000-002,33333333,AMAZON AU CBA,7,0,161427.79,DR,REF643375,CBA,Current
05-08-2025 13:00,CBA213D201B785244C09DE0,063-000-002,33333333,FLIXBUS CBA,44.78,0,161383.01,DR,REF170896,CBA,Current
05-08-2025 13:10,CBA26447E45990F4719A2BE,063-000-002,33333333,JB HI-FI CBA,17.06,0,161365.95,DR,REF251495,CBA,Current
05-08-2025 13:14,CBA3ECBAE29770E43F7A821,063-000-002,33333333,PAYPAL *NETFLIX CBA,31.02,0,161334.93,DR,REF257692,CBA,Current
05-08-2025 13:24,CBA5842A1C0339548C7BDC2,063-000-002,33333333,COLES CBA,6.99,0,161327.94,DR,REF111574,CBA,Current
05-08-2025 14:30,CBA92DE421937884B84815C,063-000-002,33333333,7-ELEVEN CBA,53.3,0,161274.64,DR,REF445949,CBA,Current
05-08-2025 14:36,CBA15858A57FD954B5F8F29,063-000-002,33333333,TAFE BOOKSHOP CBA,27.69,0,161246.95,DR,REF340123,CBA,Current
05-08-2025 14:59,CBA355771CB1CEF4A82A1C1,063-000-002,33333333,FLIXBUS CBA,54.34,0,161192.61,DR,REF185550,CBA,Current
05-08-2025 15:13,CBA227E8D57A624472CBD25,063-000-002,33333333,WAGES CREDIT CBA,0,484.16,161676.77,CR,REF156690,CBA,Current
05-08-2025 15:45,CBA3FB85F58B0414AFF99F5,063-000-002,33333333,MENULOG CBA,13.43,0,161663.34,DR,REF153822,CBA,Current
05-08-2025 16:04,CBA6508020327754C6BA316,063-000-002,33333333,PAY - SALARY CBA,0,6611.06,168274.4,CR,REF327732,CBA,Current
05-08-2025 17:48,CBA570BC9ADDFD14887A59C,063-000-002,33333333,STARBUCKS CBA,18.41,0,168255.99,DR,REF623779,CBA,Current
05-08-2025 18:06,CBAC8D9B559AE8546089CC1,063-000-002,33333333,PAYMENT GATEWAY CBA,69.67,0,168186.32,DR,REF726124,CBA,Current
05-08-2025 18:07,CBA5F7900CD393945B58C4F,063-000-002,33333333,STARBUCKS CBA,57.02,0,168129.3,DR,REF434012,CBA,Current
05-08-2025 18:12,CBA0236AF9EBA9145BBBA73,063-000-002,33333333,BIGW CBA,35.85,0,168093.45,DR,REF918339,CBA,Current
05-08-2025 18:25,CBAE58141D3F8DE4E20B2A5,063-000-002,33333333,COLES CBA,10.59,0,168082.86,DR,REF269591,CBA,Current
05-08-2025 18:54,CBABCC67B01E0964BC5A579,063-000-002,33333333,ZOOM CBA,30.16,0,168052.7,DR,REF198886,CBA,Current
05-08-2025 19:18,INT1FFFDFC3A6A74B17B043,063-000-002,33333333,TRANSFER TO CBA 22222222,1568.23,0,166484.47,DR,INT-80383,CBA,Current
05-08-2025 20:22,CBACFC3220775084ADDBE42,063-000-002,33333333,TAFE BOOKSHOP CBA,53.27,0,166431.2,DR,REF701246,CBA,Current
05-08-2025 20:25,CBA0E39466EEE1148AFAF38,063-000-002,33333333,WOOLWORTHS CBA,3.59,0,166427.61,DR,REF108562,CBA,Current
05-08-2025 20:36,CBA7B3FDE2A1C5447CD94D4,063-000-002,33333333,PAYPAL *NETFLIX CBA,86.55,0,166341.06,DR,REF641180,CBA,Current
05-08-2025 20:38,CBA92E2DCFD9987461F95CE,063-000-002,33333333,APPLE CBA,30.9,0,166310.16,DR,REF616075,CBA,Current
05-08-2025 20:47,INT5678941F295049D885A2,063-000-002,33333333,TRANSFER FROM CBA 22222222,0,474.2,166784.36,CR,INT-59790,CBA,Current
05-08-2025 21:04,CBA1801BBD600D34BE987EF,063-000-002,33333333,SPOTIFY CBA,47.13,0,166737.23,DR,REF834794,CBA,Current
05-08-2025 21:08,CBA4E2A4ACCB90D4901AD37,063-000-002,33333333,KFC CBA,4.98,0,166732.25,DR,REF195501,CBA,Current
05-08-2025 21:17,CBA92AA2A65CEF1454B9149,063-000-002,33333333,SALARY PAYMENT CBA,0,6793.74,173525.99,CR,REF579097,CBA,Current
05-08-2025 21:35,CBAD84CC45FF821445C9D85,063-000-002,33333333,UBER EATS CBA,58.82,0,173467.17,DR,REF369666,CBA,Current
05-08-2025 22:38,CBAA0C16FD41F8F478CB188,063-000-002,33333333,INTERNET TRANSFER CBA,7.98,0,173459.19,DR,REF893364,CBA,Current
05-08-2025 22:39,CBA64804C5CBC3D49DB9999,063-000-002,33333333,LIQUORLAND CBA,27.45,0,173431.74,DR,REF185109,CBA,Current
05-08-2025 23:26,CBA5D04F16C528B4A4EB514,063-000-002,33333333,COLES CBA,47.58,0,173384.16,DR,REF867303,CBA,Current
05-08-2025 23:42,CBA8FCE1B2F38B74A51A407,063-000-002,33333333,WOOLWORTHS CBA,31.17,0,173352.99,DR,REF533024,CBA,Current
05-08-2025 23:44,CBA8E4DCF36642E477A83D3,063-000-002,33333333,7-ELEVEN CBA,34.5,0,173318.49,DR,REF930003,CBA,Current
05-08-2025 23:46,CBAB944BD9D2B1A4E6DAF46,063-000-002,33333333,PAYMENT GATEWAY CBA,70.1,0,173248.39,DR,REF231893,CBA,Current
05-08-2025 23:47,CBA3445B996A5F94F2A8E42,063-000-002,33333333,MENULOG CBA,262.22,0,172986.17,DR,REF994505,CBA,Current
06-08-2025 00:42,CBA5CD9A9E0201141C6ADCC,063-000-002,33333333,ZOOM CBA,57.64,0,172928.53,DR,REF743847,CBA,Current
06-08-2025 00:44,CBA772B44B609E14BC987AD,063-000-002,33333333,TAFE BOOKSHOP CBA,11.42,0,172917.11,DR,REF769948,CBA,Current
06-08-2025 00:53,CBA6E5C9CF27CFF4CA6AC3C,063-000-002,33333333,HARVEY NORMAN CBA,4.73,0,172912.38,DR,REF725196,CBA,Current
06-08-2025 01:06,CBA25BBBF13C12944F8947C,063-000-002,33333333,WAGES CREDIT CBA,0,7555.32,180467.7,CR,REF359417,CBA,Current
06-08-2025 01:19,CBAF98ABF4D5EB64C99B6E2,063-000-002,33333333,7-ELEVEN CBA,20.66,0,180447.04,DR,REF771665,CBA,Current
06-08-2025 01:26,CBA7BD76C17657F4BBAB408,063-000-002,33333333,TAFE BOOKSHOP CBA,41.42,0,180405.62,DR,REF716930,CBA,Current
06-08-2025 01:47,CBA4E3E60E031724F589A7F,063-000-002,33333333,BWS CBA,50.08,0,180355.54,DR,REF481030,CBA,Current
06-08-2025 01:49,CBA594FCCCCD2D2444086DC,063-000-002,33333333,COLES CBA,18.03,0,180337.51,DR,REF371094,CBA,Current
06-08-2025 01:51,CBA43750FC9A68A49B19EAE,063-000-002,33333333,WOOLWORTHS CBA,95.4,0,180242.11,DR,REF468667,CBA,Current
06-08-2025 02:23,CBA2703EBA3744848B289DA,063-000-002,33333333,SHELL CBA,79.5,0,180162.61,DR,REF133122,CBA,Current
06-08-2025 02:25,CBADF16117744094A58A950,063-000-002,33333333,AMAZON AU CBA,45.8,0,180116.81,DR,REF659550,CBA,Current
06-08-2025 02:39,CBA5116E37FC1C4421B80B3,063-000-002,33333333,JB HI-FI CBA,15.23,0,180101.58,DR,REF321479,CBA,Current
06-08-2025 02:55,CBA98DC294754384CBAB85D,063-000-002,33333333,SALARY PAYMENT CBA,0,57.26,180158.84,CR,REF922150,CBA,Current
06-08-2025 03:01,CBAD7494F7E6A694564B578,063-000-002,33333333,PAYMENT GATEWAY CBA,82.67,0,180076.17,DR,REF982819,CBA,Current
06-08-2025 03:55,INT20A0639A6DE2485CB1FF,063-000-002,33333333,TRANSFER TO NAB 44444444,529.99,0,179546.18,DR,INT-35242,CBA,Current
06-08-2025 04:42,CBAF3627806BA6F493FA107,063-000-002,33333333,HARVEY NORMAN CBA,27.92,0,179518.26,DR,REF235210,CBA,Current
06-08-2025 04:43,INT597352AED15E427EAB49,063-000-002,33333333,TRANSFER FROM CBA 22222222,0,333.21,179851.47,CR,INT-20256,CBA,Current
06-08-2025 05:22,CBA074B3A5253EF4380BA62,063-000-002,33333333,DOMINO'S PIZZA CBA,25.47,0,179826,DR,REF517487,CBA,Current
06-08-2025 05:27,CBA4542F81A1B1544319BC1,063-000-002,33333333,BIGW CBA,107.82,0,179718.18,DR,REF757228,CBA,Current
06-08-2025 06:11,CBA642A0BD00EEF4140AC9F,063-000-002,33333333,AMAZON AU CBA,19.33,0,179698.85,DR,REF571042,CBA,Current
06-08-2025 06:15,CBA26F1F7803EA74025AA24,063-000-002,33333333,PAY - SALARY CBA,0,4734.52,184433.37,CR,REF560631,CBA,Current
06-08-2025 06:23,CBA729B3116DCA34A61A4AD,063-000-002,33333333,INTERNET TRANSFER CBA,57.62,0,184375.75,DR,REF762566,CBA,Current
06-08-2025 06:54,CBA03121E3ECFC241738DA8,063-000-002,33333333,LIQUORLAND CBA,33.43,0,184342.32,DR,REF270712,CBA,Current
06-08-2025 07:01,CBA71300701B8F1496180D3,063-000-002,33333333,APPLE CBA,12.95,0,184329.37,DR,REF949382,CBA,Current
06-08-2025 07:49,CBAEA83CE3F364F4E57BDBB,063-000-002,33333333,FLIXBUS CBA,52.41,0,184276.96,DR,REF448502,CBA,Current
06-08-2025 08:43,INT188313757F0F418D8FDF,063-000-002,33333333,TRANSFER FROM NAB 44444444,0,740.91,185017.87,CR,INT-57176,CBA,Current
06-08-2025 08:46,CBA54AEF182F32641F5ADB1,063-000-002,33333333,PAYROLL CREDIT CBA,0,3082.54,188100.41,CR,REF943742,CBA,Current
06-08-2025 08:47,CBA996529730A3744E990B1,063-000-002,33333333,BWS CBA,41.98,0,188058.43,DR,REF199214,CBA,Current
06-08-2025 08:55,CBAE17228468EB142808257,063-000-002,33333333,SHELL CBA,40.07,0,188018.36,DR,REF127922,CBA,Current
06-08-2025 09:13,CBA079E9A18CF8946B886C4,063-000-002,33333333,HARVEY NORMAN CBA,33.9,0,187984.46,DR,REF426208,CBA,Current
06-08-2025 09:19,CBA03724F15294945D0BEBA,063-000-002,33333333,JB HI-FI CBA,18.7,0,187965.76,DR,REF620829,CBA,Current
06-08-2025 09:50,CBAFF7C6602799A4C1A993A,063-000-002,33333333,BP CBA,55.56,0,187910.2,DR,REF954683,CBA,Current
06-08-2025 09:59,CBA640AB3B7B3EC422A9F2B,063-000-002,33333333,COMPANY PAYROLL CBA,0,229.43,188139.63,CR,REF921490,CBA,Current
06-08-2025 10:24,CBAF9A37B29027B44588A42,063-000-002,33333333,JB HI-FI CBA,38.75,0,188100.88,DR,REF398633,CBA,Current
06-08-2025 11:05,CBA142BA185D55248C0A9A8,063-000-002,33333333,DOMINO'S PIZZA CBA,45.64,0,188055.24,DR,REF186529,CBA,Current
06-08-2025 11:21,CBA677AC9C14CE744C682AE,063-000-002,33333333,TAFE BOOKSHOP CBA,31.94,0,188023.3,DR,REF122495,CBA,Current
06-08-2025 11:24,CBADCFC0B4773854027A512,063-000-002,33333333,JB HI-FI CBA,274.13,0,187749.17,DR,REF742846,CBA,Current
06-08-2025 11:36,CBAF5578983C39C44FAB2FD,063-000-002,33333333,UBER EATS CBA,50.02,0,187699.15,DR,REF357710,CBA,Current
06-08-2025 11:38,CBA731687334548472CBCA8,063-000-002,33333333,AMAZON AU CBA,20,0,187679.15,DR,REF405042,CBA,Current
06-08-2025 11:46,CBAB029841E63004B2AAF76,063-000-002,33333333,BANK FEE CBA,33.06,0,187646.09,DR,REF954911,CBA,Current
06-08-2025 11:48,CBACC2A634B9A5849EEA7B0,063-000-002,33333333,BWS CBA,18.69,0,187627.4,DR,REF202732,CBA,Current
06-08-2025 11:50,CBA5DD8599C8CD2403A9B94,063-000-002,33333333,TAFE BOOKSHOP CBA,7.17,0,187620.23,DR,REF543008,CBA,Current
06-08-2025 11:51,CBA5DF173A3E2394A9B8D8A,063-000-002,33333333,HARVEY NORMAN CBA,60.49,0,187559.74,DR,REF114856,CBA,Current
06-08-2025 11:56,CBA1FB4F03959BF488A9533,063-000-002,33333333,SPOTIFY CBA,5.15,0,187554.59,DR,REF809126,CBA,Current
06-08-2025 12:58,CBAF6C7FD26F4F441B58C09,063-000-002,33333333,WOOLWORTHS CBA,72.77,0,187481.82,DR,REF477675,CBA,Current
06-08-2025 13:07,CBA49D56C62A2424322A1A9,063-000-002,33333333,INTERNET TRANSFER CBA,30.84,0,187450.98,DR,REF171085,CBA,Current
06-08-2025 13:19,CBADA113AFE565F49EBAFFC,063-000-002,33333333,BIGW CBA,21.9,0,187429.08,DR,REF586892,CBA,Current
06-08-2025 13:30,CBA06E1F70DB1C245DD8B82,063-000-002,33333333,BWS CBA,41.51,0,187387.57,DR,REF778822,CBA,Current
06-08-2025 14:16,CBAEA955A669DA64706BB5B,063-000-002,33333333,BP CBA,26.39,0,187361.18,DR,REF596494,CBA,Current
06-08-2025 14:36,CBA655268027C6548EEA032,063-000-002,33333333,SALARY PAYMENT CBA,0,7734.66,195095.84,CR,REF329274,CBA,Current
06-08-2025 16:08,CBABAF3956A0C524A4BA9E1,063-000-002,33333333,INTERNET TRANSFER CBA,44.03,0,195051.81,DR,REF844407,CBA,Current
06-08-2025 16:44,CBAC58596F5868A4C23864D,063-000-002,33333333,DOMINO'S PIZZA CBA,75.36,0,194976.45,DR,REF985744,CBA,Current
06-08-2025 16:44,CBAB6117EA403614DE1BA5C,063-000-002,33333333,PAYMENT GATEWAY CBA,31.12,0,194945.33,DR,REF136235,CBA,Current
06-08-2025 17:21,CBA41C89E6E234342C1BEFE,063-000-002,33333333,KFC CBA,20.09,0,194925.24,DR,REF710031,CBA,Current
06-08-2025 17:29,CBAB83BDCE60D9F46FAA7A0,063-000-002,33333333,TAFE BOOKSHOP CBA,62.35,0,194862.89,DR,REF403633,CBA,Current
06-08-2025 17:53,CBA25438C5E10B24E92AEC2,063-000-002,33333333,COLES CBA,39.55,0,194823.34,DR,REF487567,CBA,Current
06-08-2025 18:52,CBA5F3150F500D34E22B948,063-000-002,33333333,PAYMENT GATEWAY CBA,33.21,0,194790.13,DR,REF446016,CBA,Current
06-08-2025 19:13,CBA9E88BC51AD874BB7B779,063-000-002,33333333,ZOOM CBA,14.68,0,194775.45,DR,REF644549,CBA,Current
06-08-2025 19:14,INT7FDB24D3F2C348BFB22C,063-000-002,33333333,TRANSFER FROM NAB 44444444,0,1352.58,196128.03,CR,INT-81564,CBA,Current
06-08-2025 19:34,CBAE9459A4608874A559973,063-000-002,33333333,7-ELEVEN CBA,44.17,0,196083.86,DR,REF330835,CBA,Current
06-08-2025 20:01,CBAC32F1A48EB764E9096F0,063-000-002,33333333,PAYPAL *NETFLIX CBA,27.25,0,196056.61,DR,REF797682,CBA,Current
06-08-2025 20:10,CBA9B09795A919F479BA94A,063-000-002,33333333,KFC CBA,98.35,0,195958.26,DR,REF295382,CBA,Current
06-08-2025 20:13,CBA21E2DB1F711842198204,063-000-002,33333333,TAFE BOOKSHOP CBA,11.84,0,195946.42,DR,REF536817,CBA,Current
06-08-2025 20:18,CBAC30F9AD3A61E41308BD5,063-000-002,33333333,SPOTIFY CBA,57.97,0,195888.45,DR,REF590552,CBA,Current
06-08-2025 20:24,CBA127C8CC9C03247C99F7C,063-000-002,33333333,KFC CBA,36.57,0,195851.88,DR,REF118836,CBA,Current
06-08-2025 20:46,CBAE6B8A0AB5367492BAFA0,063-000-002,33333333,COMPANY PAYROLL CBA,0,372.97,196224.85,CR,REF385660,CBA,Current
06-08-2025 21:14,CBA4182D72911344F038C1D,063-000-002,33333333,LIQUORLAND CBA,46.96,0,196177.89,DR,REF817126,CBA,Current
06-08-2025 21:18,CBAAFE0C0B442164D9F87B2,063-000-002,33333333,BWS CBA,36.34,0,196141.55,DR,REF688157,CBA,Current
06-08-2025 21:24,CBA952AB8A5AEB94486A727,063-000-002,33333333,CITYLINK CBA,48.37,0,196093.18,DR,REF864324,CBA,Current
06-08-2025 22:53,CBA1A9272B4330D4458B1AD,063-000-002,33333333,ZOOM CBA,30.52,0,196062.66,DR,REF270866,CBA,Current
06-08-2025 23:14,CBAEA676A543819466CB61B,063-000-002,33333333,UBER EATS CBA,49.81,0,196012.85,DR,REF242826,CBA,Current
07-08-2025 01:03,CBA19DF9A01DAE9479A9104,063-000-002,33333333,SALARY PAYMENT CBA,0,5307.71,201320.56,CR,REF374965,CBA,Current
07-08-2025 01:14,CBA89ABCBB4F78A4049B097,063-000-002,33333333,PAYROLL CREDIT CBA,0,5538.31,206858.87,CR,REF991205,CBA,Current
07-08-2025 02:00,CBAEE4277F8AB4644F8B62B,063-000-002,33333333,WOOLWORTHS CBA,76.86,0,206782.01,DR,REF662345,CBA,Current
07-08-2025 02:02,INT98D9CB662B0C409FB61A,063-000-002,33333333,TRANSFER TO NAB 44444444,1681.31,0,205100.7,DR,INT-37093,CBA,Current
07-08-2025 02:05,CBA1DB81D5122BE418C9B7B,063-000-002,33333333,APPLE CBA,149.89,0,204950.81,DR,REF203073,CBA,Current
07-08-2025 02:07,CBA61E67FC8C5ED4A48A27C,063-000-002,33333333,PAYROLL CREDIT CBA,0,2395.25,207346.06,CR,REF134235,CBA,Current
07-08-2025 02:25,CBAC8A6597AA00B41388256,063-000-002,33333333,STARBUCKS CBA,27.59,0,207318.47,DR,REF566285,CBA,Current
07-08-2025 02:32,CBA672ED09112114A25B6BE,063-000-002,33333333,HARVEY NORMAN CBA,43.39,0,207275.08,DR,REF356284,CBA,Current
07-08-2025 03:11,CBADF2A8B7A109043D18BB0,063-000-002,33333333,JB HI-FI CBA,34.15,0,207240.93,DR,REF824842,CBA,Current
07-08-2025 03:14,CBA84C5148796D949DEB03E,063-000-002,33333333,ALDI CBA,351.71,0,206889.22,DR,REF341260,CBA,Current
07-08-2025 03:34,CBA5487B4839D2841CD8326,063-000-002,33333333,AMAZON AU CBA,30.23,0,206858.99,DR,REF825383,CBA,Current
07-08-2025 03:48,INT81546CCA5B7B46FCB15F,063-000-002,33333333,TRANSFER FROM NAB 44444444,0,1103.07,207962.06,CR,INT-59586,CBA,Current
07-08-2025 03:50,CBA1BF2AEC141344AE2A0CC,063-000-002,33333333,SHELL CBA,6.68,0,207955.38,DR,REF843153,CBA,Current
07-08-2025 04:11,CBA258B7554292943AA880F,063-000-002,33333333,PAYMENT GATEWAY CBA,46.15,0,207909.23,DR,REF832836,CBA,Current
07-08-2025 04:17,CBA1FBC51BF4FBC4156A359,063-000-002,33333333,PAYROLL CREDIT CBA,0,6462.36,214371.59,CR,REF132286,CBA,Current
07-08-2025 04:20,CBAD4D7F7F7F6C7492BA3EB,063-000-002,33333333,TAFE BOOKSHOP CBA,46.38,0,214325.21,DR,REF957061,CBA,Current
07-08-2025 04:41,CBA667A6075ABEC48E6B158,063-000-002,33333333,CITYLINK CBA,57.27,0,214267.94,DR,REF784003,CBA,Current
07-08-2025 05:32,CBA134DB588AC4941219C2D,063-000-002,33333333,ALDI CBA,17.76,0,214250.18,DR,REF246013,CBA,Current
07-08-2025 05:58,CBAF382874BD17E4E199D5F,063-000-002,33333333,ZOOM CBA,14.41,0,214235.77,DR,REF864246,CBA,Current
07-08-2025 06:06,CBA7BFC7D8953AC47A9A3B8,063-000-002,33333333,INTERNET TRANSFER CBA,11.61,0,214224.16,DR,REF992561,CBA,Current
07-08-2025 06:49,CBAA72FB4C211C14EFEA086,063-000-002,33333333,SHELL CBA,59.8,0,214164.36,DR,REF772797,CBA,Current
07-08-2025 06:59,INT902329101E1F4C1097B8,063-000-002,33333333,TRANSFER FROM ANZ 11111111,0,212.39,214376.75,CR,INT-32848,CBA,Current
07-08-2025 07:15,CBA13F6D8752E5A49D19797,063-000-002,33333333,KFC CBA,45.32,0,214331.43,DR,REF865376,CBA,Current
07-08-2025 07:16,CBA8CFD2627C0674A1993CD,063-000-002,33333333,INTERNET TRANSFER CBA,11.63,0,214319.8,DR,REF857913,CBA,Current
07-08-2025 07:17,CBA0AC3BAA9F18A498780A6,063-000-002,33333333,BP CBA,26.55,0,214293.25,DR,REF396690,CBA,Current
07-08-2025 07:23,CBA99A5DCEF3CF740DF93F3,063-000-002,33333333,COLES CBA,59.04,0,214234.21,DR,REF577245,CBA,Current
07-08-2025 07:52,CBA936E71F3A61C4259A5BD,063-000-002,33333333,FLIXBUS CBA,64.83,0,214169.38,DR,REF732807,CBA,Current
07-08-2025 07:52,CBA128DE08D5FE24FF1B49F,063-000-002,33333333,7-ELEVEN CBA,84.7,0,214084.68,DR,REF144630,CBA,Current
07-08-2025 08:21,CBA695D927E6B5D4733AC9C,063-000-002,33333333,COMPANY PAYROLL CBA,0,4998.86,219083.54,CR,REF416837,CBA,Current
07-08-2025 08:28,CBA656433136D644F629C97,063-000-002,33333333,FLIXBUS CBA,10.35,0,219073.19,DR,REF294408,CBA,Current
07-08-2025 08:41,CBA9B028699DA3649ACA766,063-000-002,33333333,ALDI CBA,77.71,0,218995.48,DR,REF222526,CBA,Current
07-08-2025 09:01,CBA3B3F9ACD0B364B1F88AC,063-000-002,33333333,HARVEY NORMAN CBA,66.18,0,218929.3,DR,REF104853,CBA,Current
07-08-2025 09:14,CBA22FE2ADE8A724FAA9E82,063-000-002,33333333,CITYLINK CBA,11.75,0,218917.55,DR,REF574110,CBA,Current
07-08-2025 09:19,CBA9523331338BA4E6AAA61,063-000-002,33333333,PAYROLL CREDIT CBA,0,1945.27,220862.82,CR,REF236688,CBA,Current
07-08-2025 09:32,CBAD929CB8DFA694818BC69,063-000-002,33333333,ALDI CBA,47.19,0,220815.63,DR,REF486847,CBA,Current
07-08-2025 09:40,CBA54898A9711EE4BCF95F6,063-000-002,33333333,SALARY PAYMENT CBA,0,1734.74,222550.37,CR,REF961575,CBA,Current
07-08-2025 09:44,CBAA837FD896C484199A055,063-000-002,33333333,COMPANY PAYROLL CBA,0,888.03,223438.4,CR,REF723929,CBA,Current
07-08-2025 09:54,CBACB74F0CC5079411887CD,063-000-002,33333333,BWS CBA,79.93,0,223358.47,DR,REF297916,CBA,Current
07-08-2025 11:49,CBA09E8F96BD43A4AE8AC8A,063-000-002,33333333,BP CBA,25.52,0,223332.95,DR,REF972810,CBA,Current
07-08-2025 11:51,CBA047129B9024E4642A627,063-000-002,33333333,MCDONALDS CBA,8.97,0,223323.98,DR,REF937392,CBA,Current
07-08-2025 12:02,CBAE0DC66C7C8EE4E729DE4,063-000-002,33333333,COLES CBA,49.91,0,223274.07,DR,REF591412,CBA,Current
07-08-2025 12:08,CBA31293DEE50B54A13AC15,063-000-002,33333333,BP CBA,38.03,0,223236.04,DR,REF809233,CBA,Current
07-08-2025 12:30,CBA0570FED3CD8E433C99F3,063-000-002,33333333,7-ELEVEN CBA,87.47,0,223148.57,DR,REF128596,CBA,Current
07-08-2025 12:40,CBA7D651592210D455099A1,063-000-002,33333333,FLIXBUS CBA,90.15,0,223058.42,DR,REF235976,CBA,Current
07-08-2025 12:44,CBA437EDFC2A66745E3BA71,063-000-002,33333333,CITYLINK CBA,16.34,0,223042.08,DR,REF458896,CBA,Current
07-08-2025 12:46,INT5802D28D380C491E81C9,063-000-002,33333333,TRANSFER FROM ANZ 11111111,0,1812.46,224854.54,CR,INT-61577,CBA,Current
07-08-2025 13:02,CBA6502D8C93F50421AB7DA,063-000-002,33333333,PAY - SALARY CBA,0,6250.27,231104.81,CR,REF912229,CBA,Current
07-08-2025 13:44,CBA97E661F3E7904900929F,063-000-002,33333333,MCDONALDS CBA,43.51,0,231061.3,DR,REF284300,CBA,Current
07-08-2025 13:44,CBA1325D77995B64480A8AC,063-000-002,33333333,BANK FEE CBA,20.41,0,231040.89,DR,REF350675,CBA,Current
07-08-2025 14:04,CBA318BE08EC9E54E1B9D65,063-000-002,33333333,FLIXBUS CBA,80.72,0,230960.17,DR,REF153800,CBA,Current
07-08-2025 14:33,CBA83D1E1D029E842F5A048,063-000-002,33333333,COMPANY PAYROLL CBA,0,2674.55,233634.72,CR,REF119096,CBA,Current
07-08-2025 15:38,CBA6ECB081A959B4B00B0CC,063-000-002,33333333,LIQUORLAND CBA,40.3,0,233594.42,DR,REF502042,CBA,Current
07-08-2025 16:06,CBA9D2224C259314DA18F24,063-000-002,33333333,PAYMENT GATEWAY CBA,5.63,0,233588.79,DR,REF336991,CBA,Current
07-08-2025 16:18,CBABFEA30FA3DE348539F74,063-000-002,33333333,ALDI CBA,72.99,0,233515.8,DR,REF730736,CBA,Current
07-08-2025 16:21,CBA0CBD8BE1BE0B4D1B9F92,063-000-002,33333333,TAFE BOOKSHOP CBA,3.61,0,233512.19,DR,REF269056,CBA,Current
07-08-2025 16:36,CBAA06A9DBE4F664DF893A3,063-000-002,33333333,CITYLINK CBA,81.53,0,233430.66,DR,REF482551,CBA,Current
07-08-2025 16:56,CBA8610DAFE54D44165A84D,063-000-002,33333333,WAGES CREDIT CBA,0,4121.64,237552.3,CR,REF852863,CBA,Current
07-08-2025 17:03,CBA896CE0C85FB444739D47,063-000-002,33333333,PAY - SALARY CBA,0,7963.55,245515.85,CR,REF341409,CBA,Current
07-08-2025 17:28,CBAA412FE7F38604BCE91F4,063-000-002,33333333,SPOTIFY CBA,34.32,0,245481.53,DR,REF797358,CBA,Current
07-08-2025 17:28,CBA9D7E97E5272E4E8AB260,063-000-002,33333333,BP CBA,52.69,0,245428.84,DR,REF975030,CBA,Current
07-08-2025 17:37,CBA8DD94E5AFBDF4B4A8E3D,063-000-002,33333333,PAYROLL CREDIT CBA,0,966.86,246395.7,CR,REF786087,CBA,Current
07-08-2025 17:41,CBAC46A214A561C43D8BBFD,063-000-002,33333333,AMAZON AU CBA,111.87,0,246283.83,DR,REF435869,CBA,Current
07-08-2025 17:50,CBA57FB972F1EDD4644AFDF,063-000-002,33333333,APPLE CBA,60.29,0,246223.54,DR,REF810380,CBA,Current
07-08-2025 18:17,INT22B41BC927BE49A79E7D,063-000-002,33333333,TRANSFER FROM CBA 22222222,0,480.94,246704.48,CR,INT-14239,CBA,Current
07-08-2025 19:00,CBA3473A88DE72C4CAE97C2,063-000-002,33333333,WOOLWORTHS CBA,13.07,0,246691.41,DR,REF569552,CBA,Current
07-08-2025 19:55,CBA5380C9C6279D4E85A4E1,063-000-002,33333333,TAFE BOOKSHOP CBA,13.49,0,246677.92,DR,REF315695,CBA,Current
07-08-2025 20:23,INT595A8A43C31F4EFF90D8,063-000-002,33333333,TRANSFER TO ANZ 11111111,254.58,0,246423.34,DR,INT-78509,CBA,Current
07-08-2025 20:43,CBACF8C65D2553B448C89FC,063-000-002,33333333,SHELL CBA,10.97,0,246412.37,DR,REF749495,CBA,Current
07-08-2025 21:15,CBA8A514A4788124E9C9FC8,063-000-002,33333333,BANK FEE CBA,60.18,0,246352.19,DR,REF792491,CBA,Current
07-08-2025 21:34,CBA95B5DC8D0701424AB8E6,063-000-002,33333333,TAFE BOOKSHOP CBA,20.14,0,246332.05,DR,REF978176,CBA,Current
07-08-2025 21:47,CBADCFA5795216D4241B104,063-000-002,33333333,JB HI-FI CBA,54.06,0,246277.99,DR,REF687184,CBA,Current
07-08-2025 22:03,CBAF6AAEAE79E6B44F7B973,063-000-002,33333333,FLIXBUS CBA,67.94,0,246210.05,DR,REF189157,CBA,Current
07-08-2025 22:09,CBA725305341FE04126AAB8,063-000-002,33333333,UBER EATS CBA,5.55,0,246204.5,DR,REF644130,CBA,Current
07-08-2025 22:41,CBAD2CAB3F9172D48D49787,063-000-002,33333333,DOMINO'S PIZZA CBA,98.23,0,246106.27,DR,REF474937,CBA,Current
07-08-2025 22:51,CBA6284AC122C034FAAB425,063-000-002,33333333,AMAZON AU CBA,59.27,0,246047,DR,REF201991,CBA,Current
07-08-2025 22:52,CBA5E1C2814023F444EB734,063-000-002,33333333,RAILWAY STATION CBA,55.02,0,245991.98,DR,REF741826,CBA,Current
07-08-2025 22:55,CBA6F4477DE7308487A9594,063-000-002,33333333,COMPANY PAYROLL CBA,0,4398.5,250390.48,CR,REF140159,CBA,Current
07-08-2025 23:31,CBA0A386431567C4C81B222,063-000-002,33333333,PAYMENT GATEWAY CBA,47.45,0,250343.03,DR,REF472787,CBA,Current
07-08-2025 23:36,CBA27A6F64C59744F70B8AF,063-000-002,33333333,APPLE CBA,133.54,0,250209.49,DR,REF754254,CBA,Current
07-08-2025 23:52,CBA43403FDC145D4D878701,063-000-002,33333333,MENULOG CBA,8.07,0,250201.42,DR,REF486123,CBA,Current
08-08-2025 00:36,CBAE5ACDC5F35A44D819E35,063-000-002,33333333,SPOTIFY CBA,97.81,0,250103.61,DR,REF737304,CBA,Current
08-08-2025 00:44,CBACA5047CD7B304F3DA52C,063-000-002,33333333,JB HI-FI CBA,33.14,0,250070.47,DR,REF522971,CBA,Current
08-08-2025 00:55,CBABC9A8C82AB4B41C8BEED,063-000-002,33333333,7-ELEVEN CBA,156.46,0,249914.01,DR,REF906278,CBA,Current
08-08-2025 01:40,CBA0AA8C727800A48FBA345,063-000-002,33333333,WAGES CREDIT CBA,0,2264.43,252178.44,CR,REF505621,CBA,Current
08-08-2025 01:54,CBA09E8A9C575F24CB9A671,063-000-002,33333333,SHELL CBA,24.76,0,252153.68,DR,REF253587,CBA,Current
08-08-2025 01:58,CBA36A6B1956EAF434B97E3,063-000-002,33333333,STARBUCKS CBA,16.06,0,252137.62,DR,REF592470,CBA,Current
08-08-2025 02:33,INT7AABD20B01CF4A4ABD22,063-000-002,33333333,TRANSFER FROM ANZ 11111111,0,999.09,253136.71,CR,INT-37816,CBA,Current
08-08-2025 02:33,CBAB563F9F0966948808AF6,063-000-002,33333333,SHELL CBA,21.19,0,253115.52,DR,REF105538,CBA,Current
08-08-2025 03:09,CBA5D3BE486200840CFB4F0,063-000-002,33333333,BIGW CBA,19.24,0,253096.28,DR,REF585359,CBA,Current
08-08-2025 03:12,INT33D2F5B6D7954353BC38,063-000-002,33333333,TRANSFER TO ANZ 11111111,1973.38,0,251122.9,DR,INT-30984,CBA,Current
08-08-2025 03:32,CBA30142E70420448BC89A6,063-000-002,33333333,JB HI-FI CBA,32.82,0,251090.08,DR,REF676203,CBA,Current
08-08-2025 04:07,CBAEE49B993A5BD48B5BCAA,063-000-002,33333333,MENULOG CBA,89.16,0,251000.92,DR,REF341569,CBA,Current
08-08-2025 04:20,CBA96B23CC8FDBE4C4585A7,063-000-002,33333333,UBER EATS CBA,98.26,0,250902.66,DR,REF385138,CBA,Current
08-08-2025 04:30,CBAD3E64FE3B28D4731BA1B,063-000-002,33333333,APPLE CBA,22.97,0,250879.69,DR,REF109461,CBA,Current
08-08-2025 04:44,CBA746FC03BBC8B472CBAFC,063-000-002,33333333,SHELL CBA,17.46,0,250862.23,DR,REF908217,CBA,Current
08-08-2025 05:00,CBA3BD67C4596634587BE38,063-000-002,33333333,FLIXBUS CBA,27.44,0,250834.79,DR,REF633058,CBA,Current
08-08-2025 05:13,CBA70BE450DDDA54CFAB7EC,063-000-002,33333333,PAYMENT GATEWAY CBA,75.19,0,250759.6,DR,REF283003,CBA,Current
08-08-2025 05:13,CBAA93658A4C3864E57A7FF,063-000-002,33333333,BANK FEE CBA,31.04,0,250728.56,DR,REF449739,CBA,Current
08-08-2025 05:28,CBA888B53AB98AA4497980B,063-000-002,33333333,WOOLWORTHS CBA,41.4,0,250687.16,DR,REF540081,CBA,Current
08-08-2025 05:53,CBAA0A7218F1ACA4172BEC3,063-000-002,33333333,BIGW CBA,18.29,0,250668.87,DR,REF830475,CBA,Current
08-08-2025 06:13,CBA2524FA36A18747978894,063-000-002,33333333,LIQUORLAND CBA,48.3,0,250620.57,DR,REF406881,CBA,Current
08-08-2025 06:45,CBA3C6C62B888A74017BAC5,063-000-002,33333333,MENULOG CBA,36.29,0,250584.28,DR,REF256155,CBA,Current
08-08-2025 06:56,INT696BE5143BE3476B842F,063-000-002,33333333,TRANSFER FROM CBA 22222222,0,988.67,251572.95,CR,INT-26013,CBA,Current
08-08-2025 07:06,CBA99387A71517D4C368B42,063-000-002,33333333,AMAZON AU CBA,32.37,0,251540.58,DR,REF703180,CBA,Current
08-08-2025 07:46,CBAB0C52865D9634A338F7D,063-000-002,33333333,SHELL CBA,120.77,0,251419.81,DR,REF473347,CBA,Current
08-08-2025 08:01,CBA99B5EB9528BE49EB9CED,063-000-002,33333333,MENULOG CBA,42.83,0,251376.98,DR,REF973955,CBA,Current
08-08-2025 08:22,CBA9D6093DBD6ED4576B12D,063-000-002,33333333,INTERNET TRANSFER CBA,3.76,0,251373.22,DR,REF750898,CBA,Current
08-08-2025 08:26,CBAC005C134F0E54338AC8F,063-000-002,33333333,APPLE CBA,60.09,0,251313.13,DR,REF661111,CBA,Current
08-08-2025 08:41,CBAC4140DF8396F4F9899FC,063-000-002,33333333,DOMINO'S PIZZA CBA,17.3,0,251295.83,DR,REF524973,CBA,Current
08-08-2025 09:14,CBAFFA82AA32A924EAD84F8,063-000-002,33333333,WAGES CREDIT CBA,0,608.18,251904.01,CR,REF928156,CBA,Current
08-08-2025 09:14,INTED5A67C3D6EB4148A8FC,063-000-002,33333333,TRANSFER FROM CBA 22222222,0,1736.28,253640.29,CR,INT-41250,CBA,Current
08-08-2025 09:23,CBAE17DBEDF511741FC8F00,063-000-002,33333333,MENULOG CBA,68.27,0,253572.02,DR,REF232303,CBA,Current
08-08-2025 09:27,CBA8F88BD0D27394027B348,063-000-002,33333333,FLIXBUS CBA,70.29,0,253501.73,DR,REF163291,CBA,Current
08-08-2025 10:16,CBA6F979B93BFD44BF9A637,063-000-002,33333333,LIQUORLAND CBA,66.85,0,253434.88,DR,REF490124,CBA,Current
08-08-2025 10:40,CBA09CD81E1E68549B49137,063-000-002,33333333,PAYPAL *NETFLIX CBA,3.19,0,253431.69,DR,REF490851,CBA,Current
08-08-2025 10:50,CBA77AB9080A7F84D529C6B,063-000-002,33333333,SALARY PAYMENT CBA,0,5732.63,259164.32,CR,REF902987,CBA,Current
08-08-2025 11:00,CBACAE68828D5144692939C,063-000-002,33333333,TAFE BOOKSHOP CBA,42.03,0,259122.29,DR,REF889569,CBA,Current
08-08-2025 11:17,CBA44E710016FF146FE9914,063-000-002,33333333,ALDI CBA,12.38,0,259109.91,DR,REF920600,CBA,Current
08-08-2025 11:46,CBADD65AC21F042474EA0D2,063-000-002,33333333,PAY - SALARY CBA,0,1881.42,260991.33,CR,REF417002,CBA,Current
08-08-2025 11:57,CBA6CA8EF6B05474EFF9B98,063-000-002,33333333,PAY - SALARY CBA,0,2931.34,263922.67,CR,REF372996,CBA,Current
08-08-2025 12:43,CBAB9BC7DCEF8664661B2A6,063-000-002,33333333,MENULOG CBA,43.49,0,263879.18,DR,REF916482,CBA,Current
08-08-2025 12:52,CBAAB8FEA5A48AD42199703,063-000-002,33333333,COLES CBA,169.51,0,263709.67,DR,REF666707,CBA,Current
08-08-2025 12:59,CBAFF72DC437D724B829C73,063-000-002,33333333,SALARY PAYMENT CBA,0,7432.53,271142.2,CR,REF416803,CBA,Current
08-08-2025 13:00,CBA016A06EBD213422E84BA,063-000-002,33333333,PAYMENT GATEWAY CBA,32.8,0,271109.4,DR,REF136881,CBA,Current
08-08-2025 13:02,CBA14956F544186480D9AFF,063-000-002,33333333,BANK FEE CBA,4.3,0,271105.1,DR,REF801913,CBA,Current
08-08-2025 13:07,CBADB15E20FC06943CF8C32,063-000-002,33333333,APPLE CBA,61.64,0,271043.46,DR,REF213363,CBA,Current
08-08-2025 13:11,CBA15214ADE6D2A486B866A,063-000-002,33333333,APPLE CBA,23.41,0,271020.05,DR,REF583022,CBA,Current
08-08-2025 13:18,CBA2FAB2C8BCB5C4B50B8DF,063-000-002,33333333,BANK FEE CBA,50.97,0,270969.08,DR,REF908961,CBA,Current
08-08-2025 13:19,CBA86374569691C48F69CA7,063-000-002,33333333,COMPANY PAYROLL CBA,0,3277.94,274247.02,CR,REF605091,CBA,Current
08-08-2025 13:32,CBAF6A46745163E4762AA26,063-000-002,33333333,PAY - SALARY CBA,0,6896.21,281143.23,CR,REF353081,CBA,Current
08-08-2025 13:50,CBA3E8BC923B3444932864C,063-000-002,33333333,LIQUORLAND CBA,100.75,0,281042.48,DR,REF493758,CBA,Current
08-08-2025 14:04,CBA1C850BC6D0E5420DAE6C,063-000-002,33333333,WAGES CREDIT CBA,0,6890.97,287933.45,CR,REF814928,CBA,Current
08-08-2025 14:10,CBAC579A7CCF00A434D8F23,063-000-002,33333333,WOOLWORTHS CBA,210.79,0,287722.66,DR,REF414896,CBA,Current
08-08-2025 14:11,CBA936173FB9B86406C9D2D,063-000-002,33333333,MENULOG CBA,6.68,0,287715.98,DR,REF765943,CBA,Current
08-08-2025 14:16,CBA03FA95B9A85E45B393C8,063-000-002,33333333,INTERNET TRANSFER CBA,6.31,0,287709.67,DR,REF152106,CBA,Current
08-08-2025 14:21,CBAB18674BB0B7F48508A16,063-000-002,33333333,KFC CBA,4.95,0,287704.72,DR,REF587909,CBA,Current
08-08-2025 14:46,CBA8741C0C4CF8B44AF936C,063-000-002,33333333,PAYPAL *NETFLIX CBA,8,0,287696.72,DR,REF509421,CBA,Current
08-08-2025 14:58,CBA9ECD653191EE449FBF51,063-000-002,33333333,WOOLWORTHS CBA,15.39,0,287681.33,DR,REF979313,CBA,Current
08-08-2025 15:19,INTD207834351144B74A9F8,063-000-002,33333333,TRANSFER FROM CBA 22222222,0,1339.3,289020.63,CR,INT-51249,CBA,Current
08-08-2025 15:25,CBA9E4BB02004BB491CBA0A,063-000-002,33333333,SALARY PAYMENT CBA,0,782.84,289803.47,CR,REF363922,CBA,Current
08-08-2025 15:34,CBA4811DA11490E47F28F07,063-000-002,33333333,COMPANY PAYROLL CBA,0,2770.22,292573.69,CR,REF474849,CBA,Current
08-08-2025 15:44,INT1D59FBDDEE664D5CB44B,063-000-002,33333333,TRANSFER TO ANZ 11111111,1771,0,290802.69,DR,INT-67996,CBA,Current
08-08-2025 16:14,CBAC34232BB4D884C559C0F,063-000-002,33333333,SHELL CBA,48.41,0,290754.28,DR,REF638954,CBA,Current
08-08-2025 16:17,INT5ADDC196E2E2421BAE87,063-000-002,33333333,TRANSFER TO CBA 22222222,866.64,0,289887.64,DR,INT-84190,CBA,Current
08-08-2025 16:22,CBA9A6B6010D6AA43109040,063-000-002,33333333,MCDONALDS CBA,178.27,0,289709.37,DR,REF168849,CBA,Current
08-08-2025 17:31,CBAD99D775D46D54B9E8EA7,063-000-002,33333333,TAFE BOOKSHOP CBA,42.83,0,289666.54,DR,REF646206,CBA,Current
08-08-2025 17:43,CBA92706CE55E3A4D1CBD1F,063-000-002,33333333,FLIXBUS CBA,9.63,0,289656.91,DR,REF520251,CBA,Current
08-08-2025 18:08,CBAF4B5CEE93FCA453E94BC,063-000-002,33333333,7-ELEVEN CBA,92.23,0,289564.68,DR,REF566554,CBA,Current
08-08-2025 18:20,CBA8221A4750DD04A838383,063-000-002,33333333,STARBUCKS CBA,29.58,0,289535.1,DR,REF347150,CBA,Current
08-08-2025 18:21,CBA8C36762AE3E94E2FAB06,063-000-002,33333333,AMAZON AU CBA,29.95,0,289505.15,DR,REF693306,CBA,Current
08-08-2025 18:51,CBA53B5FAEE567143E7AA25,063-000-002,33333333,RAILWAY STATION CBA,47.58,0,289457.57,DR,REF680677,CBA,Current
08-08-2025 19:20,CBA1A58A8086C7E4F7AA05C,063-000-002,33333333,PAYROLL CREDIT CBA,0,2857.78,292315.35,CR,REF573848,CBA,Current
08-08-2025 19:20,CBA5EA375A2EDA24F5AA399,063-000-002,33333333,PAYMENT GATEWAY CBA,6.13,0,292309.22,DR,REF718012,CBA,Current
08-08-2025 20:28,CBA656F4A27648C4E5EA00E,063-000-002,33333333,COLES CBA,20.19,0,292289.03,DR,REF934642,CBA,Current
08-08-2025 21:11,CBA8089B7B2243747699EF2,063-000-002,33333333,PAYMENT GATEWAY CBA,50.35,0,292238.68,DR,REF475189,CBA,Current
08-08-2025 21:19,CBA948D628995E64E46A4C9,063-000-002,33333333,CITYLINK CBA,4.44,0,292234.24,DR,REF666871,CBA,Current
08-08-2025 22:03,CBAD04FA645E2804D41AC0D,063-000-002,33333333,BP CBA,33.97,0,292200.27,DR,REF435539,CBA,Current
08-08-2025 22:07,CBAB9BED18CB50A4FB89EBA,063-000-002,33333333,BIGW CBA,74.91,0,292125.36,DR,REF719454,CBA,Current
08-08-2025 22:51,CBA5B2E6598816542139372,063-000-002,33333333,COLES CBA,12.81,0,292112.55,DR,REF964842,CBA,Current
08-08-2025 22:52,CBA33AE3971E5A74163B9BF,063-000-002,33333333,COLES CBA,12.75,0,292099.8,DR,REF920095,CBA,Current
08-08-2025 22:53,CBA93E6B9800C254965B24C,063-000-002,33333333,PAYMENT GATEWAY CBA,214.31,0,291885.49,DR,REF996763,CBA,Current
08-08-2025 23:08,CBA6297CFD2F666456DBE10,063-000-002,33333333,WAGES CREDIT CBA,0,636.2,292521.69,CR,REF486292,CBA,Current
08-08-2025 23:15,CBA7BC2987C424C453C9BDB,063-000-002,33333333,SHELL CBA,54.55,0,292467.14,DR,REF740099,CBA,Current
08-08-2025 23:34,CBAB84D38DB09514E0A99B4,063-000-002,33333333,PAYPAL *NETFLIX CBA,105.42,0,292361.72,DR,REF874381,CBA,Current
08-08-2025 23:46,CBA115451FB69C3429880D2,063-000-002,33333333,AMAZON AU CBA,30.8,0,292330.92,DR,REF850741,CBA,Current
09-08-2025 00:36,CBADF7C89AFBFC147B48285,063-000-002,33333333,BP CBA,26.82,0,292304.1,DR,REF372974,CBA,Current
09-08-2025 01:12,CBACB1EFC6F493C468DB177,063-000-002,33333333,INTERNET TRANSFER CBA,34.31,0,292269.79,DR,REF474561,CBA,Current
09-08-2025 01:26,CBA1BBCCD6475F14A62A38F,063-000-002,33333333,STARBUCKS CBA,30.79,0,292239,DR,REF628072,CBA,Current
09-08-2025 01:36,CBADBF09F2B151D4BE0A8DF,063-000-002,33333333,WAGES CREDIT CBA,0,896.76,293135.76,CR,REF764043,CBA,Current
09-08-2025 01:43,CBAC1CE99674F044FBE9C18,063-000-002,33333333,WAGES CREDIT CBA,0,1951.39,295087.15,CR,REF417517,CBA,Current
09-08-2025 01:54,CBA307F9C82B9504DCF8E53,063-000-002,33333333,STARBUCKS CBA,191.08,0,294896.07,DR,REF272303,CBA,Current
09-08-2025 02:10,CBAE7DAFCFED0C248DD82A2,063-000-002,33333333,APPLE CBA,71.87,0,294824.2,DR,REF263439,CBA,Current
09-08-2025 02:12,CBA9213D07C6A8B41028325,063-000-002,33333333,7-ELEVEN CBA,71.36,0,294752.84,DR,REF679533,CBA,Current
09-08-2025 02:26,CBAFA94CAECF2E040A9AE0F,063-000-002,33333333,AMAZON AU CBA,81.61,0,294671.23,DR,REF933930,CBA,Current
09-08-2025 02:28,CBA52D3D1835516456BAA75,063-000-002,33333333,PAYMENT GATEWAY CBA,31.93,0,294639.3,DR,REF893205,CBA,Current
09-08-2025 02:35,CBAC74774EE7087493FAAB0,063-000-002,33333333,WAGES CREDIT CBA,0,3052.29,297691.59,CR,REF413371,CBA,Current
09-08-2025 02:39,CBA1073EE33515044CFA490,063-000-002,33333333,7-ELEVEN CBA,10.66,0,297680.93,DR,REF748772,CBA,Current
09-08-2025 03:27,CBAC4C8B1064CA7497F9A81,063-000-002,33333333,JB HI-FI CBA,44.27,0,297636.66,DR,REF867514,CBA,Current
09-08-2025 03:51,CBA22B64D87838848D09348,063-000-002,33333333,JB HI-FI CBA,9.08,0,297627.58,DR,REF830898,CBA,Current
09-08-2025 04:35,CBACF1F46485F9947F1AE64,063-000-002,33333333,AMAZON AU CBA,4.93,0,297622.65,DR,REF520466,CBA,Current
09-08-2025 04:39,CBAE1A39E39A4A8489691E1,063-000-002,33333333,FLIXBUS CBA,4.14,0,297618.51,DR,REF504311,CBA,Current
09-08-2025 05:18,CBA662E775A0DC74B7BBDA5,063-000-002,33333333,MENULOG CBA,20.17,0,297598.34,DR,REF979773,CBA,Current
09-08-2025 05:55,CBA932189111F734246A69C,063-000-002,33333333,COLES CBA,24.52,0,297573.82,DR,REF551196,CBA,Current
09-08-2025 06:36,CBAEE27C5388CB54ECDB97F,063-000-002,33333333,MCDONALDS CBA,6.27,0,297567.55,DR,REF287737,CBA,Current
09-08-2025 06:42,CBAFB68A123448048AC81C9,063-000-002,33333333,SPOTIFY CBA,28.16,0,297539.39,DR,REF780568,CBA,Current
09-08-2025 07:00,CBA9FA28F4EDF0340CF9F07,063-000-002,33333333,WAGES CREDIT CBA,0,779.13,298318.52,CR,REF583996,CBA,Current
09-08-2025 07:29,CBA9EBA1D92FC01459E9258,063-000-002,33333333,ZOOM CBA,55.79,0,298262.73,DR,REF413662,CBA,Current
09-08-2025 07:29,CBAF44570B2365D42D494D5,063-000-002,33333333,RAILWAY STATION CBA,200.9,0,298061.83,DR,REF286905,CBA,Current
09-08-2025 07:31,CBAB73E0CB056A84F8DA805,063-000-002,33333333,SHELL CBA,14.61,0,298047.22,DR,REF388159,CBA,Current
09-08-2025 07:57,CBA45362BAE072A4574AD51,063-000-002,33333333,SALARY PAYMENT CBA,0,3122.83,301170.05,CR,REF481577,CBA,Current
09-08-2025 08:03,CBA589A84D676D64B9EB0F7,063-000-002,33333333,PAYMENT GATEWAY CBA,22.35,0,301147.7,DR,REF557826,CBA,Current
09-08-2025 08:17,CBAE3AA66FEDECC4F3DB840,063-000-002,33333333,CITYLINK CBA,71.47,0,301076.23,DR,REF381275,CBA,Current
09-08-2025 08:42,CBAC07CC277B47A4B0D838F,063-000-002,33333333,MENULOG CBA,168.49,0,300907.74,DR,REF352383,CBA,Current
09-08-2025 09:03,CBA19F2BF003FC645EBBF39,063-000-002,33333333,COLES CBA,44.31,0,300863.43,DR,REF646574,CBA,Current
09-08-2025 09:14,CBA4FFAB5F88B5B4BC7AF41,063-000-002,33333333,BP CBA,3.99,0,300859.44,DR,REF242284,CBA,Current
09-08-2025 09:18,CBA8C3ABCAFDFBC4228B847,063-000-002,33333333,ZOOM CBA,19.57,0,300839.87,DR,REF194148,CBA,Current
09-08-2025 09:20,CBA6B1391575CEE4D168433,063-000-002,33333333,AMAZON AU CBA,13.31,0,300826.56,DR,REF775775,CBA,Current
09-08-2025 09:58,INTA887A5650BD549D79703,063-000-002,33333333,TRANSFER TO ANZ 11111111,1554.36,0,299272.2,DR,INT-92615,CBA,Current
09-08-2025 10:06,CBA0F0DAB5E54BF447E8801,063-000-002,33333333,PAYMENT GATEWAY CBA,103.89,0,299168.31,DR,REF128580,CBA,Current
09-08-2025 10:42,CBA6E4CEF2F26724BDBA16B,063-000-002,33333333,DOMINO'S PIZZA CBA,16.23,0,299152.08,DR,REF528569,CBA,Current
09-08-2025 11:52,CBA7FA6A37E1B9B463E970D,063-000-002,33333333,DOMINO'S PIZZA CBA,3.68,0,299148.4,DR,REF597307,CBA,Current
09-08-2025 11:55,CBA24E0035439B74DE4A623,063-000-002,33333333,WAGES CREDIT CBA,0,4240.03,303388.43,CR,REF856911,CBA,Current
09-08-2025 12:05,CBA0BC1816E6E0F4C9B83DA,063-000-002,33333333,COMPANY PAYROLL CBA,0,6011.51,309399.94,CR,REF908757,CBA,Current
09-08-2025 12:42,CBA74CBEE7AFC3540D29C85,063-000-002,33333333,MENULOG CBA,113.21,0,309286.73,DR,REF510701,CBA,Current
09-08-2025 12:52,INTDFAA2DD6F11847FD8E9F,063-000-002,33333333,TRANSFER TO ANZ 11111111,1046.68,0,308240.05,DR,INT-39710,CBA,Current
09-08-2025 12:59,CBA1BF45BA12D0D439AB781,063-000-002,33333333,CITYLINK CBA,65.72,0,308174.33,DR,REF173118,CBA,Current
09-08-2025 13:33,CBA76622CB4B87941A882CE,063-000-002,33333333,APPLE CBA,68.26,0,308106.07,DR,REF770963,CBA,Current
09-08-2025 14:16,CBAC07CD474922548D09050,063-000-002,33333333,PAYROLL CREDIT CBA,0,2812.18,310918.25,CR,REF607388,CBA,Current
09-08-2025 14:33,CBABBB781C358E54DEC8B94,063-000-002,33333333,WOOLWORTHS CBA,67.69,0,310850.56,DR,REF655494,CBA,Current
09-08-2025 15:19,CBAAAD15735CC684130A982,063-000-002,33333333,BP CBA,60.35,0,310790.21,DR,REF646759,CBA,Current
09-08-2025 15:22,CBAAC6A2246334740DCAEB8,063-000-002,33333333,COLES CBA,162.86,0,310627.35,DR,REF495577,CBA,Current
09-08-2025 15:40,CBA259D9E8C785F4599947C,063-000-002,33333333,RAILWAY STATION CBA,52.24,0,310575.11,DR,REF538883,CBA,Current
09-08-2025 15:59,CBA4A357212CA09416C8782,063-000-002,33333333,SHELL CBA,24.15,0,310550.96,DR,REF791729,CBA,Current
09-08-2025 16:08,CBACAEAFBAA9D73442FB304,063-000-002,33333333,MCDONALDS CBA,69.53,0,310481.43,DR,REF448253,CBA,Current
09-08-2025 16:13,CBA9CE02A819F1B43889DF3,063-000-002,33333333,COMPANY PAYROLL CBA,0,3335.93,313817.36,CR,REF554968,CBA,Current
09-08-2025 16:17,CBA215E3F7A069C479EA7B2,063-000-002,33333333,ZOOM CBA,36.14,0,313781.22,DR,REF884268,CBA,Current
09-08-2025 16:37,CBAEB83E13C47214D5F8A59,063-000-002,33333333,KFC CBA,20.54,0,313760.68,DR,REF438953,CBA,Current
09-08-2025 16:48,CBADC14036B2C7D48EAA126,063-000-002,33333333,INTERNET TRANSFER CBA,72.36,0,313688.32,DR,REF455549,CBA,Current
09-08-2025 16:58,CBA97B4D5B82BA648DD8CEE,063-000-002,33333333,BANK FEE CBA,73.57,0,313614.75,DR,REF806836,CBA,Current
09-08-2025 17:59,CBA4C940CE3EEF84F4391D6,063-000-002,33333333,SHELL CBA,35.11,0,313579.64,DR,REF894930,CBA,Current
09-08-2025 18:29,CBAEA95BD377485437A8A52,063-000-002,33333333,HARVEY NORMAN CBA,10.9,0,313568.74,DR,REF666269,CBA,Current
09-08-2025 20:07,CBA4E672008405B42349C50,063-000-002,33333333,PAYROLL CREDIT CBA,0,4041.61,317610.35,CR,REF404865,CBA,Current
09-08-2025 20:44,CBACDB1195E522840A2B943,063-000-002,33333333,SPOTIFY CBA,32.81,0,317577.54,DR,REF951688,CBA,Current
09-08-2025 20:56,CBA55AF3675E04748C686CB,063-000-002,33333333,KFC CBA,82.77,0,317494.77,DR,REF254387,CBA,Current
09-08-2025 20:59,INT0110D5933F1643CFAB38,063-000-002,33333333,TRANSFER TO CBA 22222222,276.27,0,317218.5,DR,INT-31679,CBA,Current
09-08-2025 21:55,CBA9137E29C17534A52A56B,063-000-002,33333333,AMAZON AU CBA,137.7,0,317080.8,DR,REF275494,CBA,Current
09-08-2025 22:14,INTF844AF45EFA241D68FC2,063-000-002,33333333,TRANSFER TO NAB 44444444,1594.98,0,315485.82,DR,INT-86622,CBA,Current
09-08-2025 23:05,CBA33435F11790748CBB928,063-000-002,33333333,PAYMENT GATEWAY CBA,11.67,0,315474.15,DR,REF728071,CBA,Current
09-08-2025 23:18,CBA5F41B4B920B340059CF3,063-000-002,33333333,SPOTIFY CBA,11.58,0,315462.57,DR,REF483496,CBA,Current
09-08-2025 23:20,CBA5861D3B42471406B8F64,063-000-002,33333333,WAGES CREDIT CBA,0,989.31,316451.88,CR,REF155533,CBA,Current
09-08-2025 23:57,CBACA24C8460A2348C291B2,063-000-002,33333333,PAYROLL CREDIT CBA,0,4452.69,320904.57,CR,REF722132,CBA,Current
10-08-2025 00:05,CBA6573AAE4EFB747D98EE4,063-000-002,33333333,STARBUCKS CBA,96.1,0,320808.47,DR,REF616234,CBA,Current
10-08-2025 00:13,CBA6C61E7258D1D4220B657,063-000-002,33333333,BP CBA,71.7,0,320736.77,DR,REF556439,CBA,Current
10-08-2025 00:31,CBA33951C216FB94D54B9B9,063-000-002,33333333,LIQUORLAND CBA,36.24,0,320700.53,DR,REF435339,CBA,Current
10-08-2025 00:45,CBAA747EB313F62435A9CE5,063-000-002,33333333,STARBUCKS CBA,37.23,0,320663.3,DR,REF425695,CBA,Current
10-08-2025 00:50,CBA12796DF750C54EDABFF3,063-000-002,33333333,COLES CBA,54.66,0,320608.64,DR,REF743172,CBA,Current
10-08-2025 01:24,CBA4318B8591CA141429179,063-000-002,33333333,TAFE BOOKSHOP CBA,7.35,0,320601.29,DR,REF764695,CBA,Current
10-08-2025 03:24,CBAB46816BF4C654D9B8514,063-000-002,33333333,WAGES CREDIT CBA,0,6185.57,326786.86,CR,REF606746,CBA,Current
10-08-2025 03:29,INTA46F6BB1B23C4EB3883A,063-000-002,33333333,TRANSFER TO ANZ 11111111,1272.41,0,325514.45,DR,INT-76632,CBA,Current
10-08-2025 03:40,CBA492E02FE20604B779199,063-000-002,33333333,FLIXBUS CBA,65.21,0,325449.24,DR,REF141748,CBA,Current
10-08-2025 03:55,CBA0938E877F6E845CC8A29,063-000-002,33333333,PAYPAL *NETFLIX CBA,42.71,0,325406.53,DR,REF943209,CBA,Current
10-08-2025 04:05,CBAC61855CC788F4B41AB2D,063-000-002,33333333,ALDI CBA,20.04,0,325386.49,DR,REF386786,CBA,Current
10-08-2025 04:42,CBA09B63F62788C43B598EA,063-000-002,33333333,SPOTIFY CBA,37.21,0,325349.28,DR,REF534429,CBA,Current
10-08-2025 05:01,CBA4749B8F9F7F14BE180CA,063-000-002,33333333,APPLE CBA,49.21,0,325300.07,DR,REF455873,CBA,Current
10-08-2025 05:14,CBA8D9E8CDF476D495587BE,063-000-002,33333333,UBER EATS CBA,8.12,0,325291.95,DR,REF971572,CBA,Current
10-08-2025 05:15,CBA1436EAB6AEB64A659EE1,063-000-002,33333333,UBER EATS CBA,17.01,0,325274.94,DR,REF492461,CBA,Current
10-08-2025 05:22,INT339DD81F08FE4B97B188,063-000-002,33333333,TRANSFER TO NAB 44444444,942.78,0,324332.16,DR,INT-72919,CBA,Current
10-08-2025 05:32,CBAC32CB88356EC48DFBE40,063-000-002,33333333,BP CBA,40.09,0,324292.07,DR,REF395250,CBA,Current
10-08-2025 05:37,CBA76B753230BF041EB9832,063-000-002,33333333,INTERNET TRANSFER CBA,188.05,0,324104.02,DR,REF441590,CBA,Current
10-08-2025 05:41,CBAD13DB1D45F6747519FE4,063-000-002,33333333,TAFE BOOKSHOP CBA,37.03,0,324066.99,DR,REF258821,CBA,Current
10-08-2025 06:39,CBAEDA30D76ECDE4B74B9F2,063-000-002,33333333,CITYLINK CBA,118.34,0,323948.65,DR,REF388226,CBA,Current
10-08-2025 06:49,CBABDA1FA6B88D240EA9EC1,063-000-002,33333333,DOMINO'S PIZZA CBA,58.74,0,323889.91,DR,REF897606,CBA,Current
10-08-2025 06:55,CBAFA566216B926468EA6B1,063-000-002,33333333,PAYPAL *NETFLIX CBA,13.45,0,323876.46,DR,REF574129,CBA,Current
10-08-2025 07:08,CBADFD1E5EB4D994592AA33,063-000-002,33333333,PAYROLL CREDIT CBA,0,998.2,324874.66,CR,REF609605,CBA,Current
10-08-2025 07:13,CBA6F9F09DD191640A7AAF7,063-000-002,33333333,LIQUORLAND CBA,3.76,0,324870.9,DR,REF462336,CBA,Current
10-08-2025 07:15,CBA8F95CDB2C4414DF6876B,063-000-002,33333333,PAYPAL *NETFLIX CBA,47.25,0,324823.65,DR,REF731931,CBA,Current
10-08-2025 07:19,CBA815B9A7664504E8CA655,063-000-002,33333333,TAFE BOOKSHOP CBA,29.98,0,324793.67,DR,REF785231,CBA,Current
10-08-2025 08:05,CBA1AF4FDE86A444E17876A,063-000-002,33333333,LIQUORLAND CBA,33.4,0,324760.27,DR,REF997236,CBA,Current
10-08-2025 08:41,CBA0EDFBE6900EA46468A61,063-000-002,33333333,JB HI-FI CBA,16.02,0,324744.25,DR,REF992000,CBA,Current
10-08-2025 09:30,CBAAEC06DA334A940C0B447,063-000-002,33333333,JB HI-FI CBA,45.9,0,324698.35,DR,REF714147,CBA,Current
10-08-2025 09:46,CBA27E04007D3BD4B8C819D,063-000-002,33333333,PAYROLL CREDIT CBA,0,7140.85,331839.2,CR,REF877799,CBA,Current
10-08-2025 09:59,CBAC23626A7B2134B0B8EC8,063-000-002,33333333,APPLE CBA,14.65,0,331824.55,DR,REF861088,CBA,Current
10-08-2025 10:02,CBA8AB8996791B7429EB03F,063-000-002,33333333,CITYLINK CBA,33.14,0,331791.41,DR,REF269879,CBA,Current
10-08-2025 10:37,CBA322E12D8B94D41428790,063-000-002,33333333,KFC CBA,7.06,0,331784.35,DR,REF573684,CBA,Current
10-08-2025 11:30,CBA8B4119A2D8A54979924C,063-000-002,33333333,SHELL CBA,24.02,0,331760.33,DR,REF911945,CBA,Current
10-08-2025 11:35,CBA680CA4C786B142B9A7C1,063-000-002,33333333,STARBUCKS CBA,17.82,0,331742.51,DR,REF831409,CBA,Current
10-08-2025 11:52,CBAA1B0CACC286A4AA39DE3,063-000-002,33333333,MENULOG CBA,34.75,0,331707.76,DR,REF343910,CBA,Current
10-08-2025 12:39,CBA56D836AF42B64257A0D1,063-000-002,33333333,PAYMENT GATEWAY CBA,108.35,0,331599.41,DR,REF450566,CBA,Current
10-08-2025 13:01,CBACF9E9C8DDB11436D9D80,063-000-002,33333333,COMPANY PAYROLL CBA,0,7156.08,338755.49,CR,REF513268,CBA,Current
10-08-2025 13:06,CBA366B7963E0994732B2FD,063-000-002,33333333,PAYPAL *NETFLIX CBA,39.92,0,338715.57,DR,REF484229,CBA,Current
10-08-2025 13:09,CBA700045E754064075BACB,063-000-002,33333333,BANK FEE CBA,74.71,0,338640.86,DR,REF809659,CBA,Current
10-08-2025 13:09,CBA38203E9FE9AC4E079BCE,063-000-002,33333333,CITYLINK CBA,80.79,0,338560.07,DR,REF609692,CBA,Current
10-08-2025 13:38,CBAF5A28FD187AC4B8687F2,063-000-002,33333333,ALDI CBA,15.97,0,338544.1,DR,REF135066,CBA,Current
10-08-2025 13:44,CBAF9C0AC83648C4975A26C,063-000-002,33333333,APPLE CBA,77.5,0,338466.6,DR,REF152365,CBA,Current
10-08-2025 13:54,CBA5BF7C4D6252B46439BBE,063-000-002,33333333,DOMINO'S PIZZA CBA,61.38,0,338405.22,DR,REF704134,CBA,Current
10-08-2025 13:56,CBADD73DA28B19B487CA214,063-000-002,33333333,STARBUCKS CBA,9.89,0,338395.33,DR,REF303111,CBA,Current
10-08-2025 13:57,CBAD58BC57CF7E14E158A4C,063-000-002,33333333,COLES CBA,15.28,0,338380.05,DR,REF125195,CBA,Current
10-08-2025 14:21,CBAC5056BAD566D481FA42E,063-000-002,33333333,ZOOM CBA,24.01,0,338356.04,DR,REF115188,CBA,Current
10-08-2025 14:28,CBA906E387C474A4ED594AB,063-000-002,33333333,PAYROLL CREDIT CBA,0,7130,345486.04,CR,REF551015,CBA,Current
10-08-2025 14:29,CBA8565433963A8467A8B0E,063-000-002,33333333,WAGES CREDIT CBA,0,3741.11,349227.15,CR,REF140693,CBA,Current
10-08-2025 14:37,CBA2B5204E976B647E0B86B,063-000-002,33333333,LIQUORLAND CBA,117.29,0,349109.86,DR,REF980720,CBA,Current
10-08-2025 14:43,CBA52D14795A67A4FFFA9E0,063-000-002,33333333,AMAZON AU CBA,19.58,0,349090.28,DR,REF857212,CBA,Current
10-08-2025 14:46,CBA70D648E4FB42408AB13D,063-000-002,33333333,LIQUORLAND CBA,48.61,0,349041.67,DR,REF744423,CBA,Current
10-08-2025 15:38,CBA7D158A1D7A8A492EAC8A,063-000-002,33333333,SPOTIFY CBA,53.08,0,348988.59,DR,REF277398,CBA,Current
10-08-2025 16:04,CBAAD2F5F5871214A95A580,063-000-002,33333333,BWS CBA,6.22,0,348982.37,DR,REF435751,CBA,Current
10-08-2025 16:08,CBA736C22F17BB0435DA9F2,063-000-002,33333333,PAYROLL CREDIT CBA,0,4879.01,353861.38,CR,REF666420,CBA,Current
10-08-2025 16:27,CBA3DB86A8601CE42C391F3,063-000-002,33333333,WOOLWORTHS CBA,58.14,0,353803.24,DR,REF693333,CBA,Current
10-08-2025 16:38,CBA90CED1DA3493423CB5CA,063-000-002,33333333,7-ELEVEN CBA,68.67,0,353734.57,DR,REF810702,CBA,Current
10-08-2025 16:56,CBABE57C143EC014A86A3CC,063-000-002,33333333,HARVEY NORMAN CBA,24.36,0,353710.21,DR,REF693642,CBA,Current
10-08-2025 17:25,CBAB45E4FA6CF3B4BF79ED9,063-000-002,33333333,STARBUCKS CBA,12.24,0,353697.97,DR,REF225587,CBA,Current
10-08-2025 17:40,CBA25B90FBE82B540A6B136,063-000-002,33333333,BP CBA,43.44,0,353654.53,DR,REF767959,CBA,Current
10-08-2025 17:50,CBAEE2DE8A560B64511B834,063-000-002,33333333,PAY - SALARY CBA,0,7704.9,361359.43,CR,REF439619,CBA,Current
10-08-2025 17:54,CBAFE5BF2ACF92F46D8B074,063-000-002,33333333,KFC CBA,45.4,0,361314.03,DR,REF798775,CBA,Current
10-08-2025 18:22,CBA46342375C5EB4F3EAA77,063-000-002,33333333,BWS CBA,32.07,0,361281.96,DR,REF455748,CBA,Current
10-08-2025 18:40,CBA8498FFDAB52D4223BBB7,063-000-002,33333333,CITYLINK CBA,23.02,0,361258.94,DR,REF870756,CBA,Current
10-08-2025 19:04,CBAE5F862C046F34915B7AA,063-000-002,33333333,7-ELEVEN CBA,22.67,0,361236.27,DR,REF935470,CBA,Current
10-08-2025 19:29,CBA8F2036BA9B414916B843,063-000-002,33333333,JB HI-FI CBA,11.17,0,361225.1,DR,REF269668,CBA,Current
10-08-2025 19:45,CBAD1D545B272834D8EA499,063-000-002,33333333,UBER EATS CBA,8.56,0,361216.54,DR,REF689108,CBA,Current
10-08-2025 19:45,INT8EA5E28DF59A4C029F8A,063-000-002,33333333,TRANSFER FROM ANZ 11111111,0,1613.73,362830.27,CR,INT-83117,CBA,Current
10-08-2025 19:46,CBA0E14BDAB04B94B75A4AC,063-000-002,33333333,SPOTIFY CBA,8.64,0,362821.63,DR,REF657380,CBA,Current
10-08-2025 20:12,CBA93E1297EB56F4DCD923F,063-000-002,33333333,UBER EATS CBA,4.43,0,362817.2,DR,REF539046,CBA,Current
10-08-2025 20:20,CBA3A54295F8B164534AF4A,063-000-002,33333333,UBER EATS CBA,65.67,0,362751.53,DR,REF363806,CBA,Current
10-08-2025 20:31,CBA5B9E1A08618A4CCB9238,063-000-002,33333333,SALARY PAYMENT CBA,0,7413.47,370165,CR,REF655883,CBA,Current
10-08-2025 21:02,CBA1200FBB0109B48ECAB6C,063-000-002,33333333,JB HI-FI CBA,77.58,0,370087.42,DR,REF987747,CBA,Current
10-08-2025 21:05,CBA80737B656CA34356892B,063-000-002,33333333,7-ELEVEN CBA,19.79,0,370067.63,DR,REF930363,CBA,Current
10-08-2025 21:08,CBA59F7B6B3A4264C42AE72,063-000-002,33333333,TAFE BOOKSHOP CBA,47.36,0,370020.27,DR,REF391334,CBA,Current
10-08-2025 21:11,CBACBB3C9FA1EAB438E8E9C,063-000-002,33333333,JB HI-FI CBA,47.01,0,369973.26,DR,REF581131,CBA,Current
10-08-2025 21:47,CBAF92F068341C74DE9966E,063-000-002,33333333,HARVEY NORMAN CBA,213.53,0,369759.73,DR,REF725955,CBA,Current
10-08-2025 21:52,CBAD62A060B2E004726B409,063-000-002,33333333,AMAZON AU CBA,101.59,0,369658.14,DR,REF214061,CBA,Current
10-08-2025 21:56,CBA9A79F051C1734DD3B83F,063-000-002,33333333,BP CBA,68.92,0,369589.22,DR,REF306440,CBA,Current
10-08-2025 21:59,CBAB7F53A2260294BE6B820,063-000-002,33333333,INTERNET TRANSFER CBA,85.21,0,369504.01,DR,REF660545,CBA,Current
10-08-2025 22:33,CBA906A477C59794B828D12,063-000-002,33333333,FLIXBUS CBA,28.33,0,369475.68,DR,REF970458,CBA,Current
10-08-2025 22:35,CBA03201F440BE142EDA479,063-000-002,33333333,TAFE BOOKSHOP CBA,58.97,0,369416.71,DR,REF591201,CBA,Current
10-08-2025 22:36,CBAFC5A631C77104CBB9F73,063-000-002,33333333,BANK FEE CBA,83.01,0,369333.7,DR,REF898442,CBA,Current
10-08-2025 22:41,CBAD158747AB108426C85B5,063-000-002,33333333,BP CBA,6.27,0,369327.43,DR,REF916216,CBA,Current
10-08-2025 23:11,CBAA21A79B0AAC34DBC8345,063-000-002,33333333,BWS CBA,29.88,0,369297.55,DR,REF632708,CBA,Current
10-08-2025 23:54,CBA95A99DD2DB4F4B198DA5,063-000-002,33333333,PAY - SALARY CBA,0,1054.09,370351.64,CR,REF845892,CBA,Current
11-08-2025 00:01,CBAB7BF3645F30C49AD8128,063-000-002,33333333,LIQUORLAND CBA,15.82,0,370335.82,DR,REF319667,CBA,Current
11-08-2025 00:17,CBA5DC3C0BC1C4D4573BBD1,063-000-002,33333333,MENULOG CBA,81.05,0,370254.77,DR,REF934763,CBA,Current
11-08-2025 00:30,CBA09D6FD9755C34E088024,063-000-002,33333333,BANK FEE CBA,97.25,0,370157.52,DR,REF871426,CBA,Current
11-08-2025 00:45,CBA8AE0405408754C1D82B4,063-000-002,33333333,DOMINO'S PIZZA CBA,33.34,0,370124.18,DR,REF186086,CBA,Current
11-08-2025 01:01,CBABED2B113D2DF41BB8067,063-000-002,33333333,FLIXBUS CBA,45.96,0,370078.22,DR,REF361834,CBA,Current
11-08-2025 01:04,INT1C1EFBC1F76F4F38B6CE,063-000-002,33333333,TRANSFER FROM CBA 22222222,0,615.68,370693.9,CR,INT-36991,CBA,Current
11-08-2025 01:12,CBA302C22B18EDE41F7A35C,063-000-002,33333333,BIGW CBA,14.13,0,370679.77,DR,REF843512,CBA,Current
11-08-2025 01:14,CBA351EA2BD90C149F699A9,063-000-002,33333333,MCDONALDS CBA,43.37,0,370636.4,DR,REF524862,CBA,Current
11-08-2025 01:17,CBACA43E5303E66440AAEAE,063-000-002,33333333,STARBUCKS CBA,15.8,0,370620.6,DR,REF168710,CBA,Current
11-08-2025 01:29,CBAD197D8AECDB84113B876,063-000-002,33333333,INTERNET TRANSFER CBA,9.95,0,370610.65,DR,REF303260,CBA,Current
11-08-2025 01:40,CBA1767F1A2665A416ABFDA,063-000-002,33333333,RAILWAY STATION CBA,55.21,0,370555.44,DR,REF579568,CBA,Current
11-08-2025 01:55,CBABC993ED46AD24C748C14,063-000-002,33333333,PAY - SALARY CBA,0,5441.34,375996.78,CR,REF109802,CBA,Current
11-08-2025 02:42,CBA702DC89FF3D64ECCA760,063-000-002,33333333,ALDI CBA,99.77,0,375897.01,DR,REF339329,CBA,Current
11-08-2025 02:47,CBACB887E9EE0C5462DBABD,063-000-002,33333333,ALDI CBA,8.84,0,375888.17,DR,REF779776,CBA,Current
11-08-2025 03:14,CBA057D2262C6DA4BF4B5D4,063-000-002,33333333,PAYPAL *NETFLIX CBA,36.9,0,375851.27,DR,REF207533,CBA,Current
11-08-2025 03:18,CBA1C38330658ED43FCB3BC,063-000-002,33333333,BANK FEE CBA,12.19,0,375839.08,DR,REF205536,CBA,Current
11-08-2025 03:20,CBA42B90A35529E49B493F5,063-000-002,33333333,COMPANY PAYROLL CBA,0,7577.02,383416.1,CR,REF278665,CBA,Current
11-08-2025 03:44,CBA136E560B8C3747E88274,063-000-002,33333333,APPLE CBA,31.63,0,383384.47,DR,REF460702,CBA,Current
11-08-2025 03:55,CBAF8586AB2F99845D88A37,063-000-002,33333333,DOMINO'S PIZZA CBA,24.95,0,383359.52,DR,REF210574,CBA,Current
11-08-2025 03:56,CBA5459945AB776457D8690,063-000-002,33333333,LIQUORLAND CBA,40.74,0,383318.78,DR,REF727288,CBA,Current
11-08-2025 04:54,CBAEF3ECF71A09D45FFABE7,063-000-002,33333333,DOMINO'S PIZZA CBA,17.97,0,383300.81,DR,REF801641,CBA,Current
11-08-2025 05:10,CBA92A3EBB5313A43F59624,063-000-002,33333333,HARVEY NORMAN CBA,17.94,0,383282.87,DR,REF622543,CBA,Current
11-08-2025 05:24,CBAB683672230694CF782D5,063-000-002,33333333,BANK FEE CBA,191.52,0,383091.35,DR,REF445485,CBA,Current
11-08-2025 06:27,CBA55597317B59D4EE8A467,063-000-002,33333333,UBER EATS CBA,12.72,0,383078.63,DR,REF572747,CBA,Current
11-08-2025 06:34,CBAFAA0438A98D14AD991E4,063-000-002,33333333,COLES CBA,5.3,0,383073.33,DR,REF902236,CBA,Current
11-08-2025 06:39,CBAFB442C8C3D4444349DBB,063-000-002,33333333,UBER EATS CBA,52.44,0,383020.89,DR,REF379238,CBA,Current
11-08-2025 07:10,CBA15C26D81F8454960909E,063-000-002,33333333,APPLE CBA,146.68,0,382874.21,DR,REF954048,CBA,Current
11-08-2025 07:17,CBAD34B2D59AFF946E2ACB5,063-000-002,33333333,PAYPAL *NETFLIX CBA,2.54,0,382871.67,DR,REF269557,CBA,Current
11-08-2025 08:01,CBA2EB9CF74846547B6A38A,063-000-002,33333333,PAYPAL *NETFLIX CBA,80.6,0,382791.07,DR,REF289461,CBA,Current
11-08-2025 08:25,CBA622531EFB92048CAA236,063-000-002,33333333,INTERNET TRANSFER CBA,96.04,0,382695.03,DR,REF283462,CBA,Current
11-08-2025 08:48,CBAF8A48340733747AD8635,063-000-002,33333333,INTERNET TRANSFER CBA,4.47,0,382690.56,DR,REF534071,CBA,Current
11-08-2025 08:55,CBAA5CB595E1D1348E598FD,063-000-002,33333333,SPOTIFY CBA,37.21,0,382653.35,DR,REF815024,CBA,Current
11-08-2025 09:40,CBA7B8FE3EAF1604B8FAE55,063-000-002,33333333,MENULOG CBA,39.06,0,382614.29,DR,REF549437,CBA,Current
11-08-2025 10:04,CBA7ECC3047975241D88D34,063-000-002,33333333,SHELL CBA,118.94,0,382495.35,DR,REF429903,CBA,Current
11-08-2025 10:22,CBACF45B5CA0BBC40AAA1BF,063-000-002,33333333,PAYROLL CREDIT CBA,0,2271.13,384766.48,CR,REF748813,CBA,Current
11-08-2025 10:41,CBA6E9333F891C7438ABC2B,063-000-002,33333333,INTERNET TRANSFER CBA,44.99,0,384721.49,DR,REF738144,CBA,Current
11-08-2025 10:48,CBA5C6F746FF1864A80B146,063-000-002,33333333,MCDONALDS CBA,15.68,0,384705.81,DR,REF813311,CBA,Current
11-08-2025 10:50,CBAD0AF7C8499D54D49BECE,063-000-002,33333333,HARVEY NORMAN CBA,113.99,0,384591.82,DR,REF768788,CBA,Current
11-08-2025 10:58,CBAC328199EFD6340E2B8B4,063-000-002,33333333,INTERNET TRANSFER CBA,39.38,0,384552.44,DR,REF392123,CBA,Current
11-08-2025 10:59,CBAC2B0232320C348E5A2EB,063-000-002,33333333,MENULOG CBA,69.3,0,384483.14,DR,REF174922,CBA,Current
11-08-2025 11:03,CBAA6925480C70F4A299240,063-000-002,33333333,FLIXBUS CBA,15.13,0,384468.01,DR,REF687410,CBA,Current
11-08-2025 11:24,CBA9C2601AB01354B6EB932,063-000-002,33333333,PAY - SALARY CBA,0,7087.79,391555.8,CR,REF952588,CBA,Current
11-08-2025 11:31,CBA6EA7445AE7344520A52C,063-000-002,33333333,TAFE BOOKSHOP CBA,39.2,0,391516.6,DR,REF550323,CBA,Current
11-08-2025 11:45,CBA5197C8F735EA44F39102,063-000-002,33333333,KFC CBA,65.88,0,391450.72,DR,REF304757,CBA,Current
11-08-2025 11:45,CBADF012A88323B4141B001,063-000-002,33333333,INTERNET TRANSFER CBA,21.81,0,391428.91,DR,REF919652,CBA,Current
11-08-2025 11:51,CBACD286B3F881E47AD9EBC,063-000-002,33333333,RAILWAY STATION CBA,181.18,0,391247.73,DR,REF710643,CBA,Current
11-08-2025 12:28,CBA318920EE299E4421B4D6,063-000-002,33333333,DOMINO'S PIZZA CBA,8.16,0,391239.57,DR,REF774199,CBA,Current
11-08-2025 12:29,CBADC006E8B0C32443BB2EC,063-000-002,33333333,COMPANY PAYROLL CBA,0,4458.81,395698.38,CR,REF769996,CBA,Current
11-08-2025 12:30,CBA541D7E91EBBE427CA376,063-000-002,33333333,ZOOM CBA,33.13,0,395665.25,DR,REF970136,CBA,Current
11-08-2025 12:39,CBAAD0E776E62A14B5F8B5E,063-000-002,33333333,UBER EATS CBA,8.06,0,395657.19,DR,REF198720,CBA,Current
11-08-2025 12:41,CBAD34309C10F5A42F2BE51,063-000-002,33333333,APPLE CBA,11.3,0,395645.89,DR,REF383333,CBA,Current
11-08-2025 12:59,CBAE68662FA1660480A8DF7,063-000-002,33333333,7-ELEVEN CBA,59.09,0,395586.8,DR,REF626954,CBA,Current
11-08-2025 13:32,CBA90A413FDE87142178B15,063-000-002,33333333,DOMINO'S PIZZA CBA,85.71,0,395501.09,DR,REF356967,CBA,Current
11-08-2025 13:41,INT300FFE52A4424CF49D1B,063-000-002,33333333,TRANSFER FROM NAB 44444444,0,1288.56,396789.65,CR,INT-97139,CBA,Current
11-08-2025 14:10,CBAFF4158A7E4E4413389F5,063-000-002,33333333,PAY - SALARY CBA,0,6296.13,403085.78,CR,REF667019,CBA,Current
11-08-2025 14:25,CBA7C52E388F6BE489C97F2,063-000-002,33333333,PAYMENT GATEWAY CBA,105.38,0,402980.4,DR,REF702022,CBA,Current
11-08-2025 14:34,CBAE860CCCFE97E43B3AF1E,063-000-002,33333333,RAILWAY STATION CBA,7.08,0,402973.32,DR,REF126690,CBA,Current
11-08-2025 15:42,CBA61E3CCD0DA174795B77A,063-000-002,33333333,RAILWAY STATION CBA,78.32,0,402895,DR,REF247943,CBA,Current
11-08-2025 16:13,CBA375B59B0776546809810,063-000-002,33333333,PAY - SALARY CBA,0,4505.78,407400.78,CR,REF734802,CBA,Current
11-08-2025 16:47,CBAE7B90643A17845A88A1C,063-000-002,33333333,INTERNET TRANSFER CBA,20.95,0,407379.83,DR,REF920292,CBA,Current
11-08-2025 16:52,CBAF7C8DCA8316B4D2F8F72,063-000-002,33333333,ALDI CBA,114.04,0,407265.79,DR,REF552148,CBA,Current
11-08-2025 17:37,CBA44129C082AE4403CA8CD,063-000-002,33333333,HARVEY NORMAN CBA,132.09,0,407133.7,DR,REF342237,CBA,Current
11-08-2025 17:45,CBAE3819101AD3C445192E6,063-000-002,33333333,FLIXBUS CBA,60.02,0,407073.68,DR,REF330608,CBA,Current
11-08-2025 17:59,CBA7B512B83C2F74FF59921,063-000-002,33333333,TAFE BOOKSHOP CBA,9.12,0,407064.56,DR,REF614763,CBA,Current
11-08-2025 18:14,CBA75586FC559D14196BEEB,063-000-002,33333333,BANK FEE CBA,14.89,0,407049.67,DR,REF120937,CBA,Current
11-08-2025 18:20,CBA4FEFF940362F41AF85D0,063-000-002,33333333,LIQUORLAND CBA,38.36,0,407011.31,DR,REF119285,CBA,Current
11-08-2025 18:38,CBA2F0899862DF34FF78093,063-000-002,33333333,WOOLWORTHS CBA,234.91,0,406776.4,DR,REF932967,CBA,Current
11-08-2025 18:49,CBADADC8CD57EFD4C369426,063-000-002,33333333,BP CBA,14.14,0,406762.26,DR,REF891403,CBA,Current
11-08-2025 19:08,CBABCDAA8AE1B1B4F639D33,063-000-002,33333333,JB HI-FI CBA,79.21,0,406683.05,DR,REF618547,CBA,Current
11-08-2025 19:14,CBAB781770B1B15412B8CF6,063-000-002,33333333,COLES CBA,22.57,0,406660.48,DR,REF189199,CBA,Current
11-08-2025 19:18,CBAA97A26A837244124B0A4,063-000-002,33333333,LIQUORLAND CBA,150.46,0,406510.02,DR,REF305704,CBA,Current
11-08-2025 19:36,CBA78C0A65B153D4E279ADC,063-000-002,33333333,ALDI CBA,20.05,0,406489.97,DR,REF621751,CBA,Current
11-08-2025 19:57,CBAC9BFFE923230492DBBC5,063-000-002,33333333,SHELL CBA,6.42,0,406483.55,DR,REF189997,CBA,Current
11-08-2025 20:23,CBAED03E3DD8A764ED78289,063-000-002,33333333,SPOTIFY CBA,16.16,0,406467.39,DR,REF521877,CBA,Current
11-08-2025 20:24,CBAD0E5E6AD0ED946C7AA4E,063-000-002,33333333,COLES CBA,8.78,0,406458.61,DR,REF117485,CBA,Current
11-08-2025 20:25,CBA595C504F4AC54E9DBA67,063-000-002,33333333,COMPANY PAYROLL CBA,0,3705.57,410164.18,CR,REF924009,CBA,Current
11-08-2025 20:44,CBA08F847D414114D0384AA,063-000-002,33333333,COLES CBA,5.03,0,410159.15,DR,REF946113,CBA,Current
11-08-2025 20:48,CBAA09768CF154648FE9A98,063-000-002,33333333,KFC CBA,76.46,0,410082.69,DR,REF936126,CBA,Current
11-08-2025 21:07,CBAA6DF93C19F8C4550A2F0,063-000-002,33333333,BP CBA,148.32,0,409934.37,DR,REF185407,CBA,Current
11-08-2025 21:07,CBAD6D499B495284B7F949C,063-000-002,33333333,SHELL CBA,26.04,0,409908.33,DR,REF483238,CBA,Current
11-08-2025 21:18,INT0B17EB6EE0B0483193A8,063-000-002,33333333,TRANSFER FROM CBA 22222222,0,1327.35,411235.68,CR,INT-69087,CBA,Current
11-08-2025 22:00,CBA61E17D9E9EBC414CA448,063-000-002,33333333,PAYMENT GATEWAY CBA,31.42,0,411204.26,DR,REF539162,CBA,Current
11-08-2025 22:05,INT5ED7712C97A144E68009,063-000-002,33333333,TRANSFER TO NAB 44444444,340.55,0,410863.71,DR,INT-56005,CBA,Current
11-08-2025 22:11,CBA3D8C4214FC6A46C39BC3,063-000-002,33333333,APPLE CBA,23.31,0,410840.4,DR,REF740623,CBA,Current
11-08-2025 22:33,CBA71CA2631B7AB40198E17,063-000-002,33333333,APPLE CBA,14.25,0,410826.15,DR,REF952807,CBA,Current
11-08-2025 22:48,CBAF81246489E3747DE835E,063-000-002,33333333,ALDI CBA,23.19,0,410802.96,DR,REF196227,CBA,Current
11-08-2025 22:58,CBA6DB969C9CE79454FA6D7,063-000-002,33333333,MCDONALDS CBA,12.26,0,410790.7,DR,REF838898,CBA,Current
11-08-2025 23:49,CBAB94D63FDF75049DF86ED,063-000-002,33333333,PAYMENT GATEWAY CBA,6.63,0,410784.07,DR,REF659651,CBA,Current
11-08-2025 23:59,CBA76B58DA7D64743608BC4,063-000-002,33333333,APPLE CBA,42.73,0,410741.34,DR,REF665554,CBA,Current
12-08-2025 00:05,CBAC8B29F3036A14A67A288,063-000-002,33333333,COMPANY PAYROLL CBA,0,2909.76,413651.1,CR,REF597355,CBA,Current
12-08-2025 00:08,CBA18AB6F0CE62A4EEAA11E,063-000-002,33333333,SPOTIFY CBA,30.05,0,413621.05,DR,REF613090,CBA,Current
12-08-2025 00:18,CBAF7659D7365514E19AAF5,063-000-002,33333333,DOMINO'S PIZZA CBA,46.59,0,413574.46,DR,REF372240,CBA,Current
12-08-2025 01:09,CBA12D936B3ABD54DFD9723,063-000-002,33333333,PAYPAL *NETFLIX CBA,76.61,0,413497.85,DR,REF679323,CBA,Current
12-08-2025 01:17,CBA533873A2EEC444F1AC97,063-000-002,33333333,COMPANY PAYROLL CBA,0,686.13,414183.98,CR,REF914440,CBA,Current
12-08-2025 01:18,CBA2F71CB6397CE4E9E9944,063-000-002,33333333,ZOOM CBA,52.85,0,414131.13,DR,REF969101,CBA,Current
12-08-2025 01:32,CBAFC8D842D676F4181AEFE,063-000-002,33333333,PAYROLL CREDIT CBA,0,6686.7,420817.83,CR,REF836563,CBA,Current
12-08-2025 02:28,CBADEA1811860EE4E17B8E8,063-000-002,33333333,COMPANY PAYROLL CBA,0,1028.56,421846.39,CR,REF986880,CBA,Current
12-08-2025 02:35,CBA14B7A68F38664FEB9250,063-000-002,33333333,MENULOG CBA,64.22,0,421782.17,DR,REF448498,CBA,Current
12-08-2025 02:37,CBA78FA7CBB7564406787A9,063-000-002,33333333,COLES CBA,155.08,0,421627.09,DR,REF972805,CBA,Current
12-08-2025 02:41,CBA7927D6B936AF42949FB4,063-000-002,33333333,7-ELEVEN CBA,13.6,0,421613.49,DR,REF939439,CBA,Current
12-08-2025 03:31,CBA4503A2669C024A5AA22E,063-000-002,33333333,COLES CBA,82.25,0,421531.24,DR,REF536764,CBA,Current
12-08-2025 03:32,CBA0FB80D544BFD4ED9B53D,063-000-002,33333333,MCDONALDS CBA,19.94,0,421511.3,DR,REF299555,CBA,Current
12-08-2025 03:34,CBAAA67ACBA50384746AD65,063-000-002,33333333,BANK FEE CBA,42.8,0,421468.5,DR,REF233839,CBA,Current
12-08-2025 03:41,CBA7E4730C9222E43368B75,063-000-002,33333333,JB HI-FI CBA,57.25,0,421411.25,DR,REF676333,CBA,Current
12-08-2025 04:11,CBAA677CFA4266D44058B0C,063-000-002,33333333,TAFE BOOKSHOP CBA,157.28,0,421253.97,DR,REF518396,CBA,Current
12-08-2025 04:40,CBA5B52E21DD70C42DC8870,063-000-002,33333333,SALARY PAYMENT CBA,0,6668.21,427922.18,CR,REF557424,CBA,Current
12-08-2025 04:40,CBA4917278E70A246DB91EA,063-000-002,33333333,BWS CBA,22.56,0,427899.62,DR,REF114498,CBA,Current
12-08-2025 05:09,CBACDB2E652799D472CA1D6,063-000-002,33333333,PAY - SALARY CBA,0,2431.51,430331.13,CR,REF437079,CBA,Current
12-08-2025 05:23,CBAB7F85E8932C34C108D62,063-000-002,33333333,DOMINO'S PIZZA CBA,42.63,0,430288.5,DR,REF585334,CBA,Current
12-08-2025 05:33,CBAABF995196A26404E9CBD,063-000-002,33333333,JB HI-FI CBA,165.91,0,430122.59,DR,REF341385,CBA,Current
12-08-2025 05:39,CBAE74F331DB3C04523BBC7,063-000-002,33333333,7-ELEVEN CBA,104.33,0,430018.26,DR,REF910906,CBA,Current
12-08-2025 06:14,CBA1ADF165036B541FF8773,063-000-002,33333333,WOOLWORTHS CBA,4.01,0,430014.25,DR,REF355538,CBA,Current
12-08-2025 06:18,CBA6AFB08F89C27401E83C0,063-000-002,33333333,BIGW CBA,134.46,0,429879.79,DR,REF161527,CBA,Current
12-08-2025 07:00,CBA3E651D0DC93A4B689770,063-000-002,33333333,MENULOG CBA,46.15,0,429833.64,DR,REF573448,CBA,Current
12-08-2025 07:05,CBA9547EC595D4E4F638348,063-000-002,33333333,STARBUCKS CBA,50.54,0,429783.1,DR,REF931814,CBA,Current
12-08-2025 07:38,CBA5E9C32D764CC4956B9E0,063-000-002,33333333,HARVEY NORMAN CBA,12.17,0,429770.93,DR,REF352674,CBA,Current
12-08-2025 07:44,INT0FB48EC20DF741038171,063-000-002,33333333,TRANSFER TO ANZ 11111111,1776.49,0,427994.44,DR,INT-84203,CBA,Current
12-08-2025 07:49,CBA337E677682B8446A949B,063-000-002,33333333,KFC CBA,116.45,0,427877.99,DR,REF323850,CBA,Current
12-08-2025 08:01,CBA0501B8EBC0B44B5BB071,063-000-002,33333333,RAILWAY STATION CBA,160.76,0,427717.23,DR,REF156576,CBA,Current
12-08-2025 08:39,CBAF065E5F02A914135B97D,063-000-002,33333333,PAYROLL CREDIT CBA,0,493.04,428210.27,CR,REF669668,CBA,Current
12-08-2025 09:35,CBA7BB36E5ED4EE4E18A7E8,063-000-002,33333333,MENULOG CBA,12.01,0,428198.26,DR,REF764633,CBA,Current
12-08-2025 10:12,CBA0EB5FA2D2F2A4A70A07A,063-000-002,33333333,PAY - SALARY CBA,0,366.83,428565.09,CR,REF181652,CBA,Current
12-08-2025 10:30,CBAE6ED5A5EB982458D833C,063-000-002,33333333,RAILWAY STATION CBA,40.51,0,428524.58,DR,REF100599,CBA,Current
12-08-2025 10:52,INT0860973418934BBA946F,063-000-002,33333333,TRANSFER TO NAB 44444444,1490.53,0,427034.05,DR,INT-64119,CBA,Current
12-08-2025 11:39,CBA7A48D3CB89404ADAB5E4,063-000-002,33333333,JB HI-FI CBA,17.48,0,427016.57,DR,REF559070,CBA,Current
12-08-2025 12:02,CBA13020F15142446E49D85,063-000-002,33333333,HARVEY NORMAN CBA,8.1,0,427008.47,DR,REF979185,CBA,Current
12-08-2025 12:24,CBA3EE9175D528840B4AF9F,063-000-002,33333333,SHELL CBA,81.82,0,426926.65,DR,REF312406,CBA,Current
12-08-2025 12:34,CBA0EDC7A20E3C3435982B6,063-000-002,33333333,BWS CBA,55.51,0,426871.14,DR,REF881897,CBA,Current
12-08-2025 12:48,CBA94C58BAD9615497DA599,063-000-002,33333333,MENULOG CBA,47.82,0,426823.32,DR,REF862093,CBA,Current
12-08-2025 13:15,CBA062662046AB84463BCC7,063-000-002,33333333,MCDONALDS CBA,9.85,0,426813.47,DR,REF583033,CBA,Current
12-08-2025 13:19,CBA5894E6D8ABAB4D51B1D7,063-000-002,33333333,LIQUORLAND CBA,38.65,0,426774.82,DR,REF875823,CBA,Current
12-08-2025 13:42,CBAD20FF6888B884805B211,063-000-002,33333333,JB HI-FI CBA,13.47,0,426761.35,DR,REF744980,CBA,Current
12-08-2025 14:03,CBA819025071E9646F9BB62,063-000-002,33333333,INTERNET TRANSFER CBA,8.65,0,426752.7,DR,REF762144,CBA,Current
12-08-2025 14:10,CBA125AC3F826C6413BB65C,063-000-002,33333333,AMAZON AU CBA,7.93,0,426744.77,DR,REF176806,CBA,Current
12-08-2025 14:20,CBA50A1D607689C460484ED,063-000-002,33333333,ALDI CBA,73.98,0,426670.79,DR,REF287106,CBA,Current
12-08-2025 14:41,CBAFEE1076D4C0042799EAA,063-000-002,33333333,PAYMENT GATEWAY CBA,1.82,0,426668.97,DR,REF869941,CBA,Current
12-08-2025 14:44,CBA3E0CDFB84E6648DCA92D,063-000-002,33333333,BWS CBA,63.03,0,426605.94,DR,REF845665,CBA,Current
12-08-2025 14:56,CBAB1390C5B3A784A5CA429,063-000-002,33333333,CITYLINK CBA,72.23,0,426533.71,DR,REF318960,CBA,Current
12-08-2025 14:58,CBAEBE43DE9278345C5A45D,063-000-002,33333333,PAYROLL CREDIT CBA,0,436.14,426969.85,CR,REF904070,CBA,Current
12-08-2025 15:33,CBA9C5BD919CA7B4574B485,063-000-002,33333333,HARVEY NORMAN CBA,219.56,0,426750.29,DR,REF788653,CBA,Current
12-08-2025 15:34,CBAD30AADB38E74450E9ABA,063-000-002,33333333,BP CBA,13.17,0,426737.12,DR,REF658421,CBA,Current
12-08-2025 16:12,CBAC082C0D291B748F99951,063-000-002,33333333,WAGES CREDIT CBA,0,3710.34,430447.46,CR,REF730191,CBA,Current
12-08-2025 16:16,CBA29490C129BC34181ABE0,063-000-002,33333333,COLES CBA,8.66,0,430438.8,DR,REF924404,CBA,Current
12-08-2025 16:24,CBA2A6256CEDC2946819B0D,063-000-002,33333333,RAILWAY STATION CBA,67.72,0,430371.08,DR,REF234670,CBA,Current
12-08-2025 16:36,CBA97756E4FB0B34B18A28A,063-000-002,33333333,LIQUORLAND CBA,33.19,0,430337.89,DR,REF509966,CBA,Current
12-08-2025 16:36,CBAE4C280AE379F4DCABE77,063-000-002,33333333,WOOLWORTHS CBA,17.6,0,430320.29,DR,REF627894,CBA,Current
12-08-2025 16:44,CBA9B5944D2F2F14F75A7B4,063-000-002,33333333,BANK FEE CBA,67.23,0,430253.06,DR,REF630519,CBA,Current
12-08-2025 17:02,CBAFEA828F8D7E1485E9788,063-000-002,33333333,SALARY PAYMENT CBA,0,699.27,430952.33,CR,REF197305,CBA,Current
12-08-2025 17:33,CBA57C6AED5DCC547F999B2,063-000-002,33333333,7-ELEVEN CBA,29.8,0,430922.53,DR,REF894971,CBA,Current
12-08-2025 18:23,CBA939E909016A84BCFB330,063-000-002,33333333,KFC CBA,101.94,0,430820.59,DR,REF479243,CBA,Current
12-08-2025 18:37,CBAF2B9159C06B44EE6AE1D,063-000-002,33333333,INTERNET TRANSFER CBA,10.13,0,430810.46,DR,REF590950,CBA,Current
12-08-2025 18:46,INTD5FFD82A37F74C079430,063-000-002,33333333,TRANSFER TO NAB 44444444,90.93,0,430719.53,DR,INT-62430,CBA,Current
12-08-2025 18:50,CBA8F36CF2E04CD49749626,063-000-002,33333333,PAY - SALARY CBA,0,6314.04,437033.57,CR,REF153655,CBA,Current
12-08-2025 18:52,CBA06C05EB7214A4DF8A466,063-000-002,33333333,AMAZON AU CBA,8.86,0,437024.71,DR,REF627249,CBA,Current
12-08-2025 19:14,CBA0833D7601FF045EF9E5B,063-000-002,33333333,MENULOG CBA,6.95,0,437017.76,DR,REF165270,CBA,Current
12-08-2025 19:32,CBA5210B63C17F84109A97A,063-000-002,33333333,PAYROLL CREDIT CBA,0,1790.48,438808.24,CR,REF337623,CBA,Current
12-08-2025 19:35,CBADDBFC1931C104000B05D,063-000-002,33333333,TAFE BOOKSHOP CBA,52.36,0,438755.88,DR,REF941225,CBA,Current
12-08-2025 20:18,CBAB4D23C551EF141E0B228,063-000-002,33333333,STARBUCKS CBA,36.9,0,438718.98,DR,REF593497,CBA,Current
12-08-2025 20:19,CBA2D7A7CF441B949B89376,063-000-002,33333333,BWS CBA,178.32,0,438540.66,DR,REF861490,CBA,Current
12-08-2025 20:22,CBA221036783B7A4501A219,063-000-002,33333333,BP CBA,55.28,0,438485.38,DR,REF736703,CBA,Current
12-08-2025 20:44,CBA47689738D5644CA29A01,063-000-002,33333333,7-ELEVEN CBA,37.43,0,438447.95,DR,REF284442,CBA,Current
12-08-2025 21:03,CBAB00152B908524E549241,063-000-002,33333333,CITYLINK CBA,113.9,0,438334.05,DR,REF627403,CBA,Current
12-08-2025 21:07,CBAE258D21921334D7A8338,063-000-002,33333333,UBER EATS CBA,33.15,0,438300.9,DR,REF725580,CBA,Current
12-08-2025 21:25,CBAF71FB3CCF6904C3295CE,063-000-002,33333333,BANK FEE CBA,8.04,0,438292.86,DR,REF917652,CBA,Current
12-08-2025 21:32,CBA600544C77E0A4C06BB99,063-000-002,33333333,ZOOM CBA,9.35,0,438283.51,DR,REF876128,CBA,Current
12-08-2025 21:44,CBA1E8F2993F2284B79BD92,063-000-002,33333333,ALDI CBA,237.48,0,438046.03,DR,REF713253,CBA,Current
12-08-2025 21:49,CBA818741D04A0C4ACD8B8C,063-000-002,33333333,AMAZON AU CBA,56.93,0,437989.1,DR,REF536879,CBA,Current
12-08-2025 21:53,CBA13B3812C9ED046D7B713,063-000-002,33333333,CITYLINK CBA,33.95,0,437955.15,DR,REF125954,CBA,Current
12-08-2025 22:42,CBAE1EA70A1867E40559C01,063-000-002,33333333,WOOLWORTHS CBA,35.68,0,437919.47,DR,REF320062,CBA,Current
12-08-2025 22:52,CBA548A5AD16478411D9847,063-000-002,33333333,FLIXBUS CBA,131.78,0,437787.69,DR,REF174223,CBA,Current
12-08-2025 22:57,CBA5150C47F6999406FB397,063-000-002,33333333,AMAZON AU CBA,11.18,0,437776.51,DR,REF577275,CBA,Current
12-08-2025 23:01,CBA43CEC005997D4425BA33,063-000-002,33333333,FLIXBUS CBA,46.57,0,437729.94,DR,REF911113,CBA,Current
12-08-2025 23:26,CBAB89C87DF64BE401B83CB,063-000-002,33333333,INTERNET TRANSFER CBA,53.52,0,437676.42,DR,REF724879,CBA,Current
12-08-2025 23:46,CBAE3237C6C67174EBB92E4,063-000-002,33333333,MCDONALDS CBA,22.98,0,437653.44,DR,REF658037,CBA,Current
12-08-2025 23:52,CBA3F7455891AE04F9889EE,063-000-002,33333333,MCDONALDS CBA,52.86,0,437600.58,DR,REF905753,CBA,Current
13-08-2025 00:18,INTE26CE2182D4C40B294C3,063-000-002,33333333,TRANSFER TO ANZ 11111111,630.67,0,436969.91,DR,INT-58249,CBA,Current
13-08-2025 00:27,CBABF198AFBBEB9468FBC0F,063-000-002,33333333,PAY - SALARY CBA,0,3898.59,440868.5,CR,REF119879,CBA,Current
13-08-2025 00:28,CBADA729D140BEB45F8A1D9,063-000-002,33333333,HARVEY NORMAN CBA,44.47,0,440824.03,DR,REF965324,CBA,Current
13-08-2025 00:43,CBAB51809680AB84794AEB1,063-000-002,33333333,DOMINO'S PIZZA CBA,35.48,0,440788.55,DR,REF689786,CBA,Current
13-08-2025 01:22,CBA48BEC1854D5944BF93EB,063-000-002,33333333,MCDONALDS CBA,107.51,0,440681.04,DR,REF931303,CBA,Current
13-08-2025 02:06,CBAC45073D264DA401888FE,063-000-002,33333333,FLIXBUS CBA,7.05,0,440673.99,DR,REF472389,CBA,Current
13-08-2025 02:43,CBA251A3F28007D4942A33F,063-000-002,33333333,UBER EATS CBA,20.44,0,440653.55,DR,REF982037,CBA,Current
13-08-2025 02:44,CBA72777D696B1544C2BC40,063-000-002,33333333,SPOTIFY CBA,74.09,0,440579.46,DR,REF949925,CBA,Current
13-08-2025 03:14,INTDC50E52CDD194F79B77D,063-000-002,33333333,TRANSFER TO ANZ 11111111,1360.31,0,439219.15,DR,INT-27645,CBA,Current
13-08-2025 03:16,INT95D46622EA3B47E8BC5B,063-000-002,33333333,TRANSFER FROM NAB 44444444,0,1867.18,441086.33,CR,INT-11893,CBA,Current
13-08-2025 03:19,CBA3D65156F2ABA4E4B8144,063-000-002,33333333,BANK FEE CBA,36.63,0,441049.7,DR,REF858739,CBA,Current
13-08-2025 03:22,CBA99A475C6C29F448B99DA,063-000-002,33333333,FLIXBUS CBA,42.31,0,441007.39,DR,REF793685,CBA,Current
13-08-2025 03:45,CBA8E82A516BDBF40588309,063-000-002,33333333,SALARY PAYMENT CBA,0,7944.69,448952.08,CR,REF227232,CBA,Current
13-08-2025 04:00,CBA72FB4547885F44E2BD28,063-000-002,33333333,STARBUCKS CBA,12.48,0,448939.6,DR,REF611238,CBA,Current
13-08-2025 05:29,CBAB8BC5F705C35483BBA1F,063-000-002,33333333,UBER EATS CBA,139.57,0,448800.03,DR,REF250058,CBA,Current
13-08-2025 05:50,CBAA0E7CB9D104E4BCFB3F1,063-000-002,33333333,COMPANY PAYROLL CBA,0,3380.45,452180.48,CR,REF139355,CBA,Current
13-08-2025 05:56,CBAA906DF628E934E20B17F,063-000-002,33333333,CITYLINK CBA,48.81,0,452131.67,DR,REF944432,CBA,Current
13-08-2025 06:05,CBA3BA5E0C56EA14525BEA5,063-000-002,33333333,BP CBA,13.55,0,452118.12,DR,REF453062,CBA,Current
13-08-2025 06:27,CBA96567FE4CDF84F9F8385,063-000-002,33333333,MENULOG CBA,70.26,0,452047.86,DR,REF450936,CBA,Current
13-08-2025 06:41,CBADE821A71BA18480CB15E,063-000-002,33333333,JB HI-FI CBA,16.37,0,452031.49,DR,REF631839,CBA,Current
13-08-2025 06:43,CBA101EA4F5DCF740F3B3A4,063-000-002,33333333,PAYROLL CREDIT CBA,0,1055.63,453087.12,CR,REF689259,CBA,Current
13-08-2025 06:59,CBAF6D1AA9C477342B4AB03,063-000-002,33333333,FLIXBUS CBA,78.19,0,453008.93,DR,REF604361,CBA,Current
13-08-2025 06:59,CBAF9B03F5B21204F0D867F,063-000-002,33333333,JB HI-FI CBA,4.52,0,453004.41,DR,REF865594,CBA,Current
13-08-2025 07:04,CBAD8EA46B6FDFD4AF3B833,063-000-002,33333333,BWS CBA,2.4,0,453002.01,DR,REF296927,CBA,Current
13-08-2025 07:38,CBAB21B9458CB3F4377A16F,063-000-002,33333333,BP CBA,65.07,0,452936.94,DR,REF748433,CBA,Current
13-08-2025 08:03,CBA449B9AEB4F23442FA10B,063-000-002,33333333,BIGW CBA,44.97,0,452891.97,DR,REF188653,CBA,Current
13-08-2025 08:13,CBA61611B81C8C245E1AA29,063-000-002,33333333,UBER EATS CBA,34.6,0,452857.37,DR,REF879443,CBA,Current
13-08-2025 08:22,CBAF304CB5ED7744C3591A3,063-000-002,33333333,COMPANY PAYROLL CBA,0,766.43,453623.8,CR,REF834794,CBA,Current
13-08-2025 09:03,CBAF0ABE5F6EC5745C8874B,063-000-002,33333333,WAGES CREDIT CBA,0,7184.17,460807.97,CR,REF382062,CBA,Current
13-08-2025 09:14,CBA39E486B8009A4939B0F8,063-000-002,33333333,LIQUORLAND CBA,16,0,460791.97,DR,REF349343,CBA,Current
13-08-2025 09:21,CBA39E29A873A5E4632BA94,063-000-002,33333333,SPOTIFY CBA,86.89,0,460705.08,DR,REF322236,CBA,Current
13-08-2025 09:26,CBA3EB24DEF31574766ACD1,063-000-002,33333333,BWS CBA,45.95,0,460659.13,DR,REF509838,CBA,Current
13-08-2025 09:53,CBA2DFF853DDD164A0AAFF7,063-000-002,33333333,TAFE BOOKSHOP CBA,149.54,0,460509.59,DR,REF960114,CBA,Current
13-08-2025 10:10,CBA0D91B7FAA096415F98AB,063-000-002,33333333,WOOLWORTHS CBA,85.48,0,460424.11,DR,REF940756,CBA,Current
13-08-2025 10:10,CBA94C4F96452AD4EADB29A,063-000-002,33333333,COLES CBA,77.64,0,460346.47,DR,REF543405,CBA,Current
13-08-2025 10:32,CBA2BD2DE916B7146D89B6D,063-000-002,33333333,MENULOG CBA,35.4,0,460311.07,DR,REF276375,CBA,Current
13-08-2025 10:53,CBA86E884DCA753419BA9E6,063-000-002,33333333,PAYMENT GATEWAY CBA,43.48,0,460267.59,DR,REF437274,CBA,Current
13-08-2025 11:16,CBAC58FBD3B69B54D1B8986,063-000-002,33333333,TAFE BOOKSHOP CBA,7.3,0,460260.29,DR,REF382165,CBA,Current
13-08-2025 11:25,CBABFBF8F70FF5641118DFA,063-000-002,33333333,BIGW CBA,14,0,460246.29,DR,REF134727,CBA,Current
13-08-2025 12:24,CBAB2AD28E91705488B8994,063-000-002,33333333,BWS CBA,22.03,0,460224.26,DR,REF786616,CBA,Current
13-08-2025 12:27,CBAA80121D6E0724C27BA84,063-000-002,33333333,ALDI CBA,12.57,0,460211.69,DR,REF711610,CBA,Current
13-08-2025 12:47,CBACE89B1E49F85431EBBFB,063-000-002,33333333,ZOOM CBA,30.04,0,460181.65,DR,REF426916,CBA,Current
13-08-2025 13:11,CBA5199020B7C3645DC8719,063-000-002,33333333,SHELL CBA,141,0,460040.65,DR,REF322244,CBA,Current
13-08-2025 13:12,CBA372268B29AB64DAAA578,063-000-002,33333333,KFC CBA,6.86,0,460033.79,DR,REF680624,CBA,Current
13-08-2025 13:19,CBA844B10F565624C1F879D,063-000-002,33333333,STARBUCKS CBA,33.81,0,459999.98,DR,REF634316,CBA,Current
13-08-2025 14:07,CBAAE6FE18D9D524F4D97D4,063-000-002,33333333,ALDI CBA,144.8,0,459855.18,DR,REF502046,CBA,Current
13-08-2025 14:57,CBA360D7F7B538A49D987B4,063-000-002,33333333,COMPANY PAYROLL CBA,0,1033.95,460889.13,CR,REF827538,CBA,Current
13-08-2025 14:59,CBAD94CAC5C157D4167A6F3,063-000-002,33333333,LIQUORLAND CBA,25.21,0,460863.92,DR,REF134923,CBA,Current
13-08-2025 15:16,CBA029EE5D830254F549C71,063-000-002,33333333,SALARY PAYMENT CBA,0,365.49,461229.41,CR,REF872390,CBA,Current
13-08-2025 15:23,CBA5B4B8CE5C8074C07B2C5,063-000-002,33333333,FLIXBUS CBA,49.53,0,461179.88,DR,REF645339,CBA,Current
13-08-2025 15:32,INT0A20446B8B94432CBA98,063-000-002,33333333,TRANSFER FROM ANZ 11111111,0,1875.67,463055.55,CR,INT-91209,CBA,Current
13-08-2025 15:49,CBA66562BD7DC1549ADAF2C,063-000-002,33333333,JB HI-FI CBA,44.91,0,463010.64,DR,REF769744,CBA,Current
13-08-2025 16:01,CBAEE09FF79D250403C9781,063-000-002,33333333,LIQUORLAND CBA,99.03,0,462911.61,DR,REF777673,CBA,Current
13-08-2025 16:03,CBAAA80B6D90C494C089679,063-000-002,33333333,RAILWAY STATION CBA,74.05,0,462837.56,DR,REF981821,CBA,Current
13-08-2025 16:16,CBAE7D2A0F3439348C79553,063-000-002,33333333,BWS CBA,63.49,0,462774.07,DR,REF830916,CBA,Current
13-08-2025 16:47,CBAACBF8AD8490447F097A4,063-000-002,33333333,BWS CBA,153.16,0,462620.91,DR,REF366343,CBA,Current
13-08-2025 16:58,CBAC42C1B1C2A844A87BBFE,063-000-002,33333333,7-ELEVEN CBA,14.96,0,462605.95,DR,REF446227,CBA,Current
13-08-2025 17:10,INT141C32CA154A46308B72,063-000-002,33333333,TRANSFER TO NAB 44444444,89.6,0,462516.35,DR,INT-95175,CBA,Current
13-08-2025 17:31,CBAC20781B13AC645E49BC7,063-000-002,33333333,BWS CBA,88.21,0,462428.14,DR,REF248948,CBA,Current
13-08-2025 18:32,CBA0F94BBEA58794DF5995E,063-000-002,33333333,HARVEY NORMAN CBA,54.99,0,462373.15,DR,REF102305,CBA,Current
13-08-2025 18:43,CBAF9CD1720949D482391B6,063-000-002,33333333,INTERNET TRANSFER CBA,6.01,0,462367.14,DR,REF156716,CBA,Current
13-08-2025 20:08,CBA5826E6F0DD01482E8345,063-000-002,33333333,UBER EATS CBA,9.56,0,462357.58,DR,REF976855,CBA,Current
13-08-2025 20:23,CBAAD98C3F6414B4F0AAFD7,063-000-002,33333333,SHELL CBA,143.94,0,462213.64,DR,REF807414,CBA,Current
13-08-2025 20:42,CBAA1AD2D6C9EF542819586,063-000-002,33333333,BP CBA,10,0,462203.64,DR,REF537507,CBA,Current
13-08-2025 20:45,CBA3E4396909A284EB09D37,063-000-002,33333333,APPLE CBA,31.07,0,462172.57,DR,REF534789,CBA,Current
13-08-2025 20:47,CBA414E0206111040D9B188,063-000-002,33333333,ALDI CBA,51.66,0,462120.91,DR,REF385177,CBA,Current
13-08-2025 20:56,CBA67C5A5BF797746F39189,063-000-002,33333333,SALARY PAYMENT CBA,0,7630.47,469751.38,CR,REF679213,CBA,Current
13-08-2025 20:56,CBAF9BD8C4383F6480F96DB,063-000-002,33333333,MENULOG CBA,41.73,0,469709.65,DR,REF110770,CBA,Current
13-08-2025 21:19,CBA1CFD8CD7CBEB468D96A9,063-000-002,33333333,INTERNET TRANSFER CBA,1.48,0,469708.17,DR,REF379279,CBA,Current
13-08-2025 21:40,CBAC2F598DFD35B4E5A9D38,063-000-002,33333333,SPOTIFY CBA,45.87,0,469662.3,DR,REF916773,CBA,Current
13-08-2025 21:53,CBA592DDE4337F1470F9997,063-000-002,33333333,JB HI-FI CBA,21.77,0,469640.53,DR,REF259291,CBA,Current
13-08-2025 22:10,CBA885585D0FD064BAAB079,063-000-002,33333333,7-ELEVEN CBA,6.79,0,469633.74,DR,REF823949,CBA,Current
13-08-2025 22:32,INT5BA6E09139BA4DB5982B,063-000-002,33333333,TRANSFER FROM CBA 22222222,0,1355.21,470988.95,CR,INT-51801,CBA,Current
13-08-2025 22:35,CBA63CB376523CC40758FB1,063-000-002,33333333,COMPANY PAYROLL CBA,0,4671.07,475660.02,CR,REF596660,CBA,Current
13-08-2025 23:00,CBA73B3C15E5A134ECC919A,063-000-002,33333333,BP CBA,21.34,0,475638.68,DR,REF697967,CBA,Current
13-08-2025 23:04,CBA84748330C76542E28920,063-000-002,33333333,RAILWAY STATION CBA,73.17,0,475565.51,DR,REF653733,CBA,Current
13-08-2025 23:07,CBA1E9E4C98000848318CAB,063-000-002,33333333,BIGW CBA,43.4,0,475522.11,DR,REF156820,CBA,Current
13-08-2025 23:30,CBACF085599424D43C5B59F,063-000-002,33333333,PAYMENT GATEWAY CBA,51.68,0,475470.43,DR,REF202883,CBA,Current
14-08-2025 00:10,CBA6FFD4C93E70C47E2B824,063-000-002,33333333,PAY - SALARY CBA,0,40.99,475511.42,CR,REF782303,CBA,Current
14-08-2025 00:34,INT65FA9FD7182A4DBD9121,063-000-002,33333333,TRANSFER TO ANZ 11111111,441.45,0,475069.97,DR,INT-95748,CBA,Current
14-08-2025 00:57,CBABAD483F58EAA438CBA08,063-000-002,33333333,PAYMENT GATEWAY CBA,18.98,0,475050.99,DR,REF384654,CBA,Current
14-08-2025 00:57,CBA97349DB572A64A779DE8,063-000-002,33333333,7-ELEVEN CBA,32.44,0,475018.55,DR,REF349006,CBA,Current
14-08-2025 01:30,CBA4316666F1AF94026ADD2,063-000-002,33333333,7-ELEVEN CBA,115.55,0,474903,DR,REF124179,CBA,Current
14-08-2025 01:40,CBA1B08ADF409E14A3EA200,063-000-002,33333333,UBER EATS CBA,16.17,0,474886.83,DR,REF128456,CBA,Current
14-08-2025 01:48,CBAA0D615B4B9364BF5980C,063-000-002,33333333,7-ELEVEN CBA,36.19,0,474850.64,DR,REF909261,CBA,Current
14-08-2025 02:50,CBA486343CBAD19451BB18B,063-000-002,33333333,WOOLWORTHS CBA,9.07,0,474841.57,DR,REF813444,CBA,Current
14-08-2025 03:36,CBAA1B57CD5A41C41CE8FD3,063-000-002,33333333,ZOOM CBA,47.35,0,474794.22,DR,REF991718,CBA,Current
14-08-2025 03:39,CBA8EA70D8717E04DAB82EE,063-000-002,33333333,INTERNET TRANSFER CBA,28.17,0,474766.05,DR,REF608467,CBA,Current
14-08-2025 04:06,CBA043CF3BFD2DF481E8209,063-000-002,33333333,MCDONALDS CBA,69.51,0,474696.54,DR,REF456748,CBA,Current
14-08-2025 04:18,CBACEC0E2F2877E4EF2B89F,063-000-002,33333333,7-ELEVEN CBA,280.36,0,474416.18,DR,REF814206,CBA,Current
14-08-2025 04:31,CBA045646ACCB0F40FCBE4D,063-000-002,33333333,ALDI CBA,17.8,0,474398.38,DR,REF366817,CBA,Current
14-08-2025 04:51,CBA3E4A6125589546E4856C,063-000-002,33333333,RAILWAY STATION CBA,10.82,0,474387.56,DR,REF939193,CBA,Current
14-08-2025 04:59,CBAF194A5F79CB2417682E2,063-000-002,33333333,WOOLWORTHS CBA,58.4,0,474329.16,DR,REF630579,CBA,Current
14-08-2025 05:09,CBA29AAAE445DF74E048CD1,063-000-002,33333333,SHELL CBA,83.43,0,474245.73,DR,REF203148,CBA,Current
14-08-2025 05:25,CBAE0D3A118A53742158D0E,063-000-002,33333333,WOOLWORTHS CBA,77.69,0,474168.04,DR,REF423986,CBA,Current
14-08-2025 05:36,CBA10564D1B47C24612A20A,063-000-002,33333333,FLIXBUS CBA,20.03,0,474148.01,DR,REF695267,CBA,Current
14-08-2025 06:11,CBAF0B030A0479C4458BD22,063-000-002,33333333,BWS CBA,21.24,0,474126.77,DR,REF474561,CBA,Current
14-08-2025 06:12,CBA33E8E8A879EC44299C82,063-000-002,33333333,SALARY PAYMENT CBA,0,5709.01,479835.78,CR,REF572429,CBA,Current
14-08-2025 06:37,CBA208DAB5049084CC58203,063-000-002,33333333,COMPANY PAYROLL CBA,0,3736.77,483572.55,CR,REF136256,CBA,Current
14-08-2025 06:38,CBA4BE736FBFC694CA4B339,063-000-002,33333333,JB HI-FI CBA,22.01,0,483550.54,DR,REF205101,CBA,Current
14-08-2025 07:55,CBABA2C0E56CE6B45A58070,063-000-002,33333333,WOOLWORTHS CBA,10.95,0,483539.59,DR,REF856338,CBA,Current
14-08-2025 08:31,CBAFBFBF4F83C1C4B52AE7C,063-000-002,33333333,RAILWAY STATION CBA,52.71,0,483486.88,DR,REF722141,CBA,Current
14-08-2025 08:42,CBAF2F90DF47D734235B359,063-000-002,33333333,RAILWAY STATION CBA,10.69,0,483476.19,DR,REF752013,CBA,Current
14-08-2025 08:51,CBA40450E6FDE8249FBAA2E,063-000-002,33333333,HARVEY NORMAN CBA,42.32,0,483433.87,DR,REF197140,CBA,Current
14-08-2025 09:38,CBA854DC2337F6C4566BDCE,063-000-002,33333333,AMAZON AU CBA,28.73,0,483405.14,DR,REF590895,CBA,Current
14-08-2025 09:52,CBAE7E02621780B4A3E854D,063-000-002,33333333,PAYMENT GATEWAY CBA,133.14,0,483272,DR,REF725848,CBA,Current
14-08-2025 10:26,CBA0D1C7A5363154F6981C2,063-000-002,33333333,BIGW CBA,66.79,0,483205.21,DR,REF780928,CBA,Current
14-08-2025 10:32,CBAAD56402E171546E7BA0E,063-000-002,33333333,PAYMENT GATEWAY CBA,53.41,0,483151.8,DR,REF464238,CBA,Current
14-08-2025 10:36,CBA93547821E4154DAAB850,063-000-002,33333333,UBER EATS CBA,11.59,0,483140.21,DR,REF489728,CBA,Current
14-08-2025 11:34,CBAF21B1D7C08FE448A955F,063-000-002,33333333,UBER EATS CBA,175.45,0,482964.76,DR,REF146237,CBA,Current
14-08-2025 11:52,CBA38913354087744C0BFA9,063-000-002,33333333,KFC CBA,65.06,0,482899.7,DR,REF210841,CBA,Current
14-08-2025 11:52,CBAF99DF37401D24918A37A,063-000-002,33333333,CITYLINK CBA,20.37,0,482879.33,DR,REF105844,CBA,Current
14-08-2025 12:02,INT78491453A7124F09A80D,063-000-002,33333333,TRANSFER FROM ANZ 11111111,0,1360.86,484240.19,CR,INT-49946,CBA,Current
14-08-2025 12:06,CBAC76C090447AB4524A863,063-000-002,33333333,FLIXBUS CBA,65.81,0,484174.38,DR,REF814254,CBA,Current
14-08-2025 12:22,CBA4ED39A170DA8469BA382,063-000-002,33333333,KFC CBA,52.27,0,484122.11,DR,REF975252,CBA,Current
14-08-2025 13:03,CBA0F48F473DA46438A91F1,063-000-002,33333333,ALDI CBA,373.5,0,483748.61,DR,REF772818,CBA,Current
14-08-2025 13:24,CBAD377259B37BA4422BA99,063-000-002,33333333,JB HI-FI CBA,73.98,0,483674.63,DR,REF228430,CBA,Current
14-08-2025 13:44,CBA356D6E81250E4467BD7E,063-000-002,33333333,COMPANY PAYROLL CBA,0,3934.55,487609.18,CR,REF979048,CBA,Current
14-08-2025 13:47,CBA462CF7D544A64AE18039,063-000-002,33333333,7-ELEVEN CBA,42.28,0,487566.9,DR,REF676363,CBA,Current
14-08-2025 13:49,CBA29F8A2EC18AC4D918BC1,063-000-002,33333333,FLIXBUS CBA,31.03,0,487535.87,DR,REF477738,CBA,Current
14-08-2025 13:52,CBAB22E4ECE55C246EC8CC9,063-000-002,33333333,UBER EATS CBA,43.83,0,487492.04,DR,REF491475,CBA,Current
14-08-2025 14:18,CBAB08B528D2BCE4A8791DC,063-000-002,33333333,DOMINO'S PIZZA CBA,123.01,0,487369.03,DR,REF891473,CBA,Current
14-08-2025 15:00,CBAAABA068D16C543E6B9BF,063-000-002,33333333,STARBUCKS CBA,37.77,0,487331.26,DR,REF565407,CBA,Current
14-08-2025 15:15,CBAD46C69E17FF1491CB61E,063-000-002,33333333,LIQUORLAND CBA,9.2,0,487322.06,DR,REF427000,CBA,Current
14-08-2025 15:19,CBA54F69651C7414A79BC96,063-000-002,33333333,ZOOM CBA,5.1,0,487316.96,DR,REF473499,CBA,Current
14-08-2025 15:20,CBA4C6320E4FFF6494796ED,063-000-002,33333333,MCDONALDS CBA,41.23,0,487275.73,DR,REF116653,CBA,Current
14-08-2025 15:25,CBA8BB093A88039448BA1C8,063-000-002,33333333,COLES CBA,115.85,0,487159.88,DR,REF577832,CBA,Current
14-08-2025 15:32,CBA72C222CD08A84752B79C,063-000-002,33333333,WOOLWORTHS CBA,14.85,0,487145.03,DR,REF604839,CBA,Current
14-08-2025 16:07,CBABD5323B580034A31897D,063-000-002,33333333,TAFE BOOKSHOP CBA,19.84,0,487125.19,DR,REF129159,CBA,Current
14-08-2025 16:10,CBA41CCBF9106844A89AC2E,063-000-002,33333333,CITYLINK CBA,3.08,0,487122.11,DR,REF320312,CBA,Current
14-08-2025 16:18,CBADE3FE10AB5D140E58055,063-000-002,33333333,BANK FEE CBA,54.95,0,487067.16,DR,REF858426,CBA,Current
14-08-2025 16:56,CBAC19A52E1FC0842C4B5F7,063-000-002,33333333,STARBUCKS CBA,77.77,0,486989.39,DR,REF155207,CBA,Current
14-08-2025 17:27,CBA7CB2FBD65D0F454C9233,063-000-002,33333333,LIQUORLAND CBA,71.94,0,486917.45,DR,REF359275,CBA,Current
14-08-2025 17:53,CBAB060EC2AB3B04D168A58,063-000-002,33333333,DOMINO'S PIZZA CBA,17.82,0,486899.63,DR,REF767011,CBA,Current
14-08-2025 18:00,CBA7EF399510285449FBB7C,063-000-002,33333333,ZOOM CBA,65.46,0,486834.17,DR,REF456903,CBA,Current
14-08-2025 18:26,CBAF580563AD4B240C08BEC,063-000-002,33333333,SPOTIFY CBA,19.62,0,486814.55,DR,REF805631,CBA,Current
14-08-2025 18:27,CBA5239CD91E8E840D5B616,063-000-002,33333333,AMAZON AU CBA,69.17,0,486745.38,DR,REF850230,CBA,Current
14-08-2025 18:46,INT0DB392FB8A594A24A5DE,063-000-002,33333333,TRANSFER TO CBA 22222222,1812.89,0,484932.49,DR,INT-62141,CBA,Current
14-08-2025 18:51,CBA556466132ADD452EB0E7,063-000-002,33333333,ALDI CBA,44.48,0,484888.01,DR,REF308086,CBA,Current
14-08-2025 19:44,CBAEAC1864149AA4593A940,063-000-002,33333333,PAYMENT GATEWAY CBA,9.9,0,484878.11,DR,REF633124,CBA,Current
14-08-2025 19:49,CBA3105817A83FF4A0C92E4,063-000-002,33333333,BP CBA,25.89,0,484852.22,DR,REF520471,CBA,Current
14-08-2025 20:16,CBAF0C6ECBE70F044F1B69D,063-000-002,33333333,ZOOM CBA,25.19,0,484827.03,DR,REF444889,CBA,Current
14-08-2025 20:17,CBA3E21414640F643949190,063-000-002,33333333,UBER EATS CBA,4.42,0,484822.61,DR,REF313288,CBA,Current
14-08-2025 20:23,CBA9B6559BEC72F47478384,063-000-002,33333333,BIGW CBA,12.54,0,484810.07,DR,REF668340,CBA,Current
14-08-2025 21:07,INT38C07CD9FE1A45DB94F6,063-000-002,33333333,TRANSFER FROM ANZ 11111111,0,96.22,484906.29,CR,INT-28409,CBA,Current
14-08-2025 22:19,CBA3CBD70F8BA3F4B30A86D,063-000-002,33333333,COLES CBA,37.77,0,484868.52,DR,REF775916,CBA,Current
14-08-2025 22:45,CBA9AB09149D13541B0AF1B,063-000-002,33333333,MCDONALDS CBA,9.52,0,484859,DR,REF503354,CBA,Current
14-08-2025 23:01,CBA11AE100ACC3D4EBA873C,063-000-002,33333333,RAILWAY STATION CBA,9.25,0,484849.75,DR,REF779839,CBA,Current
14-08-2025 23:04,CBAEB917EA1888A47ED80FB,063-000-002,33333333,MENULOG CBA,64.2,0,484785.55,DR,REF760798,CBA,Current
14-08-2025 23:29,CBAF63465BE9C494A2F80EB,063-000-002,33333333,PAYPAL *NETFLIX CBA,104.49,0,484681.06,DR,REF530499,CBA,Current
14-08-2025 23:39,CBAFCE3D2A086694323A880,063-000-002,33333333,RAILWAY STATION CBA,26.73,0,484654.33,DR,REF163380,CBA,Current
14-08-2025 23:54,CBA075571F2BB484A0A98AA,063-000-002,33333333,JB HI-FI CBA,70.63,0,484583.7,DR,REF784671,CBA,Current
15-08-2025 00:20,CBAE2329B9BCD564A41B685,063-000-002,33333333,PAY - SALARY CBA,0,180.79,484764.49,CR,REF733607,CBA,Current
15-08-2025 00:23,CBA60705A02692A4FB0A746,063-000-002,33333333,BIGW CBA,42.54,0,484721.95,DR,REF368695,CBA,Current
15-08-2025 00:24,CBA15D4CE5643BB4CADBC55,063-000-002,33333333,PAYMENT GATEWAY CBA,18.25,0,484703.7,DR,REF933210,CBA,Current
15-08-2025 00:34,INTFA2C0EEFB10343549F65,063-000-002,33333333,TRANSFER TO ANZ 11111111,1017.99,0,483685.71,DR,INT-26376,CBA,Current
15-08-2025 00:41,CBAB41F54A0AA1F4212AE25,063-000-002,33333333,BANK FEE CBA,31.99,0,483653.72,DR,REF857053,CBA,Current
15-08-2025 01:02,CBA142AB1BDBCB2499F98DC,063-000-002,33333333,DOMINO'S PIZZA CBA,13.6,0,483640.12,DR,REF642582,CBA,Current
15-08-2025 01:04,CBA632BEFCCC4C1480DA11F,063-000-002,33333333,MENULOG CBA,94.47,0,483545.65,DR,REF274372,CBA,Current
15-08-2025 01:14,CBA93A80BA746BB46BE8D30,063-000-002,33333333,PAYMENT GATEWAY CBA,139.56,0,483406.09,DR,REF205755,CBA,Current
15-08-2025 01:25,CBAE0DA9AE78F0F41098ACC,063-000-002,33333333,MCDONALDS CBA,22.74,0,483383.35,DR,REF126553,CBA,Current
15-08-2025 01:31,CBAF7BB0DF0020545ACBF44,063-000-002,33333333,COLES CBA,16.15,0,483367.2,DR,REF916740,CBA,Current
15-08-2025 01:36,CBA8DD7828F21674EE694E8,063-000-002,33333333,DOMINO'S PIZZA CBA,37.59,0,483329.61,DR,REF274396,CBA,Current
15-08-2025 01:49,CBACC57713E88FC42158BDB,063-000-002,33333333,BWS CBA,16.85,0,483312.76,DR,REF961605,CBA,Current
15-08-2025 01:51,CBA9D15B3621C8B45528959,063-000-002,33333333,DOMINO'S PIZZA CBA,7.59,0,483305.17,DR,REF338571,CBA,Current
15-08-2025 02:02,CBAEDF44F15430640AF9611,063-000-002,33333333,ALDI CBA,10.71,0,483294.46,DR,REF939523,CBA,Current
15-08-2025 02:12,CBA5F237C91D2D24B729F71,063-000-002,33333333,BWS CBA,163.1,0,483131.36,DR,REF955145,CBA,Current
15-08-2025 02:22,CBAB3B82C9F96D540F5A656,063-000-002,33333333,JB HI-FI CBA,95.22,0,483036.14,DR,REF982806,CBA,Current
15-08-2025 02:34,CBA6C254304D1DB46688FDE,063-000-002,33333333,UBER EATS CBA,13.41,0,483022.73,DR,REF360995,CBA,Current
15-08-2025 02:35,CBA4C18B2A856BE4B879C09,063-000-002,33333333,UBER EATS CBA,3.58,0,483019.15,DR,REF138206,CBA,Current
15-08-2025 02:35,CBA5D41A1FABBAD432CA94E,063-000-002,33333333,SHELL CBA,58.11,0,482961.04,DR,REF944500,CBA,Current
15-08-2025 02:42,CBAD405DA43085A465AA72E,063-000-002,33333333,WAGES CREDIT CBA,0,7363.76,490324.8,CR,REF968950,CBA,Current
15-08-2025 03:01,CBA570236CAD8EA4307A0CE,063-000-002,33333333,JB HI-FI CBA,34.85,0,490289.95,DR,REF136437,CBA,Current
15-08-2025 04:34,CBA4D51B583C40247BBB758,063-000-002,33333333,WOOLWORTHS CBA,47.01,0,490242.94,DR,REF500905,CBA,Current
15-08-2025 04:40,CBA37B60F8AA2A9495FBAD3,063-000-002,33333333,MCDONALDS CBA,114.96,0,490127.98,DR,REF961206,CBA,Current
15-08-2025 05:36,CBAC3EB54605B514AA0A0A0,063-000-002,33333333,AMAZON AU CBA,10.78,0,490117.2,DR,REF632373,CBA,Current
15-08-2025 05:38,CBADE348060372548AE955B,063-000-002,33333333,WOOLWORTHS CBA,87.02,0,490030.18,DR,REF538259,CBA,Current
15-08-2025 06:51,CBAF8D33425665B47368872,063-000-002,33333333,PAY - SALARY CBA,0,7838.01,497868.19,CR,REF832450,CBA,Current
15-08-2025 06:51,CBA996A613784F6467788C9,063-000-002,33333333,TAFE BOOKSHOP CBA,58.69,0,497809.5,DR,REF609228,CBA,Current
15-08-2025 07:02,CBAD9CBD5EB92FD470F8849,063-000-002,33333333,BP CBA,86.32,0,497723.18,DR,REF181455,CBA,Current
15-08-2025 07:08,CBA80A980DF41D049468941,063-000-002,33333333,BP CBA,25.53,0,497697.65,DR,REF470390,CBA,Current
15-08-2025 07:17,CBA7FD35AE90B604BC08569,063-000-002,33333333,JB HI-FI CBA,85.3,0,497612.35,DR,REF287536,CBA,Current
15-08-2025 07:39,CBAFEA694CB287548D7AD23,063-000-002,33333333,AMAZON AU CBA,84.12,0,497528.23,DR,REF172720,CBA,Current
15-08-2025 07:42,CBAA944106466B94EEC9739,063-000-002,33333333,WOOLWORTHS CBA,34.98,0,497493.25,DR,REF337353,CBA,Current
15-08-2025 07:48,CBA5FE127E7575B4F158F13,063-000-002,33333333,SPOTIFY CBA,113.16,0,497380.09,DR,REF447639,CBA,Current
15-08-2025 08:02,CBA55D5D8BF060F42E19DC1,063-000-002,33333333,FLIXBUS CBA,10.13,0,497369.96,DR,REF185151,CBA,Current
15-08-2025 08:07,CBA4A3D278F0D3E4520B703,063-000-002,33333333,RAILWAY STATION CBA,19.44,0,497350.52,DR,REF821701,CBA,Current
15-08-2025 08:31,CBAE113EB18822C401C8255,063-000-002,33333333,WAGES CREDIT CBA,0,488.37,497838.89,CR,REF984829,CBA,Current
15-08-2025 08:42,CBA80D74744E14B4088B4E0,063-000-002,33333333,RAILWAY STATION CBA,49.47,0,497789.42,DR,REF289570,CBA,Current
15-08-2025 09:00,CBA440D2DC7533C4DFC80CD,063-000-002,33333333,CITYLINK CBA,7.62,0,497781.8,DR,REF261249,CBA,Current
15-08-2025 09:01,CBA749E8A50600B42A2B968,063-000-002,33333333,CITYLINK CBA,58.3,0,497723.5,DR,REF268734,CBA,Current
15-08-2025 09:15,CBA87EB1DFF39B846438351,063-000-002,33333333,WOOLWORTHS CBA,6.97,0,497716.53,DR,REF240363,CBA,Current
15-08-2025 09:37,CBA9032B58B525D46769CD7,063-000-002,33333333,UBER EATS CBA,57.44,0,497659.09,DR,REF835405,CBA,Current
15-08-2025 09:37,CBA91FCC55AA54247E9B03F,063-000-002,33333333,TAFE BOOKSHOP CBA,31.5,0,497627.59,DR,REF999620,CBA,Current
15-08-2025 10:12,CBA7934CC6833E84027947D,063-000-002,33333333,ZOOM CBA,5.79,0,497621.8,DR,REF894404,CBA,Current
15-08-2025 10:31,CBA2DBDF36C58BE4349B700,063-000-002,33333333,WAGES CREDIT CBA,0,181.43,497803.23,CR,REF219133,CBA,Current
15-08-2025 10:40,CBA1A0DD2B84D9143528022,063-000-002,33333333,JB HI-FI CBA,15.74,0,497787.49,DR,REF481872,CBA,Current
15-08-2025 10:52,CBA9EAF4020F4B94F188B75,063-000-002,33333333,7-ELEVEN CBA,94.36,0,497693.13,DR,REF722454,CBA,Current
15-08-2025 10:56,INT52984963763A4ACCA5C7,063-000-002,33333333,TRANSFER FROM ANZ 11111111,0,1918.98,499612.11,CR,INT-59117,CBA,Current
15-08-2025 11:10,CBA1A94B42AD60E4F27A1FF,063-000-002,33333333,BIGW CBA,100.11,0,499512,DR,REF862759,CBA,Current
15-08-2025 11:24,CBAC202F57A85F9462AB49E,063-000-002,33333333,LIQUORLAND CBA,56.42,0,499455.58,DR,REF212043,CBA,Current
15-08-2025 11:38,CBA06664712D4744C1CB01C,063-000-002,33333333,JB HI-FI CBA,87.11,0,499368.47,DR,REF618326,CBA,Current
15-08-2025 11:54,INT9A696C1A5B534D60872E,063-000-002,33333333,TRANSFER FROM ANZ 11111111,0,1910.06,501278.53,CR,INT-70191,CBA,Current
15-08-2025 11:59,INTCAEC23367F3C4F5D807B,063-000-002,33333333,TRANSFER FROM ANZ 11111111,0,1050.6,502329.13,CR,INT-54257,CBA,Current
15-08-2025 12:33,CBA1637CC9103D54CB985D7,063-000-002,33333333,HARVEY NORMAN CBA,40.55,0,502288.58,DR,REF118540,CBA,Current
15-08-2025 12:34,CBACAC42B40D156453B81D3,063-000-002,33333333,STARBUCKS CBA,27.6,0,502260.98,DR,REF114868,CBA,Current
15-08-2025 13:08,CBA9060C404A10F4A8CBE8E,063-000-002,33333333,RAILWAY STATION CBA,13.18,0,502247.8,DR,REF121088,CBA,Current
15-08-2025 13:41,CBA5D5BFB381A8B464DBCA6,063-000-002,33333333,TAFE BOOKSHOP CBA,86.96,0,502160.84,DR,REF753483,CBA,Current
15-08-2025 13:50,CBAB4AADB55E10D4D718F0A,063-000-002,33333333,COLES CBA,13.41,0,502147.43,DR,REF280487,CBA,Current
15-08-2025 14:02,CBA2CC90800109A42629B70,063-000-002,33333333,JB HI-FI CBA,14.5,0,502132.93,DR,REF203616,CBA,Current
15-08-2025 14:29,CBAFCC23BC0F6B848C7944F,063-000-002,33333333,FLIXBUS CBA,30.21,0,502102.72,DR,REF808296,CBA,Current
15-08-2025 14:35,CBA60ADC3D4D0C9493FB6F0,063-000-002,33333333,SALARY PAYMENT CBA,0,2606.95,504709.67,CR,REF567394,CBA,Current
15-08-2025 14:37,CBAD0097C31E7B84D6EBD0D,063-000-002,33333333,RAILWAY STATION CBA,16.99,0,504692.68,DR,REF278140,CBA,Current
15-08-2025 14:39,CBA8134AC025F334EF7BE33,063-000-002,33333333,PAYPAL *NETFLIX CBA,40.54,0,504652.14,DR,REF726273,CBA,Current
15-08-2025 15:48,CBA28C55A283E254A3C84B6,063-000-002,33333333,MENULOG CBA,15.72,0,504636.42,DR,REF732014,CBA,Current
15-08-2025 16:20,CBAE21AAFAF5D984205A011,063-000-002,33333333,PAYPAL *NETFLIX CBA,45.34,0,504591.08,DR,REF514098,CBA,Current
15-08-2025 16:34,CBABDF41F24083043D49FF2,063-000-002,33333333,DOMINO'S PIZZA CBA,6.24,0,504584.84,DR,REF381071,CBA,Current
15-08-2025 16:42,CBA39E0486DC9D74B9C9ADE,063-000-002,33333333,AMAZON AU CBA,26.71,0,504558.13,DR,REF842465,CBA,Current
15-08-2025 16:49,CBA37DD18693FA64B96860F,063-000-002,33333333,RAILWAY STATION CBA,229.08,0,504329.05,DR,REF355735,CBA,Current
15-08-2025 16:53,CBA573084B4D74645938188,063-000-002,33333333,KFC CBA,68.79,0,504260.26,DR,REF633273,CBA,Current
15-08-2025 16:59,CBA592799EEB501409DB31F,063-000-002,33333333,ALDI CBA,58.95,0,504201.31,DR,REF162919,CBA,Current
15-08-2025 17:42,CBAF066399225084D4D9B54,063-000-002,33333333,RAILWAY STATION CBA,16.3,0,504185.01,DR,REF971254,CBA,Current
15-08-2025 18:48,CBAC6F8D1C7B8FD4409B4AC,063-000-002,33333333,COLES CBA,39.98,0,504145.03,DR,REF407687,CBA,Current
15-08-2025 19:39,CBAE20F7CFC37A0430A8496,063-000-002,33333333,COMPANY PAYROLL CBA,0,6802.13,510947.16,CR,REF711755,CBA,Current
15-08-2025 19:53,CBAB2425E64667A49E39144,063-000-002,33333333,WOOLWORTHS CBA,22.67,0,510924.49,DR,REF146011,CBA,Current
15-08-2025 20:13,CBAB53486BF9CD9441FA8CE,063-000-002,33333333,LIQUORLAND CBA,4.18,0,510920.31,DR,REF102417,CBA,Current
15-08-2025 20:15,INT3B0ABEC445F9403DAC1A,063-000-002,33333333,TRANSFER TO NAB 44444444,1061.51,0,509858.8,DR,INT-53988,CBA,Current
15-08-2025 20:27,INT9EE2E854C9734499AE23,063-000-002,33333333,TRANSFER TO ANZ 11111111,659.74,0,509199.06,DR,INT-96122,CBA,Current
15-08-2025 21:10,CBA4CD184D9047745A58631,063-000-002,33333333,FLIXBUS CBA,91.33,0,509107.73,DR,REF757003,CBA,Current
15-08-2025 21:12,CBACD4515C406E04FC7B18D,063-000-002,33333333,DOMINO'S PIZZA CBA,21.37,0,509086.36,DR,REF991929,CBA,Current
15-08-2025 21:23,CBA86446DC369E54ACAB059,063-000-002,33333333,7-ELEVEN CBA,106.75,0,508979.61,DR,REF258188,CBA,Current
15-08-2025 21:51,CBA89F109A24A6C442BB53B,063-000-002,33333333,ZOOM CBA,19.12,0,508960.49,DR,REF525943,CBA,Current
15-08-2025 22:19,CBA30C781373A2E44D48395,063-000-002,33333333,APPLE CBA,27.03,0,508933.46,DR,REF786833,CBA,Current
15-08-2025 22:41,CBAB24D695CA7984E809290,063-000-002,33333333,ALDI CBA,29.13,0,508904.33,DR,REF365193,CBA,Current
15-08-2025 23:01,CBAAEF77D9A142D402D8EAB,063-000-002,33333333,BWS CBA,77.98,0,508826.35,DR,REF703493,CBA,Current
15-08-2025 23:12,INT8EA88BFE63F54A81ABC5,063-000-002,33333333,TRANSFER TO ANZ 11111111,1458.43,0,507367.92,DR,INT-37354,CBA,Current
15-08-2025 23:19,INT60DE4B2506184DC1A668,063-000-002,33333333,TRANSFER TO NAB 44444444,1552.82,0,505815.1,DR,INT-71493,CBA,Current
15-08-2025 23:19,CBA861C04B43F9D44F7A602,063-000-002,33333333,SALARY PAYMENT CBA,0,2510.29,508325.39,CR,REF987243,CBA,Current
15-08-2025 23:45,CBAF87B99A574054656A89B,063-000-002,33333333,WOOLWORTHS CBA,69.64,0,508255.75,DR,REF182393,CBA,Current
15-08-2025 23:55,CBA99D31BC128684B6AA272,063-000-002,33333333,BP CBA,15.08,0,508240.67,DR,REF486297,CBA,Current
16-08-2025 00:09,CBA6C7C38662B784DE593A7,063-000-002,33333333,PAYMENT GATEWAY CBA,17.5,0,508223.17,DR,REF788768,CBA,Current
16-08-2025 00:26,CBA6FF62F38CDA445A3B85C,063-000-002,33333333,HARVEY NORMAN CBA,56.45,0,508166.72,DR,REF333603,CBA,Current
16-08-2025 00:59,CBAF5521A3888FC482FAAF3,063-000-002,33333333,PAYMENT GATEWAY CBA,11.63,0,508155.09,DR,REF589638,CBA,Current
16-08-2025 01:20,CBABFC7F04B8C6646689D96,063-000-002,33333333,MENULOG CBA,10.81,0,508144.28,DR,REF758414,CBA,Current
16-08-2025 01:23,CBA8DD07EF7F4BA481B853B,063-000-002,33333333,AMAZON AU CBA,80.62,0,508063.66,DR,REF675570,CBA,Current
16-08-2025 01:40,CBAB52D1A6D7A524DF99AB6,063-000-002,33333333,PAYPAL *NETFLIX CBA,18.98,0,508044.68,DR,REF408011,CBA,Current
16-08-2025 01:45,CBA4E0AC254F4FE4093BE50,063-000-002,33333333,STARBUCKS CBA,29.46,0,508015.22,DR,REF144115,CBA,Current
16-08-2025 02:11,CBA730D4B1957CA48279C58,063-000-002,33333333,AMAZON AU CBA,176.16,0,507839.06,DR,REF679790,CBA,Current
16-08-2025 02:30,CBAD34F26F3B04E452DAA00,063-000-002,33333333,JB HI-FI CBA,17.92,0,507821.14,DR,REF168019,CBA,Current
16-08-2025 02:34,CBA73E2C12DC7C84523B40B,063-000-002,33333333,BANK FEE CBA,21.97,0,507799.17,DR,REF547922,CBA,Current
16-08-2025 02:37,CBA14433DA0694F41DA8E56,063-000-002,33333333,HARVEY NORMAN CBA,11.65,0,507787.52,DR,REF569562,CBA,Current
16-08-2025 02:44,CBAFC7E86BA1FC541DCAAA9,063-000-002,33333333,SPOTIFY CBA,18.08,0,507769.44,DR,REF637345,CBA,Current
16-08-2025 02:54,CBA895AA9B2F0F349EE99C4,063-000-002,33333333,BP CBA,53.73,0,507715.71,DR,REF235202,CBA,Current
16-08-2025 03:16,CBAB4EA60877D34452D8BDF,063-000-002,33333333,ZOOM CBA,5.87,0,507709.84,DR,REF727491,CBA,Current
16-08-2025 03:32,CBA7BE4C5F156584AA9950F,063-000-002,33333333,FLIXBUS CBA,14.09,0,507695.75,DR,REF242670,CBA,Current
16-08-2025 04:06,CBACB33D1A7898E454A96DD,063-000-002,33333333,ZOOM CBA,27.65,0,507668.1,DR,REF517946,CBA,Current
16-08-2025 04:29,CBA2D3F9F8496F84393A335,063-000-002,33333333,ALDI CBA,2.41,0,507665.69,DR,REF225298,CBA,Current
16-08-2025 05:12,CBA870DE5020A954C80B920,063-000-002,33333333,BANK FEE CBA,11.53,0,507654.16,DR,REF192869,CBA,Current
16-08-2025 05:23,CBAD465F3369F1B480299DF,063-000-002,33333333,FLIXBUS CBA,10.21,0,507643.95,DR,REF276392,CBA,Current
16-08-2025 05:39,CBACA524E1234CD4A54853A,063-000-002,33333333,BWS CBA,11.53,0,507632.42,DR,REF610794,CBA,Current
16-08-2025 05:50,CBA448E75F469B44C139E3B,063-000-002,33333333,PAYROLL CREDIT CBA,0,6947.62,514580.04,CR,REF423530,CBA,Current
16-08-2025 05:55,CBA0F87DA4C1C244EA0A51F,063-000-002,33333333,APPLE CBA,91.55,0,514488.49,DR,REF530743,CBA,Current
16-08-2025 06:22,CBA3A4A3A48E3B04CFCB8F8,063-000-002,33333333,UBER EATS CBA,22.49,0,514466,DR,REF464321,CBA,Current
16-08-2025 06:30,CBAB47756EC5B434A6E8A30,063-000-002,33333333,UBER EATS CBA,13.85,0,514452.15,DR,REF117786,CBA,Current
16-08-2025 06:34,CBABE1DCCC80B9C4113BB76,063-000-002,33333333,WAGES CREDIT CBA,0,4743.38,519195.53,CR,REF674789,CBA,Current
16-08-2025 06:45,CBA6655D76D1EBE457DAEC3,063-000-002,33333333,WOOLWORTHS CBA,61.69,0,519133.84,DR,REF958910,CBA,Current
16-08-2025 07:08,CBA706A3CC3EB584F29976C,063-000-002,33333333,ZOOM CBA,11.79,0,519122.05,DR,REF324546,CBA,Current
16-08-2025 07:28,CBA0689FD21931C422CAD22,063-000-002,33333333,LIQUORLAND CBA,9.43,0,519112.62,DR,REF532953,CBA,Current
16-08-2025 07:35,CBA2D6D49164C2544AD966B,063-000-002,33333333,FLIXBUS CBA,99.7,0,519012.92,DR,REF567104,CBA,Current
16-08-2025 08:12,CBAEB78B7835955420DA89E,063-000-002,33333333,UBER EATS CBA,15.09,0,518997.83,DR,REF253574,CBA,Current
16-08-2025 08:24,CBADABD08072DB148FBA37F,063-000-002,33333333,INTERNET TRANSFER CBA,21.34,0,518976.49,DR,REF289549,CBA,Current
16-08-2025 08:28,CBAC8D57BA43B7141EB8DCE,063-000-002,33333333,BWS CBA,32.71,0,518943.78,DR,REF176466,CBA,Current
16-08-2025 08:37,CBA84F3316BF50149959012,063-000-002,33333333,COLES CBA,19.5,0,518924.28,DR,REF877469,CBA,Current
16-08-2025 09:25,CBA6AAEF6BB5FDF427592F7,063-000-002,33333333,BIGW CBA,37.31,0,518886.97,DR,REF596523,CBA,Current
16-08-2025 09:30,CBAC0D2332A235A4CEAA78C,063-000-002,33333333,CITYLINK CBA,8.29,0,518878.68,DR,REF599752,CBA,Current
16-08-2025 09:34,CBA3DF62E3819844104AFBC,063-000-002,33333333,FLIXBUS CBA,46.63,0,518832.05,DR,REF231971,CBA,Current
16-08-2025 09:42,CBAFB22FDC5DD3C49DDB631,063-000-002,33333333,PAYPAL *NETFLIX CBA,21.61,0,518810.44,DR,REF333415,CBA,Current
16-08-2025 09:57,CBA2F8DAD4152E74B06B08E,063-000-002,33333333,UBER EATS CBA,115.16,0,518695.28,DR,REF857189,CBA,Current
16-08-2025 10:08,CBA87CA0B4EB5C9425BB5F6,063-000-002,33333333,RAILWAY STATION CBA,68.6,0,518626.68,DR,REF290225,CBA,Current
16-08-2025 11:23,CBA8591E8E1EA3A4274BE91,063-000-002,33333333,INTERNET TRANSFER CBA,29.94,0,518596.74,DR,REF516465,CBA,Current
16-08-2025 11:30,CBA066543AC1AB7472DB527,063-000-002,33333333,ZOOM CBA,10.94,0,518585.8,DR,REF352764,CBA,Current
16-08-2025 11:30,CBA84B3732C01C14FF5A5F2,063-000-002,33333333,WOOLWORTHS CBA,28.35,0,518557.45,DR,REF223952,CBA,Current
16-08-2025 11:38,CBA4EECF8F9FA464393B1FE,063-000-002,33333333,SHELL CBA,34.99,0,518522.46,DR,REF567216,CBA,Current
16-08-2025 11:46,CBA74F54C06D102445BA95D,063-000-002,33333333,FLIXBUS CBA,94.61,0,518427.85,DR,REF953386,CBA,Current
16-08-2025 12:48,CBAC47D84682E9F4468B777,063-000-002,33333333,PAYPAL *NETFLIX CBA,44.11,0,518383.74,DR,REF731071,CBA,Current
16-08-2025 13:00,CBAEF9A2DB3A651449F936E,063-000-002,33333333,BANK FEE CBA,14.96,0,518368.78,DR,REF266707,CBA,Current
16-08-2025 13:00,CBAEF36A943DC27490E85E6,063-000-002,33333333,RAILWAY STATION CBA,11.26,0,518357.52,DR,REF375375,CBA,Current
16-08-2025 13:00,CBA600D972C9C31492FA927,063-000-002,33333333,ALDI CBA,120.16,0,518237.36,DR,REF232886,CBA,Current
16-08-2025 13:38,CBA46C17488E5E046A9AC68,063-000-002,33333333,INTERNET TRANSFER CBA,74.16,0,518163.2,DR,REF228501,CBA,Current
16-08-2025 13:41,CBA46D625F4D4554A0DB2D3,063-000-002,33333333,SALARY PAYMENT CBA,0,6310.77,524473.97,CR,REF741900,CBA,Current
16-08-2025 14:59,CBAE199F8D4E5A6485A815F,063-000-002,33333333,BANK FEE CBA,15.84,0,524458.13,DR,REF890754,CBA,Current
16-08-2025 15:04,CBA92D386A73726434C83C8,063-000-002,33333333,APPLE CBA,70.52,0,524387.61,DR,REF570596,CBA,Current
16-08-2025 15:07,CBAD479765DEAF943419FFF,063-000-002,33333333,ALDI CBA,33.85,0,524353.76,DR,REF887656,CBA,Current
16-08-2025 15:16,CBA626EAF299E394F7F896A,063-000-002,33333333,FLIXBUS CBA,66.71,0,524287.05,DR,REF643705,CBA,Current
16-08-2025 16:04,CBAB57BD786807B4028A95B,063-000-002,33333333,COLES CBA,6.35,0,524280.7,DR,REF228935,CBA,Current
16-08-2025 16:24,CBA3369C21F57F64F95875C,063-000-002,33333333,BP CBA,33.91,0,524246.79,DR,REF135853,CBA,Current
16-08-2025 16:41,INTDA48BB72350C49F68D01,063-000-002,33333333,TRANSFER TO CBA 22222222,449.18,0,523797.61,DR,INT-40658,CBA,Current
16-08-2025 16:50,CBA7792FC0BEEBD488887DE,063-000-002,33333333,COLES CBA,139.32,0,523658.29,DR,REF684231,CBA,Current
16-08-2025 16:57,CBA648E8D2D77A949A0B043,063-000-002,33333333,SPOTIFY CBA,9.04,0,523649.25,DR,REF882740,CBA,Current
16-08-2025 17:14,CBADE2B032FE4CA417DBFDF,063-000-002,33333333,INTERNET TRANSFER CBA,111.37,0,523537.88,DR,REF535690,CBA,Current
16-08-2025 17:29,CBA6DADC35CE4FA419C87A6,063-000-002,33333333,WOOLWORTHS CBA,43.62,0,523494.26,DR,REF595451,CBA,Current
16-08-2025 17:52,CBA1F84E540F5F44D138ADD,063-000-002,33333333,RAILWAY STATION CBA,19.67,0,523474.59,DR,REF289252,CBA,Current
16-08-2025 18:56,CBA12369D1A8A554175A9A0,063-000-002,33333333,PAYPAL *NETFLIX CBA,38.83,0,523435.76,DR,REF688872,CBA,Current
16-08-2025 19:02,CBAEEE36A3331574A6C8D43,063-000-002,33333333,CITYLINK CBA,73.91,0,523361.85,DR,REF432192,CBA,Current
16-08-2025 19:10,CBA916DA8C6952C48A8B2ED,063-000-002,33333333,JB HI-FI CBA,5.4,0,523356.45,DR,REF971960,CBA,Current
16-08-2025 19:10,CBAE9BB7ACB203E4A24A8BB,063-000-002,33333333,CITYLINK CBA,21.41,0,523335.04,DR,REF825068,CBA,Current
16-08-2025 19:24,CBABF28A390EEF047EE9614,063-000-002,33333333,ZOOM CBA,7.36,0,523327.68,DR,REF365589,CBA,Current
16-08-2025 19:53,CBA88FEE4C79F79418DB4FD,063-000-002,33333333,JB HI-FI CBA,64.06,0,523263.62,DR,REF342775,CBA,Current
16-08-2025 19:54,CBA43DA491361A14637BC8E,063-000-002,33333333,COLES CBA,9.94,0,523253.68,DR,REF605493,CBA,Current
16-08-2025 19:57,CBA376387AFA7E84082A00F,063-000-002,33333333,MENULOG CBA,24.65,0,523229.03,DR,REF213714,CBA,Current
16-08-2025 20:08,CBA797114E6900E487BA628,063-000-002,33333333,AMAZON AU CBA,29.06,0,523199.97,DR,REF104631,CBA,Current
16-08-2025 20:10,CBAB984D46F2ADA4296B59B,063-000-002,33333333,PAYROLL CREDIT CBA,0,1032.28,524232.25,CR,REF583225,CBA,Current
16-08-2025 20:12,CBA5A5CE462468B444AA15F,063-000-002,33333333,BANK FEE CBA,13.89,0,524218.36,DR,REF335878,CBA,Current
16-08-2025 20:44,CBA3201F1681B004891B4E6,063-000-002,33333333,BP CBA,18.48,0,524199.88,DR,REF680119,CBA,Current
16-08-2025 21:43,CBA7DD129BFD23A48FD886D,063-000-002,33333333,BP CBA,72.3,0,524127.58,DR,REF428379,CBA,Current
16-08-2025 22:07,CBA8B1B0242049B416D86A3,063-000-002,33333333,MENULOG CBA,16.32,0,524111.26,DR,REF186213,CBA,Current
16-08-2025 22:07,CBA42D1550339A243ED8F7F,063-000-002,33333333,AMAZON AU CBA,277.25,0,523834.01,DR,REF985637,CBA,Current
16-08-2025 22:23,CBA8E587465878A44F9AA24,063-000-002,33333333,AMAZON AU CBA,63.26,0,523770.75,DR,REF334955,CBA,Current
16-08-2025 22:47,CBAD06E24A3669E4CB5931F,063-000-002,33333333,APPLE CBA,11.56,0,523759.19,DR,REF188465,CBA,Current
16-08-2025 22:59,CBA7203AE36295F4D6AA26E,063-000-002,33333333,TAFE BOOKSHOP CBA,13.27,0,523745.92,DR,REF239564,CBA,Current
16-08-2025 23:09,CBA4472D4F4A9FF4844962F,063-000-002,33333333,WAGES CREDIT CBA,0,5198.43,528944.35,CR,REF763358,CBA,Current
16-08-2025 23:24,CBA82C81CF0488047838D6B,063-000-002,33333333,PAYROLL CREDIT CBA,0,5780.44,534724.79,CR,REF459012,CBA,Current
16-08-2025 23:32,CBABCFCB7C142C04CC58EF8,063-000-002,33333333,JB HI-FI CBA,60.86,0,534663.93,DR,REF787753,CBA,Current
16-08-2025 23:39,CBA5261B34C144D42598CEE,063-000-002,33333333,PAYMENT GATEWAY CBA,12.26,0,534651.67,DR,REF977187,CBA,Current
17-08-2025 00:17,CBA4CB79FDAF5114AE79120,063-000-002,33333333,ALDI CBA,10.26,0,534641.41,DR,REF912919,CBA,Current
17-08-2025 00:19,CBA19F7D2648FBB4352ADA5,063-000-002,33333333,ZOOM CBA,150.84,0,534490.57,DR,REF643247,CBA,Current
17-08-2025 00:36,INTA8DD2F098DC74EE78361,063-000-002,33333333,TRANSFER FROM NAB 44444444,0,1195.27,535685.84,CR,INT-86761,CBA,Current
17-08-2025 00:41,CBAB0DA2E809ECF4301BD51,063-000-002,33333333,BP CBA,16.37,0,535669.47,DR,REF797272,CBA,Current
17-08-2025 00:51,CBAE862D10FC25749BE91B0,063-000-002,33333333,AMAZON AU CBA,10.54,0,535658.93,DR,REF905491,CBA,Current
17-08-2025 01:20,CBA9B704603E1E94363974D,063-000-002,33333333,ALDI CBA,139.02,0,535519.91,DR,REF913064,CBA,Current
17-08-2025 01:38,CBAD7AD935C55E34234B28F,063-000-002,33333333,APPLE CBA,45.81,0,535474.1,DR,REF919445,CBA,Current
17-08-2025 02:05,CBA23790F06826B40DDA797,063-000-002,33333333,MCDONALDS CBA,41.91,0,535432.19,DR,REF657169,CBA,Current
17-08-2025 02:14,CBA1C39B91FA3464586BCD6,063-000-002,33333333,KFC CBA,5.9,0,535426.29,DR,REF159268,CBA,Current
17-08-2025 03:17,CBA17A89FA8F61D4CE0AF6F,063-000-002,33333333,BANK FEE CBA,4.53,0,535421.76,DR,REF191231,CBA,Current
17-08-2025 03:18,CBA85BC303E22354DEA882C,063-000-002,33333333,INTERNET TRANSFER CBA,73.97,0,535347.79,DR,REF411999,CBA,Current
17-08-2025 03:19,CBA6ABCACE4C9264A83B574,063-000-002,33333333,CITYLINK CBA,28.6,0,535319.19,DR,REF898732,CBA,Current
17-08-2025 03:31,CBA93C544F85EFA4D15833B,063-000-002,33333333,7-ELEVEN CBA,6.84,0,535312.35,DR,REF792498,CBA,Current
17-08-2025 03:38,CBAB7D32D114FB0445C920F,063-000-002,33333333,BIGW CBA,3.55,0,535308.8,DR,REF997138,CBA,Current
17-08-2025 03:41,CBA74747A15ACF94038B00D,063-000-002,33333333,AMAZON AU CBA,58.87,0,535249.93,DR,REF160684,CBA,Current
17-08-2025 03:42,CBAD1630BB09D014ED1BA3A,063-000-002,33333333,SHELL CBA,20.58,0,535229.35,DR,REF730799,CBA,Current
17-08-2025 04:33,CBA25FEF91CB69F4BB68D71,063-000-002,33333333,SALARY PAYMENT CBA,0,6104.3,541333.65,CR,REF944917,CBA,Current
17-08-2025 05:10,CBA79194DF2C4AD4791BA14,063-000-002,33333333,LIQUORLAND CBA,13.89,0,541319.76,DR,REF804031,CBA,Current
17-08-2025 05:11,CBA1D19341F99BF442C8203,063-000-002,33333333,PAY - SALARY CBA,0,7619.83,548939.59,CR,REF942588,CBA,Current
17-08-2025 05:27,CBA44E8B45486324EB1ABA0,063-000-002,33333333,PAYPAL *NETFLIX CBA,86.75,0,548852.84,DR,REF864514,CBA,Current
17-08-2025 06:01,CBADFC2E0CDB8F1425092B3,063-000-002,33333333,INTERNET TRANSFER CBA,102.43,0,548750.41,DR,REF479091,CBA,Current
17-08-2025 06:09,CBAE0B2A65E4D8145929D5E,063-000-002,33333333,BANK FEE CBA,31.97,0,548718.44,DR,REF762892,CBA,Current
17-08-2025 06:14,CBA1C42C944F4074C82B17F,063-000-002,33333333,CITYLINK CBA,29.65,0,548688.79,DR,REF916837,CBA,Current
17-08-2025 06:23,CBAEEDABC387DD2409995FE,063-000-002,33333333,RAILWAY STATION CBA,25.71,0,548663.08,DR,REF421688,CBA,Current
17-08-2025 06:27,CBA2B43636EDFCE4CF5B01F,063-000-002,33333333,RAILWAY STATION CBA,144.26,0,548518.82,DR,REF639793,CBA,Current
17-08-2025 06:56,CBA833F41E7D3434F78B674,063-000-002,33333333,LIQUORLAND CBA,43.35,0,548475.47,DR,REF988898,CBA,Current
17-08-2025 06:57,CBA2B13EC1FA8904490B82C,063-000-002,33333333,ZOOM CBA,58.68,0,548416.79,DR,REF816878,CBA,Current
17-08-2025 07:20,CBAD954C25958134E99AA0E,063-000-002,33333333,PAYROLL CREDIT CBA,0,6133.68,554550.47,CR,REF208920,CBA,Current
17-08-2025 07:22,CBA47C43CA271024260A46C,063-000-002,33333333,COLES CBA,7.76,0,554542.71,DR,REF495242,CBA,Current
17-08-2025 07:48,CBACA936748DE3D4F80AB05,063-000-002,33333333,WAGES CREDIT CBA,0,3210.34,557753.05,CR,REF497486,CBA,Current
17-08-2025 08:00,CBA870F3AB9EF93402F8BA8,063-000-002,33333333,PAYPAL *NETFLIX CBA,101.11,0,557651.94,DR,REF856361,CBA,Current
17-08-2025 08:00,CBA763B49437A0D44A5A596,063-000-002,33333333,7-ELEVEN CBA,55.01,0,557596.93,DR,REF984612,CBA,Current
17-08-2025 08:00,CBA9200391EF0F74A5E90AC,063-000-002,33333333,JB HI-FI CBA,79.55,0,557517.38,DR,REF848593,CBA,Current
17-08-2025 08:04,CBA654BF36704614D4A881B,063-000-002,33333333,BANK FEE CBA,4.17,0,557513.21,DR,REF649057,CBA,Current
17-08-2025 08:19,CBA591B5D1A75CF4EE9A457,063-000-002,33333333,7-ELEVEN CBA,54.75,0,557458.46,DR,REF833315,CBA,Current
17-08-2025 09:22,CBA293F2F8CB12642098D86,063-000-002,33333333,JB HI-FI CBA,66.44,0,557392.02,DR,REF536685,CBA,Current
17-08-2025 09:31,CBA85799B73DCB24734960F,063-000-002,33333333,JB HI-FI CBA,11.3,0,557380.72,DR,REF936995,CBA,Current
17-08-2025 09:31,CBA51F5DB7BBEB940C1B842,063-000-002,33333333,SALARY PAYMENT CBA,0,759.11,558139.83,CR,REF476187,CBA,Current
17-08-2025 09:59,CBA85E4E1BE2F824122BAA8,063-000-002,33333333,PAYPAL *NETFLIX CBA,36.61,0,558103.22,DR,REF152054,CBA,Current
17-08-2025 10:48,CBACC1035B474E24D6FB4AD,063-000-002,33333333,WOOLWORTHS CBA,71.86,0,558031.36,DR,REF660035,CBA,Current
17-08-2025 11:59,CBACC857F6237D34FA88EDC,063-000-002,33333333,BANK FEE CBA,48.71,0,557982.65,DR,REF345413,CBA,Current
17-08-2025 12:10,CBAB270BEAEBD9047D5801D,063-000-002,33333333,LIQUORLAND CBA,161.74,0,557820.91,DR,REF860873,CBA,Current
17-08-2025 12:10,CBAA06A7047DBB14352B804,063-000-002,33333333,HARVEY NORMAN CBA,60.98,0,557759.93,DR,REF573035,CBA,Current
17-08-2025 12:15,CBA623E9E16D2CE41B5A8F2,063-000-002,33333333,RAILWAY STATION CBA,13.07,0,557746.86,DR,REF796119,CBA,Current
17-08-2025 12:20,CBAF5694DB309C7429A89D3,063-000-002,33333333,7-ELEVEN CBA,11.49,0,557735.37,DR,REF361319,CBA,Current
17-08-2025 12:22,CBA8054D9AC68BE4F78A071,063-000-002,33333333,AMAZON AU CBA,82.74,0,557652.63,DR,REF890668,CBA,Current
17-08-2025 12:42,CBA03D428D3352544D699D3,063-000-002,33333333,7-ELEVEN CBA,111.86,0,557540.77,DR,REF108683,CBA,Current
17-08-2025 13:39,CBAADCB03F8A93E4DC5B270,063-000-002,33333333,PAYROLL CREDIT CBA,0,3363.83,560904.6,CR,REF636077,CBA,Current
17-08-2025 13:59,CBA57C491A2889246D8916C,063-000-002,33333333,CITYLINK CBA,54.18,0,560850.42,DR,REF157736,CBA,Current
17-08-2025 14:11,CBA00B555B9F64E4D2F9D2B,063-000-002,33333333,ZOOM CBA,45.54,0,560804.88,DR,REF254948,CBA,Current
17-08-2025 14:12,CBA5F358A4C53CA49F7B961,063-000-002,33333333,HARVEY NORMAN CBA,48.64,0,560756.24,DR,REF608335,CBA,Current
17-08-2025 14:30,INT3F92E9C0E40A44DCA85B,063-000-002,33333333,TRANSFER TO CBA 22222222,1256.54,0,559499.7,DR,INT-40286,CBA,Current
17-08-2025 14:41,CBA6635DBF2DCC545E88DD8,063-000-002,33333333,WOOLWORTHS CBA,107.28,0,559392.42,DR,REF864155,CBA,Current
17-08-2025 14:42,CBA07F873F96E3E40458A43,063-000-002,33333333,CITYLINK CBA,109.96,0,559282.46,DR,REF689677,CBA,Current
17-08-2025 14:42,CBA89E8D33859C84182A00C,063-000-002,33333333,AMAZON AU CBA,61.76,0,559220.7,DR,REF579181,CBA,Current
17-08-2025 15:01,CBA7791C7D08C8746D7B03A,063-000-002,33333333,PAYMENT GATEWAY CBA,99.76,0,559120.94,DR,REF362574,CBA,Current
17-08-2025 15:06,CBAD4360BFA99F04043BDBD,063-000-002,33333333,PAYROLL CREDIT CBA,0,4183.24,563304.18,CR,REF169592,CBA,Current
17-08-2025 15:10,CBA7CBD355C69D24157B2D8,063-000-002,33333333,CITYLINK CBA,95.72,0,563208.46,DR,REF140033,CBA,Current
17-08-2025 15:16,CBA0A0AD224070744DD9FCF,063-000-002,33333333,COMPANY PAYROLL CBA,0,6694.24,569902.7,CR,REF347857,CBA,Current
17-08-2025 15:22,CBAF0BAA6BAC3524A598442,063-000-002,33333333,AMAZON AU CBA,39.38,0,569863.32,DR,REF885524,CBA,Current
17-08-2025 15:36,INT243309D325CA4057AC35,063-000-002,33333333,TRANSFER TO NAB 44444444,787.92,0,569075.4,DR,INT-54331,CBA,Current
17-08-2025 15:41,CBAB7C648F9C4EA40FAAF63,063-000-002,33333333,PAYPAL *NETFLIX CBA,22,0,569053.4,DR,REF362713,CBA,Current
17-08-2025 16:13,CBA11C76F52FF1746A2B029,063-000-002,33333333,COMPANY PAYROLL CBA,0,1892.46,570945.86,CR,REF989868,CBA,Current
17-08-2025 16:21,CBA8E3C1A57709E4332A449,063-000-002,33333333,UBER EATS CBA,6.36,0,570939.5,DR,REF105512,CBA,Current
17-08-2025 16:22,CBA74659BD0EB584FCBB6B3,063-000-002,33333333,STARBUCKS CBA,52.62,0,570886.88,DR,REF711235,CBA,Current
17-08-2025 16:39,CBAF61C88B27B574078B4E3,063-000-002,33333333,INTERNET TRANSFER CBA,16.56,0,570870.32,DR,REF841705,CBA,Current
17-08-2025 16:55,CBA38DB69C498C24F7CA65C,063-000-002,33333333,MCDONALDS CBA,43.89,0,570826.43,DR,REF152935,CBA,Current
17-08-2025 16:58,CBA807B2C79E429425492A5,063-000-002,33333333,CITYLINK CBA,49.26,0,570777.17,DR,REF721352,CBA,Current
17-08-2025 17:02,CBA533CA98C56694DCEAE0E,063-000-002,33333333,AMAZON AU CBA,18.01,0,570759.16,DR,REF195029,CBA,Current
17-08-2025 17:04,CBA81D9E7AA715C4B4BADE3,063-000-002,33333333,FLIXBUS CBA,39.72,0,570719.44,DR,REF575307,CBA,Current
17-08-2025 17:32,CBA82D3A677B99D413DAC49,063-000-002,33333333,DOMINO'S PIZZA CBA,4.82,0,570714.62,DR,REF102711,CBA,Current
17-08-2025 17:43,CBA69D13AB83DB847908CA2,063-000-002,33333333,MCDONALDS CBA,14.28,0,570700.34,DR,REF721685,CBA,Current
17-08-2025 17:49,CBA40E1C3C94F214F88A52F,063-000-002,33333333,TAFE BOOKSHOP CBA,90.09,0,570610.25,DR,REF770366,CBA,Current
17-08-2025 17:58,CBA93F4B171457648D2ACAC,063-000-002,33333333,STARBUCKS CBA,99.78,0,570510.47,DR,REF822814,CBA,Current
17-08-2025 18:23,CBAD0904D0353E94925803A,063-000-002,33333333,HARVEY NORMAN CBA,27.74,0,570482.73,DR,REF786867,CBA,Current
17-08-2025 19:49,CBA86F6A3A270064E60941F,063-000-002,33333333,PAYROLL CREDIT CBA,0,1868.4,572351.13,CR,REF493556,CBA,Current
17-08-2025 19:52,CBA516C41646903491AA4E5,063-000-002,33333333,7-ELEVEN CBA,54.37,0,572296.76,DR,REF903526,CBA,Current
17-08-2025 20:01,CBA6AD706A8314D44DEAAEE,063-000-002,33333333,INTERNET TRANSFER CBA,73.98,0,572222.78,DR,REF198003,CBA,Current
17-08-2025 20:24,CBA5F98C90D0303423EA80B,063-000-002,33333333,HARVEY NORMAN CBA,39.33,0,572183.45,DR,REF867544,CBA,Current
17-08-2025 20:59,CBAE77E2F4F6ACF4912A694,063-000-002,33333333,TAFE BOOKSHOP CBA,7.77,0,572175.68,DR,REF731216,CBA,Current
17-08-2025 20:59,CBA6B972262324D418E8342,063-000-002,33333333,WOOLWORTHS CBA,62.08,0,572113.6,DR,REF181909,CBA,Current
17-08-2025 21:37,CBA9D0ADE934B654CB39361,063-000-002,33333333,BP CBA,108.44,0,572005.16,DR,REF838726,CBA,Current
17-08-2025 21:43,CBABBDF5832D26D46288F6A,063-000-002,33333333,PAYROLL CREDIT CBA,0,1024.53,573029.69,CR,REF597051,CBA,Current
17-08-2025 22:24,CBA02C6F386B23F48FD835D,063-000-002,33333333,BIGW CBA,11.56,0,573018.13,DR,REF418837,CBA,Current
17-08-2025 22:32,CBADAE45C496AEC420E8B80,063-000-002,33333333,MENULOG CBA,53.97,0,572964.16,DR,REF271934,CBA,Current
17-08-2025 22:44,CBA3277A3CDF1BF4AE1AC21,063-000-002,33333333,RAILWAY STATION CBA,22.99,0,572941.17,DR,REF659696,CBA,Current
17-08-2025 23:01,CBA5FDC21CD37F449EA81FB,063-000-002,33333333,DOMINO'S PIZZA CBA,5.97,0,572935.2,DR,REF362262,CBA,Current
17-08-2025 23:03,CBA8F749FDB735D4AC5B1A6,063-000-002,33333333,WAGES CREDIT CBA,0,2667.17,575602.37,CR,REF661240,CBA,Current
17-08-2025 23:06,CBABE591C38D8F64772A845,063-000-002,33333333,CITYLINK CBA,15.04,0,575587.33,DR,REF443725,CBA,Current
17-08-2025 23:08,CBAF7A1FF7EF5E14AB78838,063-000-002,33333333,JB HI-FI CBA,80.95,0,575506.38,DR,REF726055,CBA,Current
17-08-2025 23:10,CBAC006764E3D87416A9122,063-000-002,33333333,7-ELEVEN CBA,107.05,0,575399.33,DR,REF220259,CBA,Current
17-08-2025 23:51,CBAE9C6A9EF447F4EDA8893,063-000-002,33333333,DOMINO'S PIZZA CBA,90.15,0,575309.18,DR,REF957891,CBA,Current
18-08-2025 00:33,CBA600A7A1F058842CC807E,063-000-002,33333333,HARVEY NORMAN CBA,22.81,0,575286.37,DR,REF103268,CBA,Current
18-08-2025 00:52,CBA90CC98A506B948B9ACB3,063-000-002,33333333,SALARY PAYMENT CBA,0,2964.78,578251.15,CR,REF886651,CBA,Current
18-08-2025 01:00,CBAEB3279E95F0B4EAD9D75,063-000-002,33333333,BIGW CBA,200.82,0,578050.33,DR,REF936798,CBA,Current
18-08-2025 01:26,CBA4F93CF73823945798FD0,063-000-002,33333333,BWS CBA,3.64,0,578046.69,DR,REF108281,CBA,Current
18-08-2025 02:22,CBA77E1C2D6FEF54739B2AF,063-000-002,33333333,SHELL CBA,39.23,0,578007.46,DR,REF983792,CBA,Current
18-08-2025 02:48,CBA59DC0A0DD1AD445FB5F0,063-000-002,33333333,ALDI CBA,77.29,0,577930.17,DR,REF973558,CBA,Current
18-08-2025 02:48,CBA883FF5D1F4B547AABF4E,063-000-002,33333333,SHELL CBA,17.5,0,577912.67,DR,REF825861,CBA,Current
18-08-2025 03:59,CBABD239B352CBF4754BE97,063-000-002,33333333,DOMINO'S PIZZA CBA,20.09,0,577892.58,DR,REF916300,CBA,Current
18-08-2025 04:36,CBA04FA1281D4274F3590C2,063-000-002,33333333,DOMINO'S PIZZA CBA,70.79,0,577821.79,DR,REF951969,CBA,Current
18-08-2025 04:36,CBAC0D79E8519444129BF1B,063-000-002,33333333,TAFE BOOKSHOP CBA,12.18,0,577809.61,DR,REF108812,CBA,Current
18-08-2025 05:01,CBA274A08248FD74053AEE3,063-000-002,33333333,PAY - SALARY CBA,0,1127.22,578936.83,CR,REF579676,CBA,Current
18-08-2025 05:02,CBAD8F29B47B71F4F54844C,063-000-002,33333333,SALARY PAYMENT CBA,0,7068.95,586005.78,CR,REF671104,CBA,Current
18-08-2025 05:23,CBA76A3274738B84FC194BC,063-000-002,33333333,MCDONALDS CBA,76.13,0,585929.65,DR,REF864304,CBA,Current
18-08-2025 06:13,CBA091F38E964BC423BB9A0,063-000-002,33333333,INTERNET TRANSFER CBA,36.3,0,585893.35,DR,REF134917,CBA,Current
18-08-2025 06:27,CBA1C609E705AFA4DEE8F63,063-000-002,33333333,UBER EATS CBA,23.76,0,585869.59,DR,REF627093,CBA,Current
18-08-2025 06:42,CBA86CFBB8B4E7543AC8865,063-000-002,33333333,MCDONALDS CBA,95.14,0,585774.45,DR,REF832742,CBA,Current
18-08-2025 07:07,CBAD3DAF467B3554F4597C2,063-000-002,33333333,WAGES CREDIT CBA,0,4780.34,590554.79,CR,REF301329,CBA,Current
18-08-2025 07:10,CBAB9BE6BF537CF4325B2B8,063-000-002,33333333,HARVEY NORMAN CBA,62.04,0,590492.75,DR,REF852425,CBA,Current
18-08-2025 07:45,CBA6B9FE8CB70CC475FB1E0,063-000-002,33333333,PAYMENT GATEWAY CBA,102.96,0,590389.79,DR,REF800473,CBA,Current
18-08-2025 08:54,CBA78FE5906FF7A470CA95A,063-000-002,33333333,STARBUCKS CBA,19.39,0,590370.4,DR,REF848063,CBA,Current
18-08-2025 09:05,CBA06356822C56F4C22AB45,063-000-002,33333333,SPOTIFY CBA,78.42,0,590291.98,DR,REF879731,CBA,Current
18-08-2025 09:24,CBA453CFBAE3DAE4F12BB5B,063-000-002,33333333,DOMINO'S PIZZA CBA,55.64,0,590236.34,DR,REF762531,CBA,Current
18-08-2025 10:05,CBA1F373ED06AC64702AE49,063-000-002,33333333,7-ELEVEN CBA,39.65,0,590196.69,DR,REF167215,CBA,Current
18-08-2025 10:14,CBACA7C6499D32B4C778507,063-000-002,33333333,ALDI CBA,57.23,0,590139.46,DR,REF343773,CBA,Current
18-08-2025 10:23,CBA011B59E1924640C5AFB7,063-000-002,33333333,JB HI-FI CBA,12.4,0,590127.06,DR,REF363503,CBA,Current
18-08-2025 10:25,CBA1269ED068BCE44999D2E,063-000-002,33333333,APPLE CBA,4.93,0,590122.13,DR,REF742722,CBA,Current
18-08-2025 10:39,CBA39CDB1AA21BC4FC8A968,063-000-002,33333333,MCDONALDS CBA,50.62,0,590071.51,DR,REF263561,CBA,Current
18-08-2025 10:51,CBA24292CE1B7984C1591F6,063-000-002,33333333,COLES CBA,84.77,0,589986.74,DR,REF200418,CBA,Current
18-08-2025 11:12,INT69D0FB74E8AD437794C6,063-000-002,33333333,TRANSFER FROM ANZ 11111111,0,997.48,590984.22,CR,INT-25872,CBA,Current
18-08-2025 11:15,INTE9047270FB7C49C790BC,063-000-002,33333333,TRANSFER TO CBA 22222222,1379.29,0,589604.93,DR,INT-70040,CBA,Current
18-08-2025 11:22,CBA01A8E922CEBD4D6BB653,063-000-002,33333333,PAYROLL CREDIT CBA,0,5681.49,595286.42,CR,REF846916,CBA,Current
18-08-2025 11:40,CBA42EEA788BE88488F8C60,063-000-002,33333333,APPLE CBA,38.29,0,595248.13,DR,REF601057,CBA,Current
18-08-2025 11:47,CBAE0C7923A2049458CA9A5,063-000-002,33333333,LIQUORLAND CBA,19.37,0,595228.76,DR,REF249386,CBA,Current
18-08-2025 12:50,CBA3B8220A2B2FF4B87B1BC,063-000-002,33333333,BANK FEE CBA,14.64,0,595214.12,DR,REF235566,CBA,Current
18-08-2025 13:01,CBAF71C71EAB2804717843C,063-000-002,33333333,WAGES CREDIT CBA,0,5656.95,600871.07,CR,REF895737,CBA,Current
18-08-2025 13:03,CBA56D3A980636544458B83,063-000-002,33333333,PAYMENT GATEWAY CBA,32.9,0,600838.17,DR,REF694690,CBA,Current
18-08-2025 13:26,CBA7F077D10FCB04DB3911F,063-000-002,33333333,PAYROLL CREDIT CBA,0,2246.95,603085.12,CR,REF953079,CBA,Current
18-08-2025 13:35,CBA6124FFFD3DF9487283B6,063-000-002,33333333,BANK FEE CBA,2.35,0,603082.77,DR,REF209601,CBA,Current
18-08-2025 14:41,INT0409B4376D8647209775,063-000-002,33333333,TRANSFER FROM ANZ 11111111,0,116.9,603199.67,CR,INT-32326,CBA,Current
18-08-2025 14:53,CBA3447B2DE1BC44B269FFF,063-000-002,33333333,AMAZON AU CBA,61.54,0,603138.13,DR,REF252072,CBA,Current
18-08-2025 15:11,CBAE78FF72444434D0C8751,063-000-002,33333333,DOMINO'S PIZZA CBA,28.73,0,603109.4,DR,REF671595,CBA,Current
18-08-2025 15:44,CBA57F35130EFF74FD4A357,063-000-002,33333333,TAFE BOOKSHOP CBA,11.51,0,603097.89,DR,REF980372,CBA,Current
18-08-2025 16:07,CBADE6D7CBEF06D41FAB2AB,063-000-002,33333333,INTERNET TRANSFER CBA,20.94,0,603076.95,DR,REF911228,CBA,Current
18-08-2025 16:28,CBA83768FBA923945E1A792,063-000-002,33333333,PAYROLL CREDIT CBA,0,7993.34,611070.29,CR,REF435802,CBA,Current
18-08-2025 16:32,CBABA9188C8A1C44539BF48,063-000-002,33333333,CITYLINK CBA,46.95,0,611023.34,DR,REF815144,CBA,Current
18-08-2025 16:35,CBAA63650C3544D4D01A2E5,063-000-002,33333333,INTERNET TRANSFER CBA,29.06,0,610994.28,DR,REF333345,CBA,Current
18-08-2025 16:40,CBAA604A9C7908048E09EA1,063-000-002,33333333,MCDONALDS CBA,8.79,0,610985.49,DR,REF710733,CBA,Current
18-08-2025 17:15,CBA323B5AF78A9246F28DEE,063-000-002,33333333,SALARY PAYMENT CBA,0,4438.93,615424.42,CR,REF844413,CBA,Current
18-08-2025 17:47,CBAF0A8A151B9724589A10F,063-000-002,33333333,SHELL CBA,6.71,0,615417.71,DR,REF146674,CBA,Current
18-08-2025 18:09,CBABE1666ED551A4A409343,063-000-002,33333333,CITYLINK CBA,50.81,0,615366.9,DR,REF623453,CBA,Current
18-08-2025 18:17,CBA09E4645763DB4FA38424,063-000-002,33333333,UBER EATS CBA,138.23,0,615228.67,DR,REF259577,CBA,Current
18-08-2025 18:26,CBA6E619E952D8443A7BE46,063-000-002,33333333,APPLE CBA,31.33,0,615197.34,DR,REF567822,CBA,Current
18-08-2025 18:49,CBA32C5E3948EEF44F1B76D,063-000-002,33333333,BP CBA,12.57,0,615184.77,DR,REF475991,CBA,Current
18-08-2025 18:53,CBA8CBDAB489A0945978A43,063-000-002,33333333,APPLE CBA,231.57,0,614953.2,DR,REF490873,CBA,Current
18-08-2025 19:31,CBA54B0D9C958E643E8B8D5,063-000-002,33333333,COLES CBA,14.28,0,614938.92,DR,REF729287,CBA,Current
18-08-2025 20:02,CBAB9E662E892914ADB9AE8,063-000-002,33333333,HARVEY NORMAN CBA,188.96,0,614749.96,DR,REF312413,CBA,Current
18-08-2025 20:06,CBAEB8962E40D3542058B0B,063-000-002,33333333,MCDONALDS CBA,22.89,0,614727.07,DR,REF666742,CBA,Current
18-08-2025 20:42,CBAE125D4B3746A4AE7BD4B,063-000-002,33333333,ZOOM CBA,228.51,0,614498.56,DR,REF212502,CBA,Current
18-08-2025 21:02,CBAB34154720695430B8881,063-000-002,33333333,WOOLWORTHS CBA,21.57,0,614476.99,DR,REF261879,CBA,Current
18-08-2025 21:06,CBA22B298312A6F4A7B96DF,063-000-002,33333333,INTERNET TRANSFER CBA,7.7,0,614469.29,DR,REF676705,CBA,Current
18-08-2025 21:29,CBA7C9F05B2A6F345B1A086,063-000-002,33333333,UBER EATS CBA,175.63,0,614293.66,DR,REF224187,CBA,Current
18-08-2025 21:37,CBA2CFF217EA700496C8479,063-000-002,33333333,BP CBA,27,0,614266.66,DR,REF843050,CBA,Current
18-08-2025 22:16,CBA9CF56364CBAF4336AE2C,063-000-002,33333333,PAYMENT GATEWAY CBA,4.48,0,614262.18,DR,REF480039,CBA,Current
18-08-2025 22:21,CBAB561BADF158D43358726,063-000-002,33333333,ALDI CBA,48.82,0,614213.36,DR,REF390707,CBA,Current
18-08-2025 22:23,CBA24C2C51F92494D759DEC,063-000-002,33333333,ZOOM CBA,159.05,0,614054.31,DR,REF392364,CBA,Current
18-08-2025 22:27,CBA1073E3ED07A84DD49EB9,063-000-002,33333333,SPOTIFY CBA,121.39,0,613932.92,DR,REF457766,CBA,Current
18-08-2025 22:52,CBAD2D1914E499E442C836E,063-000-002,33333333,LIQUORLAND CBA,1.98,0,613930.94,DR,REF522111,CBA,Current
18-08-2025 22:55,CBADC53419BB15448969A26,063-000-002,33333333,PAYROLL CREDIT CBA,0,2579.73,616510.67,CR,REF360938,CBA,Current
18-08-2025 23:26,CBAFD47E79FDF33476896E2,063-000-002,33333333,SALARY PAYMENT CBA,0,7835.22,624345.89,CR,REF928319,CBA,Current
18-08-2025 23:42,CBA4E5878140ACC4C11B89F,063-000-002,33333333,WOOLWORTHS CBA,105.18,0,624240.71,DR,REF866958,CBA,Current
18-08-2025 23:58,CBABE95E0780F184213A827,063-000-002,33333333,WOOLWORTHS CBA,35.35,0,624205.36,DR,REF111624,CBA,Current
19-08-2025 00:26,CBA468A6489D22C4358A59F,063-000-002,33333333,INTERNET TRANSFER CBA,25.28,0,624180.08,DR,REF444687,CBA,Current
19-08-2025 00:40,CBAC88D2B035D71435E95A0,063-000-002,33333333,INTERNET TRANSFER CBA,28.21,0,624151.87,DR,REF964464,CBA,Current
19-08-2025 00:49,CBA7D7347FAE3CD4F1E906D,063-000-002,33333333,BANK FEE CBA,54.94,0,624096.93,DR,REF721021,CBA,Current
19-08-2025 01:10,CBA49C127D2016A489F8559,063-000-002,33333333,WAGES CREDIT CBA,0,260.83,624357.76,CR,REF427236,CBA,Current
19-08-2025 01:14,CBACA48A5BD85BD4BEABDC8,063-000-002,33333333,CITYLINK CBA,21.55,0,624336.21,DR,REF298396,CBA,Current
19-08-2025 01:29,CBA1BC7C82C5F494EBFB359,063-000-002,33333333,SHELL CBA,6.51,0,624329.7,DR,REF840663,CBA,Current
19-08-2025 01:42,CBA6366672DB7FC4D849335,063-000-002,33333333,SPOTIFY CBA,18.05,0,624311.65,DR,REF920572,CBA,Current
19-08-2025 01:54,CBAC59CD7B8B72B43D8B631,063-000-002,33333333,ALDI CBA,5.14,0,624306.51,DR,REF403658,CBA,Current
19-08-2025 02:01,CBA1EF0B475F7984E2DB351,063-000-002,33333333,MCDONALDS CBA,22.96,0,624283.55,DR,REF301986,CBA,Current
19-08-2025 02:20,CBABA419035996B4194963C,063-000-002,33333333,7-ELEVEN CBA,11.59,0,624271.96,DR,REF130004,CBA,Current
19-08-2025 02:28,CBAE88DBC179C7E4D22BE2C,063-000-002,33333333,RAILWAY STATION CBA,73.55,0,624198.41,DR,REF478228,CBA,Current
19-08-2025 02:28,CBA3EC78ABC05D74B5CB659,063-000-002,33333333,WOOLWORTHS CBA,95.21,0,624103.2,DR,REF154716,CBA,Current
19-08-2025 03:05,CBABA83FCADB5864C7B800F,063-000-002,33333333,TAFE BOOKSHOP CBA,10.92,0,624092.28,DR,REF671745,CBA,Current
19-08-2025 03:08,CBACFE79FBB937D41F8AA48,063-000-002,33333333,UBER EATS CBA,37.89,0,624054.39,DR,REF738914,CBA,Current
19-08-2025 03:36,CBA79FD894FF6CC45C689F1,063-000-002,33333333,ALDI CBA,13.18,0,624041.21,DR,REF279581,CBA,Current
19-08-2025 03:38,CBAD6FFACEE159B42B5BF08,063-000-002,33333333,COLES CBA,3.76,0,624037.45,DR,REF443325,CBA,Current
19-08-2025 03:51,CBAC93187295BEA4E6E99ED,063-000-002,33333333,DOMINO'S PIZZA CBA,81.54,0,623955.91,DR,REF173657,CBA,Current
19-08-2025 03:58,CBA7B3D6934B4A0490EBB80,063-000-002,33333333,CITYLINK CBA,220.51,0,623735.4,DR,REF720895,CBA,Current
19-08-2025 03:58,CBA56339E20F8F74A8085CE,063-000-002,33333333,LIQUORLAND CBA,40.95,0,623694.45,DR,REF175482,CBA,Current
19-08-2025 05:11,CBACB0F92A92969464F8B32,063-000-002,33333333,BWS CBA,9.08,0,623685.37,DR,REF962441,CBA,Current
19-08-2025 05:16,CBAFF9BC8E6B42D4353BBA6,063-000-002,33333333,KFC CBA,25.49,0,623659.88,DR,REF145133,CBA,Current
19-08-2025 05:19,CBA032E5016359F484AB4D8,063-000-002,33333333,PAY - SALARY CBA,0,588.84,624248.72,CR,REF626339,CBA,Current
19-08-2025 05:21,CBAE6D8DAC9F2EF4B1385B9,063-000-002,33333333,COLES CBA,2.92,0,624245.8,DR,REF562809,CBA,Current
19-08-2025 05:40,CBA07FFD2E417044A61AAF1,063-000-002,33333333,BANK FEE CBA,183.31,0,624062.49,DR,REF291204,CBA,Current
19-08-2025 06:08,CBA49EEA4BD479941C094A1,063-000-002,33333333,SALARY PAYMENT CBA,0,1093.21,625155.7,CR,REF985634,CBA,Current
19-08-2025 06:36,CBAB8303B556897449A8F71,063-000-002,33333333,SPOTIFY CBA,24.72,0,625130.98,DR,REF433044,CBA,Current
19-08-2025 06:53,CBADB02B93667F34FA2A737,063-000-002,33333333,BWS CBA,19.5,0,625111.48,DR,REF217251,CBA,Current
19-08-2025 07:21,CBAE54B7D05A992473DB86F,063-000-002,33333333,WAGES CREDIT CBA,0,7642.06,632753.54,CR,REF752542,CBA,Current
19-08-2025 07:44,CBA2747C0FCEDFB407F987F,063-000-002,33333333,WOOLWORTHS CBA,7.09,0,632746.45,DR,REF891090,CBA,Current
19-08-2025 07:59,INT937C7670FCBC4B609344,063-000-002,33333333,TRANSFER FROM CBA 22222222,0,872.33,633618.78,CR,INT-30926,CBA,Current
19-08-2025 08:34,CBA77F21EA1EF45415BB07B,063-000-002,33333333,SHELL CBA,11.2,0,633607.58,DR,REF645970,CBA,Current
19-08-2025 08:48,CBA8CFEAC6DC99942809971,063-000-002,33333333,7-ELEVEN CBA,81.2,0,633526.38,DR,REF727935,CBA,Current
19-08-2025 09:10,CBA8902B8882016454BA5CF,063-000-002,33333333,COLES CBA,28.99,0,633497.39,DR,REF919335,CBA,Current
19-08-2025 09:13,CBA7FA79AD4A3E84253BBAA,063-000-002,33333333,STARBUCKS CBA,30.2,0,633467.19,DR,REF195307,CBA,Current
19-08-2025 09:13,CBA1044DDCEAC8C45A2B6E7,063-000-002,33333333,RAILWAY STATION CBA,6.92,0,633460.27,DR,REF630076,CBA,Current
19-08-2025 09:23,CBAF1C7089D58644EA3A9E4,063-000-002,33333333,COMPANY PAYROLL CBA,0,194.36,633654.63,CR,REF537120,CBA,Current
19-08-2025 09:25,CBA70DE0E11BDBD4F88A363,063-000-002,33333333,FLIXBUS CBA,98.38,0,633556.25,DR,REF687474,CBA,Current
19-08-2025 09:39,CBA2A38253D0C814E1FB048,063-000-002,33333333,BANK FEE CBA,47.08,0,633509.17,DR,REF249376,CBA,Current
19-08-2025 09:49,CBA30CE2D0F9E0D4039A412,063-000-002,33333333,RAILWAY STATION CBA,225.22,0,633283.95,DR,REF336505,CBA,Current
19-08-2025 09:56,CBADF8FD6C286E24387A568,063-000-002,33333333,WOOLWORTHS CBA,191.61,0,633092.34,DR,REF449510,CBA,Current
19-08-2025 10:00,CBA5816AD328B994BA98352,063-000-002,33333333,BIGW CBA,28.44,0,633063.9,DR,REF471686,CBA,Current
19-08-2025 10:22,CBA54F16BF019234F45A8E5,063-000-002,33333333,ALDI CBA,38.68,0,633025.22,DR,REF191980,CBA,Current
19-08-2025 10:41,CBABBEB27337344429EBF44,063-000-002,33333333,SPOTIFY CBA,51.16,0,632974.06,DR,REF180811,CBA,Current
19-08-2025 10:42,CBA9D8CD9E403E54151A4AB,063-000-002,33333333,AMAZON AU CBA,13.34,0,632960.72,DR,REF501353,CBA,Current
19-08-2025 11:10,CBA994D2C7C07154EBDB570,063-000-002,33333333,JB HI-FI CBA,21.53,0,632939.19,DR,REF791358,CBA,Current
19-08-2025 11:37,CBAAD20363F234C48E7B979,063-000-002,33333333,JB HI-FI CBA,3.68,0,632935.51,DR,REF163585,CBA,Current
19-08-2025 12:09,CBA16779038816B47B2BEB1,063-000-002,33333333,FLIXBUS CBA,201.53,0,632733.98,DR,REF447421,CBA,Current
19-08-2025 12:33,CBA088F2E9997764B72B61F,063-000-002,33333333,MCDONALDS CBA,70.85,0,632663.13,DR,REF619424,CBA,Current
19-08-2025 12:37,CBAB8FCCE0848014E92853F,063-000-002,33333333,INTERNET TRANSFER CBA,49.11,0,632614.02,DR,REF482900,CBA,Current
19-08-2025 12:53,CBAF20AC6DC815A4F6C8692,063-000-002,33333333,KFC CBA,72.51,0,632541.51,DR,REF781608,CBA,Current
19-08-2025 14:16,CBAEB8A91CD84D44922B3D5,063-000-002,33333333,MENULOG CBA,119.22,0,632422.29,DR,REF568375,CBA,Current
19-08-2025 14:20,CBA2692A642CBC94F538A27,063-000-002,33333333,LIQUORLAND CBA,98.91,0,632323.38,DR,REF409024,CBA,Current
19-08-2025 14:27,CBA62FF2423BC6E4340A8D8,063-000-002,33333333,BANK FEE CBA,105.74,0,632217.64,DR,REF172990,CBA,Current
19-08-2025 14:37,CBA60D3BBC6705542D08759,063-000-002,33333333,HARVEY NORMAN CBA,43.44,0,632174.2,DR,REF319215,CBA,Current
19-08-2025 14:44,CBA2F00A13918CD4A83ACBF,063-000-002,33333333,7-ELEVEN CBA,44.56,0,632129.64,DR,REF237255,CBA,Current
19-08-2025 15:27,CBA3970FB22D56F46299F06,063-000-002,33333333,HARVEY NORMAN CBA,40.63,0,632089.01,DR,REF839601,CBA,Current
19-08-2025 16:00,CBA95D8B728275C413BA02C,063-000-002,33333333,HARVEY NORMAN CBA,59.11,0,632029.9,DR,REF461702,CBA,Current
19-08-2025 16:07,CBAC9A41AC95487495186B0,063-000-002,33333333,DOMINO'S PIZZA CBA,14.22,0,632015.68,DR,REF406304,CBA,Current
19-08-2025 16:23,CBA00949D3C221E4F0D94C0,063-000-002,33333333,APPLE CBA,123.28,0,631892.4,DR,REF929033,CBA,Current
19-08-2025 16:28,INT95493940A1EB4DC79B54,063-000-002,33333333,TRANSFER FROM CBA 22222222,0,1513.7,633406.1,CR,INT-60238,CBA,Current
19-08-2025 16:59,CBA8CE06F8CAA2D4F15B114,063-000-002,33333333,WOOLWORTHS CBA,148.04,0,633258.06,DR,REF518009,CBA,Current
19-08-2025 17:05,CBA8246FD650ABE4736B946,063-000-002,33333333,WAGES CREDIT CBA,0,6440.89,639698.95,CR,REF786809,CBA,Current
19-08-2025 17:44,CBAEE4934E402054726A83E,063-000-002,33333333,BANK FEE CBA,7.03,0,639691.92,DR,REF802684,CBA,Current
19-08-2025 17:51,CBA7B00F5A6F9D14E949B82,063-000-002,33333333,LIQUORLAND CBA,8.76,0,639683.16,DR,REF540255,CBA,Current
19-08-2025 17:57,INT4A520BE5F6A34E95805F,063-000-002,33333333,TRANSFER TO CBA 22222222,1189.37,0,638493.79,DR,INT-21943,CBA,Current
19-08-2025 18:23,CBA2E76F5EA69174C50ACD4,063-000-002,33333333,KFC CBA,118.6,0,638375.19,DR,REF869575,CBA,Current
19-08-2025 18:45,INT848BF651FCD744FE8DF6,063-000-002,33333333,TRANSFER FROM NAB 44444444,0,1094.67,639469.86,CR,INT-28782,CBA,Current
19-08-2025 19:10,CBA4B6741E8A68C40E69136,063-000-002,33333333,JB HI-FI CBA,16.05,0,639453.81,DR,REF583108,CBA,Current
19-08-2025 19:21,CBAB4744B5AB9704C68872B,063-000-002,33333333,SALARY PAYMENT CBA,0,4163.33,643617.14,CR,REF762909,CBA,Current
19-08-2025 20:00,CBA6EF9C5EC671044539176,063-000-002,33333333,COLES CBA,19.23,0,643597.91,DR,REF952636,CBA,Current
19-08-2025 20:16,CBA49BA5BBFD8D843D49C79,063-000-002,33333333,STARBUCKS CBA,51.8,0,643546.11,DR,REF334016,CBA,Current
19-08-2025 20:18,CBA78E49006B3F0494BB3E0,063-000-002,33333333,UBER EATS CBA,30.98,0,643515.13,DR,REF291981,CBA,Current
19-08-2025 20:56,CBA5EB0B076889C4AAEB9B2,063-000-002,33333333,PAYROLL CREDIT CBA,0,1092.96,644608.09,CR,REF596700,CBA,Current
19-08-2025 21:05,CBA49DB5CA3FB174F43BA20,063-000-002,33333333,7-ELEVEN CBA,2.23,0,644605.86,DR,REF561251,CBA,Current
19-08-2025 21:07,CBAFFAE208CCBFD444C9A07,063-000-002,33333333,SHELL CBA,6.1,0,644599.76,DR,REF359959,CBA,Current
19-08-2025 23:10,CBAFCCD9EB8B8C74C6A9AD9,063-000-002,33333333,RAILWAY STATION CBA,22.96,0,644576.8,DR,REF932963,CBA,Current
19-08-2025 23:17,CBA178909E2D7EA4538890B,063-000-002,33333333,CITYLINK CBA,61.96,0,644514.84,DR,REF970343,CBA,Current
19-08-2025 23:17,CBA035E4EDB17E54139AF41,063-000-002,33333333,BANK FEE CBA,12.28,0,644502.56,DR,REF749644,CBA,Current
19-08-2025 23:43,CBAD349CDB4374E4A40B1AF,063-000-002,33333333,DOMINO'S PIZZA CBA,86.8,0,644415.76,DR,REF451413,CBA,Current
20-08-2025 00:00,CBA4B882F752EE046C69B2F,063-000-002,33333333,PAYROLL CREDIT CBA,0,991.82,645407.58,CR,REF208945,CBA,Current
20-08-2025 00:14,CBA448E651FBD924E1D97FD,063-000-002,33333333,TAFE BOOKSHOP CBA,12.4,0,645395.18,DR,REF364750,CBA,Current
20-08-2025 00:28,CBA525046A7C6E84C6DA66A,063-000-002,33333333,PAYMENT GATEWAY CBA,19.29,0,645375.89,DR,REF610230,CBA,Current
20-08-2025 00:42,CBA59515EC7FF094E0FB1FA,063-000-002,33333333,WOOLWORTHS CBA,63.3,0,645312.59,DR,REF446789,CBA,Current
20-08-2025 01:08,CBA5236E6BBB47E4E5E9963,063-000-002,33333333,MCDONALDS CBA,54.36,0,645258.23,DR,REF656653,CBA,Current
20-08-2025 01:30,CBA1797D2FA9FD1438793E3,063-000-002,33333333,ZOOM CBA,117.44,0,645140.79,DR,REF443381,CBA,Current
20-08-2025 01:33,CBA69CBD6EAD689464A8DEF,063-000-002,33333333,FLIXBUS CBA,17.56,0,645123.23,DR,REF696806,CBA,Current
20-08-2025 01:47,CBACCEBBA9FF9B8436E9E69,063-000-002,33333333,UBER EATS CBA,1.89,0,645121.34,DR,REF522696,CBA,Current
20-08-2025 02:07,CBAA3EF90FB7F8D4D8BADC3,063-000-002,33333333,PAYPAL *NETFLIX CBA,29.39,0,645091.95,DR,REF975021,CBA,Current
20-08-2025 02:12,CBA056F90E6B22241B78900,063-000-002,33333333,KFC CBA,31.41,0,645060.54,DR,REF777866,CBA,Current
20-08-2025 02:27,INTA243AC73C4A34CDA90FE,063-000-002,33333333,TRANSFER TO ANZ 11111111,638.3,0,644422.24,DR,INT-36503,CBA,Current
20-08-2025 02:48,CBA7895C144948A4E89BF55,063-000-002,33333333,INTERNET TRANSFER CBA,2.93,0,644419.31,DR,REF890274,CBA,Current
20-08-2025 02:59,CBA880579BA1B454B3CA3E9,063-000-002,33333333,COLES CBA,9.62,0,644409.69,DR,REF590338,CBA,Current
20-08-2025 03:06,CBA2E78D72CA4A342529CAF,063-000-002,33333333,INTERNET TRANSFER CBA,57.95,0,644351.74,DR,REF462895,CBA,Current
20-08-2025 03:40,CBAC82223F57977417F9F86,063-000-002,33333333,LIQUORLAND CBA,12.17,0,644339.57,DR,REF949069,CBA,Current
20-08-2025 03:42,CBA24580443F3D24A10A59D,063-000-002,33333333,UBER EATS CBA,37.67,0,644301.9,DR,REF105251,CBA,Current
20-08-2025 03:50,CBA50503AC89D2A4EF487AC,063-000-002,33333333,MCDONALDS CBA,6.64,0,644295.26,DR,REF510082,CBA,Current
20-08-2025 03:56,CBA0DDC9FF2EBEB46FEBFC3,063-000-002,33333333,ZOOM CBA,38.66,0,644256.6,DR,REF749814,CBA,Current
20-08-2025 04:04,CBA5C1CB8ED3A474ADEBC11,063-000-002,33333333,DOMINO'S PIZZA CBA,78.24,0,644178.36,DR,REF479032,CBA,Current
20-08-2025 04:10,CBA8CE5A3D21AD04656A360,063-000-002,33333333,KFC CBA,9.16,0,644169.2,DR,REF649770,CBA,Current
20-08-2025 04:41,CBA55129445285640A1A39E,063-000-002,33333333,LIQUORLAND CBA,40.98,0,644128.22,DR,REF945111,CBA,Current
20-08-2025 04:54,CBACBDE3192F5CA4C7FB3AC,063-000-002,33333333,UBER EATS CBA,157.35,0,643970.87,DR,REF824117,CBA,Current
20-08-2025 05:06,CBA54EDF442867140EB9BD2,063-000-002,33333333,HARVEY NORMAN CBA,23.24,0,643947.63,DR,REF516704,CBA,Current
20-08-2025 05:08,CBA3A1B146AE0E1481AA87C,063-000-002,33333333,STARBUCKS CBA,72.05,0,643875.58,DR,REF743322,CBA,Current
20-08-2025 05:19,CBAFA6A452ED9B94FE7A2C6,063-000-002,33333333,ZOOM CBA,103.44,0,643772.14,DR,REF165861,CBA,Current
20-08-2025 05:21,CBADDBAB96DD2644AD193A9,063-000-002,33333333,PAYMENT GATEWAY CBA,10.1,0,643762.04,DR,REF233150,CBA,Current
20-08-2025 05:36,CBA631F3FC879A34FB39504,063-000-002,33333333,ZOOM CBA,71.37,0,643690.67,DR,REF485246,CBA,Current
20-08-2025 05:39,CBABDE7A3AACA424D179C96,063-000-002,33333333,COLES CBA,66.36,0,643624.31,DR,REF267233,CBA,Current
20-08-2025 06:26,CBA73E071A7F32F4A82BF6E,063-000-002,33333333,BANK FEE CBA,5.62,0,643618.69,DR,REF110985,CBA,Current
20-08-2025 06:43,CBA411100861E8D4FBD9FB7,063-000-002,33333333,INTERNET TRANSFER CBA,19.65,0,643599.04,DR,REF584592,CBA,Current
20-08-2025 06:55,CBAD4AC00AB6F0448BEA5CC,063-000-002,33333333,JB HI-FI CBA,49.68,0,643549.36,DR,REF794199,CBA,Current
20-08-2025 07:20,CBA5BCF941D47334382A692,063-000-002,33333333,APPLE CBA,8.44,0,643540.92,DR,REF249341,CBA,Current
20-08-2025 07:27,CBA86541EEBD5CC4DF6805E,063-000-002,33333333,SPOTIFY CBA,38.23,0,643502.69,DR,REF506021,CBA,Current
20-08-2025 07:29,CBA7D332A5088FB452B8792,063-000-002,33333333,WAGES CREDIT CBA,0,447.85,643950.54,CR,REF475946,CBA,Current
20-08-2025 07:33,CBA3257F884B7BE4281BCB7,063-000-002,33333333,FLIXBUS CBA,44.64,0,643905.9,DR,REF106570,CBA,Current
20-08-2025 07:49,CBA7A602286E5B04C14885C,063-000-002,33333333,FLIXBUS CBA,17.33,0,643888.57,DR,REF287190,CBA,Current
20-08-2025 07:49,CBAEC5ED00FC350413CA319,063-000-002,33333333,7-ELEVEN CBA,77.34,0,643811.23,DR,REF639450,CBA,Current
20-08-2025 07:54,CBAF8DF4BDA9B1D46479929,063-000-002,33333333,UBER EATS CBA,3.41,0,643807.82,DR,REF738067,CBA,Current
20-08-2025 08:01,CBA25FF68C7A8134FA9B0C0,063-000-002,33333333,HARVEY NORMAN CBA,49.71,0,643758.11,DR,REF412682,CBA,Current
20-08-2025 08:08,CBAFA27386077CE4FB3B34B,063-000-002,33333333,WOOLWORTHS CBA,51.44,0,643706.67,DR,REF790798,CBA,Current
20-08-2025 08:32,CBADEEBEEE74C694AA5A63E,063-000-002,33333333,FLIXBUS CBA,83.98,0,643622.69,DR,REF716574,CBA,Current
20-08-2025 08:36,CBABB3FA275304E4C07B6B7,063-000-002,33333333,PAYROLL CREDIT CBA,0,6991.47,650614.16,CR,REF519689,CBA,Current
20-08-2025 09:24,CBA8A5A6642AE50425BB221,063-000-002,33333333,HARVEY NORMAN CBA,89.73,0,650524.43,DR,REF642079,CBA,Current
20-08-2025 10:06,CBA23DCB744CF504F71A8F5,063-000-002,33333333,UBER EATS CBA,139.78,0,650384.65,DR,REF848726,CBA,Current
20-08-2025 10:19,CBA40763F08C5F44719B314,063-000-002,33333333,COLES CBA,23.79,0,650360.86,DR,REF332399,CBA,Current
20-08-2025 10:28,CBA368D98F888D9406FBB35,063-000-002,33333333,TAFE BOOKSHOP CBA,18.37,0,650342.49,DR,REF878615,CBA,Current
20-08-2025 10:57,CBA099DA893946F4314B48A,063-000-002,33333333,AMAZON AU CBA,74.75,0,650267.74,DR,REF718171,CBA,Current
20-08-2025 11:04,INT845C5B5362B64EE2B6AD,063-000-002,33333333,TRANSFER TO ANZ 11111111,887.17,0,649380.57,DR,INT-20576,CBA,Current
20-08-2025 11:21,CBAD040798D5B36425FBC6F,063-000-002,33333333,CITYLINK CBA,11.09,0,649369.48,DR,REF135401,CBA,Current
20-08-2025 11:37,CBA6654C112ECD84F23AD04,063-000-002,33333333,SALARY PAYMENT CBA,0,6887.66,656257.14,CR,REF613761,CBA,Current
20-08-2025 11:40,CBA9207FCFA13F94471A580,063-000-002,33333333,ZOOM CBA,5.82,0,656251.32,DR,REF175653,CBA,Current
20-08-2025 12:23,CBA4AFEDDB9479A48E5855F,063-000-002,33333333,HARVEY NORMAN CBA,43.02,0,656208.3,DR,REF563529,CBA,Current
20-08-2025 12:31,CBA5B80CFD5C6804F3192E0,063-000-002,33333333,RAILWAY STATION CBA,20.94,0,656187.36,DR,REF995252,CBA,Current
20-08-2025 12:48,CBAFF254E67293248CF88F5,063-000-002,33333333,SPOTIFY CBA,41.67,0,656145.69,DR,REF218218,CBA,Current
20-08-2025 13:39,CBA9DFDBD4EDBBD4BE49F6A,063-000-002,33333333,PAYROLL CREDIT CBA,0,7924.62,664070.31,CR,REF193816,CBA,Current
20-08-2025 13:53,CBAB9F90C6EC0DE4D9EA9D2,063-000-002,33333333,APPLE CBA,41.58,0,664028.73,DR,REF568456,CBA,Current
20-08-2025 14:09,CBA01A8DA921A9F4E0BAE42,063-000-002,33333333,AMAZON AU CBA,12.08,0,664016.65,DR,REF857354,CBA,Current
20-08-2025 14:10,CBA88160BED53964826B91D,063-000-002,33333333,PAY - SALARY CBA,0,3371.06,667387.71,CR,REF648645,CBA,Current
20-08-2025 14:19,CBA2ABEFB3510ED4F588A6D,063-000-002,33333333,KFC CBA,60.45,0,667327.26,DR,REF438783,CBA,Current
20-08-2025 14:46,CBA7703810923F14C36BDF1,063-000-002,33333333,SPOTIFY CBA,20.15,0,667307.11,DR,REF689066,CBA,Current
20-08-2025 15:01,CBA8B0CB941F700428A817E,063-000-002,33333333,COLES CBA,7.8,0,667299.31,DR,REF998089,CBA,Current
20-08-2025 15:09,CBA16FAC1A3DDD346939D3D,063-000-002,33333333,PAYROLL CREDIT CBA,0,1126.54,668425.85,CR,REF848423,CBA,Current
20-08-2025 15:18,CBAA270D03C7E3741C88BD9,063-000-002,33333333,LIQUORLAND CBA,39.95,0,668385.9,DR,REF457555,CBA,Current
20-08-2025 15:26,CBA5085BC38B3F14E00B729,063-000-002,33333333,BANK FEE CBA,4.49,0,668381.41,DR,REF275444,CBA,Current
20-08-2025 15:31,CBAE3E8277F22A24CDEAA45,063-000-002,33333333,ZOOM CBA,60.34,0,668321.07,DR,REF854943,CBA,Current
20-08-2025 15:42,CBAABB5A8D9DDF748018661,063-000-002,33333333,SHELL CBA,54.37,0,668266.7,DR,REF725452,CBA,Current
20-08-2025 16:28,CBA088E19987E1C4C399C04,063-000-002,33333333,7-ELEVEN CBA,84.91,0,668181.79,DR,REF562229,CBA,Current
20-08-2025 16:28,CBAE35FBE345ED24B2A90F7,063-000-002,33333333,COMPANY PAYROLL CBA,0,6209.94,674391.73,CR,REF511656,CBA,Current
20-08-2025 16:29,CBA595ECBDD14DC421AA920,063-000-002,33333333,KFC CBA,66.34,0,674325.39,DR,REF520367,CBA,Current
20-08-2025 16:40,CBA9473DE0B82934DBC9A50,063-000-002,33333333,7-ELEVEN CBA,63.13,0,674262.26,DR,REF452447,CBA,Current
20-08-2025 17:37,CBAFA08C029B78945A69A46,063-000-002,33333333,INTERNET TRANSFER CBA,47.77,0,674214.49,DR,REF373580,CBA,Current
20-08-2025 17:44,CBA7E0A18EB1F4D46468510,063-000-002,33333333,SALARY PAYMENT CBA,0,167.32,674381.81,CR,REF550813,CBA,Current
20-08-2025 18:31,CBABC95594030AB42A0B7E4,063-000-002,33333333,FLIXBUS CBA,233.3,0,674148.51,DR,REF689185,CBA,Current
20-08-2025 18:35,CBA12BD5AB5A40F4BD491EE,063-000-002,33333333,PAYROLL CREDIT CBA,0,224.21,674372.72,CR,REF326396,CBA,Current
20-08-2025 18:50,CBA29E780D22A2642A09971,063-000-002,33333333,BANK FEE CBA,13.71,0,674359.01,DR,REF935340,CBA,Current
20-08-2025 19:34,CBA496AC4B61C4E42AD9129,063-000-002,33333333,SALARY PAYMENT CBA,0,92.45,674451.46,CR,REF184758,CBA,Current
20-08-2025 19:34,CBAC0D1B808155E405BA520,063-000-002,33333333,APPLE CBA,15.86,0,674435.6,DR,REF393366,CBA,Current
20-08-2025 20:33,CBADFB405F93169496F9B6F,063-000-002,33333333,MCDONALDS CBA,127.85,0,674307.75,DR,REF729721,CBA,Current
20-08-2025 21:10,CBA3358C7E5DDAB4304BC23,063-000-002,33333333,PAYMENT GATEWAY CBA,26.57,0,674281.18,DR,REF695402,CBA,Current
20-08-2025 22:08,CBAE9273A8F2BA742D9969F,063-000-002,33333333,KFC CBA,20.84,0,674260.34,DR,REF728381,CBA,Current
20-08-2025 22:21,CBA5FAD460AF2FC478DBC35,063-000-002,33333333,7-ELEVEN CBA,19.46,0,674240.88,DR,REF549444,CBA,Current
20-08-2025 22:28,CBAE4BC30E1F5DC4B0F808D,063-000-002,33333333,TAFE BOOKSHOP CBA,76.25,0,674164.63,DR,REF487288,CBA,Current
20-08-2025 22:34,CBA1822E6890E6B4286AA83,063-000-002,33333333,KFC CBA,115.6,0,674049.03,DR,REF931333,CBA,Current
20-08-2025 23:00,CBAAF8BCD9E828043D49BC7,063-000-002,33333333,STARBUCKS CBA,5.16,0,674043.87,DR,REF950362,CBA,Current
20-08-2025 23:48,CBA0F8E919941E74AACB227,063-000-002,33333333,LIQUORLAND CBA,49.3,0,673994.57,DR,REF459353,CBA,Current
20-08-2025 23:59,CBAE689721DE00E4701BB33,063-000-002,33333333,WOOLWORTHS CBA,80.11,0,673914.46,DR,REF250246,CBA,Current
21-08-2025 00:15,CBA1153954565794BF9BD40,063-000-002,33333333,ALDI CBA,61.78,0,673852.68,DR,REF599949,CBA,Current
21-08-2025 00:47,CBA67A4F85B3A124A43872B,063-000-002,33333333,WAGES CREDIT CBA,0,5802.25,679654.93,CR,REF276442,CBA,Current
21-08-2025 01:22,CBA2F1B012D2EF64E29B813,063-000-002,33333333,JB HI-FI CBA,34.56,0,679620.37,DR,REF858310,CBA,Current
21-08-2025 01:41,CBAF534168FABD54F4EB016,063-000-002,33333333,MCDONALDS CBA,59.15,0,679561.22,DR,REF172020,CBA,Current
21-08-2025 02:03,CBACE6347D7EE3F4EF691C5,063-000-002,33333333,7-ELEVEN CBA,19.79,0,679541.43,DR,REF788532,CBA,Current
21-08-2025 02:19,CBA7996B73EE41540189282,063-000-002,33333333,COLES CBA,98.57,0,679442.86,DR,REF924277,CBA,Current
21-08-2025 02:25,CBA59F42A226A954E949E7E,063-000-002,33333333,BP CBA,6.58,0,679436.28,DR,REF997845,CBA,Current
21-08-2025 02:31,CBA6F740E4ADDFC4956BD9A,063-000-002,33333333,BIGW CBA,12.98,0,679423.3,DR,REF517851,CBA,Current
21-08-2025 02:46,CBA1B80478298544D13A46E,063-000-002,33333333,WOOLWORTHS CBA,17.17,0,679406.13,DR,REF379590,CBA,Current
21-08-2025 03:28,CBA574900DD7B924A45A511,063-000-002,33333333,BANK FEE CBA,8.82,0,679397.31,DR,REF756796,CBA,Current
21-08-2025 03:32,CBAAA3CBBF76D644031BA04,063-000-002,33333333,7-ELEVEN CBA,12.23,0,679385.08,DR,REF689489,CBA,Current
21-08-2025 03:55,CBAC66F96AC8B074F1FAB0B,063-000-002,33333333,SPOTIFY CBA,53.18,0,679331.9,DR,REF572228,CBA,Current
21-08-2025 04:17,CBA30D4F3071E4E43FE9233,063-000-002,33333333,BANK FEE CBA,26.56,0,679305.34,DR,REF154708,CBA,Current
21-08-2025 04:18,CBADF2857EB05E94E1F8010,063-000-002,33333333,WOOLWORTHS CBA,13.32,0,679292.02,DR,REF178664,CBA,Current
21-08-2025 05:31,CBAED5A79AC16C545F4B27F,063-000-002,33333333,BP CBA,203.11,0,679088.91,DR,REF709323,CBA,Current
21-08-2025 05:32,CBA22D1D4341A744C089002,063-000-002,33333333,COMPANY PAYROLL CBA,0,1066.41,680155.32,CR,REF905925,CBA,Current
21-08-2025 05:34,CBAB965E4C6AA5442909814,063-000-002,33333333,AMAZON AU CBA,30.4,0,680124.92,DR,REF846898,CBA,Current
21-08-2025 05:35,CBAFE487D1175A94415827E,063-000-002,33333333,JB HI-FI CBA,14.56,0,680110.36,DR,REF213227,CBA,Current
21-08-2025 05:52,CBAF86565DAA83E46F89133,063-000-002,33333333,DOMINO'S PIZZA CBA,49,0,680061.36,DR,REF382747,CBA,Current
21-08-2025 06:40,CBA991D9437E0F744DCBD91,063-000-002,33333333,JB HI-FI CBA,24.61,0,680036.75,DR,REF491487,CBA,Current
21-08-2025 06:51,CBA24051DD77B7D4D5B9FD0,063-000-002,33333333,BANK FEE CBA,53.67,0,679983.08,DR,REF796238,CBA,Current
21-08-2025 06:54,CBA907B01CE03484F00B7AB,063-000-002,33333333,ZOOM CBA,28.36,0,679954.72,DR,REF896660,CBA,Current
21-08-2025 07:02,CBAD1A4A594043042368E70,063-000-002,33333333,SPOTIFY CBA,23.68,0,679931.04,DR,REF148304,CBA,Current
21-08-2025 08:03,CBA6C79A5BA19B04F21AAE8,063-000-002,33333333,ALDI CBA,29.41,0,679901.63,DR,REF984156,CBA,Current
21-08-2025 08:21,CBA21A5D29D95EC4B3A823D,063-000-002,33333333,SHELL CBA,9.09,0,679892.54,DR,REF689090,CBA,Current
21-08-2025 08:44,INTBFCD516F968E47A8B2B7,063-000-002,33333333,TRANSFER FROM NAB 44444444,0,1903.99,681796.53,CR,INT-66389,CBA,Current
21-08-2025 09:05,CBA6E22588B61DC4B1CB6F5,063-000-002,33333333,STARBUCKS CBA,76.3,0,681720.23,DR,REF570884,CBA,Current
21-08-2025 09:11,CBA7263CC72397F4689A5D1,063-000-002,33333333,MENULOG CBA,154.45,0,681565.78,DR,REF189390,CBA,Current
21-08-2025 09:34,CBA9E627F79D2C842CC8882,063-000-002,33333333,DOMINO'S PIZZA CBA,76.09,0,681489.69,DR,REF517397,CBA,Current
21-08-2025 09:49,CBA55DF6664071E48629005,063-000-002,33333333,MCDONALDS CBA,30.69,0,681459,DR,REF687250,CBA,Current
21-08-2025 10:28,CBA9396D9951BC74C1FB7AC,063-000-002,33333333,BANK FEE CBA,27.13,0,681431.87,DR,REF931230,CBA,Current
21-08-2025 10:55,CBAEBF084EEECD2410A87BC,063-000-002,33333333,LIQUORLAND CBA,37.55,0,681394.32,DR,REF939442,CBA,Current
21-08-2025 11:11,CBAAE4135A4539C478AB03C,063-000-002,33333333,STARBUCKS CBA,5.82,0,681388.5,DR,REF951424,CBA,Current
21-08-2025 11:23,CBA6012AFF98CD841DAB79E,063-000-002,33333333,FLIXBUS CBA,20.18,0,681368.32,DR,REF366897,CBA,Current
21-08-2025 11:37,CBA9F3AC5078B994CF98D14,063-000-002,33333333,PAYROLL CREDIT CBA,0,610.62,681978.94,CR,REF293561,CBA,Current
21-08-2025 11:45,CBAA3FA2801753F491CB5B0,063-000-002,33333333,KFC CBA,92.25,0,681886.69,DR,REF756814,CBA,Current
21-08-2025 11:53,CBA4AAE337F6E9F4ABCB38F,063-000-002,33333333,PAY - SALARY CBA,0,593.23,682479.92,CR,REF707694,CBA,Current
21-08-2025 12:13,CBA775FAE9FA9C742A68969,063-000-002,33333333,INTERNET TRANSFER CBA,67.75,0,682412.17,DR,REF689367,CBA,Current
21-08-2025 13:44,CBAFAB2E4966A364BD584A4,063-000-002,33333333,ZOOM CBA,91.67,0,682320.5,DR,REF261950,CBA,Current
21-08-2025 13:53,CBAF692568B908848C5BBA1,063-000-002,33333333,JB HI-FI CBA,86.69,0,682233.81,DR,REF908088,CBA,Current
21-08-2025 14:08,CBA05C7D85274D34B169EDF,063-000-002,33333333,AMAZON AU CBA,60.8,0,682173.01,DR,REF670267,CBA,Current
21-08-2025 14:33,CBAAD16FC0B777048E6B452,063-000-002,33333333,INTERNET TRANSFER CBA,6.61,0,682166.4,DR,REF981319,CBA,Current
21-08-2025 14:34,CBA4F9C41BC13994FCB96B1,063-000-002,33333333,TAFE BOOKSHOP CBA,23.29,0,682143.11,DR,REF929282,CBA,Current
21-08-2025 14:45,CBAB41FA3FC02F74029BBC1,063-000-002,33333333,MENULOG CBA,83.83,0,682059.28,DR,REF509817,CBA,Current
21-08-2025 14:59,CBAFF22F40E0C6B47AF894C,063-000-002,33333333,WAGES CREDIT CBA,0,7696.11,689755.39,CR,REF662579,CBA,Current
21-08-2025 15:20,CBA3AB478141BBC444C839C,063-000-002,33333333,RAILWAY STATION CBA,4.02,0,689751.37,DR,REF294955,CBA,Current
21-08-2025 15:43,CBAD582A16FE4EE4A1CB036,063-000-002,33333333,7-ELEVEN CBA,95.08,0,689656.29,DR,REF632061,CBA,Current
21-08-2025 15:57,CBAD996CFF210EE40818AF4,063-000-002,33333333,MCDONALDS CBA,28.87,0,689627.42,DR,REF223492,CBA,Current
21-08-2025 16:04,CBA27556D09910E407A90AF,063-000-002,33333333,FLIXBUS CBA,35.61,0,689591.81,DR,REF678399,CBA,Current
21-08-2025 16:06,CBA7E23A0F3BFCB4BC09218,063-000-002,33333333,CITYLINK CBA,12.16,0,689579.65,DR,REF421605,CBA,Current
21-08-2025 16:19,CBA5D55C931CE754B6A94DC,063-000-002,33333333,BP CBA,25.43,0,689554.22,DR,REF883170,CBA,Current
21-08-2025 16:45,CBAB837180E7D6343329313,063-000-002,33333333,PAYPAL *NETFLIX CBA,115.46,0,689438.76,DR,REF781924,CBA,Current
21-08-2025 16:50,CBA374C2822854443AD9EEF,063-000-002,33333333,JB HI-FI CBA,4.04,0,689434.72,DR,REF967654,CBA,Current
21-08-2025 17:57,CBA74C3061E7F2145BAB42C,063-000-002,33333333,DOMINO'S PIZZA CBA,88.89,0,689345.83,DR,REF388024,CBA,Current
21-08-2025 18:26,CBA3DCA3C3DA90B4396A701,063-000-002,33333333,BWS CBA,36.88,0,689308.95,DR,REF696794,CBA,Current
21-08-2025 18:37,CBA1D0DD29C4D2C4005B253,063-000-002,33333333,KFC CBA,26.7,0,689282.25,DR,REF518753,CBA,Current
21-08-2025 18:59,CBAEA19FB19146F46D28A63,063-000-002,33333333,STARBUCKS CBA,8.35,0,689273.9,DR,REF387878,CBA,Current
21-08-2025 19:01,CBA635A9690F9C84F6CBD70,063-000-002,33333333,BWS CBA,5.82,0,689268.08,DR,REF353296,CBA,Current
21-08-2025 19:34,CBA62A6F179F9FD4F75BB01,063-000-002,33333333,ZOOM CBA,12.33,0,689255.75,DR,REF857555,CBA,Current
21-08-2025 19:48,CBAC416B6767E804096AAA0,063-000-002,33333333,SALARY PAYMENT CBA,0,2765.01,692020.76,CR,REF362829,CBA,Current
21-08-2025 19:48,CBAB0C4BA9D16F64D5C88D2,063-000-002,33333333,ALDI CBA,14.7,0,692006.06,DR,REF519814,CBA,Current
21-08-2025 20:11,CBA78428BB6BC8F4F14A649,063-000-002,33333333,COLES CBA,13.14,0,691992.92,DR,REF725315,CBA,Current
21-08-2025 20:17,CBAF780967E241943AE82BE,063-000-002,33333333,STARBUCKS CBA,49.94,0,691942.98,DR,REF265083,CBA,Current
21-08-2025 20:20,CBAE93133D999DC482FA88F,063-000-002,33333333,BANK FEE CBA,192.99,0,691749.99,DR,REF898175,CBA,Current
21-08-2025 20:26,CBA08C3614EAA934F6EB0B2,063-000-002,33333333,MCDONALDS CBA,29.14,0,691720.85,DR,REF803908,CBA,Current
21-08-2025 20:37,CBADCEF56AAAA59409B90D2,063-000-002,33333333,DOMINO'S PIZZA CBA,36.66,0,691684.19,DR,REF286801,CBA,Current
21-08-2025 20:39,CBA3B30AA555C1D48F7AE88,063-000-002,33333333,PAYMENT GATEWAY CBA,120.65,0,691563.54,DR,REF956568,CBA,Current
21-08-2025 20:55,CBA5DA67D21F066457ABB42,063-000-002,33333333,MENULOG CBA,31.62,0,691531.92,DR,REF570513,CBA,Current
21-08-2025 20:58,CBAD2D13F2A44EB43E2BD86,063-000-002,33333333,DOMINO'S PIZZA CBA,18.36,0,691513.56,DR,REF486826,CBA,Current
21-08-2025 21:07,CBA17B8F7AD855140188206,063-000-002,33333333,MENULOG CBA,95.15,0,691418.41,DR,REF285817,CBA,Current
21-08-2025 21:24,INTC799686252BB432B84E5,063-000-002,33333333,TRANSFER TO NAB 44444444,753.39,0,690665.02,DR,INT-50573,CBA,Current
21-08-2025 21:26,INT2448D4125D9B4427A391,063-000-002,33333333,TRANSFER TO CBA 22222222,1449.46,0,689215.56,DR,INT-50487,CBA,Current
21-08-2025 21:33,CBAF822C884710B47CBBD7A,063-000-002,33333333,RAILWAY STATION CBA,27.94,0,689187.62,DR,REF853692,CBA,Current
21-08-2025 21:57,CBAAF132F8BF8EE41BAB351,063-000-002,33333333,JB HI-FI CBA,4.89,0,689182.73,DR,REF696132,CBA,Current
21-08-2025 22:03,CBA1CA7ED4570BB45FCA5E6,063-000-002,33333333,MENULOG CBA,68.73,0,689114,DR,REF373112,CBA,Current
21-08-2025 22:58,CBAE8B518C2A7584357AD83,063-000-002,33333333,ALDI CBA,42.58,0,689071.42,DR,REF252483,CBA,Current
21-08-2025 23:15,CBA13698C5077064171BEDF,063-000-002,33333333,7-ELEVEN CBA,13.57,0,689057.85,DR,REF240337,CBA,Current
21-08-2025 23:16,CBAFA710FDFE41D4587A8C4,063-000-002,33333333,PAYROLL CREDIT CBA,0,6431.31,695489.16,CR,REF301682,CBA,Current
21-08-2025 23:24,CBAB3C64BE49DF9446C8CE0,063-000-002,33333333,BP CBA,42.81,0,695446.35,DR,REF531786,CBA,Current
21-08-2025 23:54,CBAFFEDE717B2AD4BCBAE10,063-000-002,33333333,BIGW CBA,5.77,0,695440.58,DR,REF214322,CBA,Current
22-08-2025 00:18,CBA494475FDA7ED41A6AE4D,063-000-002,33333333,BIGW CBA,2.21,0,695438.37,DR,REF437266,CBA,Current
22-08-2025 00:24,CBA574A7A67D0CB42A0B0D2,063-000-002,33333333,ZOOM CBA,146.97,0,695291.4,DR,REF830450,CBA,Current
22-08-2025 00:33,CBA4725DF22A1B249E18509,063-000-002,33333333,WOOLWORTHS CBA,25.76,0,695265.64,DR,REF471901,CBA,Current
22-08-2025 00:38,CBA3E7E71739A0943709B1C,063-000-002,33333333,RAILWAY STATION CBA,15.94,0,695249.7,DR,REF439023,CBA,Current
22-08-2025 00:45,CBA5507BBC69B4E43C0963C,063-000-002,33333333,SHELL CBA,72.31,0,695177.39,DR,REF530185,CBA,Current
22-08-2025 01:37,CBA438D23DAF6864A2E8883,063-000-002,33333333,CITYLINK CBA,103.02,0,695074.37,DR,REF645224,CBA,Current
22-08-2025 02:19,CBA209CBBD04DDE43DE9051,063-000-002,33333333,ALDI CBA,115.03,0,694959.34,DR,REF774703,CBA,Current
22-08-2025 02:40,CBA02FDC3F2875E4D0787C9,063-000-002,33333333,SALARY PAYMENT CBA,0,6519.11,701478.45,CR,REF474612,CBA,Current
22-08-2025 02:54,CBA43E13BD780B44FBBB4E0,063-000-002,33333333,ZOOM CBA,11.72,0,701466.73,DR,REF440172,CBA,Current
22-08-2025 02:58,CBA1654866DAE65494B9BB9,063-000-002,33333333,RAILWAY STATION CBA,39.48,0,701427.25,DR,REF476161,CBA,Current
22-08-2025 03:18,CBAA9E463C70C6A41478673,063-000-002,33333333,SALARY PAYMENT CBA,0,7426.13,708853.38,CR,REF292174,CBA,Current
22-08-2025 03:23,CBA8A88EE3411C448E0AE59,063-000-002,33333333,AMAZON AU CBA,18.6,0,708834.78,DR,REF275623,CBA,Current
22-08-2025 03:25,CBAF95B5206C7C14A0E85FE,063-000-002,33333333,7-ELEVEN CBA,29.64,0,708805.14,DR,REF876929,CBA,Current
22-08-2025 04:01,CBA4836CE928E9D474BBB20,063-000-002,33333333,BWS CBA,8.57,0,708796.57,DR,REF838985,CBA,Current
22-08-2025 04:25,CBA58BBDCFA367540A4ADF7,063-000-002,33333333,ZOOM CBA,36.26,0,708760.31,DR,REF101117,CBA,Current
22-08-2025 04:46,CBA1ADB516B9A7248E5B6CD,063-000-002,33333333,STARBUCKS CBA,25.53,0,708734.78,DR,REF434800,CBA,Current
22-08-2025 05:03,INTDCF6703F77D24128A59B,063-000-002,33333333,TRANSFER TO CBA 22222222,246.06,0,708488.72,DR,INT-89886,CBA,Current
22-08-2025 05:31,CBA28DFDC602C9647E294CA,063-000-002,33333333,INTERNET TRANSFER CBA,20.35,0,708468.37,DR,REF922462,CBA,Current
22-08-2025 05:42,CBA620424DA14014A808A53,063-000-002,33333333,FLIXBUS CBA,14.2,0,708454.17,DR,REF527111,CBA,Current
22-08-2025 06:16,CBA56FD057DE32A4431A118,063-000-002,33333333,STARBUCKS CBA,17.13,0,708437.04,DR,REF799418,CBA,Current
22-08-2025 06:30,CBA3F3A596CC73F488584E2,063-000-002,33333333,BANK FEE CBA,4.47,0,708432.57,DR,REF515678,CBA,Current
22-08-2025 06:50,CBA757483276D9C45A79B43,063-000-002,33333333,COMPANY PAYROLL CBA,0,269.75,708702.32,CR,REF100111,CBA,Current
22-08-2025 07:09,CBA85484152DE014398AB49,063-000-002,33333333,RAILWAY STATION CBA,4.64,0,708697.68,DR,REF929667,CBA,Current
22-08-2025 07:11,CBA131816FFCF674AEA83E2,063-000-002,33333333,BANK FEE CBA,35.09,0,708662.59,DR,REF891854,CBA,Current
22-08-2025 07:27,CBAB41E8E0A036F43FCA8CD,063-000-002,33333333,BWS CBA,212.84,0,708449.75,DR,REF802393,CBA,Current
22-08-2025 07:31,CBACBDACCF9B2A54981B5A0,063-000-002,33333333,PAYMENT GATEWAY CBA,69.37,0,708380.38,DR,REF944063,CBA,Current
22-08-2025 08:23,CBA3D79C1B683A4460386AC,063-000-002,33333333,BWS CBA,41.87,0,708338.51,DR,REF676264,CBA,Current
22-08-2025 09:18,CBADAF5AD7F1AB548218566,063-000-002,33333333,CITYLINK CBA,68.9,0,708269.61,DR,REF242733,CBA,Current
22-08-2025 10:07,CBA6DB3AA5A0B484C1C818A,063-000-002,33333333,7-ELEVEN CBA,34.86,0,708234.75,DR,REF669420,CBA,Current
22-08-2025 10:17,CBAEA2191AC518F460E9AB7,063-000-002,33333333,7-ELEVEN CBA,29.89,0,708204.86,DR,REF640930,CBA,Current
22-08-2025 10:31,CBAC8D2F35CC160432E95A2,063-000-002,33333333,LIQUORLAND CBA,101.73,0,708103.13,DR,REF457761,CBA,Current
22-08-2025 10:42,CBAFF361AC7AA154092AC05,063-000-002,33333333,UBER EATS CBA,123.63,0,707979.5,DR,REF753969,CBA,Current
22-08-2025 10:43,CBA0DFA5D6C460C4917A05E,063-000-002,33333333,PAYMENT GATEWAY CBA,71.41,0,707908.09,DR,REF204228,CBA,Current
22-08-2025 10:47,CBA9B397ED374FF428CB351,063-000-002,33333333,BANK FEE CBA,137.09,0,707771,DR,REF184319,CBA,Current
22-08-2025 10:47,CBAE35C171014BD4D40AF19,063-000-002,33333333,BP CBA,48.57,0,707722.43,DR,REF485280,CBA,Current
22-08-2025 10:50,CBA845066E129DF442DA8DE,063-000-002,33333333,ZOOM CBA,45.5,0,707676.93,DR,REF574138,CBA,Current
22-08-2025 10:51,CBAF6F35D24FB9C44768C64,063-000-002,33333333,HARVEY NORMAN CBA,8.97,0,707667.96,DR,REF760422,CBA,Current
22-08-2025 10:53,CBAB7756E5150B64F9CA13B,063-000-002,33333333,COLES CBA,37.13,0,707630.83,DR,REF749479,CBA,Current
22-08-2025 12:31,CBA5F2A732068B14BE4A79A,063-000-002,33333333,STARBUCKS CBA,44.86,0,707585.97,DR,REF130251,CBA,Current
22-08-2025 12:35,CBA282690E6BA61440C9253,063-000-002,33333333,LIQUORLAND CBA,21.04,0,707564.93,DR,REF862010,CBA,Current
22-08-2025 12:35,CBAF5E9C1649E2442848724,063-000-002,33333333,SALARY PAYMENT CBA,0,5592.69,713157.62,CR,REF674522,CBA,Current
22-08-2025 12:37,INT3277753371BF4EA59FEA,063-000-002,33333333,TRANSFER FROM NAB 44444444,0,1536.38,714694,CR,INT-13257,CBA,Current
22-08-2025 13:37,CBA47C4E1A1CC8F4690B5A6,063-000-002,33333333,JB HI-FI CBA,54.33,0,714639.67,DR,REF358102,CBA,Current
22-08-2025 13:40,CBA005F4F4D7CD44E4283B7,063-000-002,33333333,INTERNET TRANSFER CBA,9.35,0,714630.32,DR,REF355669,CBA,Current
22-08-2025 14:16,CBA4E027F2EA8624546AC48,063-000-002,33333333,MENULOG CBA,32.75,0,714597.57,DR,REF512692,CBA,Current
22-08-2025 14:20,CBA606272FF59D74FED8E18,063-000-002,33333333,SALARY PAYMENT CBA,0,988.27,715585.84,CR,REF213718,CBA,Current
22-08-2025 14:22,CBAC6646DC275AF45FAAFA2,063-000-002,33333333,PAYROLL CREDIT CBA,0,3981.46,719567.3,CR,REF194681,CBA,Current
22-08-2025 14:37,CBAB74F8B392CD043DE8496,063-000-002,33333333,INTERNET TRANSFER CBA,18.01,0,719549.29,DR,REF330965,CBA,Current
22-08-2025 14:37,CBA22A6FF81B00645239C25,063-000-002,33333333,STARBUCKS CBA,39.01,0,719510.28,DR,REF645256,CBA,Current
22-08-2025 14:43,CBA6F4E54BE719C412992B2,063-000-002,33333333,INTERNET TRANSFER CBA,8.81,0,719501.47,DR,REF129387,CBA,Current
22-08-2025 15:05,CBA1F66F585919D428390C9,063-000-002,33333333,AMAZON AU CBA,13.4,0,719488.07,DR,REF880919,CBA,Current
22-08-2025 15:22,CBAD3B4A46CC8DA4FE6B98D,063-000-002,33333333,BIGW CBA,39.2,0,719448.87,DR,REF257559,CBA,Current
22-08-2025 15:46,CBA74185589296343E6924A,063-000-002,33333333,BWS CBA,141.22,0,719307.65,DR,REF573047,CBA,Current
22-08-2025 16:24,CBA43E3055BE90C497597F9,063-000-002,33333333,BP CBA,27.3,0,719280.35,DR,REF972530,CBA,Current
22-08-2025 16:45,INTB92C59C76C4446088152,063-000-002,33333333,TRANSFER FROM NAB 44444444,0,1771.39,721051.74,CR,INT-72371,CBA,Current
22-08-2025 16:46,CBAEDA9A6447B4847B7B188,063-000-002,33333333,BWS CBA,9.03,0,721042.71,DR,REF788291,CBA,Current
22-08-2025 17:13,CBAD750FFE114E44BC89C06,063-000-002,33333333,AMAZON AU CBA,42.41,0,721000.3,DR,REF527699,CBA,Current
22-08-2025 17:21,CBA768685EF4EEE4867ABE9,063-000-002,33333333,TAFE BOOKSHOP CBA,22.29,0,720978.01,DR,REF142716,CBA,Current
22-08-2025 17:29,CBAAB72BF95D6BE41CDBAC5,063-000-002,33333333,BIGW CBA,14.36,0,720963.65,DR,REF153819,CBA,Current
22-08-2025 17:44,INT42215F4918F74E10BB6D,063-000-002,33333333,TRANSFER FROM ANZ 11111111,0,1279.79,722243.44,CR,INT-86572,CBA,Current
22-08-2025 17:46,CBAE68D443153844DCD8A58,063-000-002,33333333,RAILWAY STATION CBA,71.53,0,722171.91,DR,REF954501,CBA,Current
22-08-2025 18:14,CBAA65E3FF902BC44CEA69C,063-000-002,33333333,UBER EATS CBA,10.32,0,722161.59,DR,REF296406,CBA,Current
22-08-2025 18:41,INT18F1AC1F5FC24A1F8089,063-000-002,33333333,TRANSFER FROM CBA 22222222,0,938.52,723100.11,CR,INT-46335,CBA,Current
22-08-2025 18:49,CBA34EC8AD6A60A48EB8FC6,063-000-002,33333333,PAY - SALARY CBA,0,5367.07,728467.18,CR,REF492704,CBA,Current
22-08-2025 19:26,CBA39314CD91358493A9822,063-000-002,33333333,WOOLWORTHS CBA,6.99,0,728460.19,DR,REF931201,CBA,Current
22-08-2025 19:31,CBA091B081C99FC4B2B9CF2,063-000-002,33333333,COLES CBA,5.47,0,728454.72,DR,REF572902,CBA,Current
22-08-2025 19:48,CBAB687AE592AD94D9C98BA,063-000-002,33333333,KFC CBA,14.42,0,728440.3,DR,REF536280,CBA,Current
22-08-2025 20:18,CBAF466B31380304CADB477,063-000-002,33333333,PAYMENT GATEWAY CBA,19.34,0,728420.96,DR,REF516669,CBA,Current
22-08-2025 20:25,CBA1B9F1A6C97FE419587CE,063-000-002,33333333,CITYLINK CBA,52.86,0,728368.1,DR,REF227960,CBA,Current
22-08-2025 20:36,CBA43CAD70789CE4750BD73,063-000-002,33333333,WAGES CREDIT CBA,0,3924.78,732292.88,CR,REF133145,CBA,Current
22-08-2025 20:44,CBA770CB66802E14789ABC9,063-000-002,33333333,7-ELEVEN CBA,55.41,0,732237.47,DR,REF571123,CBA,Current
22-08-2025 21:10,CBA4457B41F7E94466D8DC2,063-000-002,33333333,LIQUORLAND CBA,116.44,0,732121.03,DR,REF289677,CBA,Current
22-08-2025 21:13,CBA8B72F9016F2645EF9B61,063-000-002,33333333,MCDONALDS CBA,123.57,0,731997.46,DR,REF633538,CBA,Current
22-08-2025 21:29,CBA96E78726D5C44BC3BB49,063-000-002,33333333,MENULOG CBA,12.74,0,731984.72,DR,REF111649,CBA,Current
22-08-2025 21:31,CBA2C8396DFDBB4417A9D85,063-000-002,33333333,ALDI CBA,42.47,0,731942.25,DR,REF173944,CBA,Current
22-08-2025 21:54,CBAFFB933BC4BBA4D17B18B,063-000-002,33333333,BIGW CBA,12.04,0,731930.21,DR,REF535607,CBA,Current
22-08-2025 22:06,CBA94620A339ACF421A9064,063-000-002,33333333,7-ELEVEN CBA,80.23,0,731849.98,DR,REF655056,CBA,Current
22-08-2025 22:08,CBADB88A7C644B945308090,063-000-002,33333333,RAILWAY STATION CBA,26.84,0,731823.14,DR,REF712436,CBA,Current
22-08-2025 22:48,CBA70DBFA98D1E34E7D8570,063-000-002,33333333,MENULOG CBA,58.11,0,731765.03,DR,REF660466,CBA,Current
22-08-2025 23:07,CBA6152B59676D1404CA9E0,063-000-002,33333333,7-ELEVEN CBA,158.18,0,731606.85,DR,REF882275,CBA,Current
22-08-2025 23:21,CBA580920AB15BF47CE9DD2,063-000-002,33333333,WAGES CREDIT CBA,0,384.04,731990.89,CR,REF268386,CBA,Current
23-08-2025 00:29,CBA84D19F72D4484442AB89,063-000-002,33333333,PAYMENT GATEWAY CBA,161.69,0,731829.2,DR,REF543708,CBA,Current
23-08-2025 00:38,CBA8DDF0E8277EE4D768A4B,063-000-002,33333333,PAYROLL CREDIT CBA,0,2267.2,734096.4,CR,REF322451,CBA,Current
23-08-2025 00:40,CBA25B50E75ECBB4C6A85FA,063-000-002,33333333,AMAZON AU CBA,278.66,0,733817.74,DR,REF733742,CBA,Current
23-08-2025 01:07,CBA3BF468D8331E486FA8E8,063-000-002,33333333,BANK FEE CBA,21.81,0,733795.93,DR,REF286763,CBA,Current
23-08-2025 01:22,CBA7E486D3E5C4E4965A2B8,063-000-002,33333333,UBER EATS CBA,68.26,0,733727.67,DR,REF144663,CBA,Current
23-08-2025 01:24,CBA99FA97C34495452CB534,063-000-002,33333333,SHELL CBA,34.33,0,733693.34,DR,REF529683,CBA,Current
23-08-2025 02:25,CBA54ED6F9C6F2C40289E8A,063-000-002,33333333,7-ELEVEN CBA,108.06,0,733585.28,DR,REF548218,CBA,Current
23-08-2025 02:33,CBAA183005917674FC7BD11,063-000-002,33333333,BIGW CBA,60.81,0,733524.47,DR,REF602030,CBA,Current
23-08-2025 02:43,CBADFACE0F1C3E24F7D9AB1,063-000-002,33333333,PAYMENT GATEWAY CBA,59.14,0,733465.33,DR,REF250337,CBA,Current
23-08-2025 02:43,CBAFC3583CCCA424031ABDC,063-000-002,33333333,INTERNET TRANSFER CBA,41.12,0,733424.21,DR,REF258669,CBA,Current
23-08-2025 02:56,CBA12E77769A51346BCB127,063-000-002,33333333,APPLE CBA,15.83,0,733408.38,DR,REF902404,CBA,Current
23-08-2025 03:29,CBA98D1D84BFCD44347A77B,063-000-002,33333333,STARBUCKS CBA,48.16,0,733360.22,DR,REF117282,CBA,Current
23-08-2025 03:47,CBA1E6F20404C284267BA68,063-000-002,33333333,KFC CBA,43.32,0,733316.9,DR,REF297429,CBA,Current
23-08-2025 04:34,CBA0B97AA4BDEDD4BA8BA51,063-000-002,33333333,KFC CBA,117.17,0,733199.73,DR,REF947365,CBA,Current
23-08-2025 04:41,CBA5EC22CB4BECC485DB68B,063-000-002,33333333,LIQUORLAND CBA,140.34,0,733059.39,DR,REF899668,CBA,Current
23-08-2025 05:18,CBA436EBA3C742442AEB0B5,063-000-002,33333333,DOMINO'S PIZZA CBA,25.93,0,733033.46,DR,REF326789,CBA,Current
23-08-2025 05:18,CBA1653B17C5D1E44758A1E,063-000-002,33333333,BP CBA,46.23,0,732987.23,DR,REF436453,CBA,Current
23-08-2025 06:00,INT5F173D9A995045458251,063-000-002,33333333,TRANSFER FROM NAB 44444444,0,212.91,733200.14,CR,INT-34739,CBA,Current
23-08-2025 06:08,CBAB2EE5A9AD2114FF5A07A,063-000-002,33333333,PAYROLL CREDIT CBA,0,5830.5,739030.64,CR,REF454021,CBA,Current
23-08-2025 07:15,CBA7D37CCAE9622448BA686,063-000-002,33333333,MENULOG CBA,45.11,0,738985.53,DR,REF244150,CBA,Current
23-08-2025 07:15,CBA0CDB09A38E5B4E2D8601,063-000-002,33333333,FLIXBUS CBA,36.93,0,738948.6,DR,REF966120,CBA,Current
23-08-2025 07:28,CBA35A70E6D7C944F90B75E,063-000-002,33333333,PAY - SALARY CBA,0,3892.96,742841.56,CR,REF125489,CBA,Current
23-08-2025 07:52,CBA109EB448315C4059852F,063-000-002,33333333,HARVEY NORMAN CBA,6.63,0,742834.93,DR,REF222102,CBA,Current
23-08-2025 08:41,CBA0EF249D126504549B65A,063-000-002,33333333,BIGW CBA,156.85,0,742678.08,DR,REF173780,CBA,Current
23-08-2025 08:50,CBA3DEDEC561F744E25967B,063-000-002,33333333,TAFE BOOKSHOP CBA,28.31,0,742649.77,DR,REF221982,CBA,Current
23-08-2025 09:06,CBAC0132B97CB314DE2BF7B,063-000-002,33333333,HARVEY NORMAN CBA,38.28,0,742611.49,DR,REF984789,CBA,Current
23-08-2025 09:27,CBA45CFC6210F4E44238FDC,063-000-002,33333333,7-ELEVEN CBA,5.03,0,742606.46,DR,REF239042,CBA,Current
23-08-2025 09:41,CBAFAD88076460D485AB368,063-000-002,33333333,PAYROLL CREDIT CBA,0,7260.35,749866.81,CR,REF252426,CBA,Current
23-08-2025 09:51,CBA52EDCBC83B954F90B1C5,063-000-002,33333333,PAYPAL *NETFLIX CBA,32.9,0,749833.91,DR,REF454014,CBA,Current
23-08-2025 09:52,CBA84C226C277664D5F83A5,063-000-002,33333333,JB HI-FI CBA,106.11,0,749727.8,DR,REF952846,CBA,Current
23-08-2025 10:22,CBAD3BE801E3DBB454E8C0F,063-000-002,33333333,CITYLINK CBA,4.61,0,749723.19,DR,REF773228,CBA,Current
23-08-2025 11:02,CBA07FCDADB51624BA3A2EB,063-000-002,33333333,WOOLWORTHS CBA,36.44,0,749686.75,DR,REF927110,CBA,Current
23-08-2025 11:03,CBA7CC63DC72C75412FBD71,063-000-002,33333333,HARVEY NORMAN CBA,22.74,0,749664.01,DR,REF438043,CBA,Current
23-08-2025 11:11,CBAD76F09E219974A8C8232,063-000-002,33333333,HARVEY NORMAN CBA,140.02,0,749523.99,DR,REF394761,CBA,Current
23-08-2025 11:33,CBA80CA4626A0174870B510,063-000-002,33333333,BP CBA,30.29,0,749493.7,DR,REF717763,CBA,Current
23-08-2025 11:56,CBA152354816BBA43B0921E,063-000-002,33333333,LIQUORLAND CBA,113.94,0,749379.76,DR,REF155685,CBA,Current
23-08-2025 12:10,CBAA482C338EE564F7CBC78,063-000-002,33333333,AMAZON AU CBA,41.77,0,749337.99,DR,REF760841,CBA,Current
23-08-2025 12:15,CBABF53244D7CD64C3A842C,063-000-002,33333333,ZOOM CBA,40.89,0,749297.1,DR,REF241991,CBA,Current
23-08-2025 12:16,CBADA484D846F0A4FB28B70,063-000-002,33333333,ALDI CBA,30.37,0,749266.73,DR,REF307951,CBA,Current
23-08-2025 12:55,CBAE38E3D684E7A4961BACA,063-000-002,33333333,LIQUORLAND CBA,5.9,0,749260.83,DR,REF350223,CBA,Current
23-08-2025 13:06,CBACCE4770D011B4F54A839,063-000-002,33333333,BP CBA,51.99,0,749208.84,DR,REF620291,CBA,Current
23-08-2025 13:14,CBA4893CE776F6043ED8182,063-000-002,33333333,SPOTIFY CBA,38.59,0,749170.25,DR,REF424318,CBA,Current
23-08-2025 13:15,CBA8369E751B1B14E439C20,063-000-002,33333333,BANK FEE CBA,42.94,0,749127.31,DR,REF280599,CBA,Current
23-08-2025 13:24,CBA02B1B9E69E084A3A8002,063-000-002,33333333,MCDONALDS CBA,79.27,0,749048.04,DR,REF978565,CBA,Current
23-08-2025 14:04,CBA0FE314C0F3CF4632B621,063-000-002,33333333,UBER EATS CBA,39.19,0,749008.85,DR,REF207010,CBA,Current
23-08-2025 14:30,CBAA844024E37BA4EA581D1,063-000-002,33333333,UBER EATS CBA,91.47,0,748917.38,DR,REF189103,CBA,Current
23-08-2025 14:42,CBA3CF4A7E78A904744B0A7,063-000-002,33333333,7-ELEVEN CBA,12.28,0,748905.1,DR,REF556125,CBA,Current
23-08-2025 14:47,CBAC3B858B818DD486F809B,063-000-002,33333333,COLES CBA,45.74,0,748859.36,DR,REF522191,CBA,Current
23-08-2025 14:47,CBA0875D049F07E4AE1A728,063-000-002,33333333,ZOOM CBA,21.23,0,748838.13,DR,REF991266,CBA,Current
23-08-2025 14:59,CBAF1780A3266BE4C16A5E1,063-000-002,33333333,WOOLWORTHS CBA,141.45,0,748696.68,DR,REF780025,CBA,Current
23-08-2025 16:58,CBA4A1C9AF0B65F4144B079,063-000-002,33333333,INTERNET TRANSFER CBA,200.99,0,748495.69,DR,REF355979,CBA,Current
23-08-2025 17:54,CBAE88F28EE40094EA587B7,063-000-002,33333333,PAY - SALARY CBA,0,7613.35,756109.04,CR,REF167038,CBA,Current
23-08-2025 18:11,CBA6075D307B2DF4D7DA70B,063-000-002,33333333,ZOOM CBA,81.01,0,756028.03,DR,REF609696,CBA,Current
23-08-2025 18:34,CBA4B2075728FD24E1EA372,063-000-002,33333333,UBER EATS CBA,70.22,0,755957.81,DR,REF520508,CBA,Current
23-08-2025 18:39,CBA142BD471486A4358AB52,063-000-002,33333333,UBER EATS CBA,99.81,0,755858,DR,REF405872,CBA,Current
23-08-2025 19:04,CBAEEE6492FE4B2449580E7,063-000-002,33333333,ALDI CBA,107.7,0,755750.3,DR,REF910542,CBA,Current
23-08-2025 19:07,CBAAB5BF8612B8A4D54AF7A,063-000-002,33333333,AMAZON AU CBA,65.02,0,755685.28,DR,REF922948,CBA,Current
23-08-2025 19:11,CBAEC995B56C0754AED9131,063-000-002,33333333,MENULOG CBA,18.71,0,755666.57,DR,REF886488,CBA,Current
23-08-2025 19:35,CBADFACC51CAC0E4F9EBE16,063-000-002,33333333,STARBUCKS CBA,50.96,0,755615.61,DR,REF607640,CBA,Current
23-08-2025 20:23,CBA0DA42310490343809213,063-000-002,33333333,BANK FEE CBA,7.16,0,755608.45,DR,REF393644,CBA,Current
23-08-2025 20:35,CBAD2E1ABF1D0AE4BF79DC8,063-000-002,33333333,SALARY PAYMENT CBA,0,7792.85,763401.3,CR,REF183152,CBA,Current
23-08-2025 20:44,CBA08598E5E3B4743C8B682,063-000-002,33333333,BWS CBA,137.88,0,763263.42,DR,REF768215,CBA,Current
23-08-2025 21:05,CBA44EDDF5C76794D39B20E,063-000-002,33333333,BIGW CBA,41.53,0,763221.89,DR,REF629452,CBA,Current
23-08-2025 21:11,CBAEBB0962C64F94636804D,063-000-002,33333333,BP CBA,120.69,0,763101.2,DR,REF745268,CBA,Current
23-08-2025 21:30,CBA2547B18A87984198B06D,063-000-002,33333333,TAFE BOOKSHOP CBA,45.43,0,763055.77,DR,REF269543,CBA,Current
23-08-2025 22:18,CBA32330C3A24C049ACBAF5,063-000-002,33333333,CITYLINK CBA,5.77,0,763050,DR,REF429831,CBA,Current
23-08-2025 22:38,CBA838B801BD9FB4F0FBB6B,063-000-002,33333333,UBER EATS CBA,32.53,0,763017.47,DR,REF233191,CBA,Current
23-08-2025 22:54,CBA4043783872E3401D8630,063-000-002,33333333,JB HI-FI CBA,23.47,0,762994,DR,REF281030,CBA,Current
23-08-2025 23:05,CBA068FD3DD7EC74761A4C9,063-000-002,33333333,WOOLWORTHS CBA,226.06,0,762767.94,DR,REF881070,CBA,Current
24-08-2025 00:00,CBAAA364C3796FA41B4BC98,063-000-002,33333333,STARBUCKS CBA,15.59,0,762752.35,DR,REF228419,CBA,Current
24-08-2025 00:18,CBA1DEDA29A1F014AF3A5C4,063-000-002,33333333,WOOLWORTHS CBA,17.35,0,762735,DR,REF688794,CBA,Current
24-08-2025 00:40,CBA52850C1B49974825B804,063-000-002,33333333,ZOOM CBA,11.44,0,762723.56,DR,REF241930,CBA,Current
24-08-2025 01:25,CBA4ED0C658443B4A6DB5D2,063-000-002,33333333,APPLE CBA,14.7,0,762708.86,DR,REF853651,CBA,Current
24-08-2025 01:28,CBAAF16F954E4A94B17A437,063-000-002,33333333,AMAZON AU CBA,151.91,0,762556.95,DR,REF873859,CBA,Current
24-08-2025 01:31,CBA04EEB57EA29C48AEACCA,063-000-002,33333333,CITYLINK CBA,8.48,0,762548.47,DR,REF177695,CBA,Current
24-08-2025 01:34,CBA1D438FF5034D4AA09D45,063-000-002,33333333,FLIXBUS CBA,22,0,762526.47,DR,REF967527,CBA,Current
24-08-2025 01:50,CBA7CE6CF22F09446128AC0,063-000-002,33333333,PAYMENT GATEWAY CBA,38.58,0,762487.89,DR,REF427341,CBA,Current
24-08-2025 02:18,CBAB46411A2F86344A38418,063-000-002,33333333,MENULOG CBA,160.48,0,762327.41,DR,REF581393,CBA,Current
24-08-2025 02:36,CBA79779FD96E774849A2B4,063-000-002,33333333,ALDI CBA,80.1,0,762247.31,DR,REF194882,CBA,Current
24-08-2025 03:10,CBAB054086D71334B0482C7,063-000-002,33333333,WAGES CREDIT CBA,0,421.92,762669.23,CR,REF493783,CBA,Current
24-08-2025 03:24,CBA19A46D6481D64E8F9CA2,063-000-002,33333333,SHELL CBA,115.95,0,762553.28,DR,REF873500,CBA,Current
24-08-2025 03:28,CBA0E62E54F87624143A587,063-000-002,33333333,HARVEY NORMAN CBA,17.7,0,762535.58,DR,REF997425,CBA,Current
24-08-2025 04:01,CBAE80BA758D0BE4653A2E5,063-000-002,33333333,BANK FEE CBA,25.25,0,762510.33,DR,REF947074,CBA,Current
24-08-2025 04:17,CBAEC0D56BBD780465E8E0D,063-000-002,33333333,SALARY PAYMENT CBA,0,6725.72,769236.05,CR,REF335739,CBA,Current
24-08-2025 05:25,CBACD8D4D86ED154019AF87,063-000-002,33333333,SALARY PAYMENT CBA,0,1083.99,770320.04,CR,REF871957,CBA,Current
24-08-2025 05:42,CBA2CEDB41C75E940AC9391,063-000-002,33333333,TAFE BOOKSHOP CBA,9.02,0,770311.02,DR,REF396881,CBA,Current
24-08-2025 06:19,CBADB4B5720836347F091CB,063-000-002,33333333,HARVEY NORMAN CBA,26.12,0,770284.9,DR,REF236978,CBA,Current
24-08-2025 06:29,CBAB21615D439224627BDBE,063-000-002,33333333,BP CBA,150.62,0,770134.28,DR,REF569193,CBA,Current
24-08-2025 07:01,CBAEBE1C6A39A754793A6C3,063-000-002,33333333,HARVEY NORMAN CBA,118.07,0,770016.21,DR,REF549007,CBA,Current
24-08-2025 07:14,CBA5B75EA4FC031438CB25F,063-000-002,33333333,KFC CBA,58.83,0,769957.38,DR,REF798082,CBA,Current
24-08-2025 07:15,CBA7383562F653549958B5B,063-000-002,33333333,MCDONALDS CBA,38.59,0,769918.79,DR,REF890904,CBA,Current
24-08-2025 07:19,CBAD8EA5122A1C2474D8A0D,063-000-002,33333333,WAGES CREDIT CBA,0,6905.26,776824.05,CR,REF903538,CBA,Current
24-08-2025 07:23,CBA5D614B157DD64A93A8B6,063-000-002,33333333,CITYLINK CBA,75.62,0,776748.43,DR,REF333937,CBA,Current
24-08-2025 07:49,CBA68768F5454794996BA06,063-000-002,33333333,BWS CBA,11.05,0,776737.38,DR,REF977799,CBA,Current
24-08-2025 07:59,CBA6F6769AC3F3E485DA213,063-000-002,33333333,ALDI CBA,39.94,0,776697.44,DR,REF386114,CBA,Current
24-08-2025 08:21,CBA46118D91480A4AE6AA83,063-000-002,33333333,7-ELEVEN CBA,35.53,0,776661.91,DR,REF735304,CBA,Current
24-08-2025 08:41,CBAE84393FCB2A94247A4A5,063-000-002,33333333,SALARY PAYMENT CBA,0,1557.64,778219.55,CR,REF153415,CBA,Current
24-08-2025 08:47,CBA8BEF9FA03F3F4B6086D2,063-000-002,33333333,JB HI-FI CBA,2.14,0,778217.41,DR,REF210010,CBA,Current
24-08-2025 09:18,CBA8B6E736D1EAB4417AF52,063-000-002,33333333,BIGW CBA,36.35,0,778181.06,DR,REF979852,CBA,Current
24-08-2025 09:20,CBA62E23A86249C4D2F947D,063-000-002,33333333,MENULOG CBA,40.11,0,778140.95,DR,REF617071,CBA,Current
24-08-2025 09:39,CBAE6FFACD4EA1E47FF9496,063-000-002,33333333,TAFE BOOKSHOP CBA,14.75,0,778126.2,DR,REF661945,CBA,Current
24-08-2025 09:50,CBAA232179BB6BE4521BD6F,063-000-002,33333333,AMAZON AU CBA,64.88,0,778061.32,DR,REF878120,CBA,Current
24-08-2025 09:53,CBA9F2D054EC51D44EB8CFC,063-000-002,33333333,PAYPAL *NETFLIX CBA,44.61,0,778016.71,DR,REF248203,CBA,Current
24-08-2025 10:02,CBAA0C783DBC24D4C4F8145,063-000-002,33333333,STARBUCKS CBA,3.11,0,778013.6,DR,REF760585,CBA,Current
24-08-2025 10:11,CBA363E0FE8D46345DDA748,063-000-002,33333333,MENULOG CBA,2.9,0,778010.7,DR,REF580429,CBA,Current
24-08-2025 10:24,CBA407AA3FD78554B68B25A,063-000-002,33333333,SHELL CBA,45.78,0,777964.92,DR,REF422632,CBA,Current
24-08-2025 10:58,CBA40FBCB4D1B0041DCA7A4,063-000-002,33333333,FLIXBUS CBA,13.47,0,777951.45,DR,REF675711,CBA,Current
24-08-2025 11:26,CBABD539EF311B24049BF69,063-000-002,33333333,7-ELEVEN CBA,100.45,0,777851,DR,REF974945,CBA,Current
24-08-2025 11:36,CBAD326FE09F1A24395A55A,063-000-002,33333333,UBER EATS CBA,32.69,0,777818.31,DR,REF222118,CBA,Current
24-08-2025 11:45,CBA4BC80E7F0D3E43A5A4DB,063-000-002,33333333,BIGW CBA,95.4,0,777722.91,DR,REF824226,CBA,Current
24-08-2025 11:45,CBA836ABE7953414D198281,063-000-002,33333333,BANK FEE CBA,99.58,0,777623.33,DR,REF324015,CBA,Current
24-08-2025 13:08,CBAC1F9720523974E0D8DD5,063-000-002,33333333,APPLE CBA,6.06,0,777617.27,DR,REF318763,CBA,Current
24-08-2025 13:30,CBACE37135043E94D7DBB18,063-000-002,33333333,APPLE CBA,265.24,0,777352.03,DR,REF828774,CBA,Current
24-08-2025 13:30,CBA384FCAA32A9F4EADBD34,063-000-002,33333333,PAYPAL *NETFLIX CBA,45.09,0,777306.94,DR,REF934832,CBA,Current
24-08-2025 13:50,CBA596ABD5813224C9EA47B,063-000-002,33333333,MCDONALDS CBA,108.52,0,777198.42,DR,REF852116,CBA,Current
24-08-2025 14:23,CBA721F692967894CCBA8A4,063-000-002,33333333,BANK FEE CBA,8.55,0,777189.87,DR,REF812692,CBA,Current
24-08-2025 14:31,CBA4C67432D85984900B84D,063-000-002,33333333,COLES CBA,39.86,0,777150.01,DR,REF579578,CBA,Current
24-08-2025 14:46,CBA9868A60E626D41F192FC,063-000-002,33333333,KFC CBA,10.83,0,777139.18,DR,REF407737,CBA,Current
24-08-2025 14:49,CBA47C065F5D29F413FBCCC,063-000-002,33333333,MCDONALDS CBA,10.51,0,777128.67,DR,REF176378,CBA,Current
24-08-2025 15:16,CBA32E55804B685425EA256,063-000-002,33333333,BP CBA,7.34,0,777121.33,DR,REF138863,CBA,Current
24-08-2025 15:23,CBA42268C048D194D688660,063-000-002,33333333,LIQUORLAND CBA,101.08,0,777020.25,DR,REF123506,CBA,Current
24-08-2025 15:40,CBA6E76B78B352547D082D6,063-000-002,33333333,PAY - SALARY CBA,0,428.09,777448.34,CR,REF491104,CBA,Current
24-08-2025 15:50,CBA7C7990EFC87849658E2C,063-000-002,33333333,BWS CBA,48.59,0,777399.75,DR,REF524881,CBA,Current
24-08-2025 17:11,CBA779215882970454393E1,063-000-002,33333333,KFC CBA,5.38,0,777394.37,DR,REF647826,CBA,Current
24-08-2025 18:10,INT5C741F0FF8C74C84835B,063-000-002,33333333,TRANSFER TO ANZ 11111111,1326.81,0,776067.56,DR,INT-21120,CBA,Current
24-08-2025 18:15,CBAC9B02332733640A1B9B4,063-000-002,33333333,UBER EATS CBA,75.25,0,775992.31,DR,REF673111,CBA,Current
24-08-2025 18:47,CBA1345B35D319D46919FB8,063-000-002,33333333,UBER EATS CBA,97.73,0,775894.58,DR,REF129651,CBA,Current
24-08-2025 18:50,CBAE9185E4B5B9C4D36A1EC,063-000-002,33333333,MCDONALDS CBA,32.95,0,775861.63,DR,REF492485,CBA,Current
24-08-2025 19:14,CBA50B11A18F047465CBCB3,063-000-002,33333333,SALARY PAYMENT CBA,0,72.27,775933.9,CR,REF875370,CBA,Current
24-08-2025 19:23,CBAAD2C9E88E69C412D9FEF,063-000-002,33333333,SPOTIFY CBA,38.96,0,775894.94,DR,REF639975,CBA,Current
24-08-2025 20:13,CBA1EA6A7A0F30D467C9F63,063-000-002,33333333,MENULOG CBA,33.02,0,775861.92,DR,REF961335,CBA,Current
24-08-2025 20:41,CBA095D71704E674CAFA36D,063-000-002,33333333,STARBUCKS CBA,54.73,0,775807.19,DR,REF940032,CBA,Current
24-08-2025 21:12,CBA4F7EAFD7E9E74F8E822F,063-000-002,33333333,APPLE CBA,18.06,0,775789.13,DR,REF420701,CBA,Current
24-08-2025 21:27,CBA8A794D91F78D47ECBD53,063-000-002,33333333,CITYLINK CBA,28.15,0,775760.98,DR,REF814086,CBA,Current
24-08-2025 21:51,CBAF87D35155D5945C885B7,063-000-002,33333333,DOMINO'S PIZZA CBA,7.36,0,775753.62,DR,REF321916,CBA,Current
24-08-2025 22:33,CBA563E936D46484BB3862D,063-000-002,33333333,MENULOG CBA,19.9,0,775733.72,DR,REF269092,CBA,Current
25-08-2025 00:05,CBA2E73802A33464B328B86,063-000-002,33333333,BP CBA,121.73,0,775611.99,DR,REF362876,CBA,Current
25-08-2025 00:05,CBA7B2628041A374C4B88B3,063-000-002,33333333,UBER EATS CBA,2.83,0,775609.16,DR,REF406799,CBA,Current
25-08-2025 00:09,CBA8FE2CBEF4C154C308947,063-000-002,33333333,MCDONALDS CBA,38.7,0,775570.46,DR,REF496443,CBA,Current
25-08-2025 00:11,CBAAE9BE5F7F1E54AC183FB,063-000-002,33333333,SHELL CBA,31.02,0,775539.44,DR,REF626406,CBA,Current
25-08-2025 00:23,CBAAB6AA5A8B2BD4D75A663,063-000-002,33333333,ZOOM CBA,108.37,0,775431.07,DR,REF678285,CBA,Current
25-08-2025 00:34,CBA80E2E6A660434EFCB85B,063-000-002,33333333,BP CBA,208.64,0,775222.43,DR,REF462274,CBA,Current
25-08-2025 01:23,CBA29ADA1AB15D042129908,063-000-002,33333333,UBER EATS CBA,107.44,0,775114.99,DR,REF508185,CBA,Current
25-08-2025 01:24,CBA2896EF5E53744E29937B,063-000-002,33333333,BP CBA,4.47,0,775110.52,DR,REF353660,CBA,Current
25-08-2025 01:57,CBA6FCD0AFC288A491296EE,063-000-002,33333333,7-ELEVEN CBA,22.05,0,775088.47,DR,REF900528,CBA,Current
25-08-2025 02:18,CBADAE4528E4EBC434593A3,063-000-002,33333333,RAILWAY STATION CBA,29.99,0,775058.48,DR,REF426951,CBA,Current
25-08-2025 02:44,CBA5E73B7017CC444CFBA6C,063-000-002,33333333,AMAZON AU CBA,45.05,0,775013.43,DR,REF517371,CBA,Current
25-08-2025 02:46,CBA9EA10373D7004FD0BD8D,063-000-002,33333333,WAGES CREDIT CBA,0,6416.81,781430.24,CR,REF697088,CBA,Current
25-08-2025 02:57,CBA53052E8CC7A1456CA271,063-000-002,33333333,COLES CBA,7.09,0,781423.15,DR,REF414883,CBA,Current
25-08-2025 03:06,CBA5F32C7CB2A994C61BEF9,063-000-002,33333333,COMPANY PAYROLL CBA,0,5651.66,787074.81,CR,REF517716,CBA,Current
25-08-2025 03:23,CBA60426CE0E1A04B19ADDE,063-000-002,33333333,SHELL CBA,36.4,0,787038.41,DR,REF302275,CBA,Current
25-08-2025 03:34,CBAC6101B0ABAEF4EBC8AD8,063-000-002,33333333,KFC CBA,65.94,0,786972.47,DR,REF991753,CBA,Current
25-08-2025 03:40,CBA7A75775F3FD84F4AB2FC,063-000-002,33333333,PAY - SALARY CBA,0,5351,792323.47,CR,REF452987,CBA,Current
25-08-2025 03:44,CBACC7CDB475E7A4788A1FD,063-000-002,33333333,PAYROLL CREDIT CBA,0,523.13,792846.6,CR,REF169410,CBA,Current
25-08-2025 03:48,CBAD890A2A7FE984F38B959,063-000-002,33333333,ALDI CBA,61.19,0,792785.41,DR,REF147670,CBA,Current
25-08-2025 04:00,CBA8FBA91A2B9BB4D79A475,063-000-002,33333333,BIGW CBA,98.71,0,792686.7,DR,REF858971,CBA,Current
25-08-2025 04:14,CBA59AD9B9193904E9282DC,063-000-002,33333333,KFC CBA,14.36,0,792672.34,DR,REF834130,CBA,Current
25-08-2025 04:32,CBA193DD70ADB374FC08777,063-000-002,33333333,ZOOM CBA,39.27,0,792633.07,DR,REF571879,CBA,Current
25-08-2025 04:51,CBAE6C85D26CE764B969726,063-000-002,33333333,BIGW CBA,16.65,0,792616.42,DR,REF496281,CBA,Current
25-08-2025 05:02,CBADE8CB1C282544CD1850E,063-000-002,33333333,APPLE CBA,17.39,0,792599.03,DR,REF661043,CBA,Current
25-08-2025 05:17,CBAC51CD4D10F544A838CD7,063-000-002,33333333,PAYROLL CREDIT CBA,0,1796.66,794395.69,CR,REF402721,CBA,Current
25-08-2025 06:09,CBA31B1EC812B3B433B8421,063-000-002,33333333,PAYMENT GATEWAY CBA,18.88,0,794376.81,DR,REF276752,CBA,Current
25-08-2025 06:14,CBA2FF767855A8F48CAA396,063-000-002,33333333,LIQUORLAND CBA,73.6,0,794303.21,DR,REF915035,CBA,Current
25-08-2025 06:20,CBA3AC2623677EA40D5BB0B,063-000-002,33333333,FLIXBUS CBA,59.33,0,794243.88,DR,REF771465,CBA,Current
25-08-2025 07:23,CBA9043FEE534764CED9F8C,063-000-002,33333333,WOOLWORTHS CBA,133.46,0,794110.42,DR,REF148522,CBA,Current
25-08-2025 07:27,CBA64FDCBCFA67B4D0DAD63,063-000-002,33333333,PAYMENT GATEWAY CBA,4.11,0,794106.31,DR,REF451380,CBA,Current
25-08-2025 07:34,CBA9C25A73D02AC47C7B74C,063-000-002,33333333,COMPANY PAYROLL CBA,0,5457.86,799564.17,CR,REF707624,CBA,Current
25-08-2025 07:42,CBA08EE65DE40244526B0A8,063-000-002,33333333,PAYPAL *NETFLIX CBA,15.58,0,799548.59,DR,REF195489,CBA,Current
25-08-2025 08:11,INT76A2CBACC4A84D99AA4A,063-000-002,33333333,TRANSFER FROM ANZ 11111111,0,455.5,800004.09,CR,INT-11938,CBA,Current
25-08-2025 08:14,CBADA265ED91BD54672B77A,063-000-002,33333333,7-ELEVEN CBA,292.16,0,799711.93,DR,REF141896,CBA,Current
25-08-2025 08:15,CBA1C3FF94F2A294335961B,063-000-002,33333333,TAFE BOOKSHOP CBA,55.47,0,799656.46,DR,REF672007,CBA,Current
25-08-2025 08:32,CBA53C1B3E7745246B082B7,063-000-002,33333333,HARVEY NORMAN CBA,100.58,0,799555.88,DR,REF989444,CBA,Current
25-08-2025 08:59,CBA9DDC33A36356443D9A0F,063-000-002,33333333,HARVEY NORMAN CBA,23.7,0,799532.18,DR,REF325865,CBA,Current
25-08-2025 09:08,INT17A3CA84B26844768026,063-000-002,33333333,TRANSFER TO CBA 22222222,1445.71,0,798086.47,DR,INT-74428,CBA,Current
25-08-2025 09:28,CBA8D970DB07C584B178EBB,063-000-002,33333333,AMAZON AU CBA,37.87,0,798048.6,DR,REF786635,CBA,Current
25-08-2025 09:51,CBA5B152F38B946436C8A94,063-000-002,33333333,INTERNET TRANSFER CBA,31.89,0,798016.71,DR,REF782408,CBA,Current
25-08-2025 09:55,INT1C9866C0189D4BBFAB1B,063-000-002,33333333,TRANSFER TO NAB 44444444,585.68,0,797431.03,DR,INT-88934,CBA,Current
25-08-2025 10:08,CBA05D95016A5FA46B78652,063-000-002,33333333,CITYLINK CBA,1.31,0,797429.72,DR,REF205532,CBA,Current
25-08-2025 10:18,CBA52F609741F394C76B50F,063-000-002,33333333,ALDI CBA,88.68,0,797341.04,DR,REF125336,CBA,Current
25-08-2025 10:38,CBA428EDF9469124A81853C,063-000-002,33333333,COLES CBA,26.61,0,797314.43,DR,REF771078,CBA,Current
25-08-2025 10:45,CBAA2733976801A4D99898A,063-000-002,33333333,ALDI CBA,147.22,0,797167.21,DR,REF495189,CBA,Current
25-08-2025 10:57,CBAE8E7302FA9B54CB29559,063-000-002,33333333,COLES CBA,106.98,0,797060.23,DR,REF441880,CBA,Current
25-08-2025 11:00,CBA85293CC83CE94C9485B8,063-000-002,33333333,FLIXBUS CBA,61.81,0,796998.42,DR,REF860792,CBA,Current
25-08-2025 11:09,CBA8038E8764F85465E9576,063-000-002,33333333,DOMINO'S PIZZA CBA,36.88,0,796961.54,DR,REF585211,CBA,Current
25-08-2025 11:13,CBA2E131FA56185440C874D,063-000-002,33333333,KFC CBA,37.03,0,796924.51,DR,REF810159,CBA,Current
25-08-2025 11:55,CBA1B5D826DD68049D1B49B,063-000-002,33333333,SALARY PAYMENT CBA,0,1172.29,798096.8,CR,REF354567,CBA,Current
25-08-2025 12:15,CBA9DC4FF1BDF9044A78A0C,063-000-002,33333333,MENULOG CBA,5.06,0,798091.74,DR,REF811658,CBA,Current
25-08-2025 12:20,CBA06522AF535064421B24E,063-000-002,33333333,AMAZON AU CBA,184.58,0,797907.16,DR,REF476153,CBA,Current
25-08-2025 12:30,CBA1251647732D44196BA9C,063-000-002,33333333,WOOLWORTHS CBA,43.51,0,797863.65,DR,REF967222,CBA,Current
25-08-2025 12:38,INT6044447053DC40B9B2C6,063-000-002,33333333,TRANSFER TO NAB 44444444,703.39,0,797160.26,DR,INT-17125,CBA,Current
25-08-2025 12:40,CBAFD602FF5FD22419F84A0,063-000-002,33333333,MCDONALDS CBA,68.59,0,797091.67,DR,REF743385,CBA,Current
25-08-2025 12:42,CBAF985DFBD1BC3474DA1F0,063-000-002,33333333,KFC CBA,41.7,0,797049.97,DR,REF740454,CBA,Current
25-08-2025 12:53,CBA999BDABD0C584D3CBF3E,063-000-002,33333333,FLIXBUS CBA,73.42,0,796976.55,DR,REF700442,CBA,Current
25-08-2025 12:58,CBABA6C7692B5444C9FB30A,063-000-002,33333333,INTERNET TRANSFER CBA,14.76,0,796961.79,DR,REF256437,CBA,Current
25-08-2025 13:33,CBAB332842CC71940819A8B,063-000-002,33333333,BP CBA,154.3,0,796807.49,DR,REF402446,CBA,Current
25-08-2025 13:41,CBAFB55A506ABFC40F9BE3C,063-000-002,33333333,BIGW CBA,10.48,0,796797.01,DR,REF652079,CBA,Current
25-08-2025 13:43,CBAB5E708E5D25B486D9F17,063-000-002,33333333,ZOOM CBA,45.8,0,796751.21,DR,REF412901,CBA,Current
25-08-2025 13:49,CBA41414128640F401085AC,063-000-002,33333333,JB HI-FI CBA,7.77,0,796743.44,DR,REF314229,CBA,Current
25-08-2025 13:53,CBAC052D7E81F5341B587EE,063-000-002,33333333,BWS CBA,26.09,0,796717.35,DR,REF480649,CBA,Current
25-08-2025 14:00,CBA06FDB788B6EC451A9AD1,063-000-002,33333333,HARVEY NORMAN CBA,69.22,0,796648.13,DR,REF516846,CBA,Current
25-08-2025 14:07,CBA3F050B6803434C31A67C,063-000-002,33333333,BWS CBA,35.74,0,796612.39,DR,REF219092,CBA,Current
25-08-2025 14:13,CBAF78386DD55414AD58EB9,063-000-002,33333333,KFC CBA,11.55,0,796600.84,DR,REF612549,CBA,Current
25-08-2025 16:18,CBA2840F1D9C0EB4D249C8D,063-000-002,33333333,FLIXBUS CBA,49.06,0,796551.78,DR,REF326252,CBA,Current
25-08-2025 16:32,CBA93E76D9A146F43519D22,063-000-002,33333333,7-ELEVEN CBA,69.03,0,796482.75,DR,REF716603,CBA,Current
25-08-2025 16:38,CBAFED39DED62234589B14F,063-000-002,33333333,UBER EATS CBA,56.11,0,796426.64,DR,REF744516,CBA,Current
25-08-2025 17:08,CBA6FE5C755C8E5430AA198,063-000-002,33333333,AMAZON AU CBA,63.36,0,796363.28,DR,REF848557,CBA,Current
25-08-2025 17:29,CBA1B56E2018B61440F9183,063-000-002,33333333,STARBUCKS CBA,5.71,0,796357.57,DR,REF570481,CBA,Current
25-08-2025 17:52,CBAB9B3159D1F2D4EF18964,063-000-002,33333333,ALDI CBA,17.3,0,796340.27,DR,REF215493,CBA,Current
25-08-2025 17:57,CBA5353BF28FB7843EDB61D,063-000-002,33333333,ALDI CBA,81.77,0,796258.5,DR,REF765837,CBA,Current
25-08-2025 19:09,CBA7A20193C9C9E4627A6F2,063-000-002,33333333,WAGES CREDIT CBA,0,6470.46,802728.96,CR,REF696694,CBA,Current
25-08-2025 19:26,CBAD1DD86D232B44FDCB974,063-000-002,33333333,PAYMENT GATEWAY CBA,25.18,0,802703.78,DR,REF332080,CBA,Current
25-08-2025 19:35,CBA24AC1D22644B4EFABB49,063-000-002,33333333,PAYMENT GATEWAY CBA,22.88,0,802680.9,DR,REF999447,CBA,Current
25-08-2025 19:37,CBABEA2D1290BE0470E813D,063-000-002,33333333,WOOLWORTHS CBA,12.38,0,802668.52,DR,REF293963,CBA,Current
25-08-2025 19:55,CBA5BB5E8AA01A14ECDA301,063-000-002,33333333,BP CBA,4.9,0,802663.62,DR,REF285587,CBA,Current
25-08-2025 20:17,CBA9973E407A7C04DD6B38F,063-000-002,33333333,DOMINO'S PIZZA CBA,179.95,0,802483.67,DR,REF699057,CBA,Current
25-08-2025 20:24,CBAD3D977D7CF5B4A7F9009,063-000-002,33333333,BP CBA,45.39,0,802438.28,DR,REF679591,CBA,Current
25-08-2025 21:21,CBA2E7F6712BBA2442CB41E,063-000-002,33333333,7-ELEVEN CBA,14.55,0,802423.73,DR,REF564483,CBA,Current
25-08-2025 21:27,CBAF2FE67D1B7F648AAB3C7,063-000-002,33333333,STARBUCKS CBA,19,0,802404.73,DR,REF569172,CBA,Current
25-08-2025 21:50,CBAEC958FFB0D124F49A05B,063-000-002,33333333,TAFE BOOKSHOP CBA,5.59,0,802399.14,DR,REF312553,CBA,Current
25-08-2025 21:51,CBA460A1682C2AC407F89A8,063-000-002,33333333,PAYPAL *NETFLIX CBA,29.75,0,802369.39,DR,REF593836,CBA,Current
25-08-2025 22:08,CBA3982F994C02C497996A1,063-000-002,33333333,ALDI CBA,8.37,0,802361.02,DR,REF401781,CBA,Current
25-08-2025 22:24,CBAE242A7456EE54A1DBF54,063-000-002,33333333,PAYMENT GATEWAY CBA,53.26,0,802307.76,DR,REF942639,CBA,Current
25-08-2025 22:35,INTD1A550674CFB49AE9B6A,063-000-002,33333333,TRANSFER TO CBA 22222222,1579.38,0,800728.38,DR,INT-29798,CBA,Current
25-08-2025 22:36,CBAA7AA55BB302F4031ABA3,063-000-002,33333333,WOOLWORTHS CBA,26.42,0,800701.96,DR,REF441670,CBA,Current
25-08-2025 22:36,CBA1C40CF67A3034E6AB2B7,063-000-002,33333333,BANK FEE CBA,86.77,0,800615.19,DR,REF208836,CBA,Current
25-08-2025 22:37,CBA6DA1AF643E4C494D828C,063-000-002,33333333,KFC CBA,42.77,0,800572.42,DR,REF613465,CBA,Current
25-08-2025 23:13,CBAF1216F45AD014EA0B7B4,063-000-002,33333333,BIGW CBA,130.7,0,800441.72,DR,REF371332,CBA,Current
25-08-2025 23:17,CBA8AD8BDF77126426A95C1,063-000-002,33333333,BANK FEE CBA,50.32,0,800391.4,DR,REF536796,CBA,Current
25-08-2025 23:20,CBA34152EF755AD420284EB,063-000-002,33333333,PAYPAL *NETFLIX CBA,96.36,0,800295.04,DR,REF554834,CBA,Current
25-08-2025 23:44,CBA02A2A6779B8E43709E6D,063-000-002,33333333,CITYLINK CBA,12.76,0,800282.28,DR,REF588194,CBA,Current
25-08-2025 23:57,CBAE52D6222FEA14DB8AB3A,063-000-002,33333333,ZOOM CBA,131.93,0,800150.35,DR,REF694977,CBA,Current
26-08-2025 00:08,CBA3529611CAB2F47609F15,063-000-002,33333333,RAILWAY STATION CBA,200,0,799950.35,DR,REF909111,CBA,Current
26-08-2025 00:11,CBAFA6EB6D7532D49C28D2D,063-000-002,33333333,PAYMENT GATEWAY CBA,110.98,0,799839.37,DR,REF462439,CBA,Current
26-08-2025 00:54,CBA8E667B6422004CE0B1C5,063-000-002,33333333,PAYROLL CREDIT CBA,0,3923.13,803762.5,CR,REF731697,CBA,Current
26-08-2025 01:01,CBA23419F7AF08F49C69900,063-000-002,33333333,BANK FEE CBA,9.33,0,803753.17,DR,REF898751,CBA,Current
26-08-2025 01:02,CBA48BAD0FD4B3F48D9BC6E,063-000-002,33333333,ALDI CBA,19.45,0,803733.72,DR,REF452853,CBA,Current
26-08-2025 01:48,INT2B08A877964C48168CE0,063-000-002,33333333,TRANSFER FROM CBA 22222222,0,1864.88,805598.6,CR,INT-92851,CBA,Current
26-08-2025 01:56,CBA9BB46AF297D54F7ABB6F,063-000-002,33333333,SALARY PAYMENT CBA,0,1860.75,807459.35,CR,REF172139,CBA,Current
26-08-2025 02:17,CBA07850A37414E41E19181,063-000-002,33333333,PAYROLL CREDIT CBA,0,2623.7,810083.05,CR,REF498798,CBA,Current
26-08-2025 03:14,CBA64BDBF5579B74AE098B0,063-000-002,33333333,DOMINO'S PIZZA CBA,25.15,0,810057.9,DR,REF479510,CBA,Current
26-08-2025 03:26,CBA14474726E31C49BABCCF,063-000-002,33333333,CITYLINK CBA,86.24,0,809971.66,DR,REF363256,CBA,Current
26-08-2025 03:55,CBA56D03AF15FB14BD28B0D,063-000-002,33333333,UBER EATS CBA,79.92,0,809891.74,DR,REF606350,CBA,Current
26-08-2025 04:01,CBA24D8D64FF62C4083837D,063-000-002,33333333,PAYMENT GATEWAY CBA,21.94,0,809869.8,DR,REF634084,CBA,Current
26-08-2025 04:10,CBADBC92F6E6BC74BB4BA8F,063-000-002,33333333,TAFE BOOKSHOP CBA,26.74,0,809843.06,DR,REF578663,CBA,Current
26-08-2025 04:14,CBAFA2E7450CAE44B378E44,063-000-002,33333333,MCDONALDS CBA,65.66,0,809777.4,DR,REF910634,CBA,Current
26-08-2025 04:24,CBA05AA1B09FAB54D9B9F28,063-000-002,33333333,TAFE BOOKSHOP CBA,51.71,0,809725.69,DR,REF505733,CBA,Current
26-08-2025 04:31,CBA0DBD57A4939E4A8CBC77,063-000-002,33333333,BANK FEE CBA,77.56,0,809648.13,DR,REF315843,CBA,Current
26-08-2025 04:31,CBA2504E3FE65414F959CD1,063-000-002,33333333,PAYROLL CREDIT CBA,0,7262.1,816910.23,CR,REF126808,CBA,Current
26-08-2025 04:36,CBABDADE36636C54268A3B5,063-000-002,33333333,RAILWAY STATION CBA,85.01,0,816825.22,DR,REF317485,CBA,Current
26-08-2025 05:03,CBAF41D22F403A34E5B825C,063-000-002,33333333,LIQUORLAND CBA,85.12,0,816740.1,DR,REF293214,CBA,Current
26-08-2025 05:59,CBA27D9D2650261437F9D2F,063-000-002,33333333,MCDONALDS CBA,38.86,0,816701.24,DR,REF117709,CBA,Current
26-08-2025 06:09,CBA01D47D962D7E49198D74,063-000-002,33333333,UBER EATS CBA,94.46,0,816606.78,DR,REF852021,CBA,Current
26-08-2025 06:23,INT32C0B79DEF4C40C7A2DC,063-000-002,33333333,TRANSFER TO NAB 44444444,940.37,0,815666.41,DR,INT-27691,CBA,Current
26-08-2025 06:31,CBA0852E3BCA38C4E04A6E8,063-000-002,33333333,MENULOG CBA,3.96,0,815662.45,DR,REF896209,CBA,Current
26-08-2025 06:41,CBA13F32A43786945DDA7FA,063-000-002,33333333,UBER EATS CBA,11.91,0,815650.54,DR,REF699591,CBA,Current
26-08-2025 06:50,CBA89CF74A50F5244BE9DB2,063-000-002,33333333,BWS CBA,75.51,0,815575.03,DR,REF339863,CBA,Current
26-08-2025 06:59,CBAF796B61091C34AEEA186,063-000-002,33333333,BIGW CBA,65.63,0,815509.4,DR,REF912789,CBA,Current
26-08-2025 07:29,CBA4FA95D2EBC9742039915,063-000-002,33333333,SALARY PAYMENT CBA,0,382.36,815891.76,CR,REF620006,CBA,Current
26-08-2025 07:34,CBAB5006F35080249169037,063-000-002,33333333,CITYLINK CBA,65.86,0,815825.9,DR,REF955342,CBA,Current
26-08-2025 07:51,CBADAC4DFF093974362928F,063-000-002,33333333,FLIXBUS CBA,96.51,0,815729.39,DR,REF314957,CBA,Current
26-08-2025 07:53,CBAC5047036ED7E463685D8,063-000-002,33333333,RAILWAY STATION CBA,17.68,0,815711.71,DR,REF432382,CBA,Current
26-08-2025 08:11,CBA9CE11843CD34486FB086,063-000-002,33333333,COMPANY PAYROLL CBA,0,4688.89,820400.6,CR,REF803237,CBA,Current
26-08-2025 08:15,CBA17F2099B42ED49999D2F,063-000-002,33333333,ALDI CBA,30.66,0,820369.94,DR,REF111210,CBA,Current
26-08-2025 09:09,CBAE06B36BDC0E24C19AA13,063-000-002,33333333,PAY - SALARY CBA,0,5085.81,825455.75,CR,REF290821,CBA,Current
26-08-2025 09:28,CBA18632A52288C482C83DC,063-000-002,33333333,COLES CBA,123.85,0,825331.9,DR,REF439542,CBA,Current
26-08-2025 10:16,INTF84A60B2869748AD887B,063-000-002,33333333,TRANSFER TO ANZ 11111111,1262.14,0,824069.76,DR,INT-67179,CBA,Current
26-08-2025 11:05,CBABA61D7082A2D4AACB165,063-000-002,33333333,DOMINO'S PIZZA CBA,223.68,0,823846.08,DR,REF876689,CBA,Current
26-08-2025 11:39,CBA82562077E75D4D24AFF9,063-000-002,33333333,PAY - SALARY CBA,0,761.26,824607.34,CR,REF468228,CBA,Current
26-08-2025 12:04,INT0BDD770A54E0410DAB55,063-000-002,33333333,TRANSFER TO ANZ 11111111,1962.61,0,822644.73,DR,INT-73550,CBA,Current
26-08-2025 12:32,CBAE699924219CB41B288DD,063-000-002,33333333,BIGW CBA,95.25,0,822549.48,DR,REF778129,CBA,Current
26-08-2025 12:41,CBA0687541A42444E73A20A,063-000-002,33333333,BP CBA,16.31,0,822533.17,DR,REF780991,CBA,Current
26-08-2025 13:23,CBA65AE2831F80E4DF7B29F,063-000-002,33333333,ZOOM CBA,12.38,0,822520.79,DR,REF297972,CBA,Current
26-08-2025 14:42,CBAD2851CC5A1D34F68AF70,063-000-002,33333333,WOOLWORTHS CBA,13.22,0,822507.57,DR,REF383163,CBA,Current
26-08-2025 14:46,CBA23396416A0B34EC582CC,063-000-002,33333333,AMAZON AU CBA,64.89,0,822442.68,DR,REF499122,CBA,Current
26-08-2025 14:52,CBA6C3E6D32B6F94D7E85FB,063-000-002,33333333,MCDONALDS CBA,5.8,0,822436.88,DR,REF554450,CBA,Current
26-08-2025 15:12,CBA6F34C7FCC5EE43A2830D,063-000-002,33333333,JB HI-FI CBA,50.8,0,822386.08,DR,REF456349,CBA,Current
26-08-2025 15:31,CBA475F7DF4894745AB822E,063-000-002,33333333,PAYROLL CREDIT CBA,0,1017.06,823403.14,CR,REF680961,CBA,Current
26-08-2025 15:38,CBA9FE310E1403E47199878,063-000-002,33333333,BIGW CBA,23.58,0,823379.56,DR,REF544264,CBA,Current
26-08-2025 16:10,CBAEF73C3FCD5D244B08819,063-000-002,33333333,STARBUCKS CBA,8.85,0,823370.71,DR,REF982920,CBA,Current
26-08-2025 16:42,CBAA0199C38668A4ADD91E2,063-000-002,33333333,PAYMENT GATEWAY CBA,22.98,0,823347.73,DR,REF346536,CBA,Current
26-08-2025 16:43,INT74BF773A72E14439AFFA,063-000-002,33333333,TRANSFER FROM NAB 44444444,0,270.34,823618.07,CR,INT-65503,CBA,Current
26-08-2025 16:50,CBA5E53C527188744458A33,063-000-002,33333333,COMPANY PAYROLL CBA,0,6350.99,829969.06,CR,REF580593,CBA,Current
26-08-2025 17:13,CBA71DE2B20EDAA4E108D6A,063-000-002,33333333,ZOOM CBA,15.67,0,829953.39,DR,REF202140,CBA,Current
26-08-2025 17:16,CBA14DA893484B0494AAFF1,063-000-002,33333333,PAY - SALARY CBA,0,148.67,830102.06,CR,REF887797,CBA,Current
26-08-2025 17:48,CBA4437DD05F37D40DBB62F,063-000-002,33333333,SPOTIFY CBA,44.44,0,830057.62,DR,REF559665,CBA,Current
26-08-2025 17:51,CBA4607D23BCAE54E068D4E,063-000-002,33333333,RAILWAY STATION CBA,90.77,0,829966.85,DR,REF588433,CBA,Current
26-08-2025 17:55,CBA038F573D90854876BE02,063-000-002,33333333,SHELL CBA,12.86,0,829953.99,DR,REF351817,CBA,Current
26-08-2025 18:05,CBA2B9522186A65438B9B9F,063-000-002,33333333,UBER EATS CBA,188.42,0,829765.57,DR,REF276045,CBA,Current
26-08-2025 18:07,CBA433A845EEF2B4BB8B9E3,063-000-002,33333333,SHELL CBA,36.44,0,829729.13,DR,REF211561,CBA,Current
26-08-2025 18:36,CBAA9637667CF90484CAB07,063-000-002,33333333,PAYPAL *NETFLIX CBA,27.73,0,829701.4,DR,REF973462,CBA,Current
26-08-2025 18:40,CBA7E26E6779F8E4DBD9EBC,063-000-002,33333333,SPOTIFY CBA,33.72,0,829667.68,DR,REF855464,CBA,Current
26-08-2025 19:01,CBA791AA34D0B8741FEB3C6,063-000-002,33333333,MENULOG CBA,90.41,0,829577.27,DR,REF288781,CBA,Current
26-08-2025 19:15,CBACA4E10F039634D7E85D5,063-000-002,33333333,ALDI CBA,192.83,0,829384.44,DR,REF869317,CBA,Current
26-08-2025 19:23,CBA4AD4B707AF55406F9BBF,063-000-002,33333333,COLES CBA,8.23,0,829376.21,DR,REF722015,CBA,Current
26-08-2025 20:14,CBAB258802A04874ECAB381,063-000-002,33333333,SALARY PAYMENT CBA,0,81.48,829457.69,CR,REF121727,CBA,Current
26-08-2025 21:04,CBA7952909A2ED6474F9050,063-000-002,33333333,STARBUCKS CBA,13.15,0,829444.54,DR,REF776092,CBA,Current
26-08-2025 21:08,CBAFFDC41D3EC7648019526,063-000-002,33333333,PAYPAL *NETFLIX CBA,42.95,0,829401.59,DR,REF216096,CBA,Current
26-08-2025 22:18,CBA39C666F26A624FA5A387,063-000-002,33333333,7-ELEVEN CBA,26.11,0,829375.48,DR,REF969301,CBA,Current
26-08-2025 22:22,CBABE0D0CB2677A451A9D74,063-000-002,33333333,HARVEY NORMAN CBA,61.36,0,829314.12,DR,REF188450,CBA,Current
26-08-2025 22:39,INT25C01647854148BD99A3,063-000-002,33333333,TRANSFER FROM NAB 44444444,0,810.42,830124.54,CR,INT-87838,CBA,Current
26-08-2025 23:09,CBA8C6EF263CFB94E74995F,063-000-002,33333333,AMAZON AU CBA,7.8,0,830116.74,DR,REF786330,CBA,Current
26-08-2025 23:15,CBAE65F5A92F3294B60A860,063-000-002,33333333,BP CBA,93.27,0,830023.47,DR,REF579281,CBA,Current
26-08-2025 23:38,CBA427D9696FF8643119A24,063-000-002,33333333,RAILWAY STATION CBA,104.36,0,829919.11,DR,REF690553,CBA,Current
27-08-2025 00:04,CBAF9E036D6352F4BA7BC5A,063-000-002,33333333,PAYROLL CREDIT CBA,0,3382.47,833301.58,CR,REF309743,CBA,Current
27-08-2025 00:08,CBAE09C9A652B304643ABD2,063-000-002,33333333,APPLE CBA,12.79,0,833288.79,DR,REF498112,CBA,Current
27-08-2025 00:33,CBA91034E8205144E9FBCF6,063-000-002,33333333,ZOOM CBA,92.61,0,833196.18,DR,REF947029,CBA,Current
27-08-2025 00:57,CBA1F61FC7D60064FF8B577,063-000-002,33333333,UBER EATS CBA,36.41,0,833159.77,DR,REF468319,CBA,Current
27-08-2025 00:58,CBAC8405CDB8C96446FBFE4,063-000-002,33333333,PAYPAL *NETFLIX CBA,210.82,0,832948.95,DR,REF223379,CBA,Current
27-08-2025 01:00,CBADCD5E0A38367471C8507,063-000-002,33333333,ALDI CBA,112.21,0,832836.74,DR,REF280938,CBA,Current
27-08-2025 01:09,CBA98C898E2BDAC4FCCB2E6,063-000-002,33333333,RAILWAY STATION CBA,4.62,0,832832.12,DR,REF998241,CBA,Current
27-08-2025 01:33,CBAFD7AD800CFE44A93A1CC,063-000-002,33333333,TAFE BOOKSHOP CBA,53.95,0,832778.17,DR,REF172542,CBA,Current
27-08-2025 01:40,CBAB3C006709C3546ACA9F3,063-000-002,33333333,BP CBA,89.04,0,832689.13,DR,REF175099,CBA,Current
27-08-2025 01:48,CBAB881D58C8F23401A9264,063-000-002,33333333,APPLE CBA,57.53,0,832631.6,DR,REF747800,CBA,Current
27-08-2025 02:37,CBAED87B1356407465DA047,063-000-002,33333333,WAGES CREDIT CBA,0,1090.42,833722.02,CR,REF215410,CBA,Current
27-08-2025 02:44,CBABECE9C7D01E54B8092C2,063-000-002,33333333,SALARY PAYMENT CBA,0,1813.3,835535.32,CR,REF708773,CBA,Current
27-08-2025 02:46,CBA3E794A8CA0C44F709ABC,063-000-002,33333333,PAY - SALARY CBA,0,5915.78,841451.1,CR,REF620124,CBA,Current
27-08-2025 02:50,CBAE74C99ACEB7A448580B0,063-000-002,33333333,WOOLWORTHS CBA,34.74,0,841416.36,DR,REF647694,CBA,Current
27-08-2025 03:34,CBAC07A9A0B98F44794BE12,063-000-002,33333333,COLES CBA,36.11,0,841380.25,DR,REF160146,CBA,Current
27-08-2025 03:49,CBA8BA5A73DB7334ED5B85D,063-000-002,33333333,KFC CBA,77.63,0,841302.62,DR,REF141419,CBA,Current
27-08-2025 03:50,CBAAD4F46D22C224AE69873,063-000-002,33333333,MENULOG CBA,38.49,0,841264.13,DR,REF802803,CBA,Current
27-08-2025 04:30,CBA1D10EE0F078E48AD92C6,063-000-002,33333333,WOOLWORTHS CBA,34.19,0,841229.94,DR,REF534441,CBA,Current
27-08-2025 04:32,CBAC5E1BF55D6814926B7B2,063-000-002,33333333,PAYROLL CREDIT CBA,0,959.39,842189.33,CR,REF457304,CBA,Current
27-08-2025 04:37,CBA079C07ABCF0048688EFB,063-000-002,33333333,BWS CBA,7.11,0,842182.22,DR,REF164917,CBA,Current
27-08-2025 05:10,CBAAB92D42B195C4A02906E,063-000-002,33333333,PAYPAL *NETFLIX CBA,66.1,0,842116.12,DR,REF373789,CBA,Current
27-08-2025 06:33,CBA2F4EBF9B06D64E9D89CE,063-000-002,33333333,TAFE BOOKSHOP CBA,71.96,0,842044.16,DR,REF868151,CBA,Current
27-08-2025 07:23,INT8BFAA8BCB7154EBEABEB,063-000-002,33333333,TRANSFER FROM CBA 22222222,0,251.64,842295.8,CR,INT-75127,CBA,Current
27-08-2025 07:49,CBA27D2CEC01894475FAB81,063-000-002,33333333,INTERNET TRANSFER CBA,19.25,0,842276.55,DR,REF499131,CBA,Current
27-08-2025 07:59,CBAD7CC71147C01452087E0,063-000-002,33333333,DOMINO'S PIZZA CBA,60.03,0,842216.52,DR,REF706346,CBA,Current
27-08-2025 08:18,CBA61C94708408B4AA6818A,063-000-002,33333333,STARBUCKS CBA,24.25,0,842192.27,DR,REF247611,CBA,Current
27-08-2025 08:47,CBAB9685AB5DECF4409BCD6,063-000-002,33333333,JB HI-FI CBA,7.56,0,842184.71,DR,REF796202,CBA,Current
27-08-2025 09:03,CBA0EFE4D51CD35438BAB29,063-000-002,33333333,WAGES CREDIT CBA,0,3147.31,845332.02,CR,REF655283,CBA,Current
27-08-2025 09:03,INTB45ECB46D96148C79E3F,063-000-002,33333333,TRANSFER TO CBA 22222222,1147.62,0,844184.4,DR,INT-22708,CBA,Current
27-08-2025 10:05,CBAB7CCD973644C46A4989A,063-000-002,33333333,SPOTIFY CBA,99.96,0,844084.44,DR,REF905235,CBA,Current
27-08-2025 10:28,CBA5B70F7FA9FBC4F54A202,063-000-002,33333333,TAFE BOOKSHOP CBA,35.59,0,844048.85,DR,REF131578,CBA,Current
27-08-2025 10:58,CBA178CD3D4C4E84F688C3D,063-000-002,33333333,BWS CBA,34.71,0,844014.14,DR,REF614658,CBA,Current
27-08-2025 11:25,CBA6EA40E96C9104E8AB8D3,063-000-002,33333333,BIGW CBA,219.36,0,843794.78,DR,REF500565,CBA,Current
27-08-2025 11:34,CBA1B906D75DEB843DDAC65,063-000-002,33333333,ZOOM CBA,11.29,0,843783.49,DR,REF603893,CBA,Current
27-08-2025 11:40,CBA16C22AE22100445DB970,063-000-002,33333333,ALDI CBA,24.24,0,843759.25,DR,REF215343,CBA,Current
27-08-2025 11:49,CBA0F00D2B3B64B4BF4BAAE,063-000-002,33333333,7-ELEVEN CBA,9.17,0,843750.08,DR,REF683439,CBA,Current
27-08-2025 12:13,CBA3E7B34AADF6147C6A4B9,063-000-002,33333333,HARVEY NORMAN CBA,75.65,0,843674.43,DR,REF618606,CBA,Current
27-08-2025 13:41,CBA72C21907BDE34CF38C57,063-000-002,33333333,INTERNET TRANSFER CBA,8.14,0,843666.29,DR,REF319303,CBA,Current
27-08-2025 13:43,CBAA1531F12B75144CBB04D,063-000-002,33333333,INTERNET TRANSFER CBA,68.25,0,843598.04,DR,REF215706,CBA,Current
27-08-2025 14:10,CBA013D6FA1826F4207AE9C,063-000-002,33333333,HARVEY NORMAN CBA,15.12,0,843582.92,DR,REF352547,CBA,Current
27-08-2025 14:28,CBA90AD7BD8B5564608BA41,063-000-002,33333333,RAILWAY STATION CBA,5.94,0,843576.98,DR,REF526927,CBA,Current
27-08-2025 14:44,CBACAB646CBBDF54DC6BD65,063-000-002,33333333,DOMINO'S PIZZA CBA,94.91,0,843482.07,DR,REF323391,CBA,Current
27-08-2025 15:13,CBAFD702AB1C79C48CCB4FF,063-000-002,33333333,LIQUORLAND CBA,101.83,0,843380.24,DR,REF907575,CBA,Current
27-08-2025 15:36,INT82CC25B752084A98AF8A,063-000-002,33333333,TRANSFER TO ANZ 11111111,1086.06,0,842294.18,DR,INT-15555,CBA,Current
27-08-2025 15:58,CBAA256EA2AEDDC478F90FB,063-000-002,33333333,FLIXBUS CBA,68.73,0,842225.45,DR,REF483784,CBA,Current
27-08-2025 16:08,CBABB0B838AA8B9496786C1,063-000-002,33333333,ALDI CBA,11.05,0,842214.4,DR,REF482482,CBA,Current
27-08-2025 16:14,INTC35AF93026CE4E199657,063-000-002,33333333,TRANSFER TO ANZ 11111111,142.72,0,842071.68,DR,INT-88126,CBA,Current
27-08-2025 16:34,CBAAAAAF6BE2FDA4BC48FDA,063-000-002,33333333,HARVEY NORMAN CBA,152,0,841919.68,DR,REF847352,CBA,Current
27-08-2025 16:52,CBA14731A386EC84726A783,063-000-002,33333333,PAYMENT GATEWAY CBA,36.62,0,841883.06,DR,REF611836,CBA,Current
27-08-2025 17:18,CBA01E91A08C1C44D1698E2,063-000-002,33333333,HARVEY NORMAN CBA,93.87,0,841789.19,DR,REF894003,CBA,Current
27-08-2025 17:40,CBA8F6F3B5F128441D6B047,063-000-002,33333333,STARBUCKS CBA,21.09,0,841768.1,DR,REF873454,CBA,Current
27-08-2025 18:23,CBACEA98BF6BC2440DE8483,063-000-002,33333333,PAYMENT GATEWAY CBA,5.51,0,841762.59,DR,REF284186,CBA,Current
27-08-2025 18:25,CBA35E677107DAB41268FF2,063-000-002,33333333,LIQUORLAND CBA,14.01,0,841748.58,DR,REF578792,CBA,Current
27-08-2025 18:28,CBA3163DF3BA9DE4720AE92,063-000-002,33333333,COLES CBA,3.23,0,841745.35,DR,REF177812,CBA,Current
27-08-2025 18:32,CBA7D8D43507EA845DE90B8,063-000-002,33333333,COMPANY PAYROLL CBA,0,7281.77,849027.12,CR,REF491699,CBA,Current
27-08-2025 18:48,CBA696C5D98B46941FDB7ED,063-000-002,33333333,DOMINO'S PIZZA CBA,15.86,0,849011.26,DR,REF181959,CBA,Current
27-08-2025 18:59,CBA13952F7C05124F9A8A40,063-000-002,33333333,COMPANY PAYROLL CBA,0,6879.9,855891.16,CR,REF898325,CBA,Current
27-08-2025 19:27,CBAD2AF678504D646D6A6C9,063-000-002,33333333,RAILWAY STATION CBA,13.6,0,855877.56,DR,REF911516,CBA,Current
27-08-2025 19:32,CBAE1C4F1FA610D4736B0BA,063-000-002,33333333,UBER EATS CBA,23.13,0,855854.43,DR,REF220365,CBA,Current
27-08-2025 19:39,CBA70293DE470F441E69092,063-000-002,33333333,BIGW CBA,151.58,0,855702.85,DR,REF265500,CBA,Current
27-08-2025 20:13,CBAAFC11238D70544419157,063-000-002,33333333,WAGES CREDIT CBA,0,4194.39,859897.24,CR,REF508169,CBA,Current
27-08-2025 20:18,CBABB0BC9201B854F229631,063-000-002,33333333,APPLE CBA,18.01,0,859879.23,DR,REF398434,CBA,Current
27-08-2025 20:28,CBA152479B026934D15A166,063-000-002,33333333,FLIXBUS CBA,52.38,0,859826.85,DR,REF715524,CBA,Current
27-08-2025 20:29,CBAE78C360811D249489358,063-000-002,33333333,DOMINO'S PIZZA CBA,5.52,0,859821.33,DR,REF810198,CBA,Current
27-08-2025 20:31,INTEA7D4EE27D224B89951C,063-000-002,33333333,TRANSFER TO ANZ 11111111,81.46,0,859739.87,DR,INT-32799,CBA,Current
27-08-2025 21:11,CBAF935FF71B08F42BB8CA3,063-000-002,33333333,RAILWAY STATION CBA,16.34,0,859723.53,DR,REF523555,CBA,Current
27-08-2025 21:22,CBA20E4FF373A564DA4A476,063-000-002,33333333,APPLE CBA,85.91,0,859637.62,DR,REF197808,CBA,Current
27-08-2025 21:27,CBA8C50D173B13141B98C0B,063-000-002,33333333,AMAZON AU CBA,106.39,0,859531.23,DR,REF419753,CBA,Current
27-08-2025 22:11,CBA19681741CD984AAD9069,063-000-002,33333333,APPLE CBA,50.16,0,859481.07,DR,REF423846,CBA,Current
27-08-2025 22:20,CBA8BC0CCA7A8C14889AFCA,063-000-002,33333333,SPOTIFY CBA,91.53,0,859389.54,DR,REF484278,CBA,Current
27-08-2025 22:22,CBA36449DBAFE41422CB79F,063-000-002,33333333,FLIXBUS CBA,41.61,0,859347.93,DR,REF274864,CBA,Current
27-08-2025 22:28,CBA88132B6E5FA1437A8586,063-000-002,33333333,JB HI-FI CBA,71.33,0,859276.6,DR,REF285302,CBA,Current
27-08-2025 22:40,CBA030FEF820ED64D37AD7B,063-000-002,33333333,BP CBA,82.18,0,859194.42,DR,REF685086,CBA,Current
27-08-2025 22:43,CBA63D9743D07B1484081C3,063-000-002,33333333,BWS CBA,31.87,0,859162.55,DR,REF587912,CBA,Current
27-08-2025 23:26,CBAB2D1B056BB83420E8F98,063-000-002,33333333,BWS CBA,73.5,0,859089.05,DR,REF191003,CBA,Current
28-08-2025 00:44,CBAD407E189E86E4F678EED,063-000-002,33333333,KFC CBA,42.03,0,859047.02,DR,REF369757,CBA,Current
28-08-2025 00:51,CBA6E7F2BA8932747F5A8D1,063-000-002,33333333,COMPANY PAYROLL CBA,0,2182.89,861229.91,CR,REF633693,CBA,Current
28-08-2025 01:05,CBA360C50B7F3E14DCA9FD5,063-000-002,33333333,COLES CBA,69.87,0,861160.04,DR,REF585878,CBA,Current
28-08-2025 01:13,CBAA68E62F6514F41CC8250,063-000-002,33333333,BANK FEE CBA,9.08,0,861150.96,DR,REF242441,CBA,Current
28-08-2025 01:13,CBA6A9134351BEC4FFEA1EC,063-000-002,33333333,PAYMENT GATEWAY CBA,10.39,0,861140.57,DR,REF381867,CBA,Current
28-08-2025 01:38,CBAB6A0CDE2B6CE4C5E8677,063-000-002,33333333,PAYROLL CREDIT CBA,0,3483.44,864624.01,CR,REF698353,CBA,Current
28-08-2025 01:42,CBA79BCD7CC6DF547968D70,063-000-002,33333333,CITYLINK CBA,60.1,0,864563.91,DR,REF393921,CBA,Current
28-08-2025 02:17,CBAB32EBB8C95C644E698B0,063-000-002,33333333,TAFE BOOKSHOP CBA,57.54,0,864506.37,DR,REF539027,CBA,Current
28-08-2025 02:45,CBA3E9606A68D6B43488CB7,063-000-002,33333333,BWS CBA,62.57,0,864443.8,DR,REF414581,CBA,Current
28-08-2025 02:56,CBA76CB6E6EFB32411CBBD7,063-000-002,33333333,MENULOG CBA,212.59,0,864231.21,DR,REF110320,CBA,Current
28-08-2025 03:07,CBAA5F51D2ABF9A4464B2B4,063-000-002,33333333,MCDONALDS CBA,35.01,0,864196.2,DR,REF159171,CBA,Current
28-08-2025 03:41,CBA2B8B3C16D2904C0DB5F2,063-000-002,33333333,WOOLWORTHS CBA,27.44,0,864168.76,DR,REF764945,CBA,Current
28-08-2025 03:55,CBA5A36F02D2FCB44C3B2A2,063-000-002,33333333,ZOOM CBA,19.83,0,864148.93,DR,REF387264,CBA,Current
28-08-2025 04:08,CBA47F9A394018243A7B51E,063-000-002,33333333,RAILWAY STATION CBA,73.44,0,864075.49,DR,REF366985,CBA,Current
28-08-2025 04:35,CBA8CDAD46B6A6D4C92835B,063-000-002,33333333,FLIXBUS CBA,44.97,0,864030.52,DR,REF513867,CBA,Current
28-08-2025 05:14,CBAA1D40CF3306A4F548AC3,063-000-002,33333333,RAILWAY STATION CBA,46.91,0,863983.61,DR,REF762612,CBA,Current
28-08-2025 05:40,CBA6525FBEBED0041A5BE79,063-000-002,33333333,KFC CBA,44.55,0,863939.06,DR,REF747913,CBA,Current
28-08-2025 06:10,CBAFF041EC8E7014E4E8E4E,063-000-002,33333333,SALARY PAYMENT CBA,0,7834.61,871773.67,CR,REF464252,CBA,Current
28-08-2025 06:12,CBAD1017F78221C414C8FDD,063-000-002,33333333,PAYMENT GATEWAY CBA,13.08,0,871760.59,DR,REF666378,CBA,Current
28-08-2025 06:18,CBA329954F3C44B4EE29A01,063-000-002,33333333,BWS CBA,35.34,0,871725.25,DR,REF109549,CBA,Current
28-08-2025 06:46,CBA6C3EDEE59BB74CE89A37,063-000-002,33333333,KFC CBA,71.34,0,871653.91,DR,REF916906,CBA,Current
28-08-2025 07:02,CBABE17931B55A14B2093C2,063-000-002,33333333,COMPANY PAYROLL CBA,0,6250.2,877904.11,CR,REF459471,CBA,Current
28-08-2025 07:41,CBA773D328E321640C2A473,063-000-002,33333333,UBER EATS CBA,54.64,0,877849.47,DR,REF852089,CBA,Current
28-08-2025 07:49,CBA6D81FBA4C7504D58BC0E,063-000-002,33333333,HARVEY NORMAN CBA,71.1,0,877778.37,DR,REF694214,CBA,Current
28-08-2025 08:33,CBA0767137EDFA0418D9183,063-000-002,33333333,AMAZON AU CBA,80.87,0,877697.5,DR,REF193620,CBA,Current
28-08-2025 09:31,CBABB7E304B17144E90919C,063-000-002,33333333,COLES CBA,150.64,0,877546.86,DR,REF307509,CBA,Current
28-08-2025 10:10,CBA625914B8311641EB9BFE,063-000-002,33333333,SHELL CBA,29.76,0,877517.1,DR,REF443551,CBA,Current
28-08-2025 10:22,CBAAA8B3AF94D9E4AE6AD1B,063-000-002,33333333,CITYLINK CBA,87.97,0,877429.13,DR,REF709999,CBA,Current
28-08-2025 10:27,CBAB506037DE9294AC59F77,063-000-002,33333333,BP CBA,25.94,0,877403.19,DR,REF792841,CBA,Current
28-08-2025 10:29,CBAA655F35CEC0B4F54AF8F,063-000-002,33333333,SALARY PAYMENT CBA,0,3721.43,881124.62,CR,REF402183,CBA,Current
28-08-2025 10:53,CBA75759E8ED55A4DC9A8C3,063-000-002,33333333,INTERNET TRANSFER CBA,84.02,0,881040.6,DR,REF996507,CBA,Current
28-08-2025 11:37,CBA368537E26FED4F83A988,063-000-002,33333333,SHELL CBA,23.45,0,881017.15,DR,REF766777,CBA,Current
28-08-2025 11:58,CBAE75ACE6497054C41B699,063-000-002,33333333,JB HI-FI CBA,12.25,0,881004.9,DR,REF821757,CBA,Current
28-08-2025 11:58,CBAB551142B0F3641169E35,063-000-002,33333333,WAGES CREDIT CBA,0,5300.37,886305.27,CR,REF414118,CBA,Current
28-08-2025 12:34,CBA7AD420C2904046C0B1EC,063-000-002,33333333,HARVEY NORMAN CBA,11.3,0,886293.97,DR,REF899962,CBA,Current
28-08-2025 12:38,CBA6E4B88F00110471DB66C,063-000-002,33333333,WOOLWORTHS CBA,38.02,0,886255.95,DR,REF132769,CBA,Current
28-08-2025 12:49,CBA828FEF0D966643F7B164,063-000-002,33333333,MENULOG CBA,111.88,0,886144.07,DR,REF651267,CBA,Current
28-08-2025 13:02,INT526E01F0134B4569AB92,063-000-002,33333333,TRANSFER TO CBA 22222222,1043.43,0,885100.64,DR,INT-35633,CBA,Current
28-08-2025 13:34,CBA94FDA3933A1E43AFBD41,063-000-002,33333333,STARBUCKS CBA,111.13,0,884989.51,DR,REF204943,CBA,Current
28-08-2025 13:46,CBAB4BBC5C151D840FAB764,063-000-002,33333333,RAILWAY STATION CBA,10.09,0,884979.42,DR,REF996062,CBA,Current
28-08-2025 14:18,CBA97E45590E8E94A7CBC48,063-000-002,33333333,SPOTIFY CBA,36.32,0,884943.1,DR,REF461809,CBA,Current
28-08-2025 14:42,CBACF90972E11FB4EF8A5D9,063-000-002,33333333,UBER EATS CBA,80.33,0,884862.77,DR,REF270358,CBA,Current
28-08-2025 15:19,CBA1790FAE8388C47AEBFE1,063-000-002,33333333,INTERNET TRANSFER CBA,83.48,0,884779.29,DR,REF329715,CBA,Current
28-08-2025 15:20,CBA0F1FBA9A1C014EF9AE69,063-000-002,33333333,ZOOM CBA,24.42,0,884754.87,DR,REF247315,CBA,Current
28-08-2025 15:36,CBAAEF7D61FF0AE4483929E,063-000-002,33333333,BWS CBA,112.85,0,884642.02,DR,REF963176,CBA,Current
28-08-2025 15:41,CBA38111874B7E44D01A6F1,063-000-002,33333333,PAYROLL CREDIT CBA,0,3454.33,888096.35,CR,REF969064,CBA,Current
28-08-2025 16:04,CBAB71B441A5C81450DB23B,063-000-002,33333333,COMPANY PAYROLL CBA,0,1620.72,889717.07,CR,REF820971,CBA,Current
28-08-2025 16:23,CBAFCA0969EB1F04273BD41,063-000-002,33333333,STARBUCKS CBA,70.77,0,889646.3,DR,REF653387,CBA,Current
28-08-2025 16:31,CBA28B06B68E1034B5D9CEE,063-000-002,33333333,ALDI CBA,15.14,0,889631.16,DR,REF689873,CBA,Current
28-08-2025 17:27,CBAD231975E6EB44B16AE49,063-000-002,33333333,PAYMENT GATEWAY CBA,38.22,0,889592.94,DR,REF500306,CBA,Current
28-08-2025 18:19,CBABB629C2DCABA425EB874,063-000-002,33333333,AMAZON AU CBA,113.83,0,889479.11,DR,REF877062,CBA,Current
28-08-2025 18:27,CBA79D123E6D9B042EEB6AC,063-000-002,33333333,BIGW CBA,37.96,0,889441.15,DR,REF445228,CBA,Current
28-08-2025 18:50,CBA4F95D63997EF4FE88DDC,063-000-002,33333333,SPOTIFY CBA,61.26,0,889379.89,DR,REF655792,CBA,Current
28-08-2025 18:53,CBA299FC10285FD4626BA25,063-000-002,33333333,PAYROLL CREDIT CBA,0,4747.41,894127.3,CR,REF839723,CBA,Current
28-08-2025 19:13,CBA99C577C027314681A52F,063-000-002,33333333,INTERNET TRANSFER CBA,85.27,0,894042.03,DR,REF731829,CBA,Current
28-08-2025 20:07,CBA1B899EEB6693417EAD50,063-000-002,33333333,COLES CBA,8.38,0,894033.65,DR,REF723395,CBA,Current
28-08-2025 20:07,CBAEE8C037A3013484C9B2C,063-000-002,33333333,MENULOG CBA,89.48,0,893944.17,DR,REF272454,CBA,Current
28-08-2025 20:35,CBA18694743BAC64A32AD08,063-000-002,33333333,PAYPAL *NETFLIX CBA,50.46,0,893893.71,DR,REF787123,CBA,Current
28-08-2025 20:37,CBADBCAE0FAC4554235B16C,063-000-002,33333333,UBER EATS CBA,27.99,0,893865.72,DR,REF960089,CBA,Current
28-08-2025 20:51,CBA1F8FF0F3F4D14890A46A,063-000-002,33333333,ZOOM CBA,27.11,0,893838.61,DR,REF420748,CBA,Current
28-08-2025 21:10,CBA88AEE9234D394CA3914F,063-000-002,33333333,BIGW CBA,12.45,0,893826.16,DR,REF436016,CBA,Current
28-08-2025 21:23,CBABDF651154D774B769CF3,063-000-002,33333333,SALARY PAYMENT CBA,0,7514.5,901340.66,CR,REF981268,CBA,Current
28-08-2025 21:34,CBA891A61D3065942A2A017,063-000-002,33333333,BANK FEE CBA,14.11,0,901326.55,DR,REF813112,CBA,Current
28-08-2025 22:33,CBA5F067D9CB5B74F5DBE11,063-000-002,33333333,PAYPAL *NETFLIX CBA,3.87,0,901322.68,DR,REF115168,CBA,Current
28-08-2025 22:42,CBA1F2EC302969040F99C66,063-000-002,33333333,ZOOM CBA,15.6,0,901307.08,DR,REF206152,CBA,Current
28-08-2025 22:45,CBABE72F5388C1F44F2813C,063-000-002,33333333,KFC CBA,82,0,901225.08,DR,REF280255,CBA,Current
28-08-2025 22:47,CBA7997F7F8136E48FF98E9,063-000-002,33333333,WAGES CREDIT CBA,0,1851.33,903076.41,CR,REF408544,CBA,Current
28-08-2025 22:56,CBA7594284676CE4F509303,063-000-002,33333333,PAYROLL CREDIT CBA,0,7019.89,910096.3,CR,REF333831,CBA,Current
28-08-2025 23:23,CBA2B049B36BD6946989D74,063-000-002,33333333,MCDONALDS CBA,4.29,0,910092.01,DR,REF289837,CBA,Current
28-08-2025 23:34,CBA91EF622DF2B04BD392ED,063-000-002,33333333,BP CBA,7.99,0,910084.02,DR,REF406094,CBA,Current
28-08-2025 23:38,CBAC2C0570EBEF740AA95D7,063-000-002,33333333,SPOTIFY CBA,107.97,0,909976.05,DR,REF358241,CBA,Current
28-08-2025 23:43,CBAABD1190D39B34D6F85F3,063-000-002,33333333,COMPANY PAYROLL CBA,0,537.9,910513.95,CR,REF286457,CBA,Current
28-08-2025 23:48,INTA40C08CDA3C74424A9E9,063-000-002,33333333,TRANSFER FROM NAB 44444444,0,594.15,911108.1,CR,INT-50772,CBA,Current
28-08-2025 23:52,CBAA462B36482944D8F9BB0,063-000-002,33333333,AMAZON AU CBA,90.84,0,911017.26,DR,REF845085,CBA,Current
28-08-2025 23:58,CBA71C1548F0CDF4AB080B8,063-000-002,33333333,RAILWAY STATION CBA,49.31,0,910967.95,DR,REF382694,CBA,Current
29-08-2025 00:12,CBAAA1518DDA9384884A323,063-000-002,33333333,PAY - SALARY CBA,0,144.07,911112.02,CR,REF342318,CBA,Current
29-08-2025 00:22,CBA071C5318D8CA4E8A861C,063-000-002,33333333,WOOLWORTHS CBA,153.35,0,910958.67,DR,REF371488,CBA,Current
29-08-2025 00:27,CBA448794698A3143789FF9,063-000-002,33333333,MENULOG CBA,4.31,0,910954.36,DR,REF138956,CBA,Current
29-08-2025 00:32,CBA0F5CD1D7C148406F9D97,063-000-002,33333333,LIQUORLAND CBA,87.05,0,910867.31,DR,REF914465,CBA,Current
29-08-2025 00:51,CBA205170CA2925468E9832,063-000-002,33333333,SHELL CBA,27.49,0,910839.82,DR,REF330471,CBA,Current
29-08-2025 00:51,CBAF426AEA799B74BF8B8D4,063-000-002,33333333,MENULOG CBA,30.84,0,910808.98,DR,REF281700,CBA,Current
29-08-2025 01:20,CBA0F35CB3E0DFE430E8906,063-000-002,33333333,PAY - SALARY CBA,0,4933.25,915742.23,CR,REF485056,CBA,Current
29-08-2025 01:27,INT4B7CA3A71D24491498D3,063-000-002,33333333,TRANSFER FROM NAB 44444444,0,1990.98,917733.21,CR,INT-99676,CBA,Current
29-08-2025 01:43,CBAAE070A2AB3934708B787,063-000-002,33333333,SPOTIFY CBA,7.15,0,917726.06,DR,REF344406,CBA,Current
29-08-2025 02:08,CBA1D8D6364484F4BA79D33,063-000-002,33333333,KFC CBA,96.22,0,917629.84,DR,REF154604,CBA,Current
29-08-2025 02:10,CBAFA059DA7A51E44D0B072,063-000-002,33333333,ALDI CBA,12.34,0,917617.5,DR,REF297243,CBA,Current
29-08-2025 02:20,CBA2C07D58671EB43218360,063-000-002,33333333,PAYMENT GATEWAY CBA,21.3,0,917596.2,DR,REF462956,CBA,Current
29-08-2025 02:47,CBA7BBD4A6AE8E14A75BCD3,063-000-002,33333333,KFC CBA,31.12,0,917565.08,DR,REF117976,CBA,Current
29-08-2025 03:03,CBA65053D8F7E0E432A9DB4,063-000-002,33333333,ALDI CBA,84.32,0,917480.76,DR,REF128255,CBA,Current
29-08-2025 03:46,CBA7B316D0143244C69ADAF,063-000-002,33333333,MCDONALDS CBA,42.71,0,917438.05,DR,REF403328,CBA,Current
29-08-2025 04:09,CBAAF08571AF32F428DBBEF,063-000-002,33333333,ZOOM CBA,5.32,0,917432.73,DR,REF168644,CBA,Current
29-08-2025 04:27,CBADEBBAF59C97C4B90900E,063-000-002,33333333,PAYPAL *NETFLIX CBA,50.99,0,917381.74,DR,REF293154,CBA,Current
29-08-2025 04:45,CBACE4095A7D6ED4E3B8391,063-000-002,33333333,ZOOM CBA,47.49,0,917334.25,DR,REF762372,CBA,Current
29-08-2025 04:59,CBA2B5A82E21DC1495D92F2,063-000-002,33333333,STARBUCKS CBA,93.43,0,917240.82,DR,REF974265,CBA,Current
29-08-2025 05:50,CBAFACCB01BD45948068A36,063-000-002,33333333,WOOLWORTHS CBA,132.85,0,917107.97,DR,REF922473,CBA,Current
29-08-2025 05:58,CBA56540BC6667440228237,063-000-002,33333333,TAFE BOOKSHOP CBA,3.81,0,917104.16,DR,REF993427,CBA,Current
29-08-2025 06:03,CBA58F5719C590C4B39AF6E,063-000-002,33333333,MENULOG CBA,74.47,0,917029.69,DR,REF425475,CBA,Current
29-08-2025 06:08,CBA87D1400C327244FEB357,063-000-002,33333333,BIGW CBA,49.08,0,916980.61,DR,REF395697,CBA,Current
29-08-2025 06:12,CBA0E440027D5B847B482E3,063-000-002,33333333,PAYPAL *NETFLIX CBA,111.19,0,916869.42,DR,REF191585,CBA,Current
29-08-2025 06:13,CBAAC53E6F4CF414002A352,063-000-002,33333333,BWS CBA,69.12,0,916800.3,DR,REF101378,CBA,Current
29-08-2025 07:05,CBA1D2552D311DB4FC99E21,063-000-002,33333333,FLIXBUS CBA,15.62,0,916784.68,DR,REF278067,CBA,Current
29-08-2025 07:06,CBA1A3BD278DD874E40BFF5,063-000-002,33333333,DOMINO'S PIZZA CBA,56.33,0,916728.35,DR,REF499592,CBA,Current
29-08-2025 07:11,CBAACB97004FBF14A20A8EE,063-000-002,33333333,INTERNET TRANSFER CBA,18.18,0,916710.17,DR,REF454765,CBA,Current
29-08-2025 07:12,CBA6BA16A8E0A934C74ADE5,063-000-002,33333333,STARBUCKS CBA,114.59,0,916595.58,DR,REF299555,CBA,Current
29-08-2025 07:40,CBA9C60D1292E0F41A89B62,063-000-002,33333333,BANK FEE CBA,15.5,0,916580.08,DR,REF350024,CBA,Current
29-08-2025 07:44,CBA28A90616FB094A208B50,063-000-002,33333333,CITYLINK CBA,40.79,0,916539.29,DR,REF550164,CBA,Current
29-08-2025 07:58,CBA6EAC80504CBB4C97B66D,063-000-002,33333333,COLES CBA,46.3,0,916492.99,DR,REF275634,CBA,Current
29-08-2025 08:09,CBA2B8E784A14F442309920,063-000-002,33333333,MENULOG CBA,64.35,0,916428.64,DR,REF646980,CBA,Current
29-08-2025 08:20,CBA4EA49C5F2F34472DBB9A,063-000-002,33333333,APPLE CBA,89.84,0,916338.8,DR,REF676155,CBA,Current
29-08-2025 08:40,CBA612915DA51114D77A84B,063-000-002,33333333,PAY - SALARY CBA,0,874.4,917213.2,CR,REF281842,CBA,Current
29-08-2025 08:41,CBAAE881E8654FD44D0BC90,063-000-002,33333333,FLIXBUS CBA,52.16,0,917161.04,DR,REF159788,CBA,Current
29-08-2025 09:22,CBA04D9F929ED134314BB58,063-000-002,33333333,FLIXBUS CBA,15.07,0,917145.97,DR,REF874309,CBA,Current
29-08-2025 10:25,CBA2534A87F9CA2406ABBFF,063-000-002,33333333,TAFE BOOKSHOP CBA,13.22,0,917132.75,DR,REF952437,CBA,Current
29-08-2025 11:06,CBA6555B2E8171B4B589407,063-000-002,33333333,JB HI-FI CBA,17.84,0,917114.91,DR,REF901168,CBA,Current
29-08-2025 11:30,CBAC6E437A2406A4EC9818F,063-000-002,33333333,PAYMENT GATEWAY CBA,40.48,0,917074.43,DR,REF500229,CBA,Current
29-08-2025 11:34,CBA94EB1363FFEA486CB168,063-000-002,33333333,COMPANY PAYROLL CBA,0,264.68,917339.11,CR,REF526777,CBA,Current
29-08-2025 12:01,CBAE6678383491B4F7C8F02,063-000-002,33333333,BIGW CBA,31.71,0,917307.4,DR,REF640423,CBA,Current
29-08-2025 12:04,CBA1EB63B7C25824A4CB652,063-000-002,33333333,SPOTIFY CBA,88.04,0,917219.36,DR,REF706540,CBA,Current
29-08-2025 12:15,CBA51CC220EDBC44F8E9313,063-000-002,33333333,INTERNET TRANSFER CBA,80.17,0,917139.19,DR,REF260082,CBA,Current
29-08-2025 12:29,CBA139CF19F47954323B410,063-000-002,33333333,UBER EATS CBA,11.26,0,917127.93,DR,REF349544,CBA,Current
29-08-2025 12:45,CBA3ECE2F1749294FCEAA6D,063-000-002,33333333,HARVEY NORMAN CBA,35.61,0,917092.32,DR,REF174799,CBA,Current
29-08-2025 12:53,CBAB6743B6B6754408BB6E9,063-000-002,33333333,DOMINO'S PIZZA CBA,85.22,0,917007.1,DR,REF175143,CBA,Current
29-08-2025 13:14,CBAF6D7FE48A9DD4ADC85CE,063-000-002,33333333,AMAZON AU CBA,21.81,0,916985.29,DR,REF678538,CBA,Current
29-08-2025 13:22,CBA491AEF68A85C4EAABD3A,063-000-002,33333333,WOOLWORTHS CBA,33.44,0,916951.85,DR,REF225857,CBA,Current
29-08-2025 13:43,CBA1D1ED19F385F4E679266,063-000-002,33333333,FLIXBUS CBA,92.15,0,916859.7,DR,REF515379,CBA,Current
29-08-2025 13:46,CBA55E3F23648084D8DA964,063-000-002,33333333,CITYLINK CBA,25.72,0,916833.98,DR,REF284210,CBA,Current
29-08-2025 13:55,INT8DCF3F19CC3D4D37BABC,063-000-002,33333333,TRANSFER TO NAB 44444444,1329.94,0,915504.04,DR,INT-88955,CBA,Current
29-08-2025 14:22,CBA679978272DFF4D13B753,063-000-002,33333333,MCDONALDS CBA,10.99,0,915493.05,DR,REF425998,CBA,Current
29-08-2025 14:35,CBACEBE4C2991894FF59987,063-000-002,33333333,RAILWAY STATION CBA,51.12,0,915441.93,DR,REF201837,CBA,Current
29-08-2025 14:51,CBA4031D0ACE091484581AB,063-000-002,33333333,SHELL CBA,4.54,0,915437.39,DR,REF573134,CBA,Current
29-08-2025 14:56,CBA20C07192B1E8431E80E8,063-000-002,33333333,BANK FEE CBA,137.99,0,915299.4,DR,REF252987,CBA,Current
29-08-2025 15:06,CBA4CBCD63010E54AF7B0B1,063-000-002,33333333,BANK FEE CBA,19.43,0,915279.97,DR,REF481055,CBA,Current
29-08-2025 15:06,CBA9C6F4E2FFC55441AA13C,063-000-002,33333333,STARBUCKS CBA,40.28,0,915239.69,DR,REF486325,CBA,Current
29-08-2025 15:19,CBA3BBD322CBCED4B80BCE8,063-000-002,33333333,RAILWAY STATION CBA,88.99,0,915150.7,DR,REF170714,CBA,Current
29-08-2025 15:45,CBA17C50BFC3A974DE7B6B7,063-000-002,33333333,CITYLINK CBA,63.03,0,915087.67,DR,REF826309,CBA,Current
29-08-2025 15:58,CBA5F74D5439206423ABAB5,063-000-002,33333333,JB HI-FI CBA,12.33,0,915075.34,DR,REF978350,CBA,Current
29-08-2025 16:22,CBA48969852CD2C44B1855C,063-000-002,33333333,FLIXBUS CBA,59.63,0,915015.71,DR,REF836392,CBA,Current
29-08-2025 16:32,CBA4205302EC56C463A9BE8,063-000-002,33333333,SPOTIFY CBA,12.97,0,915002.74,DR,REF567917,CBA,Current
29-08-2025 16:48,CBA10EF9F20972C452E9E28,063-000-002,33333333,AMAZON AU CBA,44.85,0,914957.89,DR,REF203369,CBA,Current
29-08-2025 16:58,CBAA9B9567E5B0C4C33B8F4,063-000-002,33333333,COMPANY PAYROLL CBA,0,296.14,915254.03,CR,REF385182,CBA,Current
29-08-2025 17:54,CBAA2D95EB6DA684C41A40C,063-000-002,33333333,BWS CBA,105.66,0,915148.37,DR,REF154166,CBA,Current
29-08-2025 18:00,CBAB402FCF0A776485AABC3,063-000-002,33333333,PAYROLL CREDIT CBA,0,3586.91,918735.28,CR,REF789031,CBA,Current
29-08-2025 18:51,CBA155638DAC0DD438E8523,063-000-002,33333333,BP CBA,6.9,0,918728.38,DR,REF242397,CBA,Current
29-08-2025 18:52,CBA6EE07CFB38D446A68986,063-000-002,33333333,SPOTIFY CBA,65.79,0,918662.59,DR,REF715021,CBA,Current
29-08-2025 19:16,CBA4E5B5A45ACAE4DB9B15D,063-000-002,33333333,APPLE CBA,27.43,0,918635.16,DR,REF452071,CBA,Current
29-08-2025 19:53,CBA6394BA7835694F378BC4,063-000-002,33333333,FLIXBUS CBA,34.27,0,918600.89,DR,REF226286,CBA,Current
29-08-2025 19:55,INTD9D580DB2439467283D3,063-000-002,33333333,TRANSFER FROM NAB 44444444,0,445.91,919046.8,CR,INT-92306,CBA,Current
29-08-2025 19:58,CBA08C6FF4C0BA94F8AA8BF,063-000-002,33333333,BANK FEE CBA,121.95,0,918924.85,DR,REF194123,CBA,Current
29-08-2025 20:14,INT524351EFC68545B38987,063-000-002,33333333,TRANSFER TO CBA 22222222,58.98,0,918865.87,DR,INT-59624,CBA,Current
29-08-2025 20:23,CBAF494A1D08F684696BBF9,063-000-002,33333333,INTERNET TRANSFER CBA,4.17,0,918861.7,DR,REF902952,CBA,Current
29-08-2025 20:29,CBAA7062F958B5F4FE6B044,063-000-002,33333333,JB HI-FI CBA,40.55,0,918821.15,DR,REF762791,CBA,Current
29-08-2025 20:44,INT86B60040B2044BB9BE22,063-000-002,33333333,TRANSFER TO CBA 22222222,320.2,0,918500.95,DR,INT-66374,CBA,Current
29-08-2025 21:01,CBA977A9CE97FDB40339789,063-000-002,33333333,HARVEY NORMAN CBA,79.25,0,918421.7,DR,REF788743,CBA,Current
29-08-2025 21:03,CBA9515BA2976A046EC858F,063-000-002,33333333,BANK FEE CBA,11.7,0,918410,DR,REF176771,CBA,Current
29-08-2025 21:34,CBAE63D3CE6E55444ADA060,063-000-002,33333333,SALARY PAYMENT CBA,0,3139.05,921549.05,CR,REF414469,CBA,Current
29-08-2025 21:37,CBAC31909392EEC42F99652,063-000-002,33333333,PAYROLL CREDIT CBA,0,7677.46,929226.51,CR,REF112114,CBA,Current
29-08-2025 22:29,CBA9C9E50AC248644CD9376,063-000-002,33333333,JB HI-FI CBA,115.28,0,929111.23,DR,REF290129,CBA,Current
29-08-2025 22:49,CBA3B8B669773B54030A544,063-000-002,33333333,PAYROLL CREDIT CBA,0,3453.26,932564.49,CR,REF282457,CBA,Current
29-08-2025 22:53,CBA7ECE07252FAE4F5FB559,063-000-002,33333333,WAGES CREDIT CBA,0,7763.93,940328.42,CR,REF960186,CBA,Current
29-08-2025 23:19,CBA0E3898D1BEBC4FF28381,063-000-002,33333333,KFC CBA,7.61,0,940320.81,DR,REF158119,CBA,Current
29-08-2025 23:25,CBAAF95491858D04A96B265,063-000-002,33333333,STARBUCKS CBA,95.54,0,940225.27,DR,REF715620,CBA,Current
29-08-2025 23:48,INTE9D2DF4D41C145FC9007,063-000-002,33333333,TRANSFER TO CBA 22222222,1461.58,0,938763.69,DR,INT-16559,CBA,Current
29-08-2025 23:50,CBA083818C694BB48E8882A,063-000-002,33333333,FLIXBUS CBA,127.56,0,938636.13,DR,REF719994,CBA,Current
30-08-2025 00:06,CBA9670B82299544D2392CB,063-000-002,33333333,JB HI-FI CBA,5.12,0,938631.01,DR,REF994383,CBA,Current
30-08-2025 01:24,CBAF2AC4379C8594881BCF9,063-000-002,33333333,UBER EATS CBA,112.36,0,938518.65,DR,REF532685,CBA,Current
30-08-2025 01:34,CBA941DEBAB88634372B376,063-000-002,33333333,WAGES CREDIT CBA,0,3093.73,941612.38,CR,REF913368,CBA,Current
30-08-2025 01:41,CBAC2FCD49004604D778CCE,063-000-002,33333333,JB HI-FI CBA,58.43,0,941553.95,DR,REF999462,CBA,Current
30-08-2025 02:06,CBA199DDD0ABDDB419399EF,063-000-002,33333333,SALARY PAYMENT CBA,0,2227.01,943780.96,CR,REF478284,CBA,Current
30-08-2025 02:14,CBA37960F1247DB44F8B41A,063-000-002,33333333,MENULOG CBA,7.63,0,943773.33,DR,REF147858,CBA,Current
30-08-2025 02:27,CBA00B8BE159FDA4BC8B2DA,063-000-002,33333333,LIQUORLAND CBA,53.36,0,943719.97,DR,REF661715,CBA,Current
30-08-2025 03:20,CBA7047A82AD882443F823C,063-000-002,33333333,BIGW CBA,49.94,0,943670.03,DR,REF658530,CBA,Current
30-08-2025 03:32,CBA33C93EB50610477CAB58,063-000-002,33333333,APPLE CBA,11.79,0,943658.24,DR,REF489927,CBA,Current
30-08-2025 03:46,CBA375A496B41F642C8B2BF,063-000-002,33333333,TAFE BOOKSHOP CBA,40.41,0,943617.83,DR,REF259511,CBA,Current
30-08-2025 04:01,CBA79A604D07F6747BB81A3,063-000-002,33333333,APPLE CBA,74.03,0,943543.8,DR,REF595543,CBA,Current
30-08-2025 04:25,CBAAEE2BBAF0F7E44B7A9F2,063-000-002,33333333,MCDONALDS CBA,39.69,0,943504.11,DR,REF689204,CBA,Current
30-08-2025 04:25,CBACB4230816CBE4CF7B11A,063-000-002,33333333,BIGW CBA,40.08,0,943464.03,DR,REF246789,CBA,Current
30-08-2025 04:32,CBA5ED5DCB24B254FFDA925,063-000-002,33333333,FLIXBUS CBA,6.25,0,943457.78,DR,REF431914,CBA,Current
30-08-2025 04:50,CBA713819E6AA864745B542,063-000-002,33333333,RAILWAY STATION CBA,100.82,0,943356.96,DR,REF971339,CBA,Current
30-08-2025 06:02,CBAADEBA0B0622342AAA87B,063-000-002,33333333,SPOTIFY CBA,24.68,0,943332.28,DR,REF667727,CBA,Current
30-08-2025 06:11,CBAE106424DFDDB455AB1EC,063-000-002,33333333,TAFE BOOKSHOP CBA,51.42,0,943280.86,DR,REF699556,CBA,Current
30-08-2025 06:56,CBA2A6B6A6B1D0A4274A448,063-000-002,33333333,STARBUCKS CBA,7.4,0,943273.46,DR,REF439610,CBA,Current
30-08-2025 07:02,CBAA6C4EF89A036434993A5,063-000-002,33333333,SALARY PAYMENT CBA,0,105.74,943379.2,CR,REF792119,CBA,Current
30-08-2025 07:03,CBAC384D735265F4C18A37D,063-000-002,33333333,KFC CBA,82.75,0,943296.45,DR,REF681504,CBA,Current
30-08-2025 07:29,CBA4A8A5A8DA58643938E34,063-000-002,33333333,BIGW CBA,20.53,0,943275.92,DR,REF891761,CBA,Current
30-08-2025 08:24,CBA9CFB3173543B4FAFB979,063-000-002,33333333,PAYMENT GATEWAY CBA,83.7,0,943192.22,DR,REF405081,CBA,Current
30-08-2025 08:41,CBA7ECFC9744C2F40AC9B48,063-000-002,33333333,COMPANY PAYROLL CBA,0,656.76,943848.98,CR,REF501930,CBA,Current
30-08-2025 09:12,CBA84517424DE8B4EF79938,063-000-002,33333333,BIGW CBA,38.32,0,943810.66,DR,REF240873,CBA,Current
30-08-2025 09:33,CBACEFD578B209B46BC8615,063-000-002,33333333,BWS CBA,253.66,0,943557,DR,REF206709,CBA,Current
30-08-2025 09:51,CBAAF8F03E712ED4D12BD97,063-000-002,33333333,RAILWAY STATION CBA,165.19,0,943391.81,DR,REF532431,CBA,Current
30-08-2025 11:30,CBA22347E7C27394A4998FB,063-000-002,33333333,SALARY PAYMENT CBA,0,703.15,944094.96,CR,REF728778,CBA,Current
30-08-2025 12:15,INTA824F686311947F7B821,063-000-002,33333333,TRANSFER FROM CBA 22222222,0,218.68,944313.64,CR,INT-44802,CBA,Current
30-08-2025 12:15,CBA8123612B0A434BDEB532,063-000-002,33333333,PAYPAL *NETFLIX CBA,13.4,0,944300.24,DR,REF598979,CBA,Current
30-08-2025 12:34,CBA8BA855E8462844D88A57,063-000-002,33333333,SHELL CBA,9.93,0,944290.31,DR,REF471277,CBA,Current
30-08-2025 12:50,CBA4FE5E301F57B4A9CB265,063-000-002,33333333,DOMINO'S PIZZA CBA,47.29,0,944243.02,DR,REF201335,CBA,Current
30-08-2025 14:00,CBA50EC675D01CA4D6CBA20,063-000-002,33333333,AMAZON AU CBA,17.14,0,944225.88,DR,REF561128,CBA,Current
30-08-2025 14:08,CBAC1CA74AE7F784B479AC9,063-000-002,33333333,BIGW CBA,142.55,0,944083.33,DR,REF619967,CBA,Current
30-08-2025 14:32,CBA4DB4FEAE390F4AE7AE4C,063-000-002,33333333,FLIXBUS CBA,9.49,0,944073.84,DR,REF950909,CBA,Current
30-08-2025 15:53,INTD8CBD5F92F104457A0E6,063-000-002,33333333,TRANSFER FROM NAB 44444444,0,205.81,944279.65,CR,INT-99903,CBA,Current
30-08-2025 15:59,CBA992967E6483E4B8CA5CB,063-000-002,33333333,CITYLINK CBA,55.33,0,944224.32,DR,REF979412,CBA,Current
30-08-2025 16:08,CBAA4C640418A8B495AB761,063-000-002,33333333,SPOTIFY CBA,2.65,0,944221.67,DR,REF893324,CBA,Current
30-08-2025 16:46,CBAC92024335CA6403CBA1A,063-000-002,33333333,SPOTIFY CBA,171,0,944050.67,DR,REF800631,CBA,Current
30-08-2025 16:47,CBAD58D7FBC69C5486093D1,063-000-002,33333333,INTERNET TRANSFER CBA,24.42,0,944026.25,DR,REF464087,CBA,Current
30-08-2025 16:48,CBA5551F2252BD847BB9B3E,063-000-002,33333333,CITYLINK CBA,113.89,0,943912.36,DR,REF479331,CBA,Current
30-08-2025 16:49,CBAABD58186DB754AAC81D5,063-000-002,33333333,JB HI-FI CBA,18.02,0,943894.34,DR,REF233094,CBA,Current
30-08-2025 17:15,CBA74764D5A4FF64879943A,063-000-002,33333333,DOMINO'S PIZZA CBA,79.37,0,943814.97,DR,REF827460,CBA,Current
30-08-2025 18:01,CBAF536BC05C3E345C98D7F,063-000-002,33333333,FLIXBUS CBA,12.31,0,943802.66,DR,REF163321,CBA,Current
30-08-2025 18:02,CBA823F2F8DFF014732B8EA,063-000-002,33333333,APPLE CBA,34.1,0,943768.56,DR,REF662588,CBA,Current
30-08-2025 18:09,CBAA5ADADDA36424215AFCF,063-000-002,33333333,BANK FEE CBA,48.34,0,943720.22,DR,REF449367,CBA,Current
30-08-2025 18:21,CBA056DD2227EF34BBEBF85,063-000-002,33333333,PAYMENT GATEWAY CBA,8.93,0,943711.29,DR,REF497425,CBA,Current
30-08-2025 18:23,CBAC21A0552C5FA4665B2DB,063-000-002,33333333,UBER EATS CBA,9.28,0,943702.01,DR,REF825433,CBA,Current
30-08-2025 18:26,CBAE875A2EB844D4F28A1BF,063-000-002,33333333,LIQUORLAND CBA,95.98,0,943606.03,DR,REF681112,CBA,Current
30-08-2025 19:37,CBA95053F2CF51747B28263,063-000-002,33333333,KFC CBA,290.77,0,943315.26,DR,REF239889,CBA,Current
30-08-2025 20:08,CBAD97D32E4C572449E8B9E,063-000-002,33333333,WOOLWORTHS CBA,18.82,0,943296.44,DR,REF230588,CBA,Current
30-08-2025 20:12,CBAD0C0D339F10A4F47BCD5,063-000-002,33333333,WOOLWORTHS CBA,43.31,0,943253.13,DR,REF414298,CBA,Current
30-08-2025 20:17,CBA81D6D9F0AAB34E34B1C1,063-000-002,33333333,7-ELEVEN CBA,74.1,0,943179.03,DR,REF114705,CBA,Current
30-08-2025 20:57,INTBB9B344526254ACBAE9A,063-000-002,33333333,TRANSFER TO NAB 44444444,482.6,0,942696.43,DR,INT-36355,CBA,Current
30-08-2025 21:05,CBADA54F009CCBE4B1987AA,063-000-002,33333333,MENULOG CBA,73.64,0,942622.79,DR,REF802564,CBA,Current
30-08-2025 21:09,CBA4D4F978384B443EC8BB5,063-000-002,33333333,UBER EATS CBA,4.88,0,942617.91,DR,REF118337,CBA,Current
30-08-2025 21:20,CBA6BB13526A4AC44428B63,063-000-002,33333333,PAYMENT GATEWAY CBA,33.74,0,942584.17,DR,REF566393,CBA,Current
30-08-2025 21:43,CBA0FDEB25F5A784C26993F,063-000-002,33333333,JB HI-FI CBA,13.91,0,942570.26,DR,REF477727,CBA,Current
30-08-2025 21:48,CBA316BD58C38D141F3A2A8,063-000-002,33333333,UBER EATS CBA,49.21,0,942521.05,DR,REF423615,CBA,Current
30-08-2025 22:06,CBACF39D608DA2C4A60AAEB,063-000-002,33333333,INTERNET TRANSFER CBA,12.8,0,942508.25,DR,REF340127,CBA,Current
30-08-2025 22:06,CBA319189E3A80F4C88BE3A,063-000-002,33333333,APPLE CBA,17.39,0,942490.86,DR,REF228067,CBA,Current
30-08-2025 22:51,CBA321FFFEDA48647E1AC69,063-000-002,33333333,COLES CBA,110.11,0,942380.75,DR,REF457288,CBA,Current
30-08-2025 23:16,CBA848B11B7C0634CB6AAFB,063-000-002,33333333,WOOLWORTHS CBA,13.66,0,942367.09,DR,REF916498,CBA,Current
30-08-2025 23:20,CBA3545867DF0E84912B47A,063-000-002,33333333,APPLE CBA,201.76,0,942165.33,DR,REF779171,CBA,Current
30-08-2025 23:25,CBAFF531AF91A9445EAA24C,063-000-002,33333333,DOMINO'S PIZZA CBA,14.45,0,942150.88,DR,REF598826,CBA,Current
30-08-2025 23:55,CBA6B182170533740F5B3AB,063-000-002,33333333,HARVEY NORMAN CBA,10.84,0,942140.04,DR,REF710675,CBA,Current
30-08-2025 23:56,CBA003A3844761D483FB43F,063-000-002,33333333,WOOLWORTHS CBA,9.37,0,942130.67,DR,REF472614,CBA,Current
31-08-2025 00:04,CBAFFD69E521E244F2CB41E,063-000-002,33333333,BWS CBA,18.63,0,942112.04,DR,REF184098,CBA,Current
31-08-2025 00:15,CBA0F7AADD79C444D2CA01D,063-000-002,33333333,SALARY PAYMENT CBA,0,923.97,943036.01,CR,REF187206,CBA,Current
31-08-2025 00:16,CBABA6B36A28388420FBE99,063-000-002,33333333,PAYROLL CREDIT CBA,0,173.33,943209.34,CR,REF120298,CBA,Current
31-08-2025 00:17,CBA9BCCCECBB1284D27BE3E,063-000-002,33333333,AMAZON AU CBA,12.42,0,943196.92,DR,REF388434,CBA,Current
31-08-2025 00:47,INT57FB762363D74DFF95E3,063-000-002,33333333,TRANSFER FROM ANZ 11111111,0,1600.15,944797.07,CR,INT-70561,CBA,Current
31-08-2025 01:13,CBAC443FA632BB247B1AD68,063-000-002,33333333,SPOTIFY CBA,14.72,0,944782.35,DR,REF435891,CBA,Current
31-08-2025 01:21,CBA2FE4A44169F14780BFFC,063-000-002,33333333,TAFE BOOKSHOP CBA,10.13,0,944772.22,DR,REF340386,CBA,Current
31-08-2025 01:38,CBAB996E5379A4C4B70B052,063-000-002,33333333,MCDONALDS CBA,54.22,0,944718,DR,REF417786,CBA,Current
31-08-2025 03:07,CBA085E7C4B18BA4D7B9026,063-000-002,33333333,ZOOM CBA,57.17,0,944660.83,DR,REF408544,CBA,Current
31-08-2025 03:55,CBA392F053607E34A86A6AE,063-000-002,33333333,UBER EATS CBA,48.11,0,944612.72,DR,REF786152,CBA,Current
31-08-2025 04:05,CBA22AEC68AFF1642DF8649,063-000-002,33333333,MENULOG CBA,9.92,0,944602.8,DR,REF150806,CBA,Current
31-08-2025 04:12,CBAC406990CF8B7404E8EEE,063-000-002,33333333,INTERNET TRANSFER CBA,131.04,0,944471.76,DR,REF994149,CBA,Current
31-08-2025 04:22,CBA13E5768D3DBA4CCDAE3C,063-000-002,33333333,PAYMENT GATEWAY CBA,62.97,0,944408.79,DR,REF326736,CBA,Current
31-08-2025 05:40,CBABC8DB9273869416191B8,063-000-002,33333333,PAYROLL CREDIT CBA,0,6476.27,950885.06,CR,REF927297,CBA,Current
31-08-2025 05:42,CBADBECDB3F216B4BBEBB4D,063-000-002,33333333,BP CBA,61.13,0,950823.93,DR,REF665756,CBA,Current
31-08-2025 05:44,CBAE8401A6F18A140A78A42,063-000-002,33333333,SHELL CBA,43.67,0,950780.26,DR,REF542438,CBA,Current
31-08-2025 05:52,CBA61A1E225D0F64F9C8759,063-000-002,33333333,HARVEY NORMAN CBA,9.2,0,950771.06,DR,REF100800,CBA,Current
31-08-2025 05:57,CBA8ADC9C19BD8147738D3A,063-000-002,33333333,ALDI CBA,6.31,0,950764.75,DR,REF331926,CBA,Current
31-08-2025 06:28,CBADA993BF8213E41D39472,063-000-002,33333333,APPLE CBA,55.45,0,950709.3,DR,REF192688,CBA,Current
31-08-2025 06:31,CBADC8246463F624C7889C7,063-000-002,33333333,COLES CBA,7.29,0,950702.01,DR,REF957785,CBA,Current
31-08-2025 06:32,CBA12ADBB63A1B9441782C8,063-000-002,33333333,RAILWAY STATION CBA,20.28,0,950681.73,DR,REF246190,CBA,Current
31-08-2025 06:51,CBA344C284DE5A84E4CB3D7,063-000-002,33333333,ZOOM CBA,124.91,0,950556.82,DR,REF173298,CBA,Current
31-08-2025 07:30,CBA286D089B7E724012A7CD,063-000-002,33333333,WOOLWORTHS CBA,75.48,0,950481.34,DR,REF311856,CBA,Current
31-08-2025 08:14,CBAF8B22213FA3A41EDAD75,063-000-002,33333333,LIQUORLAND CBA,106.77,0,950374.57,DR,REF480784,CBA,Current
31-08-2025 08:57,CBAF38F485700594695AA1C,063-000-002,33333333,WAGES CREDIT CBA,0,1978.15,952352.72,CR,REF448772,CBA,Current
31-08-2025 09:03,CBAF417E34246FB415CAEF9,063-000-002,33333333,SHELL CBA,30.08,0,952322.64,DR,REF429411,CBA,Current
31-08-2025 09:24,CBAD572BDBC7F2643159AAF,063-000-002,33333333,AMAZON AU CBA,92.6,0,952230.04,DR,REF321237,CBA,Current
31-08-2025 09:49,CBA2500BE22F5E54D41BD07,063-000-002,33333333,BIGW CBA,9.54,0,952220.5,DR,REF832105,CBA,Current
31-08-2025 09:51,CBAA466297C155549BD98F4,063-000-002,33333333,INTERNET TRANSFER CBA,19.98,0,952200.52,DR,REF879703,CBA,Current
31-08-2025 10:05,INTFEC3CE7C2ACB4EC491A2,063-000-002,33333333,TRANSFER TO NAB 44444444,1571.53,0,950628.99,DR,INT-40666,CBA,Current
31-08-2025 10:11,CBA72F113FF38604165A87F,063-000-002,33333333,CITYLINK CBA,37.39,0,950591.6,DR,REF478128,CBA,Current
31-08-2025 10:18,CBA34DA25B48D7845398BE7,063-000-002,33333333,SPOTIFY CBA,212.4,0,950379.2,DR,REF863601,CBA,Current
31-08-2025 10:26,CBAF08C082ACB7D4578ADFD,063-000-002,33333333,MENULOG CBA,36.72,0,950342.48,DR,REF337818,CBA,Current
31-08-2025 11:15,CBA733AF669EA294BAB96D6,063-000-002,33333333,KFC CBA,24.31,0,950318.17,DR,REF242700,CBA,Current
31-08-2025 11:18,CBA418D1A2DF25845CA9566,063-000-002,33333333,7-ELEVEN CBA,186.99,0,950131.18,DR,REF155783,CBA,Current
31-08-2025 11:31,CBAAA7D56D7389B4E028EB1,063-000-002,33333333,BANK FEE CBA,114.78,0,950016.4,DR,REF903630,CBA,Current
31-08-2025 11:47,CBA8938EC180CD045A2B723,063-000-002,33333333,BIGW CBA,99.8,0,949916.6,DR,REF793781,CBA,Current
31-08-2025 12:33,CBAF26520876FD743DF83AD,063-000-002,33333333,SALARY PAYMENT CBA,0,6144.79,956061.39,CR,REF678588,CBA,Current
31-08-2025 13:13,CBAE37DAA1CCAF74DACB19A,063-000-002,33333333,BANK FEE CBA,4.23,0,956057.16,DR,REF614996,CBA,Current
31-08-2025 13:24,CBA19098F0322B849AE934C,063-000-002,33333333,APPLE CBA,8.21,0,956048.95,DR,REF676056,CBA,Current
31-08-2025 13:39,CBAEBC3AC344A304A80906A,063-000-002,33333333,PAY - SALARY CBA,0,3776.49,959825.44,CR,REF716412,CBA,Current
31-08-2025 14:13,CBAD0BA39869A8B455F9C36,063-000-002,33333333,SHELL CBA,88.71,0,959736.73,DR,REF166444,CBA,Current
31-08-2025 15:01,CBA079D31BBA4E5425E9045,063-000-002,33333333,BIGW CBA,56.85,0,959679.88,DR,REF479943,CBA,Current
31-08-2025 15:18,CBA8015D6DED6424458A1AD,063-000-002,33333333,COLES CBA,77.8,0,959602.08,DR,REF707618,CBA,Current
31-08-2025 16:05,CBA2124303D70864728A863,063-000-002,33333333,WOOLWORTHS CBA,40.14,0,959561.94,DR,REF607804,CBA,Current
31-08-2025 16:30,CBA564B9305E01342209114,063-000-002,33333333,BP CBA,102.49,0,959459.45,DR,REF101599,CBA,Current
31-08-2025 16:36,CBA3D2E500DAD0C40EE95B4,063-000-002,33333333,BWS CBA,17.44,0,959442.01,DR,REF969805,CBA,Current
31-08-2025 16:47,CBA9A934A6652A84575BAE0,063-000-002,33333333,ZOOM CBA,55.96,0,959386.05,DR,REF153452,CBA,Current
31-08-2025 17:05,CBABB024D83BDC94A85B3CD,063-000-002,33333333,SHELL CBA,68.31,0,959317.74,DR,REF546393,CBA,Current
31-08-2025 17:36,CBA235A03EA952E48C49793,063-000-002,33333333,BP CBA,32.18,0,959285.56,DR,REF908582,CBA,Current
31-08-2025 17:37,CBAA603F956FBDB40259EB2,063-000-002,33333333,BANK FEE CBA,61.77,0,959223.79,DR,REF464703,CBA,Current
31-08-2025 17:58,CBA13E4B3AA17654955A88D,063-000-002,33333333,COMPANY PAYROLL CBA,0,3765.87,962989.66,CR,REF906502,CBA,Current
31-08-2025 18:13,CBA6A56F85A1E6C47F9953C,063-000-002,33333333,INTERNET TRANSFER CBA,47.05,0,962942.61,DR,REF566338,CBA,Current
31-08-2025 18:37,INTE5085F10D74F4F76A535,063-000-002,33333333,TRANSFER FROM NAB 44444444,0,749.49,963692.1,CR,INT-46303,CBA,Current
31-08-2025 18:53,CBA856C706D85E94D8684B9,063-000-002,33333333,ALDI CBA,24.78,0,963667.32,DR,REF778389,CBA,Current
31-08-2025 18:56,INT49487C5B4B1C43B9A904,063-000-002,33333333,TRANSFER FROM ANZ 11111111,0,1383.71,965051.03,CR,INT-84938,CBA,Current
31-08-2025 19:16,CBAB97BAA933EE34810BB82,063-000-002,33333333,TAFE BOOKSHOP CBA,27.4,0,965023.63,DR,REF683304,CBA,Current
31-08-2025 19:33,CBA575F26BAAEF8444B85E0,063-000-002,33333333,WAGES CREDIT CBA,0,760.7,965784.33,CR,REF906442,CBA,Current
31-08-2025 19:53,CBAFFE9D73CC69B40CC9330,063-000-002,33333333,INTERNET TRANSFER CBA,41.53,0,965742.8,DR,REF749714,CBA,Current
31-08-2025 20:03,CBA0671C57765F04C0B95E3,063-000-002,33333333,TAFE BOOKSHOP CBA,42.24,0,965700.56,DR,REF483653,CBA,Current
31-08-2025 20:12,CBAF0458D6C0C17415FABE9,063-000-002,33333333,MCDONALDS CBA,6.29,0,965694.27,DR,REF937952,CBA,Current
31-08-2025 21:16,CBAC090D1C87B1140C38E9D,063-000-002,33333333,SPOTIFY CBA,6.14,0,965688.13,DR,REF368045,CBA,Current
31-08-2025 21:17,CBA24EBEFC2AFD7453DA269,063-000-002,33333333,APPLE CBA,68.14,0,965619.99,DR,REF994236,CBA,Current
31-08-2025 21:43,CBAEF51DF74C481445AB4A7,063-000-002,33333333,BIGW CBA,168.02,0,965451.97,DR,REF541280,CBA,Current
31-08-2025 21:46,CBA9C4D1800D24147699471,063-000-002,33333333,ALDI CBA,70.79,0,965381.18,DR,REF431472,CBA,Current
31-08-2025 22:48,CBA972D9E30C03D48968D04,063-000-002,33333333,MCDONALDS CBA,30.88,0,965350.3,DR,REF823738,CBA,Current
31-08-2025 22:57,CBA9A9C55D158E04940A2A9,063-000-002,33333333,PAYPAL *NETFLIX CBA,32.88,0,965317.42,DR,REF127964,CBA,Current
31-08-2025 22:59,CBA81CEECF7D37E4D319C5A,063-000-002,33333333,TAFE BOOKSHOP CBA,12.5,0,965304.92,DR,REF979423,CBA,Current
31-08-2025 23:03,CBA8FD23BE17D11405BA849,063-000-002,33333333,DOMINO'S PIZZA CBA,25.47,0,965279.45,DR,REF446585,CBA,Current
31-08-2025 23:50,CBA007156382EB04930BE37,063-000-002,33333333,BWS CBA,26.36,0,965253.09,DR,REF262759,CBA,Current
01-09-2025 00:21,CBA73D84894A83F4CC09AEA,063-000-002,33333333,STARBUCKS CBA,90.6,0,965162.49,DR,REF565417,CBA,Current
01-09-2025 00:28,CBA2635F3F5E8B3438B81FC,063-000-002,33333333,CITYLINK CBA,6.87,0,965155.62,DR,REF943092,CBA,Current
01-09-2025 01:03,CBA0E79998608E74D61BAEE,063-000-002,33333333,BP CBA,13.04,0,965142.58,DR,REF301417,CBA,Current
01-09-2025 01:19,CBA79C99E91524A457CABDC,063-000-002,33333333,MENULOG CBA,9.71,0,965132.87,DR,REF717837,CBA,Current
01-09-2025 01:34,CBA1828463ADC0541CFA3FF,063-000-002,33333333,INTERNET TRANSFER CBA,169,0,964963.87,DR,REF215140,CBA,Current
01-09-2025 01:57,CBADCAED581098D4B8EACC7,063-000-002,33333333,ALDI CBA,94.08,0,964869.79,DR,REF918345,CBA,Current
01-09-2025 02:06,CBA8883F0FEC08C458F8290,063-000-002,33333333,AMAZON AU CBA,16.64,0,964853.15,DR,REF912735,CBA,Current
01-09-2025 02:40,CBAB92C75F8C7A74E08891E,063-000-002,33333333,WAGES CREDIT CBA,0,739.12,965592.27,CR,REF108700,CBA,Current
01-09-2025 03:49,CBADDE459B3134B471285FE,063-000-002,33333333,LIQUORLAND CBA,45.98,0,965546.29,DR,REF623793,CBA,Current
01-09-2025 04:12,CBA7D745847607B4E0F9C7A,063-000-002,33333333,COLES CBA,6.33,0,965539.96,DR,REF488159,CBA,Current
01-09-2025 04:25,CBAD4A3815D792C439F8E46,063-000-002,33333333,STARBUCKS CBA,18.05,0,965521.91,DR,REF782234,CBA,Current
01-09-2025 05:21,CBAFC61BA28DF7242D39031,063-000-002,33333333,INTERNET TRANSFER CBA,96.44,0,965425.47,DR,REF963207,CBA,Current
01-09-2025 05:29,CBA30F3C3DFA80B41FEA5C1,063-000-002,33333333,BP CBA,17.47,0,965408,DR,REF602801,CBA,Current
01-09-2025 05:35,CBABE1098196F3C4B3E8C49,063-000-002,33333333,MCDONALDS CBA,192.59,0,965215.41,DR,REF984304,CBA,Current
01-09-2025 05:37,CBA59954AE250C344B48788,063-000-002,33333333,COMPANY PAYROLL CBA,0,4136.79,969352.2,CR,REF532720,CBA,Current
01-09-2025 05:56,CBAD88E2F59D12E49529EF0,063-000-002,33333333,UBER EATS CBA,11.94,0,969340.26,DR,REF315622,CBA,Current
01-09-2025 06:19,CBA4D2F7F11C97B4C2ABAED,063-000-002,33333333,STARBUCKS CBA,30.3,0,969309.96,DR,REF869106,CBA,Current
01-09-2025 06:24,CBAD5E90C46749D499ABB32,063-000-002,33333333,ZOOM CBA,60.91,0,969249.05,DR,REF813912,CBA,Current
01-09-2025 06:29,CBA2756153BAC1F45FAAD3F,063-000-002,33333333,BIGW CBA,7.7,0,969241.35,DR,REF805429,CBA,Current
01-09-2025 06:36,CBA2CE1A20D655A4A3099C3,063-000-002,33333333,TAFE BOOKSHOP CBA,79.08,0,969162.27,DR,REF977676,CBA,Current
01-09-2025 07:14,CBA10DD79CE77C942329405,063-000-002,33333333,WAGES CREDIT CBA,0,6543.72,975705.99,CR,REF322039,CBA,Current
01-09-2025 07:33,CBA9DE0283357AE4DC99930,063-000-002,33333333,MCDONALDS CBA,51.26,0,975654.73,DR,REF948998,CBA,Current
01-09-2025 07:36,CBAE7A5431A6FD747BA9844,063-000-002,33333333,RAILWAY STATION CBA,6.45,0,975648.28,DR,REF236209,CBA,Current
01-09-2025 07:42,CBABAFCC1A57B3141CD9C76,063-000-002,33333333,PAYMENT GATEWAY CBA,45.02,0,975603.26,DR,REF252481,CBA,Current
01-09-2025 07:51,CBAB7F3D535A4E346ECB982,063-000-002,33333333,BIGW CBA,12.95,0,975590.31,DR,REF591100,CBA,Current
01-09-2025 07:54,CBAE4ED04E2AC7F4ED49C29,063-000-002,33333333,MCDONALDS CBA,18.69,0,975571.62,DR,REF911914,CBA,Current
01-09-2025 08:03,CBA8D2436EF6298442C9D86,063-000-002,33333333,INTERNET TRANSFER CBA,11.89,0,975559.73,DR,REF787697,CBA,Current
01-09-2025 09:48,CBA427539115D5C41E394F0,063-000-002,33333333,FLIXBUS CBA,26.86,0,975532.87,DR,REF335594,CBA,Current
01-09-2025 10:02,CBAC1FAC7FD99C9427C8B95,063-000-002,33333333,WOOLWORTHS CBA,39.79,0,975493.08,DR,REF638612,CBA,Current
01-09-2025 10:08,CBA79D8B3EE383B47AFA7F3,063-000-002,33333333,LIQUORLAND CBA,54.95,0,975438.13,DR,REF509115,CBA,Current
01-09-2025 10:16,CBAC847D5EE47824FA6833F,063-000-002,33333333,BIGW CBA,268.69,0,975169.44,DR,REF670449,CBA,Current
01-09-2025 10:44,CBAFDB8F0849A4748B0AA51,063-000-002,33333333,DOMINO'S PIZZA CBA,19.66,0,975149.78,DR,REF296295,CBA,Current
01-09-2025 11:04,CBA07CC33ADE43045C9A2E7,063-000-002,33333333,DOMINO'S PIZZA CBA,44.96,0,975104.82,DR,REF865088,CBA,Current
01-09-2025 11:20,CBA3F324DBE1AAC4E70AFDC,063-000-002,33333333,KFC CBA,4.73,0,975100.09,DR,REF520858,CBA,Current
01-09-2025 11:21,CBAEC85148D26E749D2BD7C,063-000-002,33333333,COMPANY PAYROLL CBA,0,143.63,975243.72,CR,REF438160,CBA,Current
01-09-2025 11:23,CBADE1448BA1E4C4FCBAB01,063-000-002,33333333,MENULOG CBA,35.23,0,975208.49,DR,REF128997,CBA,Current
01-09-2025 11:31,CBA424A36077BBF4657955F,063-000-002,33333333,SHELL CBA,125.92,0,975082.57,DR,REF473858,CBA,Current
01-09-2025 11:40,CBAC687D6D248804CFAA82B,063-000-002,33333333,7-ELEVEN CBA,43.57,0,975039,DR,REF167297,CBA,Current
01-09-2025 11:54,CBAA7C2E8C83A9842098888,063-000-002,33333333,APPLE CBA,127.54,0,974911.46,DR,REF229330,CBA,Current
01-09-2025 12:51,INT216E6B16AB9549E6B4C3,063-000-002,33333333,TRANSFER TO CBA 22222222,1974.2,0,972937.26,DR,INT-53628,CBA,Current
01-09-2025 13:50,CBAC0AE208F03F94C7F9655,063-000-002,33333333,INTERNET TRANSFER CBA,8.94,0,972928.32,DR,REF159619,CBA,Current
01-09-2025 13:52,CBAF0F2591D9A2243E4AF0A,063-000-002,33333333,COMPANY PAYROLL CBA,0,2625.81,975554.13,CR,REF683411,CBA,Current
01-09-2025 14:20,CBAB75B63D5A5AA4BE197BE,063-000-002,33333333,TAFE BOOKSHOP CBA,151.62,0,975402.51,DR,REF554398,CBA,Current
01-09-2025 15:57,CBA3DFAB61265C24FEC992F,063-000-002,33333333,SALARY PAYMENT CBA,0,467.79,975870.3,CR,REF200979,CBA,Current
01-09-2025 16:25,CBA4E65A289D62D49ED854A,063-000-002,33333333,APPLE CBA,16.07,0,975854.23,DR,REF996538,CBA,Current
01-09-2025 16:30,CBAA2F79ABC03EC4016A433,063-000-002,33333333,COMPANY PAYROLL CBA,0,6625.25,982479.48,CR,REF937778,CBA,Current
01-09-2025 16:31,CBA39C7B846A4EB44188DAE,063-000-002,33333333,UBER EATS CBA,50.58,0,982428.9,DR,REF439304,CBA,Current
01-09-2025 16:45,CBA36671B451F2B4DCAA895,063-000-002,33333333,KFC CBA,7.64,0,982421.26,DR,REF398869,CBA,Current
01-09-2025 16:47,CBAE180B3D60DF042959316,063-000-002,33333333,INTERNET TRANSFER CBA,38.92,0,982382.34,DR,REF718852,CBA,Current
01-09-2025 17:12,CBAF66AFE4760654DDCA76C,063-000-002,33333333,CITYLINK CBA,58.72,0,982323.62,DR,REF195621,CBA,Current
01-09-2025 17:17,CBA10E657AAEFD24E729762,063-000-002,33333333,APPLE CBA,14.74,0,982308.88,DR,REF104290,CBA,Current
01-09-2025 18:36,CBA04A438EDF73144399B0F,063-000-002,33333333,STARBUCKS CBA,57.91,0,982250.97,DR,REF583115,CBA,Current
01-09-2025 18:44,CBA37F992CDEAF840BEA88E,063-000-002,33333333,FLIXBUS CBA,15,0,982235.97,DR,REF729843,CBA,Current
01-09-2025 18:48,CBADB2393F8018E45EDBB37,063-000-002,33333333,APPLE CBA,45.14,0,982190.83,DR,REF750523,CBA,Current
01-09-2025 18:59,CBA1B2BBFE6CFA2494996DD,063-000-002,33333333,CITYLINK CBA,11.75,0,982179.08,DR,REF192955,CBA,Current
01-09-2025 19:28,CBA7111181B18D548E6B31A,063-000-002,33333333,STARBUCKS CBA,66.02,0,982113.06,DR,REF759121,CBA,Current
01-09-2025 19:35,CBA87D495733CE64FC8B3E1,063-000-002,33333333,PAYPAL *NETFLIX CBA,8.25,0,982104.81,DR,REF611249,CBA,Current
01-09-2025 19:39,CBA48844A9E97804E2AAC4D,063-000-002,33333333,BIGW CBA,8.01,0,982096.8,DR,REF896998,CBA,Current
01-09-2025 19:49,CBA29A0C02EB57946F1818C,063-000-002,33333333,FLIXBUS CBA,40.76,0,982056.04,DR,REF766708,CBA,Current
01-09-2025 20:02,CBAAE98629A46324FD2AAF0,063-000-002,33333333,ZOOM CBA,11.71,0,982044.33,DR,REF215710,CBA,Current
01-09-2025 21:04,CBA4668EA4DEB4A4D6FAF86,063-000-002,33333333,JB HI-FI CBA,91.32,0,981953.01,DR,REF188224,CBA,Current
01-09-2025 21:18,CBAF8A742510D3F4E46BDA5,063-000-002,33333333,DOMINO'S PIZZA CBA,75.43,0,981877.58,DR,REF334075,CBA,Current
01-09-2025 21:51,CBA04F30EF4C92A494A900D,063-000-002,33333333,PAY - SALARY CBA,0,5707.34,987584.92,CR,REF889674,CBA,Current
01-09-2025 22:29,CBAC1CA2D76C23B4C25BBB7,063-000-002,33333333,COMPANY PAYROLL CBA,0,1616.36,989201.28,CR,REF422853,CBA,Current
01-09-2025 23:40,CBA6FB2796DC59A4F67AEFE,063-000-002,33333333,7-ELEVEN CBA,41.52,0,989159.76,DR,REF109932,CBA,Current
01-09-2025 23:58,CBA36202DDAA8B440229D66,063-000-002,33333333,UBER EATS CBA,170.3,0,988989.46,DR,REF158318,CBA,Current
02-09-2025 00:28,CBAFA7FA3AC08F14B45B64D,063-000-002,33333333,7-ELEVEN CBA,150.89,0,988838.57,DR,REF621476,CBA,Current
02-09-2025 00:50,CBA9D2F3CD95A5C495BA84F,063-000-002,33333333,PAYPAL *NETFLIX CBA,49.38,0,988789.19,DR,REF973173,CBA,Current
02-09-2025 01:16,CBAE40343332C904170A0A2,063-000-002,33333333,APPLE CBA,75.14,0,988714.05,DR,REF806823,CBA,Current
02-09-2025 02:22,CBA336F6F8B89A14E0A9FC5,063-000-002,33333333,ALDI CBA,94.23,0,988619.82,DR,REF748277,CBA,Current
02-09-2025 02:38,CBAE7BB447D8FDF4F958F40,063-000-002,33333333,ZOOM CBA,31.86,0,988587.96,DR,REF781532,CBA,Current
02-09-2025 02:40,CBAC710997E9DF34187BDB3,063-000-002,33333333,ZOOM CBA,67.25,0,988520.71,DR,REF491322,CBA,Current
02-09-2025 02:42,CBA0866C168D27F43BFAC25,063-000-002,33333333,APPLE CBA,63.92,0,988456.79,DR,REF928084,CBA,Current
02-09-2025 02:46,CBA1AE8DD56B3DA4526A11C,063-000-002,33333333,HARVEY NORMAN CBA,44.19,0,988412.6,DR,REF893674,CBA,Current
02-09-2025 02:54,CBAB31537E87B7D42DFB50B,063-000-002,33333333,UBER EATS CBA,159.73,0,988252.87,DR,REF651077,CBA,Current
02-09-2025 03:05,CBAAACE55B106214753B049,063-000-002,33333333,SALARY PAYMENT CBA,0,4665.35,992918.22,CR,REF161044,CBA,Current
02-09-2025 03:16,CBA771A5501FE8A49F68BAC,063-000-002,33333333,MENULOG CBA,355.66,0,992562.56,DR,REF227011,CBA,Current
02-09-2025 03:21,CBADD1FA85AB24D4040A208,063-000-002,33333333,PAYPAL *NETFLIX CBA,69.38,0,992493.18,DR,REF425453,CBA,Current
02-09-2025 03:24,CBAA720315B25B3498AAE8B,063-000-002,33333333,MCDONALDS CBA,5.63,0,992487.55,DR,REF498035,CBA,Current
02-09-2025 03:27,INTB1CFEAC3078D417981F4,063-000-002,33333333,TRANSFER TO ANZ 11111111,1521.12,0,990966.43,DR,INT-44344,CBA,Current
02-09-2025 03:28,CBA59BFE489B6834D1CB90B,063-000-002,33333333,DOMINO'S PIZZA CBA,72.73,0,990893.7,DR,REF184369,CBA,Current
02-09-2025 03:37,CBAD4098FD482A649409A09,063-000-002,33333333,UBER EATS CBA,134.9,0,990758.8,DR,REF343468,CBA,Current
02-09-2025 04:24,CBA4255906EC21E4A4D8B70,063-000-002,33333333,ZOOM CBA,55.83,0,990702.97,DR,REF987192,CBA,Current
02-09-2025 04:33,CBA34DDAE5AB17649A499B3,063-000-002,33333333,RAILWAY STATION CBA,28.47,0,990674.5,DR,REF760973,CBA,Current
02-09-2025 04:36,CBAB055A6B079864051A38D,063-000-002,33333333,MCDONALDS CBA,53.83,0,990620.67,DR,REF344360,CBA,Current
02-09-2025 04:54,CBAB3711E0DA4F4430BBC72,063-000-002,33333333,BWS CBA,23.42,0,990597.25,DR,REF551287,CBA,Current
02-09-2025 05:09,CBAD5C36F4EE00540FF98DD,063-000-002,33333333,STARBUCKS CBA,24.03,0,990573.22,DR,REF734362,CBA,Current
02-09-2025 05:09,CBA670A198C1D6543A1B78B,063-000-002,33333333,FLIXBUS CBA,58.88,0,990514.34,DR,REF662489,CBA,Current
02-09-2025 05:11,CBA8B18C40AC9CD4D738902,063-000-002,33333333,7-ELEVEN CBA,29.92,0,990484.42,DR,REF976009,CBA,Current
02-09-2025 05:13,CBAE9DA57380E4E49748558,063-000-002,33333333,7-ELEVEN CBA,34.98,0,990449.44,DR,REF339067,CBA,Current
02-09-2025 05:34,CBAB6EEBF5D1B1A41E3A5BA,063-000-002,33333333,BWS CBA,6.45,0,990442.99,DR,REF418291,CBA,Current
02-09-2025 05:55,CBA89D5C005269E4AABA07A,063-000-002,33333333,UBER EATS CBA,19.07,0,990423.92,DR,REF922557,CBA,Current
02-09-2025 06:11,CBAE12412D7D80D405DB5C5,063-000-002,33333333,INTERNET TRANSFER CBA,58.11,0,990365.81,DR,REF298867,CBA,Current
02-09-2025 06:23,CBA6B93208BE0154C33BC13,063-000-002,33333333,CITYLINK CBA,66.51,0,990299.3,DR,REF373671,CBA,Current
02-09-2025 07:48,CBA45BEC823F7034F06AB52,063-000-002,33333333,SPOTIFY CBA,19.42,0,990279.88,DR,REF499029,CBA,Current
02-09-2025 07:52,CBAFE6BF1540DC945FEB89A,063-000-002,33333333,WAGES CREDIT CBA,0,192.23,990472.11,CR,REF410524,CBA,Current
02-09-2025 07:54,CBA47717029D7954587BC6E,063-000-002,33333333,PAY - SALARY CBA,0,472.1,990944.21,CR,REF783425,CBA,Current
02-09-2025 07:56,CBAA4100860BDB34915A35C,063-000-002,33333333,JB HI-FI CBA,30.01,0,990914.2,DR,REF704585,CBA,Current
02-09-2025 08:43,CBAFDA2C4D368C54F00AB54,063-000-002,33333333,ALDI CBA,88.19,0,990826.01,DR,REF600915,CBA,Current
02-09-2025 09:12,CBA83B84AD57DE54111A56E,063-000-002,33333333,RAILWAY STATION CBA,39.1,0,990786.91,DR,REF448825,CBA,Current
02-09-2025 09:20,CBA771B1F7F6FC243DD807C,063-000-002,33333333,PAYPAL *NETFLIX CBA,28.89,0,990758.02,DR,REF704870,CBA,Current
02-09-2025 09:57,INT05A1D476167C4B56848F,063-000-002,33333333,TRANSFER FROM NAB 44444444,0,428.72,991186.74,CR,INT-58078,CBA,Current
02-09-2025 10:17,CBA49679CA93EDE4FB39ABE,063-000-002,33333333,HARVEY NORMAN CBA,86.78,0,991099.96,DR,REF434596,CBA,Current
02-09-2025 10:18,CBA20AC06E47E2E4587A935,063-000-002,33333333,RAILWAY STATION CBA,18.79,0,991081.17,DR,REF644830,CBA,Current
02-09-2025 10:20,CBAC6B65C0395F5454CA243,063-000-002,33333333,COMPANY PAYROLL CBA,0,4766.75,995847.92,CR,REF359447,CBA,Current
02-09-2025 10:31,CBA9F9F66DB6C2A45B5AB3B,063-000-002,33333333,ALDI CBA,38.74,0,995809.18,DR,REF809671,CBA,Current
02-09-2025 10:34,INTBC97AA84F68B444997C6,063-000-002,33333333,TRANSFER FROM CBA 22222222,0,1355.69,997164.87,CR,INT-56484,CBA,Current
02-09-2025 11:12,CBA668728EF0E854DFB8D93,063-000-002,33333333,BANK FEE CBA,216.21,0,996948.66,DR,REF417792,CBA,Current
02-09-2025 11:32,CBA08C8A88004FF4832A7F7,063-000-002,33333333,INTERNET TRANSFER CBA,106.05,0,996842.61,DR,REF277830,CBA,Current
02-09-2025 11:44,CBA19095304B349484BB764,063-000-002,33333333,SHELL CBA,51.96,0,996790.65,DR,REF141325,CBA,Current
02-09-2025 11:49,CBA7833C53487D844B0A1ED,063-000-002,33333333,PAYROLL CREDIT CBA,0,765.34,997555.99,CR,REF128006,CBA,Current
02-09-2025 11:53,CBAD9FB662B69F54A569185,063-000-002,33333333,CITYLINK CBA,6.32,0,997549.67,DR,REF612704,CBA,Current
02-09-2025 11:54,CBA72E35F5039894DDF83C2,063-000-002,33333333,PAYMENT GATEWAY CBA,22.51,0,997527.16,DR,REF264111,CBA,Current
02-09-2025 12:11,CBA80DB04140FEC496C88CE,063-000-002,33333333,KFC CBA,208.25,0,997318.91,DR,REF196485,CBA,Current
02-09-2025 12:23,INTD66BDD64CCDB438CBF42,063-000-002,33333333,TRANSFER TO NAB 44444444,1922.72,0,995396.19,DR,INT-23080,CBA,Current
02-09-2025 12:26,CBA10DDC9EE12C14C88BB92,063-000-002,33333333,WOOLWORTHS CBA,7.12,0,995389.07,DR,REF807697,CBA,Current
02-09-2025 12:36,CBA48FA38715DA64E1993AE,063-000-002,33333333,PAYPAL *NETFLIX CBA,107.25,0,995281.82,DR,REF975964,CBA,Current
02-09-2025 12:51,CBA422381EBE98446098D6A,063-000-002,33333333,BANK FEE CBA,48.76,0,995233.06,DR,REF332314,CBA,Current
02-09-2025 13:22,CBA55C30D1421054CEE9A48,063-000-002,33333333,CITYLINK CBA,20.37,0,995212.69,DR,REF320191,CBA,Current
02-09-2025 13:58,CBA7685E6EDC2154B1D9ECF,063-000-002,33333333,RAILWAY STATION CBA,6.21,0,995206.48,DR,REF999984,CBA,Current
02-09-2025 14:12,CBA69193763E67D4628BBF5,063-000-002,33333333,COLES CBA,84.05,0,995122.43,DR,REF274748,CBA,Current
02-09-2025 14:14,CBAC6ED15D7AF8C49E786E4,063-000-002,33333333,INTERNET TRANSFER CBA,29.77,0,995092.66,DR,REF943058,CBA,Current
02-09-2025 14:56,CBAEFE3A804C0F4457CBD82,063-000-002,33333333,KFC CBA,29.49,0,995063.17,DR,REF501410,CBA,Current
02-09-2025 15:34,CBA058D03484E8440599B25,063-000-002,33333333,BWS CBA,29.56,0,995033.61,DR,REF749952,CBA,Current
02-09-2025 15:39,CBAE11244B6D4AF46F1A74D,063-000-002,33333333,BANK FEE CBA,176.9,0,994856.71,DR,REF823898,CBA,Current
02-09-2025 15:45,CBA61BDCADEF69B4A298D80,063-000-002,33333333,PAYROLL CREDIT CBA,0,679.3,995536.01,CR,REF237645,CBA,Current
02-09-2025 16:00,CBAE0783ABA4E46401B859A,063-000-002,33333333,PAYPAL *NETFLIX CBA,21.61,0,995514.4,DR,REF216684,CBA,Current
02-09-2025 16:13,CBA61D3192B5F3D497A89B1,063-000-002,33333333,ALDI CBA,117.43,0,995396.97,DR,REF998100,CBA,Current
02-09-2025 16:15,CBAB469316BE0F04BDC8750,063-000-002,33333333,LIQUORLAND CBA,58.77,0,995338.2,DR,REF899017,CBA,Current
02-09-2025 17:24,INTEE385B684B004EB088FE,063-000-002,33333333,TRANSFER TO NAB 44444444,864.38,0,994473.82,DR,INT-43115,CBA,Current
02-09-2025 17:30,CBAAFECBE31ACE647CFA111,063-000-002,33333333,PAYMENT GATEWAY CBA,30.79,0,994443.03,DR,REF911056,CBA,Current
02-09-2025 17:47,CBADD4DC2CB873B4B2582A4,063-000-002,33333333,ALDI CBA,94.36,0,994348.67,DR,REF334461,CBA,Current
02-09-2025 17:53,CBA3AA111D793B64ED8B14B,063-000-002,33333333,WAGES CREDIT CBA,0,1534.87,995883.54,CR,REF237545,CBA,Current
02-09-2025 18:15,CBA5E6AF96C6BEC4F01A22D,063-000-002,33333333,CITYLINK CBA,71.22,0,995812.32,DR,REF987001,CBA,Current
02-09-2025 18:17,CBA9008F54069CE485B8F57,063-000-002,33333333,ALDI CBA,77.05,0,995735.27,DR,REF274778,CBA,Current
02-09-2025 18:34,CBAEBD6B1D17FB643F98799,063-000-002,33333333,SHELL CBA,1.53,0,995733.74,DR,REF758473,CBA,Current
02-09-2025 18:35,INTF3673629C21A40B48F3A,063-000-002,33333333,TRANSFER FROM CBA 22222222,0,96.56,995830.3,CR,INT-28152,CBA,Current
02-09-2025 18:41,CBAA3D9335572FF4E08A228,063-000-002,33333333,WAGES CREDIT CBA,0,2896.43,998726.73,CR,REF431172,CBA,Current
02-09-2025 18:42,CBA1C0DB0E383D34D74ABF0,063-000-002,33333333,INTERNET TRANSFER CBA,29.97,0,998696.76,DR,REF734824,CBA,Current
02-09-2025 18:59,CBA33AD83BCE54749EA851F,063-000-002,33333333,WAGES CREDIT CBA,0,2173.11,1000869.87,CR,REF667445,CBA,Current
02-09-2025 19:21,INT91B5E49C060C46DC9232,063-000-002,33333333,TRANSFER TO CBA 22222222,1832,0,999037.87,DR,INT-72860,CBA,Current
02-09-2025 19:28,CBABC893DFB2778405FBBBB,063-000-002,33333333,BWS CBA,32.39,0,999005.48,DR,REF987036,CBA,Current
02-09-2025 19:53,CBA2812CD91F3B544798D83,063-000-002,33333333,UBER EATS CBA,46.26,0,998959.22,DR,REF417097,CBA,Current
02-09-2025 19:55,CBABDF0B2FF5CC6456CACDE,063-000-002,33333333,HARVEY NORMAN CBA,53.34,0,998905.88,DR,REF149619,CBA,Current
02-09-2025 19:57,CBA0336A47BBA2744679F28,063-000-002,33333333,SHELL CBA,3.46,0,998902.42,DR,REF342384,CBA,Current
02-09-2025 19:57,CBA2151B3637DB64524AA2E,063-000-002,33333333,BIGW CBA,147.41,0,998755.01,DR,REF122565,CBA,Current
02-09-2025 20:12,CBA8C7DF054F9284EC586F8,063-000-002,33333333,COLES CBA,44.82,0,998710.19,DR,REF476928,CBA,Current
02-09-2025 20:22,CBA8EB188672CCD45578704,063-000-002,33333333,COMPANY PAYROLL CBA,0,1057.56,999767.75,CR,REF826549,CBA,Current
02-09-2025 20:41,CBAFC406D84712E46C5A633,063-000-002,33333333,PAYROLL CREDIT CBA,0,6118.46,1005886.21,CR,REF493021,CBA,Current
02-09-2025 21:04,CBA7A651558CF85430FA9E2,063-000-002,33333333,BWS CBA,77.71,0,1005808.5,DR,REF910713,CBA,Current
02-09-2025 21:15,CBAB10EB1407F6A43E4A83C,063-000-002,33333333,BWS CBA,107.53,0,1005700.97,DR,REF441257,CBA,Current
02-09-2025 21:17,CBA0FCB98C73F93414F80D2,063-000-002,33333333,PAY - SALARY CBA,0,1859.69,1007560.66,CR,REF896241,CBA,Current
02-09-2025 21:27,CBAB718968F941C4E399D39,063-000-002,33333333,BANK FEE CBA,33.35,0,1007527.31,DR,REF113072,CBA,Current
02-09-2025 22:05,CBA54C29C273A964A35AE94,063-000-002,33333333,SHELL CBA,25.27,0,1007502.04,DR,REF547514,CBA,Current
02-09-2025 22:27,CBA20878F0ECDCE47AEB7E8,063-000-002,33333333,COLES CBA,98.66,0,1007403.38,DR,REF143031,CBA,Current
02-09-2025 22:54,CBA383F81C9E4B1491692D2,063-000-002,33333333,PAYPAL *NETFLIX CBA,4.34,0,1007399.04,DR,REF728791,CBA,Current
02-09-2025 22:57,CBA4AECD3739EBB4964B13A,063-000-002,33333333,BIGW CBA,3.47,0,1007395.57,DR,REF545484,CBA,Current
02-09-2025 23:22,CBAFA5878F95CAC4270BF94,063-000-002,33333333,PAY - SALARY CBA,0,733.68,1008129.25,CR,REF580301,CBA,Current
02-09-2025 23:49,CBAF3190E71ADC942FA93DC,063-000-002,33333333,BANK FEE CBA,4.76,0,1008124.49,DR,REF594413,CBA,Current
02-09-2025 23:58,CBA0A7335C6747545B19F52,063-000-002,33333333,AMAZON AU CBA,137.31,0,1007987.18,DR,REF148073,CBA,Current
03-09-2025 00:02,CBA60690E84702947EE9C86,063-000-002,33333333,HARVEY NORMAN CBA,51.94,0,1007935.24,DR,REF270013,CBA,Current
03-09-2025 00:19,CBA950DF96DC7424FDC80CD,063-000-002,33333333,KFC CBA,7.83,0,1007927.41,DR,REF311906,CBA,Current
03-09-2025 00:22,CBAAF6ACB7642FA494CBF48,063-000-002,33333333,RAILWAY STATION CBA,95.37,0,1007832.04,DR,REF456572,CBA,Current
03-09-2025 00:31,CBADC3C6C2856C64D0EA60E,063-000-002,33333333,PAY - SALARY CBA,0,3168.62,1011000.66,CR,REF750292,CBA,Current
03-09-2025 00:40,CBAE02DEFCB47BF4E30AE6C,063-000-002,33333333,BWS CBA,12.36,0,1010988.3,DR,REF432317,CBA,Current
03-09-2025 00:40,CBA37356F8F7E134331908E,063-000-002,33333333,BIGW CBA,74.43,0,1010913.87,DR,REF456682,CBA,Current
03-09-2025 00:42,CBA0E425E259E504633AF47,063-000-002,33333333,MCDONALDS CBA,22.64,0,1010891.23,DR,REF902172,CBA,Current
03-09-2025 01:05,CBAC7DDB3557C10469987FE,063-000-002,33333333,PAYMENT GATEWAY CBA,12.98,0,1010878.25,DR,REF167093,CBA,Current
03-09-2025 01:14,CBA02AFA8B385EF47B191B5,063-000-002,33333333,BANK FEE CBA,25.22,0,1010853.03,DR,REF986147,CBA,Current
03-09-2025 02:06,CBAA51680FD18F94BC48E4D,063-000-002,33333333,PAY - SALARY CBA,0,5610.95,1016463.98,CR,REF951332,CBA,Current
03-09-2025 02:41,CBAA7036944D3984467911F,063-000-002,33333333,WAGES CREDIT CBA,0,7821.94,1024285.92,CR,REF378867,CBA,Current
03-09-2025 02:47,CBA92DF4B48F28946E4BD7F,063-000-002,33333333,JB HI-FI CBA,46.29,0,1024239.63,DR,REF127181,CBA,Current
03-09-2025 02:49,CBAA607D9D078144B0F990A,063-000-002,33333333,PAYMENT GATEWAY CBA,93.13,0,1024146.5,DR,REF636435,CBA,Current
03-09-2025 03:09,CBAFE8B1C9C48DC4E37AE4D,063-000-002,33333333,KFC CBA,40.79,0,1024105.71,DR,REF110101,CBA,Current
03-09-2025 03:20,CBA53C4099542994C93BF43,063-000-002,33333333,DOMINO'S PIZZA CBA,5.7,0,1024100.01,DR,REF224550,CBA,Current
03-09-2025 03:30,CBA5DC7A76F18A946E5A32E,063-000-002,33333333,TAFE BOOKSHOP CBA,10.4,0,1024089.61,DR,REF333461,CBA,Current
03-09-2025 03:33,CBA08A4F002114F479B8B3C,063-000-002,33333333,7-ELEVEN CBA,71.73,0,1024017.88,DR,REF966841,CBA,Current
03-09-2025 03:41,CBA9A06B2433B494080ACE1,063-000-002,33333333,BANK FEE CBA,13.78,0,1024004.1,DR,REF755501,CBA,Current
03-09-2025 03:44,CBA6E37AA14464340378150,063-000-002,33333333,CITYLINK CBA,4.87,0,1023999.23,DR,REF266795,CBA,Current
03-09-2025 05:13,CBA3476E33B5E4C46879155,063-000-002,33333333,7-ELEVEN CBA,9.4,0,1023989.83,DR,REF965225,CBA,Current
03-09-2025 05:23,CBAD68F588F9CD04DA58343,063-000-002,33333333,PAYMENT GATEWAY CBA,28.34,0,1023961.49,DR,REF387980,CBA,Current
03-09-2025 05:24,CBA4F3DF36B0440479EA428,063-000-002,33333333,FLIXBUS CBA,122.88,0,1023838.61,DR,REF410413,CBA,Current
03-09-2025 05:54,CBA6CAFF237DE674D93BADB,063-000-002,33333333,BP CBA,33.43,0,1023805.18,DR,REF778547,CBA,Current
03-09-2025 06:14,CBA40BF3E982E144C9E82DA,063-000-002,33333333,RAILWAY STATION CBA,45.27,0,1023759.91,DR,REF162279,CBA,Current
03-09-2025 06:18,CBADEFF570C76F84B6AB2C2,063-000-002,33333333,COMPANY PAYROLL CBA,0,5152.39,1028912.3,CR,REF618538,CBA,Current
03-09-2025 06:35,CBAE54DFD736E8443689B99,063-000-002,33333333,WOOLWORTHS CBA,88.08,0,1028824.22,DR,REF565630,CBA,Current
03-09-2025 06:51,CBAAB886334A70A471FB7DD,063-000-002,33333333,RAILWAY STATION CBA,23.88,0,1028800.34,DR,REF795564,CBA,Current
03-09-2025 07:04,CBAA1EC8E6B578146D88453,063-000-002,33333333,TAFE BOOKSHOP CBA,107.06,0,1028693.28,DR,REF376682,CBA,Current
03-09-2025 07:14,CBAE1704E2AFBE648489584,063-000-002,33333333,PAYPAL *NETFLIX CBA,6.47,0,1028686.81,DR,REF648960,CBA,Current
03-09-2025 07:19,CBAA98A20E05AC04652B10B,063-000-002,33333333,AMAZON AU CBA,28.65,0,1028658.16,DR,REF275681,CBA,Current
03-09-2025 08:14,CBAC7DAA3B42377489BB078,063-000-002,33333333,PAYMENT GATEWAY CBA,14.48,0,1028643.68,DR,REF714343,CBA,Current
03-09-2025 09:08,CBAEEA105DA9B3544DC95D2,063-000-002,33333333,BIGW CBA,57.02,0,1028586.66,DR,REF145197,CBA,Current
03-09-2025 09:23,CBADB8BACE9125A4D94AF07,063-000-002,33333333,KFC CBA,73.97,0,1028512.69,DR,REF161179,CBA,Current
03-09-2025 09:25,INT70331FDA54AB41F0A298,063-000-002,33333333,TRANSFER TO NAB 44444444,1810.24,0,1026702.45,DR,INT-72435,CBA,Current
03-09-2025 09:56,CBA2367406D62F9453CA790,063-000-002,33333333,AMAZON AU CBA,27.38,0,1026675.07,DR,REF793401,CBA,Current
03-09-2025 09:59,CBA4D269014A1114D9F9230,063-000-002,33333333,FLIXBUS CBA,111.39,0,1026563.68,DR,REF790454,CBA,Current
03-09-2025 10:08,INT234B7F8A1CFD47EAA567,063-000-002,33333333,TRANSFER FROM CBA 22222222,0,889.3,1027452.98,CR,INT-39652,CBA,Current
03-09-2025 11:10,CBA0AE48459677749F3AA2B,063-000-002,33333333,RAILWAY STATION CBA,120.01,0,1027332.97,DR,REF695829,CBA,Current
03-09-2025 11:34,CBAD1BC4BD7037E4933A706,063-000-002,33333333,STARBUCKS CBA,76.84,0,1027256.13,DR,REF364153,CBA,Current
03-09-2025 11:58,CBABFA6D249C62C49B1A83F,063-000-002,33333333,HARVEY NORMAN CBA,19.27,0,1027236.86,DR,REF216003,CBA,Current
03-09-2025 12:06,CBA7563C8F5605B4E9AB85C,063-000-002,33333333,BWS CBA,53.16,0,1027183.7,DR,REF505008,CBA,Current
03-09-2025 12:15,CBAD816B57108B94EE78F38,063-000-002,33333333,MENULOG CBA,39.77,0,1027143.93,DR,REF176981,CBA,Current
03-09-2025 12:22,CBA07DDEEE7F0F845CBAC03,063-000-002,33333333,7-ELEVEN CBA,4.12,0,1027139.81,DR,REF653819,CBA,Current
03-09-2025 12:29,CBAB05647927B064E019EE5,063-000-002,33333333,CITYLINK CBA,19.92,0,1027119.89,DR,REF622353,CBA,Current
03-09-2025 12:33,CBA4E9512AE85444B578E13,063-000-002,33333333,MENULOG CBA,26.89,0,1027093,DR,REF288952,CBA,Current
03-09-2025 12:56,CBA98F204C5E1194DBD8F1A,063-000-002,33333333,PAY - SALARY CBA,0,666.66,1027759.66,CR,REF552030,CBA,Current
03-09-2025 13:06,INT769D663D1E9F4D799E38,063-000-002,33333333,TRANSFER FROM NAB 44444444,0,208.55,1027968.21,CR,INT-49742,CBA,Current
03-09-2025 13:21,CBAA18CEFA2496E405E8E71,063-000-002,33333333,RAILWAY STATION CBA,29.21,0,1027939,DR,REF582111,CBA,Current
03-09-2025 13:32,CBA0745A51DEF8E4B0EA47C,063-000-002,33333333,MCDONALDS CBA,57.95,0,1027881.05,DR,REF667256,CBA,Current
03-09-2025 13:43,CBA8039A712A7E54147B288,063-000-002,33333333,DOMINO'S PIZZA CBA,31.59,0,1027849.46,DR,REF737951,CBA,Current
03-09-2025 13:59,CBA80ADD9090243448DBF1B,063-000-002,33333333,PAYPAL *NETFLIX CBA,60.49,0,1027788.97,DR,REF979233,CBA,Current
03-09-2025 14:19,CBA3E4142F9DCE74DEE9210,063-000-002,33333333,TAFE BOOKSHOP CBA,47.61,0,1027741.36,DR,REF528856,CBA,Current
03-09-2025 14:52,CBA74D48B5578554B9D9BC7,063-000-002,33333333,FLIXBUS CBA,91.79,0,1027649.57,DR,REF180948,CBA,Current
03-09-2025 15:11,INT1E6796E27E7D4145ADFA,063-000-002,33333333,TRANSFER FROM ANZ 11111111,0,123.49,1027773.06,CR,INT-73744,CBA,Current
03-09-2025 15:19,CBA691E6D3561ED46E8B938,063-000-002,33333333,AMAZON AU CBA,22.74,0,1027750.32,DR,REF532915,CBA,Current
03-09-2025 16:16,CBA8FECFF19E6E749A0B19A,063-000-002,33333333,MCDONALDS CBA,53.94,0,1027696.38,DR,REF841871,CBA,Current
03-09-2025 16:17,CBA49D9BDBA2A9C43EFA75A,063-000-002,33333333,DOMINO'S PIZZA CBA,6.79,0,1027689.59,DR,REF875879,CBA,Current
03-09-2025 16:28,CBA7775EF9D709243C28565,063-000-002,33333333,SPOTIFY CBA,61.89,0,1027627.7,DR,REF815678,CBA,Current
03-09-2025 16:38,CBA4D0E78E3FE114025B115,063-000-002,33333333,APPLE CBA,199.65,0,1027428.05,DR,REF410794,CBA,Current
03-09-2025 16:49,CBAF2498D34C8EC44B9AE7B,063-000-002,33333333,PAYMENT GATEWAY CBA,10.11,0,1027417.94,DR,REF106127,CBA,Current
03-09-2025 17:08,CBA29B31987F326431AA75B,063-000-002,33333333,ZOOM CBA,41.96,0,1027375.98,DR,REF515888,CBA,Current
03-09-2025 17:35,CBAEAE92AF7FF7847038E98,063-000-002,33333333,FLIXBUS CBA,45.58,0,1027330.4,DR,REF253221,CBA,Current
03-09-2025 18:30,CBAB8610B32CEC84F0AA770,063-000-002,33333333,ZOOM CBA,90.12,0,1027240.28,DR,REF657247,CBA,Current
03-09-2025 18:48,CBA07F6DB9F75AC40FE989D,063-000-002,33333333,BWS CBA,28.82,0,1027211.46,DR,REF687250,CBA,Current
03-09-2025 20:18,CBA4D69C44825DA40F491EF,063-000-002,33333333,PAYMENT GATEWAY CBA,73.75,0,1027137.71,DR,REF491797,CBA,Current
03-09-2025 20:34,CBA091454177CB24436B16D,063-000-002,33333333,ZOOM CBA,180.08,0,1026957.63,DR,REF389245,CBA,Current
03-09-2025 20:50,CBA57C18089C59E4F51BAC8,063-000-002,33333333,BANK FEE CBA,97.88,0,1026859.75,DR,REF378505,CBA,Current
03-09-2025 21:23,CBA7D20618C79974DB48FDE,063-000-002,33333333,SALARY PAYMENT CBA,0,3893.71,1030753.46,CR,REF488114,CBA,Current
03-09-2025 21:23,CBA229269C718904457ADDF,063-000-002,33333333,APPLE CBA,91.22,0,1030662.24,DR,REF353865,CBA,Current
03-09-2025 22:08,CBAFBDEB42360764229B6F4,063-000-002,33333333,INTERNET TRANSFER CBA,87.55,0,1030574.69,DR,REF627273,CBA,Current
03-09-2025 22:22,CBAA065242728FE463D8BAD,063-000-002,33333333,ZOOM CBA,108.27,0,1030466.42,DR,REF332093,CBA,Current
03-09-2025 22:28,CBA8642D2D7383C4FB59DF3,063-000-002,33333333,MENULOG CBA,32.24,0,1030434.18,DR,REF768482,CBA,Current
03-09-2025 22:45,CBAA25EF2D1B0D747F7A6BC,063-000-002,33333333,STARBUCKS CBA,8.63,0,1030425.55,DR,REF966362,CBA,Current
03-09-2025 22:54,CBAC3E841CEFE4841FF82A4,063-000-002,33333333,FLIXBUS CBA,44.87,0,1030380.68,DR,REF560587,CBA,Current
03-09-2025 22:57,CBA3A08C7B55D7240F493FA,063-000-002,33333333,BP CBA,62.99,0,1030317.69,DR,REF647387,CBA,Current
03-09-2025 23:13,CBA5D6B167A919E42C485C7,063-000-002,33333333,FLIXBUS CBA,105.42,0,1030212.27,DR,REF908809,CBA,Current
03-09-2025 23:30,INT88FF1BF35D8D4DE59064,063-000-002,33333333,TRANSFER TO CBA 22222222,790.21,0,1029422.06,DR,INT-74913,CBA,Current
04-09-2025 00:08,CBA7511923CAFDF45B6BEEE,063-000-002,33333333,MCDONALDS CBA,55.77,0,1029366.29,DR,REF795339,CBA,Current
04-09-2025 00:18,CBA8960C8B2EFA14BCBACB4,063-000-002,33333333,HARVEY NORMAN CBA,32.58,0,1029333.71,DR,REF805119,CBA,Current
04-09-2025 00:28,CBAC1148AC57293441CBBB6,063-000-002,33333333,WOOLWORTHS CBA,134.39,0,1029199.32,DR,REF156150,CBA,Current
04-09-2025 00:57,CBA7013EDC135F6476BB60A,063-000-002,33333333,PAYMENT GATEWAY CBA,13.1,0,1029186.22,DR,REF264154,CBA,Current
04-09-2025 01:04,CBA57CCCF6EC44E4D5BA4F7,063-000-002,33333333,ALDI CBA,27.92,0,1029158.3,DR,REF119343,CBA,Current
04-09-2025 01:12,CBAD5BC5007D5274ACCA681,063-000-002,33333333,SALARY PAYMENT CBA,0,1024.39,1030182.69,CR,REF304315,CBA,Current
04-09-2025 01:27,CBA7748DDCC5D004CF5956A,063-000-002,33333333,UBER EATS CBA,144.24,0,1030038.45,DR,REF235004,CBA,Current
04-09-2025 01:29,CBA3B7777C1BDEB42A4B948,063-000-002,33333333,JB HI-FI CBA,91.5,0,1029946.95,DR,REF357575,CBA,Current
04-09-2025 01:38,CBAFC9F963DDB4C45ADAB13,063-000-002,33333333,PAY - SALARY CBA,0,2610.64,1032557.59,CR,REF115631,CBA,Current
04-09-2025 02:13,INT0B5AF65AF9D2486BBA20,063-000-002,33333333,TRANSFER TO NAB 44444444,1774.24,0,1030783.35,DR,INT-51039,CBA,Current
04-09-2025 02:30,CBA78DE7A95AF1B49558F17,063-000-002,33333333,BWS CBA,52.52,0,1030730.83,DR,REF996696,CBA,Current
04-09-2025 02:44,CBA7DA6112D8FEB438C9172,063-000-002,33333333,KFC CBA,3.57,0,1030727.26,DR,REF950088,CBA,Current
04-09-2025 02:55,CBA098F1A15DD02430B8BAC,063-000-002,33333333,AMAZON AU CBA,247.46,0,1030479.8,DR,REF980937,CBA,Current
04-09-2025 03:02,CBA11691CBD6F6242C0B770,063-000-002,33333333,BANK FEE CBA,55.05,0,1030424.75,DR,REF164128,CBA,Current
04-09-2025 04:08,CBAD1BB148A48A149AF8644,063-000-002,33333333,UBER EATS CBA,34.02,0,1030390.73,DR,REF573398,CBA,Current
04-09-2025 04:20,CBA8DB32C57C0A54FA9A445,063-000-002,33333333,7-ELEVEN CBA,92.47,0,1030298.26,DR,REF765047,CBA,Current
04-09-2025 04:27,CBAD9B9E6D7D34B42F7B969,063-000-002,33333333,7-ELEVEN CBA,141.05,0,1030157.21,DR,REF795003,CBA,Current
04-09-2025 04:38,CBAE48E1CF6278F414B9CB1,063-000-002,33333333,STARBUCKS CBA,61.51,0,1030095.7,DR,REF173486,CBA,Current
04-09-2025 05:42,CBAD2DEC0D8483C4889B649,063-000-002,33333333,PAY - SALARY CBA,0,2656.04,1032751.74,CR,REF327978,CBA,Current
04-09-2025 06:32,CBA3CAA3D9B6CC94ED2BD80,063-000-002,33333333,SHELL CBA,50.15,0,1032701.59,DR,REF270246,CBA,Current
04-09-2025 07:16,CBA273E2D6287544A958E07,063-000-002,33333333,ALDI CBA,2.87,0,1032698.72,DR,REF861534,CBA,Current
04-09-2025 07:25,CBA59158E79D74C438CBD63,063-000-002,33333333,APPLE CBA,24.11,0,1032674.61,DR,REF724522,CBA,Current
04-09-2025 07:26,CBADCDABCA720AC4F1FAE05,063-000-002,33333333,BIGW CBA,30.63,0,1032643.98,DR,REF501112,CBA,Current
04-09-2025 08:14,CBACD7F2E7BC8CC4B6BAED1,063-000-002,33333333,DOMINO'S PIZZA CBA,108.76,0,1032535.22,DR,REF405390,CBA,Current
04-09-2025 08:15,CBAF01879021B7B44CD992E,063-000-002,33333333,UBER EATS CBA,27.52,0,1032507.7,DR,REF331491,CBA,Current
04-09-2025 08:50,CBAB21F92AF6F284E2EB98C,063-000-002,33333333,MENULOG CBA,26.21,0,1032481.49,DR,REF237927,CBA,Current
04-09-2025 08:52,CBA37EFE263207441EFB47B,063-000-002,33333333,MENULOG CBA,99,0,1032382.49,DR,REF900355,CBA,Current
04-09-2025 08:55,CBAE233B152332F4216AB4B,063-000-002,33333333,MCDONALDS CBA,67.78,0,1032314.71,DR,REF314020,CBA,Current
04-09-2025 09:27,CBAA8A18D0479544A969DB7,063-000-002,33333333,CITYLINK CBA,17.56,0,1032297.15,DR,REF211064,CBA,Current
04-09-2025 09:31,CBAE6E8B7C6A71640EE8D5F,063-000-002,33333333,UBER EATS CBA,20.96,0,1032276.19,DR,REF532484,CBA,Current
04-09-2025 09:39,CBA277873321F6B4D949033,063-000-002,33333333,COMPANY PAYROLL CBA,0,3712.29,1035988.48,CR,REF472334,CBA,Current
04-09-2025 09:48,CBA25FD028E544E46739A55,063-000-002,33333333,PAY - SALARY CBA,0,448.3,1036436.78,CR,REF736269,CBA,Current
04-09-2025 10:05,CBACAC8B87D544A4D0AA575,063-000-002,33333333,CITYLINK CBA,18.31,0,1036418.47,DR,REF214835,CBA,Current
04-09-2025 10:13,CBA9F86A4B83E804F90BBF0,063-000-002,33333333,SHELL CBA,20.54,0,1036397.93,DR,REF547260,CBA,Current
04-09-2025 10:26,CBACF39C09630CC454AAEBF,063-000-002,33333333,BP CBA,21.17,0,1036376.76,DR,REF796404,CBA,Current
04-09-2025 10:27,CBA2A93FDAB99BD4B9EB2C0,063-000-002,33333333,SALARY PAYMENT CBA,0,1808.67,1038185.43,CR,REF185452,CBA,Current
04-09-2025 10:44,CBA4B6088827BEA42A0828C,063-000-002,33333333,JB HI-FI CBA,24.07,0,1038161.36,DR,REF551303,CBA,Current
04-09-2025 10:53,CBA977001A3EA3C4D438138,063-000-002,33333333,BANK FEE CBA,54.58,0,1038106.78,DR,REF744840,CBA,Current
04-09-2025 11:10,CBA6868DC4437C3470D85B2,063-000-002,33333333,CITYLINK CBA,110.96,0,1037995.82,DR,REF121642,CBA,Current
04-09-2025 11:25,CBA17E00A18DA374797A2A2,063-000-002,33333333,RAILWAY STATION CBA,6.89,0,1037988.93,DR,REF315353,CBA,Current
04-09-2025 11:42,CBAA1E937EC4A0447FD91FC,063-000-002,33333333,SHELL CBA,95.05,0,1037893.88,DR,REF291410,CBA,Current
04-09-2025 11:55,CBA13C57B8754174A3CA8D8,063-000-002,33333333,KFC CBA,119.61,0,1037774.27,DR,REF488937,CBA,Current
04-09-2025 12:02,CBA3FB8C13851FE41719705,063-000-002,33333333,COLES CBA,17.42,0,1037756.85,DR,REF170964,CBA,Current
04-09-2025 12:04,CBAD79A97AC714047FC9FD5,063-000-002,33333333,SPOTIFY CBA,45.02,0,1037711.83,DR,REF169199,CBA,Current
04-09-2025 12:11,CBA9FDB3EB900E147ECB6CF,063-000-002,33333333,BIGW CBA,34.64,0,1037677.19,DR,REF972904,CBA,Current
04-09-2025 12:14,CBA51C14043FCE04201B1AC,063-000-002,33333333,DOMINO'S PIZZA CBA,12.58,0,1037664.61,DR,REF615000,CBA,Current
04-09-2025 13:36,CBACE75096321624E2889EC,063-000-002,33333333,STARBUCKS CBA,56.47,0,1037608.14,DR,REF430609,CBA,Current
04-09-2025 13:52,CBA2ACB1424033741A383AD,063-000-002,33333333,SHELL CBA,29.67,0,1037578.47,DR,REF600423,CBA,Current
04-09-2025 13:57,CBA79226BD65D504318AD1C,063-000-002,33333333,BANK FEE CBA,25.12,0,1037553.35,DR,REF690858,CBA,Current
04-09-2025 14:14,CBAF7AE9A2F928F41CA8B0F,063-000-002,33333333,PAYPAL *NETFLIX CBA,40.98,0,1037512.37,DR,REF396129,CBA,Current
04-09-2025 14:19,CBABA5BF782EB50412F820A,063-000-002,33333333,KFC CBA,40.65,0,1037471.72,DR,REF835674,CBA,Current
04-09-2025 14:31,CBA113BBC0769C04F9CB369,063-000-002,33333333,UBER EATS CBA,8.3,0,1037463.42,DR,REF548634,CBA,Current
04-09-2025 14:33,INTF3F852B6D74B4C0E9467,063-000-002,33333333,TRANSFER FROM NAB 44444444,0,464.88,1037928.3,CR,INT-19691,CBA,Current
04-09-2025 14:51,CBA32E171F5D3B44FA69E5A,063-000-002,33333333,SALARY PAYMENT CBA,0,671.18,1038599.48,CR,REF900428,CBA,Current
04-09-2025 14:56,CBA875185B7058E412491B3,063-000-002,33333333,ZOOM CBA,20.95,0,1038578.53,DR,REF783034,CBA,Current
04-09-2025 15:02,CBAD9113D59298A4493A827,063-000-002,33333333,RAILWAY STATION CBA,44.92,0,1038533.61,DR,REF857357,CBA,Current
04-09-2025 15:27,CBAA2AF7A35B03E492AB5B9,063-000-002,33333333,COLES CBA,74.32,0,1038459.29,DR,REF458432,CBA,Current
04-09-2025 15:51,CBA716527DF6FF44D4B8115,063-000-002,33333333,FLIXBUS CBA,21.05,0,1038438.24,DR,REF145282,CBA,Current
04-09-2025 16:12,CBA7AC3789467A7417CA798,063-000-002,33333333,JB HI-FI CBA,57.01,0,1038381.23,DR,REF225487,CBA,Current
04-09-2025 18:00,CBAAEA4A6B92CBE42F5B381,063-000-002,33333333,SHELL CBA,37.45,0,1038343.78,DR,REF418355,CBA,Current
04-09-2025 18:18,CBA0DAA22741ABA41E791DA,063-000-002,33333333,FLIXBUS CBA,19.29,0,1038324.49,DR,REF971331,CBA,Current
04-09-2025 18:53,CBABCC548E2614346A0BA4D,063-000-002,33333333,CITYLINK CBA,20.77,0,1038303.72,DR,REF405297,CBA,Current
04-09-2025 19:10,INTD7A815ACA1754A04BB7F,063-000-002,33333333,TRANSFER FROM CBA 22222222,0,1833.33,1040137.05,CR,INT-27795,CBA,Current
04-09-2025 19:11,INTBC1B65F39E8C4BB180CC,063-000-002,33333333,TRANSFER TO NAB 44444444,1549.2,0,1038587.85,DR,INT-77505,CBA,Current
04-09-2025 19:24,CBA74678B2BFE3548808DB9,063-000-002,33333333,FLIXBUS CBA,38.83,0,1038549.02,DR,REF537985,CBA,Current
04-09-2025 19:28,CBAFAE4B0A2AF4C4CCD9E2E,063-000-002,33333333,DOMINO'S PIZZA CBA,7.35,0,1038541.67,DR,REF610839,CBA,Current
04-09-2025 19:29,CBAD357AAE3CA7F45E7B849,063-000-002,33333333,PAYROLL CREDIT CBA,0,3739.11,1042280.78,CR,REF289963,CBA,Current
04-09-2025 19:56,CBAF6D2B4784495450882E0,063-000-002,33333333,STARBUCKS CBA,44.2,0,1042236.58,DR,REF862011,CBA,Current
04-09-2025 20:16,CBA0AD212C5ED31443B8E10,063-000-002,33333333,7-ELEVEN CBA,60.9,0,1042175.68,DR,REF970135,CBA,Current
04-09-2025 20:25,CBABF51A6A85FA84EA7833B,063-000-002,33333333,UBER EATS CBA,17.79,0,1042157.89,DR,REF259246,CBA,Current
04-09-2025 21:05,CBA5EB14D45DDEE49889982,063-000-002,33333333,BIGW CBA,32.91,0,1042124.98,DR,REF473351,CBA,Current
04-09-2025 21:20,CBAB49A655FCEBD483AB0BB,063-000-002,33333333,APPLE CBA,35.2,0,1042089.78,DR,REF800087,CBA,Current
04-09-2025 21:45,CBA55875E2FBFA649FFA5EC,063-000-002,33333333,PAYMENT GATEWAY CBA,118.34,0,1041971.44,DR,REF842678,CBA,Current
04-09-2025 22:32,INT00A7B40507DF4DAF88BF,063-000-002,33333333,TRANSFER FROM ANZ 11111111,0,1101.36,1043072.8,CR,INT-48011,CBA,Current
04-09-2025 22:55,CBA60E23C6212AF4FE2ABFC,063-000-002,33333333,UBER EATS CBA,7.51,0,1043065.29,DR,REF582315,CBA,Current
04-09-2025 23:05,CBA93380E7B66664665A38F,063-000-002,33333333,KFC CBA,29.86,0,1043035.43,DR,REF317841,CBA,Current
05-09-2025 00:15,CBA8CD9C86014B2437E9BBC,063-000-002,33333333,PAYMENT GATEWAY CBA,68.08,0,1042967.35,DR,REF523540,CBA,Current
05-09-2025 01:13,CBA386693CC454B4074A296,063-000-002,33333333,HARVEY NORMAN CBA,87.67,0,1042879.68,DR,REF340715,CBA,Current
05-09-2025 01:22,CBA6C30B3E2E09C47D2B740,063-000-002,33333333,MCDONALDS CBA,31.84,0,1042847.84,DR,REF197943,CBA,Current
05-09-2025 01:54,CBACE496F6B219847A9A5D8,063-000-002,33333333,COLES CBA,24.61,0,1042823.23,DR,REF910360,CBA,Current
05-09-2025 01:56,CBA187CCCDD5092442BA5EE,063-000-002,33333333,KFC CBA,72.81,0,1042750.42,DR,REF491576,CBA,Current
05-09-2025 02:24,CBA5CD9A18CBBB749D19985,063-000-002,33333333,AMAZON AU CBA,29.75,0,1042720.67,DR,REF460359,CBA,Current
05-09-2025 02:39,CBA1723D41C5D444344B609,063-000-002,33333333,KFC CBA,50.07,0,1042670.6,DR,REF370022,CBA,Current
05-09-2025 02:53,CBA56AC0FCFBF4A45D2A152,063-000-002,33333333,SPOTIFY CBA,93.85,0,1042576.75,DR,REF833786,CBA,Current
05-09-2025 03:13,CBA49F62822F027438CA0B7,063-000-002,33333333,BP CBA,21.8,0,1042554.95,DR,REF726592,CBA,Current
05-09-2025 03:17,CBAECD889C3898B45EA9823,063-000-002,33333333,BP CBA,54.34,0,1042500.61,DR,REF456993,CBA,Current
05-09-2025 03:37,CBA9D606653FEF64662B027,063-000-002,33333333,ZOOM CBA,19.48,0,1042481.13,DR,REF618805,CBA,Current
05-09-2025 03:55,CBA3A6AF129A5C54BDDB77D,063-000-002,33333333,SALARY PAYMENT CBA,0,2505.85,1044986.98,CR,REF917563,CBA,Current
05-09-2025 04:14,CBAED0FC2A891394718B11B,063-000-002,33333333,WOOLWORTHS CBA,33.72,0,1044953.26,DR,REF778911,CBA,Current
05-09-2025 04:16,CBA37BFB99F7A8341ECAC97,063-000-002,33333333,MCDONALDS CBA,54.71,0,1044898.55,DR,REF819497,CBA,Current
05-09-2025 04:42,CBA01D46840FEEE433F8A67,063-000-002,33333333,SPOTIFY CBA,14.15,0,1044884.4,DR,REF665873,CBA,Current
05-09-2025 04:58,CBABD8C33FF3ECF44F5BA90,063-000-002,33333333,JB HI-FI CBA,35.43,0,1044848.97,DR,REF905820,CBA,Current
05-09-2025 05:02,CBA81CB63833D674F129E9D,063-000-002,33333333,SPOTIFY CBA,62.36,0,1044786.61,DR,REF572959,CBA,Current
05-09-2025 05:39,CBA1C11B3D6A2A44FF9B823,063-000-002,33333333,INTERNET TRANSFER CBA,21.44,0,1044765.17,DR,REF302489,CBA,Current
05-09-2025 05:52,INTB742DD28AC944092B861,063-000-002,33333333,TRANSFER FROM ANZ 11111111,0,963.59,1045728.76,CR,INT-50879,CBA,Current
05-09-2025 05:57,CBA33C690D2DA2647EBA126,063-000-002,33333333,CITYLINK CBA,38.62,0,1045690.14,DR,REF986466,CBA,Current
05-09-2025 06:02,CBADA386C0754F6448F8038,063-000-002,33333333,SHELL CBA,50.96,0,1045639.18,DR,REF571640,CBA,Current
05-09-2025 06:08,CBA55D0BAC88E9A439A8A7D,063-000-002,33333333,INTERNET TRANSFER CBA,11.26,0,1045627.92,DR,REF799989,CBA,Current
05-09-2025 06:55,CBA2CBB662A6A0A4717932C,063-000-002,33333333,SALARY PAYMENT CBA,0,3820.35,1049448.27,CR,REF476369,CBA,Current
05-09-2025 07:02,CBAAEF5FB8922F44B88AE76,063-000-002,33333333,CITYLINK CBA,18.89,0,1049429.38,DR,REF322234,CBA,Current
05-09-2025 07:38,CBAED4E33D5FFA24BBDB935,063-000-002,33333333,BP CBA,25.36,0,1049404.02,DR,REF380409,CBA,Current
05-09-2025 08:04,CBA37ADA44F38B34723882F,063-000-002,33333333,BIGW CBA,7.9,0,1049396.12,DR,REF182134,CBA,Current
05-09-2025 08:12,CBA22F756378D584C59BF29,063-000-002,33333333,CITYLINK CBA,34.47,0,1049361.65,DR,REF682653,CBA,Current
05-09-2025 08:45,CBA5F1598EE444E45858F2B,063-000-002,33333333,JB HI-FI CBA,134.45,0,1049227.2,DR,REF953708,CBA,Current
05-09-2025 09:29,INT3EFA6055D95C4C1982C4,063-000-002,33333333,TRANSFER TO ANZ 11111111,1500.49,0,1047726.71,DR,INT-58768,CBA,Current
05-09-2025 09:42,CBA7F3A60CF61754B859115,063-000-002,33333333,STARBUCKS CBA,26.29,0,1047700.42,DR,REF584331,CBA,Current
05-09-2025 09:43,CBA205C480D3C034F36A9C8,063-000-002,33333333,UBER EATS CBA,19.66,0,1047680.76,DR,REF503539,CBA,Current
05-09-2025 10:11,INTF8C500D191DD4D97A9B8,063-000-002,33333333,TRANSFER TO NAB 44444444,651.53,0,1047029.23,DR,INT-58648,CBA,Current
05-09-2025 10:12,CBAC6A71EFC7F264EF0BF7F,063-000-002,33333333,HARVEY NORMAN CBA,69.18,0,1046960.05,DR,REF953889,CBA,Current
05-09-2025 10:40,CBAFF7E581C653142439C2F,063-000-002,33333333,JB HI-FI CBA,39.36,0,1046920.69,DR,REF958635,CBA,Current
05-09-2025 10:47,CBA46AAA5FE0D91403196A3,063-000-002,33333333,KFC CBA,177.46,0,1046743.23,DR,REF205658,CBA,Current
05-09-2025 11:44,CBAA054155D5DD748D9992F,063-000-002,33333333,MCDONALDS CBA,143.28,0,1046599.95,DR,REF240417,CBA,Current
05-09-2025 11:55,INT738D15CCDF1948FD953D,063-000-002,33333333,TRANSFER TO ANZ 11111111,498.65,0,1046101.3,DR,INT-10472,CBA,Current
05-09-2025 11:59,CBA8B3E835183B44BDD8DDD,063-000-002,33333333,RAILWAY STATION CBA,29.5,0,1046071.8,DR,REF555007,CBA,Current
05-09-2025 12:23,CBAE295DDA588A541C286AA,063-000-002,33333333,COLES CBA,27.79,0,1046044.01,DR,REF822515,CBA,Current
05-09-2025 12:24,CBAF636E238EB444795A141,063-000-002,33333333,KFC CBA,98,0,1045946.01,DR,REF958908,CBA,Current
05-09-2025 12:37,CBAA23730831AC14E26B4E8,063-000-002,33333333,BANK FEE CBA,14.99,0,1045931.02,DR,REF968725,CBA,Current
05-09-2025 12:59,CBA6FE5E3682F174D279BAF,063-000-002,33333333,UBER EATS CBA,71.39,0,1045859.63,DR,REF911895,CBA,Current
05-09-2025 12:59,CBA94AB9486F4644AA382AA,063-000-002,33333333,PAYMENT GATEWAY CBA,101.66,0,1045757.97,DR,REF231783,CBA,Current
05-09-2025 13:32,CBA2A11255CC08C491289B4,063-000-002,33333333,WOOLWORTHS CBA,41.98,0,1045715.99,DR,REF182356,CBA,Current
05-09-2025 13:36,CBA012DDABED3104E3EB327,063-000-002,33333333,BP CBA,216.98,0,1045499.01,DR,REF985330,CBA,Current
05-09-2025 13:39,CBAFD50BEDF81F44010BB33,063-000-002,33333333,PAYPAL *NETFLIX CBA,8.97,0,1045490.04,DR,REF297826,CBA,Current
05-09-2025 13:52,CBACB3D9D0896AA42BB86A7,063-000-002,33333333,HARVEY NORMAN CBA,11.37,0,1045478.67,DR,REF821898,CBA,Current
05-09-2025 14:15,CBAFD4CC114BC884D6EAFB0,063-000-002,33333333,INTERNET TRANSFER CBA,113.97,0,1045364.7,DR,REF175184,CBA,Current
05-09-2025 14:16,CBA90DF37AE930F4D86A6D0,063-000-002,33333333,ALDI CBA,9.24,0,1045355.46,DR,REF520149,CBA,Current
05-09-2025 14:44,CBAD06765C08B904F8D9A43,063-000-002,33333333,BANK FEE CBA,130.01,0,1045225.45,DR,REF895712,CBA,Current
05-09-2025 14:46,CBA11C87383380D46C684C2,063-000-002,33333333,SALARY PAYMENT CBA,0,4754.74,1049980.19,CR,REF186918,CBA,Current
05-09-2025 15:06,INT629A8E7A73964426BEE4,063-000-002,33333333,TRANSFER FROM NAB 44444444,0,1649.7,1051629.89,CR,INT-64114,CBA,Current
05-09-2025 15:49,CBA8DDD353B8F9740D6BFAC,063-000-002,33333333,COLES CBA,31.44,0,1051598.45,DR,REF877113,CBA,Current
05-09-2025 15:55,CBAAD990EEB59044B1288E3,063-000-002,33333333,JB HI-FI CBA,205.62,0,1051392.83,DR,REF275343,CBA,Current
05-09-2025 16:26,CBA178CE7F2D6D94DB3B1AE,063-000-002,33333333,BWS CBA,10.62,0,1051382.21,DR,REF152175,CBA,Current
05-09-2025 16:33,CBAABC0E5F1FC8B411BA1C5,063-000-002,33333333,HARVEY NORMAN CBA,14.52,0,1051367.69,DR,REF938479,CBA,Current
05-09-2025 16:37,CBA3D6C135DB90A4131A02A,063-000-002,33333333,LIQUORLAND CBA,16.55,0,1051351.14,DR,REF223214,CBA,Current
05-09-2025 17:19,INTB9980BA97BA948DC8AC3,063-000-002,33333333,TRANSFER TO NAB 44444444,313.89,0,1051037.25,DR,INT-15011,CBA,Current
05-09-2025 17:23,CBA4F69D4927CA247118F74,063-000-002,33333333,FLIXBUS CBA,8.43,0,1051028.82,DR,REF349278,CBA,Current
05-09-2025 17:42,CBA19E817C013614A558B73,063-000-002,33333333,BIGW CBA,100.75,0,1050928.07,DR,REF124600,CBA,Current
05-09-2025 18:01,CBAE5DC28598CC14286AC74,063-000-002,33333333,HARVEY NORMAN CBA,202.99,0,1050725.08,DR,REF972447,CBA,Current
05-09-2025 18:03,CBA4E7CB66EEF8848A580C2,063-000-002,33333333,HARVEY NORMAN CBA,10.64,0,1050714.44,DR,REF327682,CBA,Current
05-09-2025 18:18,CBAAFB8A8E9B0E24B1ABCC5,063-000-002,33333333,CITYLINK CBA,48.95,0,1050665.49,DR,REF493764,CBA,Current
05-09-2025 18:27,CBADAA01F72FF3147309F85,063-000-002,33333333,BANK FEE CBA,23.26,0,1050642.23,DR,REF278577,CBA,Current
05-09-2025 18:52,CBA7D2983B246834614AE0D,063-000-002,33333333,KFC CBA,23.36,0,1050618.87,DR,REF195756,CBA,Current
05-09-2025 19:09,CBAC295599A6B4A48199DFF,063-000-002,33333333,BWS CBA,29.71,0,1050589.16,DR,REF949748,CBA,Current
05-09-2025 19:22,CBA5B390D7344AA47A786A1,063-000-002,33333333,HARVEY NORMAN CBA,19.14,0,1050570.02,DR,REF107378,CBA,Current
05-09-2025 19:47,CBA3F57AB05111A43A58C5A,063-000-002,33333333,SPOTIFY CBA,216.18,0,1050353.84,DR,REF758335,CBA,Current
05-09-2025 20:54,CBA7A955B5438C64758A5B7,063-000-002,33333333,PAY - SALARY CBA,0,6273.99,1056627.83,CR,REF393790,CBA,Current
05-09-2025 21:37,CBA286AA99716EA4B85B0C5,063-000-002,33333333,APPLE CBA,62.2,0,1056565.63,DR,REF697914,CBA,Current
05-09-2025 21:38,CBADE88EB7584B1493EACE5,063-000-002,33333333,HARVEY NORMAN CBA,81.28,0,1056484.35,DR,REF903615,CBA,Current
05-09-2025 21:46,CBA0C259A40136B4059B9A0,063-000-002,33333333,JB HI-FI CBA,172.01,0,1056312.34,DR,REF740924,CBA,Current
05-09-2025 21:56,CBA1367E6E99FAE4132BE8A,063-000-002,33333333,PAYROLL CREDIT CBA,0,6457.33,1062769.67,CR,REF413468,CBA,Current
05-09-2025 22:04,CBA1E76A3FCE0AF4DCC8F9C,063-000-002,33333333,PAYPAL *NETFLIX CBA,130.63,0,1062639.04,DR,REF498838,CBA,Current
05-09-2025 22:37,CBACE514D0B4BA6447A88AA,063-000-002,33333333,DOMINO'S PIZZA CBA,21.7,0,1062617.34,DR,REF859373,CBA,Current
05-09-2025 23:59,CBA05CF122CCCF14AFD8570,063-000-002,33333333,BWS CBA,9.9,0,1062607.44,DR,REF227423,CBA,Current
05-09-2025 23:59,CBAD9C88C489D8D4B1D9818,063-000-002,33333333,WOOLWORTHS CBA,231.99,0,1062375.45,DR,REF164432,CBA,Current
06-09-2025 00:06,CBA8C010968928C4CBF9303,063-000-002,33333333,BP CBA,23.18,0,1062352.27,DR,REF759820,CBA,Current
06-09-2025 00:53,CBA363724ED47DF486BBD75,063-000-002,33333333,TAFE BOOKSHOP CBA,2.29,0,1062349.98,DR,REF549965,CBA,Current
06-09-2025 01:07,CBA0DCEBFFE24C44070A90C,063-000-002,33333333,DOMINO'S PIZZA CBA,120.1,0,1062229.88,DR,REF490045,CBA,Current
06-09-2025 01:22,CBA95308E116F0B401CAFA4,063-000-002,33333333,APPLE CBA,11.34,0,1062218.54,DR,REF566408,CBA,Current
06-09-2025 01:42,CBA95F2E50456CC4BEDA82F,063-000-002,33333333,TAFE BOOKSHOP CBA,51.28,0,1062167.26,DR,REF744296,CBA,Current
06-09-2025 01:52,INT66FF8F02DDA44928993A,063-000-002,33333333,TRANSFER FROM ANZ 11111111,0,384.55,1062551.81,CR,INT-94651,CBA,Current
06-09-2025 01:59,CBAF65B6167BC31441E801B,063-000-002,33333333,PAYPAL *NETFLIX CBA,35.76,0,1062516.05,DR,REF341883,CBA,Current
06-09-2025 02:06,CBAECCC7AB81FA040D68CD6,063-000-002,33333333,ALDI CBA,120.48,0,1062395.57,DR,REF994342,CBA,Current
06-09-2025 02:10,CBAC9323F71D6314746ABF0,063-000-002,33333333,SALARY PAYMENT CBA,0,471.06,1062866.63,CR,REF938842,CBA,Current
06-09-2025 02:44,CBA225394E7EB694F02B981,063-000-002,33333333,COMPANY PAYROLL CBA,0,4977.92,1067844.55,CR,REF681366,CBA,Current
06-09-2025 02:58,CBA8C0D1138707C4ADA9504,063-000-002,33333333,PAYPAL *NETFLIX CBA,56.6,0,1067787.95,DR,REF592641,CBA,Current
06-09-2025 03:47,CBA80455E71D4D94F249AD4,063-000-002,33333333,COMPANY PAYROLL CBA,0,831.29,1068619.24,CR,REF217309,CBA,Current
06-09-2025 04:09,CBABDEC4DF7C0544BAD9F41,063-000-002,33333333,JB HI-FI CBA,54.88,0,1068564.36,DR,REF845314,CBA,Current
06-09-2025 04:15,CBA6B4E6BF9BFB54E2D82B8,063-000-002,33333333,MENULOG CBA,13.4,0,1068550.96,DR,REF968093,CBA,Current
06-09-2025 04:34,CBA1C0D73CCDDE04B2E9D30,063-000-002,33333333,HARVEY NORMAN CBA,18.94,0,1068532.02,DR,REF460369,CBA,Current
06-09-2025 04:42,CBA3F5DF1123D6A41C39DB3,063-000-002,33333333,AMAZON AU CBA,12.09,0,1068519.93,DR,REF320362,CBA,Current
06-09-2025 04:55,CBA805AD52015444237B1A7,063-000-002,33333333,PAYROLL CREDIT CBA,0,2580.16,1071100.09,CR,REF486572,CBA,Current
06-09-2025 04:58,CBAD9B3782257E14DE8A1CA,063-000-002,33333333,SHELL CBA,30.59,0,1071069.5,DR,REF460864,CBA,Current
06-09-2025 05:28,CBA9309FB8CC6D049D39A0F,063-000-002,33333333,RAILWAY STATION CBA,11.2,0,1071058.3,DR,REF556301,CBA,Current
06-09-2025 05:37,CBAC18FD27CBF104AAFB00C,063-000-002,33333333,JB HI-FI CBA,10.4,0,1071047.9,DR,REF418154,CBA,Current
06-09-2025 05:37,CBA8DE7800B564F42FC987C,063-000-002,33333333,BANK FEE CBA,8.03,0,1071039.87,DR,REF685099,CBA,Current
06-09-2025 05:42,CBA6E72ACC894FE452B87E2,063-000-002,33333333,CITYLINK CBA,52.6,0,1070987.27,DR,REF478346,CBA,Current
06-09-2025 06:08,CBA895551766FD3444A8958,063-000-002,33333333,PAYMENT GATEWAY CBA,12.45,0,1070974.82,DR,REF122390,CBA,Current
06-09-2025 06:29,CBAEAEF6680CD974FA7A3F8,063-000-002,33333333,COLES CBA,49.86,0,1070924.96,DR,REF305613,CBA,Current
06-09-2025 07:00,CBA879BD1FBDB7D41F08112,063-000-002,33333333,HARVEY NORMAN CBA,44.45,0,1070880.51,DR,REF492619,CBA,Current
06-09-2025 07:24,CBA6B70EB919EA348059F47,063-000-002,33333333,CITYLINK CBA,93.97,0,1070786.54,DR,REF952201,CBA,Current
06-09-2025 07:40,CBAABB910A983F04EF2AA49,063-000-002,33333333,PAY - SALARY CBA,0,580.55,1071367.09,CR,REF425695,CBA,Current
06-09-2025 08:04,CBA4DA9388224B449838DC7,063-000-002,33333333,ALDI CBA,19.92,0,1071347.17,DR,REF403181,CBA,Current
06-09-2025 08:26,CBA309D52AC87454799818D,063-000-002,33333333,FLIXBUS CBA,54.69,0,1071292.48,DR,REF255860,CBA,Current
06-09-2025 08:51,CBABC59E66701734FCA8C9C,063-000-002,33333333,DOMINO'S PIZZA CBA,108.88,0,1071183.6,DR,REF913799,CBA,Current
06-09-2025 08:52,CBAE0E96B86895E4CB392E2,063-000-002,33333333,ALDI CBA,206.56,0,1070977.04,DR,REF231444,CBA,Current
06-09-2025 09:04,CBA9E9DD429A01D4A12ACFF,063-000-002,33333333,STARBUCKS CBA,118.6,0,1070858.44,DR,REF372988,CBA,Current
06-09-2025 09:04,CBACE6BE958482049C4A020,063-000-002,33333333,MENULOG CBA,51.03,0,1070807.41,DR,REF891683,CBA,Current
06-09-2025 09:33,CBACB99E413E786450ABD4F,063-000-002,33333333,FLIXBUS CBA,2.9,0,1070804.51,DR,REF595175,CBA,Current
06-09-2025 09:36,CBA7C1357ADBA734ADA8E22,063-000-002,33333333,COLES CBA,67.8,0,1070736.71,DR,REF960989,CBA,Current
06-09-2025 09:42,CBAEA7CCC6637584F4589EB,063-000-002,33333333,MENULOG CBA,15.76,0,1070720.95,DR,REF393541,CBA,Current
06-09-2025 09:45,CBAEA2EB98A5A834B5F9747,063-000-002,33333333,MENULOG CBA,107.67,0,1070613.28,DR,REF948073,CBA,Current
06-09-2025 09:47,CBA00D4943EBFF24A86B7C5,063-000-002,33333333,PAYPAL *NETFLIX CBA,16.56,0,1070596.72,DR,REF195415,CBA,Current
06-09-2025 10:19,CBA3C2797DCA5394B61BA92,063-000-002,33333333,PAYPAL *NETFLIX CBA,35.31,0,1070561.41,DR,REF896745,CBA,Current
06-09-2025 10:38,CBA4151CF43D6B942FC88A4,063-000-002,33333333,APPLE CBA,16.21,0,1070545.2,DR,REF992367,CBA,Current
06-09-2025 11:00,CBA6F6C43C6A9E346409CC1,063-000-002,33333333,FLIXBUS CBA,35.33,0,1070509.87,DR,REF436503,CBA,Current
06-09-2025 11:09,CBAFDA50F88E37E474185E2,063-000-002,33333333,UBER EATS CBA,81.21,0,1070428.66,DR,REF666838,CBA,Current
06-09-2025 11:30,CBAA9E4AF19C97D4D36A2B5,063-000-002,33333333,APPLE CBA,32.02,0,1070396.64,DR,REF345308,CBA,Current
06-09-2025 12:08,CBAC4B16AF0EF6A407F857A,063-000-002,33333333,FLIXBUS CBA,1.27,0,1070395.37,DR,REF163754,CBA,Current
06-09-2025 12:58,CBA7681C3A005DE4E38A005,063-000-002,33333333,WOOLWORTHS CBA,72.59,0,1070322.78,DR,REF927410,CBA,Current
06-09-2025 13:13,CBA642C32C03218434D9EF9,063-000-002,33333333,JB HI-FI CBA,4.86,0,1070317.92,DR,REF829050,CBA,Current
06-09-2025 13:22,CBA3A35BA1DFCB746AF97CE,063-000-002,33333333,HARVEY NORMAN CBA,16.18,0,1070301.74,DR,REF607393,CBA,Current
06-09-2025 13:38,CBA5F9E4DCA6F8940A8985E,063-000-002,33333333,UBER EATS CBA,140.86,0,1070160.88,DR,REF930965,CBA,Current
06-09-2025 13:47,CBAA504EE9291514332911B,063-000-002,33333333,TAFE BOOKSHOP CBA,30.17,0,1070130.71,DR,REF191655,CBA,Current
06-09-2025 13:50,CBA7D999CA1BA17480BA25E,063-000-002,33333333,PAY - SALARY CBA,0,530.93,1070661.64,CR,REF495634,CBA,Current
06-09-2025 14:19,CBA110D8E2FBB32498DA7D6,063-000-002,33333333,PAYMENT GATEWAY CBA,23.21,0,1070638.43,DR,REF991585,CBA,Current
06-09-2025 14:29,CBA9D03F1020712453CADC9,063-000-002,33333333,CITYLINK CBA,69.77,0,1070568.66,DR,REF658693,CBA,Current
06-09-2025 14:41,INT1FE43766EDF6465A8FA5,063-000-002,33333333,TRANSFER TO NAB 44444444,964.37,0,1069604.29,DR,INT-21712,CBA,Current
06-09-2025 15:12,CBA8F952DB4E7604A9B9DB1,063-000-002,33333333,WOOLWORTHS CBA,109.07,0,1069495.22,DR,REF695284,CBA,Current
06-09-2025 15:17,CBA5A4D4EF0AE6C4529815C,063-000-002,33333333,APPLE CBA,15.93,0,1069479.29,DR,REF130837,CBA,Current
06-09-2025 15:21,CBA9FBBF068FDA14A53A373,063-000-002,33333333,KFC CBA,7.76,0,1069471.53,DR,REF307833,CBA,Current
06-09-2025 15:32,CBA37D2C000E1C9452BBC68,063-000-002,33333333,WAGES CREDIT CBA,0,6566.03,1076037.56,CR,REF849032,CBA,Current
06-09-2025 15:33,CBA035D09E158FD42EDA947,063-000-002,33333333,SHELL CBA,151.2,0,1075886.36,DR,REF608099,CBA,Current
06-09-2025 15:36,CBAA5E156A096FA41CF9BF9,063-000-002,33333333,BP CBA,50.4,0,1075835.96,DR,REF818140,CBA,Current
06-09-2025 16:07,CBACEE44ACB4229488CBD65,063-000-002,33333333,LIQUORLAND CBA,82.21,0,1075753.75,DR,REF736745,CBA,Current
06-09-2025 16:28,CBA4372AC3AE03E4F50A616,063-000-002,33333333,AMAZON AU CBA,102.85,0,1075650.9,DR,REF742374,CBA,Current
06-09-2025 17:06,CBACB7F756ADDB1463587D9,063-000-002,33333333,SHELL CBA,7.24,0,1075643.66,DR,REF887906,CBA,Current
06-09-2025 17:30,CBA49E69D2529814059AB5E,063-000-002,33333333,LIQUORLAND CBA,38.37,0,1075605.29,DR,REF357178,CBA,Current
06-09-2025 18:41,CBA4768BB53DFFD4ECAB927,063-000-002,33333333,TAFE BOOKSHOP CBA,34.66,0,1075570.63,DR,REF310257,CBA,Current
06-09-2025 18:53,CBAFF0E35030B9F419BB43D,063-000-002,33333333,COMPANY PAYROLL CBA,0,5140.16,1080710.79,CR,REF785555,CBA,Current
06-09-2025 19:08,CBAC9CAD138CCDE489490D3,063-000-002,33333333,AMAZON AU CBA,120.63,0,1080590.16,DR,REF507734,CBA,Current
06-09-2025 19:18,CBA83B7398EEAAB4B78B60D,063-000-002,33333333,RAILWAY STATION CBA,9.21,0,1080580.95,DR,REF448414,CBA,Current
06-09-2025 20:16,CBA0D4873337A86467F804D,063-000-002,33333333,INTERNET TRANSFER CBA,60.06,0,1080520.89,DR,REF114204,CBA,Current
06-09-2025 20:27,CBA4032DFA692D342619508,063-000-002,33333333,INTERNET TRANSFER CBA,51.71,0,1080469.18,DR,REF280466,CBA,Current
06-09-2025 20:47,CBAB28A5F7D7DFB4F0A88C2,063-000-002,33333333,AMAZON AU CBA,182.27,0,1080286.91,DR,REF430534,CBA,Current
06-09-2025 20:55,CBADD2498DB2F7C4F4D851A,063-000-002,33333333,KFC CBA,25.88,0,1080261.03,DR,REF598613,CBA,Current
06-09-2025 21:10,CBA88336605F4EC44DAB564,063-000-002,33333333,INTERNET TRANSFER CBA,107.84,0,1080153.19,DR,REF663904,CBA,Current
06-09-2025 21:15,CBAB1B25CF0368F47DBA9D3,063-000-002,33333333,KFC CBA,6.44,0,1080146.75,DR,REF920176,CBA,Current
06-09-2025 22:03,CBA05DE81A15F70442E8602,063-000-002,33333333,BP CBA,5.65,0,1080141.1,DR,REF479721,CBA,Current
06-09-2025 22:30,CBA017392B8F3504613A000,063-000-002,33333333,ALDI CBA,36.19,0,1080104.91,DR,REF306730,CBA,Current
06-09-2025 22:50,CBA3050FFD18F2345E8A849,063-000-002,33333333,SALARY PAYMENT CBA,0,6806.31,1086911.22,CR,REF282198,CBA,Current
06-09-2025 22:57,CBAD5F0974D44944F189138,063-000-002,33333333,PAYMENT GATEWAY CBA,33.17,0,1086878.05,DR,REF730299,CBA,Current
06-09-2025 23:06,CBA108FC095D48F48BC8524,063-000-002,33333333,UBER EATS CBA,65.27,0,1086812.78,DR,REF695798,CBA,Current
06-09-2025 23:13,CBA61AF4DB41CB94E36BCC1,063-000-002,33333333,APPLE CBA,13.66,0,1086799.12,DR,REF206779,CBA,Current
06-09-2025 23:42,CBA1F32D013B22043DC80CE,063-000-002,33333333,PAYMENT GATEWAY CBA,32.63,0,1086766.49,DR,REF492028,CBA,Current
07-09-2025 00:36,INT13436575599A475084D8,063-000-002,33333333,TRANSFER TO ANZ 11111111,1633.42,0,1085133.07,DR,INT-60836,CBA,Current
07-09-2025 00:37,CBA0E425C9356C14B729DB9,063-000-002,33333333,KFC CBA,47.26,0,1085085.81,DR,REF505269,CBA,Current
07-09-2025 00:44,CBA9CD175AA030645BEAB8B,063-000-002,33333333,ZOOM CBA,4.7,0,1085081.11,DR,REF145947,CBA,Current
07-09-2025 00:57,CBAE32F1B74998B497D9A36,063-000-002,33333333,TAFE BOOKSHOP CBA,24.87,0,1085056.24,DR,REF137719,CBA,Current
07-09-2025 01:15,CBA1BE9ABC4EA804146BBFF,063-000-002,33333333,UBER EATS CBA,7.09,0,1085049.15,DR,REF737084,CBA,Current
07-09-2025 01:39,CBA5E94A9384DBD40FE86FE,063-000-002,33333333,BANK FEE CBA,62.86,0,1084986.29,DR,REF271186,CBA,Current
07-09-2025 01:40,CBA837BAA79AE7044E59CA4,063-000-002,33333333,BANK FEE CBA,46.39,0,1084939.9,DR,REF374554,CBA,Current
07-09-2025 02:06,CBA95CAA5EE78A041CE9291,063-000-002,33333333,BANK FEE CBA,9.86,0,1084930.04,DR,REF435998,CBA,Current
07-09-2025 02:26,CBAB18F1C2E4BAB463A8EB6,063-000-002,33333333,INTERNET TRANSFER CBA,10.33,0,1084919.71,DR,REF341022,CBA,Current
07-09-2025 02:38,CBAF5B0FDA4F4A845F397EE,063-000-002,33333333,DOMINO'S PIZZA CBA,7.32,0,1084912.39,DR,REF407547,CBA,Current
07-09-2025 02:45,CBAF78023271F634DA6A919,063-000-002,33333333,MCDONALDS CBA,23.92,0,1084888.47,DR,REF628252,CBA,Current
07-09-2025 02:50,CBA3A82B8A9E0EE4CC79979,063-000-002,33333333,7-ELEVEN CBA,24.31,0,1084864.16,DR,REF801825,CBA,Current
07-09-2025 03:03,CBA1F76990CCA45404B8E44,063-000-002,33333333,ZOOM CBA,36.72,0,1084827.44,DR,REF145602,CBA,Current
07-09-2025 03:15,CBADEDF87FFC6E042F7BCF3,063-000-002,33333333,MENULOG CBA,66.27,0,1084761.17,DR,REF846391,CBA,Current
07-09-2025 03:25,CBA330F94F54A224AC5A5D9,063-000-002,33333333,ALDI CBA,34.7,0,1084726.47,DR,REF980683,CBA,Current
07-09-2025 03:32,CBAD4CBCE076A274B648039,063-000-002,33333333,PAYMENT GATEWAY CBA,8.95,0,1084717.52,DR,REF250781,CBA,Current
07-09-2025 03:47,INT1267F546F8F04CCB8D58,063-000-002,33333333,TRANSFER FROM ANZ 11111111,0,1550.87,1086268.39,CR,INT-66811,CBA,Current
07-09-2025 04:00,CBA741DE60F61CB472FB81F,063-000-002,33333333,WOOLWORTHS CBA,11.64,0,1086256.75,DR,REF666901,CBA,Current
07-09-2025 04:24,CBA34E58A5F29E74A40BFE9,063-000-002,33333333,UBER EATS CBA,10.05,0,1086246.7,DR,REF869653,CBA,Current
07-09-2025 04:28,CBA10BA7C9BF3A6458DB779,063-000-002,33333333,WAGES CREDIT CBA,0,7201.28,1093447.98,CR,REF434535,CBA,Current
07-09-2025 04:45,CBAA781C8B2A33344F29392,063-000-002,33333333,ZOOM CBA,49.16,0,1093398.82,DR,REF250305,CBA,Current
07-09-2025 05:32,CBAADEA0C6BB73E4B599741,063-000-002,33333333,BANK FEE CBA,144.39,0,1093254.43,DR,REF127033,CBA,Current
07-09-2025 05:58,CBAB15B812BEBDA4A47ABC8,063-000-002,33333333,ZOOM CBA,140.6,0,1093113.83,DR,REF838518,CBA,Current
07-09-2025 06:03,CBA09DE129ECF2A4018847C,063-000-002,33333333,BP CBA,23.91,0,1093089.92,DR,REF346200,CBA,Current
07-09-2025 06:26,CBABF15ABC34E3B44E3A8B0,063-000-002,33333333,BANK FEE CBA,31.35,0,1093058.57,DR,REF324468,CBA,Current
07-09-2025 06:49,CBA1EA603684A264FD99265,063-000-002,33333333,MENULOG CBA,64.76,0,1092993.81,DR,REF784607,CBA,Current
07-09-2025 07:01,CBAA1B8AB9668AA4DE48899,063-000-002,33333333,JB HI-FI CBA,20.85,0,1092972.96,DR,REF436425,CBA,Current
07-09-2025 07:49,CBA6FD8784C9E78401BA623,063-000-002,33333333,BP CBA,119.22,0,1092853.74,DR,REF305561,CBA,Current
07-09-2025 07:56,CBA490AC5C93A364939BDA1,063-000-002,33333333,7-ELEVEN CBA,95.44,0,1092758.3,DR,REF281202,CBA,Current
07-09-2025 08:12,CBA7D7ABF5EF62946BC8816,063-000-002,33333333,ALDI CBA,48.46,0,1092709.84,DR,REF646052,CBA,Current
07-09-2025 09:26,CBAC82E9F8F02FA41B388D6,063-000-002,33333333,PAYMENT GATEWAY CBA,42.78,0,1092667.06,DR,REF181961,CBA,Current
07-09-2025 09:27,CBA771B32DC3A9A4EDFB20E,063-000-002,33333333,RAILWAY STATION CBA,61.59,0,1092605.47,DR,REF394487,CBA,Current
07-09-2025 09:52,INTBE3B9E4EEA944ACFB1DB,063-000-002,33333333,TRANSFER TO NAB 44444444,1712.57,0,1090892.9,DR,INT-69236,CBA,Current
07-09-2025 10:20,CBA762164F80DBA452F8EA2,063-000-002,33333333,FLIXBUS CBA,95.54,0,1090797.36,DR,REF823728,CBA,Current
07-09-2025 10:25,CBA6D2784DCD3644055A060,063-000-002,33333333,ALDI CBA,54.86,0,1090742.5,DR,REF118896,CBA,Current
07-09-2025 10:34,CBA15E7E75BD9A44D2AA6A1,063-000-002,33333333,STARBUCKS CBA,91.87,0,1090650.63,DR,REF438498,CBA,Current
07-09-2025 10:37,CBA3C2B486983ED4F39943A,063-000-002,33333333,BP CBA,37,0,1090613.63,DR,REF756662,CBA,Current
07-09-2025 10:44,CBA436C5FBE688341A49FBE,063-000-002,33333333,TAFE BOOKSHOP CBA,18.27,0,1090595.36,DR,REF802497,CBA,Current
07-09-2025 11:14,CBA148F09FB84134D578D6B,063-000-002,33333333,DOMINO'S PIZZA CBA,17.93,0,1090577.43,DR,REF152556,CBA,Current
07-09-2025 11:50,CBAAB7D66DB86E5470A8FDE,063-000-002,33333333,7-ELEVEN CBA,15.25,0,1090562.18,DR,REF401916,CBA,Current
07-09-2025 11:55,CBA6807E802D7B04158BA95,063-000-002,33333333,BP CBA,44.98,0,1090517.2,DR,REF727446,CBA,Current
07-09-2025 12:25,CBAF26BCB28137B433D967A,063-000-002,33333333,COLES CBA,55.38,0,1090461.82,DR,REF958934,CBA,Current
07-09-2025 12:29,CBA1E5F21D4E5644C3F8F33,063-000-002,33333333,PAYMENT GATEWAY CBA,20.57,0,1090441.25,DR,REF791077,CBA,Current
07-09-2025 12:58,CBACE74E942CB7D4471A1B5,063-000-002,33333333,AMAZON AU CBA,155.97,0,1090285.28,DR,REF254463,CBA,Current
07-09-2025 13:43,CBA57310E8C23CD4E2085AC,063-000-002,33333333,UBER EATS CBA,15.33,0,1090269.95,DR,REF822328,CBA,Current
07-09-2025 13:47,CBA2EC511D798624B878838,063-000-002,33333333,BP CBA,28.08,0,1090241.87,DR,REF153234,CBA,Current
07-09-2025 14:06,CBA6FF2EE2711054EAE9FF2,063-000-002,33333333,BIGW CBA,45.15,0,1090196.72,DR,REF933890,CBA,Current
07-09-2025 14:38,CBA84F053EC64EE4EB690E7,063-000-002,33333333,TAFE BOOKSHOP CBA,91.08,0,1090105.64,DR,REF680778,CBA,Current
07-09-2025 14:51,CBA6914D2A751384400963F,063-000-002,33333333,CITYLINK CBA,136,0,1089969.64,DR,REF453326,CBA,Current
07-09-2025 15:24,CBACCBA799E7E21498C9E09,063-000-002,33333333,7-ELEVEN CBA,87.89,0,1089881.75,DR,REF745649,CBA,Current
07-09-2025 16:18,CBAD551E629F03D4C6195B5,063-000-002,33333333,RAILWAY STATION CBA,16.32,0,1089865.43,DR,REF851965,CBA,Current
07-09-2025 16:48,CBA9211E08F68054302BC37,063-000-002,33333333,UBER EATS CBA,32.58,0,1089832.85,DR,REF334132,CBA,Current
07-09-2025 16:58,CBA12D05EA1D5874C95A15C,063-000-002,33333333,APPLE CBA,41.63,0,1089791.22,DR,REF459383,CBA,Current
07-09-2025 17:20,CBAB240D2ADD8154CA99237,063-000-002,33333333,BP CBA,30.72,0,1089760.5,DR,REF118206,CBA,Current
07-09-2025 17:25,CBA6E481B470CB54F028068,063-000-002,33333333,HARVEY NORMAN CBA,12.7,0,1089747.8,DR,REF278689,CBA,Current
07-09-2025 17:27,CBA17A48FF371F142D58EC2,063-000-002,33333333,COLES CBA,161.77,0,1089586.03,DR,REF917697,CBA,Current
07-09-2025 17:35,CBA4311A948CF334A84BD31,063-000-002,33333333,COLES CBA,24.12,0,1089561.91,DR,REF642367,CBA,Current
07-09-2025 17:59,CBAC39E2C1F15A243439BC8,063-000-002,33333333,7-ELEVEN CBA,3.31,0,1089558.6,DR,REF780418,CBA,Current
07-09-2025 18:09,CBA59A5134A383549C1A7C1,063-000-002,33333333,RAILWAY STATION CBA,7.97,0,1089550.63,DR,REF454632,CBA,Current
07-09-2025 18:16,CBA4EADE36C395F49199B1E,063-000-002,33333333,MCDONALDS CBA,26.6,0,1089524.03,DR,REF644746,CBA,Current
07-09-2025 18:49,INT24B5159A626346FAA4AF,063-000-002,33333333,TRANSFER FROM NAB 44444444,0,1616.65,1091140.68,CR,INT-68347,CBA,Current
07-09-2025 18:56,CBA8B07D645214549AF94A6,063-000-002,33333333,RAILWAY STATION CBA,67.45,0,1091073.23,DR,REF597474,CBA,Current
07-09-2025 19:18,CBAE63B54560E9E4F4D99B0,063-000-002,33333333,WOOLWORTHS CBA,10.36,0,1091062.87,DR,REF429424,CBA,Current
07-09-2025 19:21,CBA434C10D279A34BCFA6A1,063-000-002,33333333,WAGES CREDIT CBA,0,2809.78,1093872.65,CR,REF450895,CBA,Current
07-09-2025 19:34,CBA29FDBE7234D845E89D7F,063-000-002,33333333,7-ELEVEN CBA,66.13,0,1093806.52,DR,REF734734,CBA,Current
07-09-2025 20:09,CBAFEFFA95727684133855F,063-000-002,33333333,TAFE BOOKSHOP CBA,14.64,0,1093791.88,DR,REF165045,CBA,Current
07-09-2025 20:19,CBADC8166239A6A47ACACD0,063-000-002,33333333,BP CBA,13.07,0,1093778.81,DR,REF623033,CBA,Current
07-09-2025 20:29,CBA54A8573D547240329AED,063-000-002,33333333,APPLE CBA,9.58,0,1093769.23,DR,REF150703,CBA,Current
07-09-2025 21:13,CBA77B3BDC7A04F4D70B4DA,063-000-002,33333333,FLIXBUS CBA,37.98,0,1093731.25,DR,REF760142,CBA,Current
07-09-2025 21:26,CBAB726E511E94A4D639F84,063-000-002,33333333,BIGW CBA,165.08,0,1093566.17,DR,REF275200,CBA,Current
07-09-2025 21:39,CBAC18B7D619F56450B9EBD,063-000-002,33333333,FLIXBUS CBA,15.12,0,1093551.05,DR,REF727165,CBA,Current
07-09-2025 21:49,INT6A2EAA1E8DF94D879F65,063-000-002,33333333,TRANSFER TO ANZ 11111111,998.74,0,1092552.31,DR,INT-74665,CBA,Current
07-09-2025 22:33,CBAAA28C7D67AE94896A934,063-000-002,33333333,UBER EATS CBA,17.75,0,1092534.56,DR,REF982807,CBA,Current
07-09-2025 23:25,CBAD03D0B663F7F406CB29A,063-000-002,33333333,AMAZON AU CBA,97.9,0,1092436.66,DR,REF495800,CBA,Current
07-09-2025 23:30,CBA1470A6316C6A48D78BEF,063-000-002,33333333,PAYMENT GATEWAY CBA,58.15,0,1092378.51,DR,REF492987,CBA,Current
08-09-2025 00:17,CBA60B9D5FBE8494DBEB537,063-000-002,33333333,WAGES CREDIT CBA,0,15.76,1092394.27,CR,REF496068,CBA,Current
08-09-2025 00:20,CBAE0548D267D624B459931,063-000-002,33333333,7-ELEVEN CBA,39.82,0,1092354.45,DR,REF890687,CBA,Current
08-09-2025 00:26,INT854966FCAE3C475D80B5,063-000-002,33333333,TRANSFER TO ANZ 11111111,855.51,0,1091498.94,DR,INT-52103,CBA,Current
08-09-2025 00:38,CBA7829C46011E24F6193DF,063-000-002,33333333,ZOOM CBA,13.45,0,1091485.49,DR,REF329667,CBA,Current
08-09-2025 00:47,CBA83363C56005544D3899C,063-000-002,33333333,FLIXBUS CBA,14.58,0,1091470.91,DR,REF919247,CBA,Current
08-09-2025 01:05,CBA4DDA838CC4DF4B26BB87,063-000-002,33333333,DOMINO'S PIZZA CBA,26.59,0,1091444.32,DR,REF163380,CBA,Current
08-09-2025 01:18,CBA672FE02E1DE349A689F1,063-000-002,33333333,COLES CBA,159.11,0,1091285.21,DR,REF923960,CBA,Current
08-09-2025 01:20,CBA4280D1521E114875B8B5,063-000-002,33333333,PAYPAL *NETFLIX CBA,37.31,0,1091247.9,DR,REF887033,CBA,Current
08-09-2025 01:52,CBA6D02F065084049B5AC84,063-000-002,33333333,LIQUORLAND CBA,92,0,1091155.9,DR,REF499572,CBA,Current
08-09-2025 02:34,CBAACA06FC661CD40959807,063-000-002,33333333,DOMINO'S PIZZA CBA,218.23,0,1090937.67,DR,REF870447,CBA,Current
08-09-2025 02:36,CBAB11B673CA6FB48A08BF3,063-000-002,33333333,DOMINO'S PIZZA CBA,9.7,0,1090927.97,DR,REF339246,CBA,Current
08-09-2025 02:54,CBAC6B0C651D4D6480EA1A9,063-000-002,33333333,CITYLINK CBA,10.29,0,1090917.68,DR,REF579795,CBA,Current
08-09-2025 02:59,CBA2E4D8CD06F05490BB946,063-000-002,33333333,BP CBA,14.31,0,1090903.37,DR,REF410174,CBA,Current
08-09-2025 03:16,CBAB6BDBB4B2A4F4B4CB4A7,063-000-002,33333333,CITYLINK CBA,48.69,0,1090854.68,DR,REF895769,CBA,Current
08-09-2025 03:19,CBA91F6426F663049D79308,063-000-002,33333333,PAY - SALARY CBA,0,7980.63,1098835.31,CR,REF879968,CBA,Current
08-09-2025 03:19,CBA869437A0E5004563B219,063-000-002,33333333,SALARY PAYMENT CBA,0,7739.42,1106574.73,CR,REF534811,CBA,Current
08-09-2025 03:31,CBAA5D3588EB9EE4CB2A860,063-000-002,33333333,RAILWAY STATION CBA,86.16,0,1106488.57,DR,REF669862,CBA,Current
08-09-2025 03:33,CBA5548E3331E0146ABA6A7,063-000-002,33333333,HARVEY NORMAN CBA,14.61,0,1106473.96,DR,REF367574,CBA,Current
08-09-2025 03:41,CBA3E0B63A416E6416ABD83,063-000-002,33333333,COLES CBA,59.75,0,1106414.21,DR,REF451128,CBA,Current
08-09-2025 03:53,CBACFA6E5B12D554916A950,063-000-002,33333333,WOOLWORTHS CBA,2.03,0,1106412.18,DR,REF465860,CBA,Current
08-09-2025 04:00,CBADE6F0FBE41E143F581CB,063-000-002,33333333,MENULOG CBA,37.86,0,1106374.32,DR,REF588101,CBA,Current
08-09-2025 04:15,CBAA2C7F748F74544BFB633,063-000-002,33333333,APPLE CBA,22.01,0,1106352.31,DR,REF406220,CBA,Current
08-09-2025 04:26,CBAB1AE50D1408A4506A77E,063-000-002,33333333,HARVEY NORMAN CBA,67.24,0,1106285.07,DR,REF760504,CBA,Current
08-09-2025 04:48,CBA5983332A4017460DAAD3,063-000-002,33333333,SALARY PAYMENT CBA,0,2814.56,1109099.63,CR,REF359658,CBA,Current
08-09-2025 05:21,CBAD59A02F9DF40421BB6B3,063-000-002,33333333,ALDI CBA,64.81,0,1109034.82,DR,REF529167,CBA,Current
08-09-2025 05:32,CBAB84888C8643D47548DB2,063-000-002,33333333,SHELL CBA,41.36,0,1108993.46,DR,REF416229,CBA,Current
08-09-2025 05:42,CBA9387BB90FFC14EB3A5EE,063-000-002,33333333,LIQUORLAND CBA,2.83,0,1108990.63,DR,REF392234,CBA,Current
08-09-2025 06:06,CBA1477B2EC8FF5467BADB2,063-000-002,33333333,PAYMENT GATEWAY CBA,210.87,0,1108779.76,DR,REF824615,CBA,Current
08-09-2025 06:16,CBAB03E8A3CD6AD48F494CE,063-000-002,33333333,BP CBA,38.65,0,1108741.11,DR,REF209675,CBA,Current
08-09-2025 06:17,CBA113A4C9BB1EC436CBB20,063-000-002,33333333,WOOLWORTHS CBA,96.02,0,1108645.09,DR,REF431496,CBA,Current
08-09-2025 06:45,CBABABE648B57224D43B1E8,063-000-002,33333333,DOMINO'S PIZZA CBA,152.24,0,1108492.85,DR,REF785504,CBA,Current
08-09-2025 07:16,CBA9717EB5B9A9E4374AB2A,063-000-002,33333333,STARBUCKS CBA,5.84,0,1108487.01,DR,REF755032,CBA,Current
08-09-2025 07:24,CBAD89DAAFFB55D492E8A87,063-000-002,33333333,APPLE CBA,42.39,0,1108444.62,DR,REF419388,CBA,Current
08-09-2025 07:44,CBAD479A5609D1643B7AD69,063-000-002,33333333,LIQUORLAND CBA,9.6,0,1108435.02,DR,REF178366,CBA,Current
08-09-2025 07:48,CBA4D03502D336543E0AEB7,063-000-002,33333333,RAILWAY STATION CBA,12.28,0,1108422.74,DR,REF626528,CBA,Current
08-09-2025 08:36,CBA8AADDE80FE0E4049869E,063-000-002,33333333,WOOLWORTHS CBA,24.54,0,1108398.2,DR,REF460745,CBA,Current
08-09-2025 08:43,CBAFD9F2080DF834C9A8B09,063-000-002,33333333,TAFE BOOKSHOP CBA,20.04,0,1108378.16,DR,REF785915,CBA,Current
08-09-2025 10:22,CBADC7C2534446746CAAC7A,063-000-002,33333333,BWS CBA,21.88,0,1108356.28,DR,REF834346,CBA,Current
08-09-2025 10:24,INT0556B9373B7A40C68240,063-000-002,33333333,TRANSFER TO ANZ 11111111,305.7,0,1108050.58,DR,INT-96103,CBA,Current
08-09-2025 10:49,CBA36BADAD1DF6E40E4AFB4,063-000-002,33333333,MCDONALDS CBA,5.75,0,1108044.83,DR,REF305941,CBA,Current
08-09-2025 11:02,CBA23B56FEFF2104C7C8CF1,063-000-002,33333333,UBER EATS CBA,28.89,0,1108015.94,DR,REF357973,CBA,Current
08-09-2025 11:02,CBAEA130743A3794BF78562,063-000-002,33333333,INTERNET TRANSFER CBA,56.05,0,1107959.89,DR,REF777069,CBA,Current
08-09-2025 11:42,CBABF216E49974B4F749DDA,063-000-002,33333333,BANK FEE CBA,32.97,0,1107926.92,DR,REF979801,CBA,Current
08-09-2025 11:47,CBA666054D775B34B2BB139,063-000-002,33333333,PAYROLL CREDIT CBA,0,996.6,1108923.52,CR,REF260004,CBA,Current
08-09-2025 12:15,CBA06BAD2321E2F4670ACEF,063-000-002,33333333,LIQUORLAND CBA,67.49,0,1108856.03,DR,REF482649,CBA,Current
08-09-2025 14:03,INT2B81A0DEC34B42CA8D18,063-000-002,33333333,TRANSFER FROM ANZ 11111111,0,305.06,1109161.09,CR,INT-27797,CBA,Current
08-09-2025 14:04,CBA5B906ABDFD9F4A888AE7,063-000-002,33333333,AMAZON AU CBA,59.46,0,1109101.63,DR,REF978137,CBA,Current
08-09-2025 14:04,CBA57FDFB3D60B04A0ABE74,063-000-002,33333333,SALARY PAYMENT CBA,0,117.19,1109218.82,CR,REF300642,CBA,Current
08-09-2025 14:20,INT570D452798474819B902,063-000-002,33333333,TRANSFER TO ANZ 11111111,1094.9,0,1108123.92,DR,INT-90727,CBA,Current
08-09-2025 14:37,CBA85AA14ECC0AA4E609C74,063-000-002,33333333,COLES CBA,12.31,0,1108111.61,DR,REF533604,CBA,Current
08-09-2025 14:41,CBA328244C445D54CD79D6F,063-000-002,33333333,SHELL CBA,14.26,0,1108097.35,DR,REF646292,CBA,Current
08-09-2025 14:50,CBACF7EF9D4E9564CD89AA9,063-000-002,33333333,DOMINO'S PIZZA CBA,45.68,0,1108051.67,DR,REF709366,CBA,Current
08-09-2025 14:56,CBA1FEDFA384CBB468EADF1,063-000-002,33333333,COLES CBA,4.72,0,1108046.95,DR,REF215045,CBA,Current
08-09-2025 15:06,CBA3FDCB35B09BD4A1D815C,063-000-002,33333333,PAY - SALARY CBA,0,980.06,1109027.01,CR,REF569634,CBA,Current
08-09-2025 15:26,CBAA3A9344D30D849AC8950,063-000-002,33333333,RAILWAY STATION CBA,169.51,0,1108857.5,DR,REF865671,CBA,Current
08-09-2025 15:34,CBAC8107B7A5CFB48CC9292,063-000-002,33333333,PAYMENT GATEWAY CBA,114.28,0,1108743.22,DR,REF877597,CBA,Current
08-09-2025 16:03,CBAD9826CFEC4334A6A9727,063-000-002,33333333,SHELL CBA,56.56,0,1108686.66,DR,REF654655,CBA,Current
08-09-2025 16:05,CBA1C9A5097BCE9463CAADE,063-000-002,33333333,BWS CBA,20.72,0,1108665.94,DR,REF872102,CBA,Current
08-09-2025 16:06,CBA31892F6E43A642A28A2A,063-000-002,33333333,BANK FEE CBA,37.66,0,1108628.28,DR,REF664601,CBA,Current
08-09-2025 16:23,CBA277DF11810BD4A149EE7,063-000-002,33333333,CITYLINK CBA,15.04,0,1108613.24,DR,REF956539,CBA,Current
08-09-2025 16:29,CBA0CE382264F4E4144B57C,063-000-002,33333333,UBER EATS CBA,113.83,0,1108499.41,DR,REF244542,CBA,Current
08-09-2025 16:57,CBA41A1E22249924B5C868F,063-000-002,33333333,PAYPAL *NETFLIX CBA,80.44,0,1108418.97,DR,REF830191,CBA,Current
08-09-2025 17:02,CBA04E789AD63A34F09B294,063-000-002,33333333,BANK FEE CBA,53.71,0,1108365.26,DR,REF980114,CBA,Current
08-09-2025 17:13,CBAF8E9D6D0DAEF427AB7F6,063-000-002,33333333,DOMINO'S PIZZA CBA,48.31,0,1108316.95,DR,REF222776,CBA,Current
08-09-2025 17:16,CBA5BA325D214F7455BB5BF,063-000-002,33333333,SALARY PAYMENT CBA,0,1865.22,1110182.17,CR,REF727513,CBA,Current
08-09-2025 17:47,CBA108F3707F7EB41E3AC0F,063-000-002,33333333,DOMINO'S PIZZA CBA,11.87,0,1110170.3,DR,REF195956,CBA,Current
08-09-2025 18:30,CBA442744CE50AC4B828F90,063-000-002,33333333,PAYPAL *NETFLIX CBA,31.77,0,1110138.53,DR,REF905190,CBA,Current
08-09-2025 18:34,CBA0188076839D444408496,063-000-002,33333333,7-ELEVEN CBA,14.31,0,1110124.22,DR,REF957553,CBA,Current
08-09-2025 19:24,CBAC4A0E84CDBA7421A99C5,063-000-002,33333333,APPLE CBA,22.65,0,1110101.57,DR,REF533673,CBA,Current
08-09-2025 20:01,CBA12F6D30DA29046F78493,063-000-002,33333333,BANK FEE CBA,14.16,0,1110087.41,DR,REF233590,CBA,Current
08-09-2025 20:39,CBAFFBE8D7D34F743139B3E,063-000-002,33333333,LIQUORLAND CBA,47.69,0,1110039.72,DR,REF516336,CBA,Current
08-09-2025 20:44,CBAFEFD632D629F442990FE,063-000-002,33333333,CITYLINK CBA,42.39,0,1109997.33,DR,REF874845,CBA,Current
08-09-2025 20:48,CBA2608DC22CC884E0AADDE,063-000-002,33333333,RAILWAY STATION CBA,32.56,0,1109964.77,DR,REF326016,CBA,Current
08-09-2025 21:31,CBA72B23CBCE36244EA8F28,063-000-002,33333333,JB HI-FI CBA,74.5,0,1109890.27,DR,REF178626,CBA,Current
08-09-2025 21:49,CBAEC0D3665E62C4D38848E,063-000-002,33333333,MENULOG CBA,22.7,0,1109867.57,DR,REF278990,CBA,Current
08-09-2025 22:18,CBA8D03C256B7F240A1A594,063-000-002,33333333,COLES CBA,14.98,0,1109852.59,DR,REF256531,CBA,Current
08-09-2025 22:20,CBAC0C3FCC6F50E4A42A932,063-000-002,33333333,MENULOG CBA,43.24,0,1109809.35,DR,REF752799,CBA,Current
08-09-2025 22:42,CBAEC79A971987C42518042,063-000-002,33333333,TAFE BOOKSHOP CBA,119.09,0,1109690.26,DR,REF681872,CBA,Current
08-09-2025 22:47,CBAFE103AC679A24B998116,063-000-002,33333333,COLES CBA,111.08,0,1109579.18,DR,REF128222,CBA,Current
08-09-2025 23:32,CBA8112EA9BF92A41E6819E,063-000-002,33333333,CITYLINK CBA,35.33,0,1109543.85,DR,REF327774,CBA,Current
08-09-2025 23:34,CBAAB4EE0DD92C84AFEA647,063-000-002,33333333,ZOOM CBA,33.19,0,1109510.66,DR,REF405497,CBA,Current
08-09-2025 23:38,CBADC1016C426384AE59676,063-000-002,33333333,STARBUCKS CBA,77.7,0,1109432.96,DR,REF732746,CBA,Current
08-09-2025 23:39,INT63563C2F39F649968FFD,063-000-002,33333333,TRANSFER FROM NAB 44444444,0,884.51,1110317.47,CR,INT-96665,CBA,Current
09-09-2025 00:39,CBA87852FF6AB0F41B89717,063-000-002,33333333,RAILWAY STATION CBA,24.34,0,1110293.13,DR,REF525227,CBA,Current
09-09-2025 01:06,CBA25ADF37C9CD448E1832D,063-000-002,33333333,APPLE CBA,22.72,0,1110270.41,DR,REF326849,CBA,Current
09-09-2025 01:41,CBAE66E55D1B1C843ABB5CF,063-000-002,33333333,BWS CBA,8.99,0,1110261.42,DR,REF267610,CBA,Current
09-09-2025 01:54,CBA94C3A9EF524B45C4A102,063-000-002,33333333,PAYROLL CREDIT CBA,0,4902.83,1115164.25,CR,REF932514,CBA,Current
09-09-2025 02:34,CBAB834DC28FEBC48ABAD29,063-000-002,33333333,SPOTIFY CBA,34.83,0,1115129.42,DR,REF681652,CBA,Current
09-09-2025 02:44,CBA6E4FCA7EEBFD43AAAA34,063-000-002,33333333,STARBUCKS CBA,78.04,0,1115051.38,DR,REF496935,CBA,Current
09-09-2025 03:00,CBAB3615E0E2F1B4564A0A7,063-000-002,33333333,STARBUCKS CBA,41.22,0,1115010.16,DR,REF776611,CBA,Current
09-09-2025 03:02,CBA4752DF49E0DF46DDAD81,063-000-002,33333333,RAILWAY STATION CBA,30.99,0,1114979.17,DR,REF780742,CBA,Current
09-09-2025 03:45,CBA029F30937F2E49C4B9C7,063-000-002,33333333,CITYLINK CBA,19.52,0,1114959.65,DR,REF349442,CBA,Current
09-09-2025 03:47,CBA76F9041A7E664503ACA6,063-000-002,33333333,CITYLINK CBA,36.22,0,1114923.43,DR,REF200841,CBA,Current
09-09-2025 03:51,CBAE3313031115745BDA1CD,063-000-002,33333333,FLIXBUS CBA,92.89,0,1114830.54,DR,REF360038,CBA,Current
09-09-2025 04:13,CBA49BFABE91AB2435B88B9,063-000-002,33333333,LIQUORLAND CBA,48.89,0,1114781.65,DR,REF177341,CBA,Current
09-09-2025 04:17,CBA1F62A68CF97C4564913D,063-000-002,33333333,HARVEY NORMAN CBA,37.51,0,1114744.14,DR,REF176837,CBA,Current
09-09-2025 04:24,CBA247F357BA82248F2B74B,063-000-002,33333333,WOOLWORTHS CBA,80.65,0,1114663.49,DR,REF231244,CBA,Current
09-09-2025 04:35,CBA7F7A82FF6B1D4436A8CB,063-000-002,33333333,DOMINO'S PIZZA CBA,10.31,0,1114653.18,DR,REF543751,CBA,Current
09-09-2025 05:01,CBAA4152AFF15F34A49BA4C,063-000-002,33333333,RAILWAY STATION CBA,20.09,0,1114633.09,DR,REF280519,CBA,Current
09-09-2025 05:16,CBACF0B3C54CD5F4174B36D,063-000-002,33333333,PAYPAL *NETFLIX CBA,120.66,0,1114512.43,DR,REF808339,CBA,Current
09-09-2025 05:17,CBAD0C3472A52734BE48756,063-000-002,33333333,SHELL CBA,54.18,0,1114458.25,DR,REF474035,CBA,Current
09-09-2025 05:34,CBAEDE790CD43664B71988E,063-000-002,33333333,7-ELEVEN CBA,75.84,0,1114382.41,DR,REF208094,CBA,Current
09-09-2025 05:56,CBAA58C8C6A61354AD6AE76,063-000-002,33333333,ZOOM CBA,72.12,0,1114310.29,DR,REF385125,CBA,Current
09-09-2025 06:45,CBAB51A4CBCE3204356B4FD,063-000-002,33333333,HARVEY NORMAN CBA,7.55,0,1114302.74,DR,REF598922,CBA,Current
09-09-2025 06:46,CBA0E4A1A48F2AC45CF9D54,063-000-002,33333333,BANK FEE CBA,2.3,0,1114300.44,DR,REF428238,CBA,Current
09-09-2025 07:01,CBA1999B9B1493847E18EC5,063-000-002,33333333,CITYLINK CBA,119.03,0,1114181.41,DR,REF483373,CBA,Current
09-09-2025 07:35,CBAB13094411986443896CA,063-000-002,33333333,COMPANY PAYROLL CBA,0,2518.62,1116700.03,CR,REF171688,CBA,Current
09-09-2025 07:52,CBA1F8A6B22045F44DB906F,063-000-002,33333333,BP CBA,6.9,0,1116693.13,DR,REF711353,CBA,Current
09-09-2025 07:55,CBAFD446557B55244B395BD,063-000-002,33333333,ZOOM CBA,19.55,0,1116673.58,DR,REF505158,CBA,Current
09-09-2025 08:43,CBA3EF50378CB644EA3B222,063-000-002,33333333,ALDI CBA,91.53,0,1116582.05,DR,REF648627,CBA,Current
09-09-2025 08:43,CBA8016C5EAA6A341FB81C8,063-000-002,33333333,MENULOG CBA,86.72,0,1116495.33,DR,REF325073,CBA,Current
09-09-2025 08:49,CBAB4E41E21E726422B8D73,063-000-002,33333333,SALARY PAYMENT CBA,0,1053.94,1117549.27,CR,REF611586,CBA,Current
09-09-2025 08:52,CBAA166B7FA9DC24924B6B3,063-000-002,33333333,ZOOM CBA,31.47,0,1117517.8,DR,REF232728,CBA,Current
09-09-2025 08:58,CBA99846D40506C4DED9260,063-000-002,33333333,BWS CBA,58.11,0,1117459.69,DR,REF447321,CBA,Current
09-09-2025 09:45,CBAD34A98712D5D45FCA9F0,063-000-002,33333333,ALDI CBA,23.73,0,1117435.96,DR,REF395119,CBA,Current
09-09-2025 09:59,CBAB5F9A02D379F4A51B45F,063-000-002,33333333,PAYMENT GATEWAY CBA,27.85,0,1117408.11,DR,REF240924,CBA,Current
09-09-2025 10:09,CBA975963E4711849FB994E,063-000-002,33333333,TAFE BOOKSHOP CBA,27.06,0,1117381.05,DR,REF656805,CBA,Current
09-09-2025 10:14,CBA023EAE858B4E4CBB8FE0,063-000-002,33333333,APPLE CBA,19.86,0,1117361.19,DR,REF849331,CBA,Current
09-09-2025 11:04,CBAC5864D537061437096BA,063-000-002,33333333,DOMINO'S PIZZA CBA,11.47,0,1117349.72,DR,REF953916,CBA,Current
09-09-2025 11:10,CBAED8DB9A73B5047E288FB,063-000-002,33333333,UBER EATS CBA,23.96,0,1117325.76,DR,REF858795,CBA,Current
09-09-2025 11:28,CBADEEFBCB49E3143CAA276,063-000-002,33333333,KFC CBA,18.98,0,1117306.78,DR,REF333464,CBA,Current
09-09-2025 11:44,CBA7B16FE41557F4C609642,063-000-002,33333333,UBER EATS CBA,5.68,0,1117301.1,DR,REF176902,CBA,Current
09-09-2025 12:52,CBAE01F532D428643A1A9C2,063-000-002,33333333,DOMINO'S PIZZA CBA,5.36,0,1117295.74,DR,REF215459,CBA,Current
09-09-2025 12:52,CBAF811A2BEA1BE405F943D,063-000-002,33333333,RAILWAY STATION CBA,23.86,0,1117271.88,DR,REF425998,CBA,Current
09-09-2025 13:19,CBAE4EBDD5F6DDA4749939F,063-000-002,33333333,PAYPAL *NETFLIX CBA,42.05,0,1117229.83,DR,REF168364,CBA,Current
09-09-2025 13:43,CBA87326B32FA494072A23E,063-000-002,33333333,SHELL CBA,13.73,0,1117216.1,DR,REF121076,CBA,Current
09-09-2025 13:52,CBAE4FAA538F39A4C2EB84C,063-000-002,33333333,PAY - SALARY CBA,0,2012.89,1119228.99,CR,REF473530,CBA,Current
09-09-2025 14:12,CBA557D4E5E083B4E478B38,063-000-002,33333333,ALDI CBA,110.01,0,1119118.98,DR,REF255863,CBA,Current
09-09-2025 15:01,CBA21D8BB22FAC549E88042,063-000-002,33333333,JB HI-FI CBA,14.78,0,1119104.2,DR,REF544631,CBA,Current
09-09-2025 15:09,CBA7329836ECC7D4C4295C9,063-000-002,33333333,COMPANY PAYROLL CBA,0,4805.88,1123910.08,CR,REF206245,CBA,Current
09-09-2025 15:10,CBAECADF07E756B4396BDF5,063-000-002,33333333,KFC CBA,51.76,0,1123858.32,DR,REF875425,CBA,Current
09-09-2025 15:25,CBA70B26A6E9A6A4942A303,063-000-002,33333333,AMAZON AU CBA,15.02,0,1123843.3,DR,REF920126,CBA,Current
09-09-2025 15:29,CBA2175F711C2BB4A3283B0,063-000-002,33333333,COMPANY PAYROLL CBA,0,5244.62,1129087.92,CR,REF942997,CBA,Current
09-09-2025 15:40,CBA7DCEAF444143460DBBB0,063-000-002,33333333,HARVEY NORMAN CBA,69.76,0,1129018.16,DR,REF793662,CBA,Current
09-09-2025 17:03,CBA2BB9BF27C5774DA5B353,063-000-002,33333333,BP CBA,92.16,0,1128926,DR,REF531065,CBA,Current
09-09-2025 17:37,CBAADD242C4D004492F8060,063-000-002,33333333,UBER EATS CBA,73.23,0,1128852.77,DR,REF996209,CBA,Current
09-09-2025 18:00,CBAEEF2D664F4C14AEC9D27,063-000-002,33333333,COLES CBA,5.18,0,1128847.59,DR,REF312021,CBA,Current
09-09-2025 18:01,CBA6CDFBF3BF5644A2AA16E,063-000-002,33333333,SHELL CBA,4.82,0,1128842.77,DR,REF641020,CBA,Current
09-09-2025 18:06,CBAF7D84A4996BC40FF907D,063-000-002,33333333,WOOLWORTHS CBA,33.03,0,1128809.74,DR,REF949645,CBA,Current
09-09-2025 18:21,CBAA4256C71EF6F41469C2F,063-000-002,33333333,RAILWAY STATION CBA,73.82,0,1128735.92,DR,REF806987,CBA,Current
09-09-2025 18:34,CBA703A75C499E94BD8A863,063-000-002,33333333,JB HI-FI CBA,47.15,0,1128688.77,DR,REF765088,CBA,Current
09-09-2025 18:36,CBA6CD92AA190284C77BB5B,063-000-002,33333333,KFC CBA,2.14,0,1128686.63,DR,REF758802,CBA,Current
09-09-2025 18:40,CBA1F33FFF48F57492AAE2D,063-000-002,33333333,WAGES CREDIT CBA,0,7889.34,1136575.97,CR,REF416645,CBA,Current
09-09-2025 19:40,CBA6FADD967C25244B59EE5,063-000-002,33333333,COMPANY PAYROLL CBA,0,1070.87,1137646.84,CR,REF912246,CBA,Current
09-09-2025 19:48,INT3146E73139AB4574ACB1,063-000-002,33333333,TRANSFER TO CBA 22222222,887.76,0,1136759.08,DR,INT-40627,CBA,Current
09-09-2025 20:48,CBA0370F542E93644618E81,063-000-002,33333333,HARVEY NORMAN CBA,16.28,0,1136742.8,DR,REF373094,CBA,Current
09-09-2025 21:05,CBA25C24B7ED7F1499C9E4B,063-000-002,33333333,PAY - SALARY CBA,0,896.29,1137639.09,CR,REF265222,CBA,Current
09-09-2025 21:19,CBA0526E20ADBE0471A9D77,063-000-002,33333333,RAILWAY STATION CBA,41.74,0,1137597.35,DR,REF196078,CBA,Current
09-09-2025 21:23,CBAFFEE3D53BE77492A9785,063-000-002,33333333,KFC CBA,15.09,0,1137582.26,DR,REF636699,CBA,Current
09-09-2025 21:27,CBA9D8AA09A8B7144D28BDF,063-000-002,33333333,ALDI CBA,17.99,0,1137564.27,DR,REF669433,CBA,Current
09-09-2025 21:35,CBAA6BAD6B1E07C4EC2A530,063-000-002,33333333,7-ELEVEN CBA,18.27,0,1137546,DR,REF792261,CBA,Current
09-09-2025 21:46,CBA3D4D6CD216804D94BB84,063-000-002,33333333,TAFE BOOKSHOP CBA,10.91,0,1137535.09,DR,REF110450,CBA,Current
09-09-2025 22:09,CBA35D53136DDCC469F9498,063-000-002,33333333,ZOOM CBA,36.08,0,1137499.01,DR,REF662285,CBA,Current
09-09-2025 22:54,CBA6B2D4B8B116A40128E67,063-000-002,33333333,INTERNET TRANSFER CBA,20.16,0,1137478.85,DR,REF454358,CBA,Current
09-09-2025 23:00,CBAA9EF5AA006F44F38ADC1,063-000-002,33333333,PAY - SALARY CBA,0,2215.11,1139693.96,CR,REF326451,CBA,Current
09-09-2025 23:31,CBA857E9BC7FBB047EFA428,063-000-002,33333333,SHELL CBA,38.34,0,1139655.62,DR,REF516967,CBA,Current
09-09-2025 23:35,CBA52E8204AAEFF447BA521,063-000-002,33333333,WOOLWORTHS CBA,165.65,0,1139489.97,DR,REF676468,CBA,Current
09-09-2025 23:50,CBAADF14FECF85144A4983F,063-000-002,33333333,PAYMENT GATEWAY CBA,105.01,0,1139384.96,DR,REF462750,CBA,Current
10-09-2025 00:02,CBAAA2F9F40EDC04F8C8685,063-000-002,33333333,PAYMENT GATEWAY CBA,132.47,0,1139252.49,DR,REF948464,CBA,Current
10-09-2025 00:15,CBA41AAF5A5396841658DBE,063-000-002,33333333,FLIXBUS CBA,26.55,0,1139225.94,DR,REF955679,CBA,Current
10-09-2025 01:04,CBA2D2EB29BEC7E4415B48A,063-000-002,33333333,BANK FEE CBA,48.98,0,1139176.96,DR,REF835795,CBA,Current
10-09-2025 01:06,CBAD41B2F83202B4A8FAFF7,063-000-002,33333333,MENULOG CBA,4.57,0,1139172.39,DR,REF499313,CBA,Current
10-09-2025 01:43,CBA05EC62AED1634E8C9ED1,063-000-002,33333333,COLES CBA,94.14,0,1139078.25,DR,REF741977,CBA,Current
10-09-2025 01:56,CBA50DC9124ED3440E5B84C,063-000-002,33333333,STARBUCKS CBA,20.2,0,1139058.05,DR,REF151996,CBA,Current
10-09-2025 01:56,CBAF854B372551E432E9937,063-000-002,33333333,CITYLINK CBA,22.8,0,1139035.25,DR,REF217035,CBA,Current
10-09-2025 01:59,CBA6883EC7B77E243E7B7CA,063-000-002,33333333,BIGW CBA,64.27,0,1138970.98,DR,REF599243,CBA,Current
10-09-2025 02:17,INTA85EB464B4BF4CCCA2FE,063-000-002,33333333,TRANSFER FROM NAB 44444444,0,762.14,1139733.12,CR,INT-24651,CBA,Current
10-09-2025 02:18,CBAC01A06FA9101482C94B5,063-000-002,33333333,BIGW CBA,88.16,0,1139644.96,DR,REF893785,CBA,Current
10-09-2025 02:27,CBA6239D48CEF7D4CB79FCD,063-000-002,33333333,JB HI-FI CBA,19.18,0,1139625.78,DR,REF535114,CBA,Current
10-09-2025 02:49,CBA4DCAC3D2B5234A0D97DA,063-000-002,33333333,BP CBA,99.14,0,1139526.64,DR,REF493541,CBA,Current
10-09-2025 03:21,CBA30A2B6D90D524F1A91EC,063-000-002,33333333,KFC CBA,45.12,0,1139481.52,DR,REF927204,CBA,Current
10-09-2025 03:23,CBA5DA4F756618F41319B33,063-000-002,33333333,DOMINO'S PIZZA CBA,55.99,0,1139425.53,DR,REF818526,CBA,Current
10-09-2025 03:46,CBA120CD56A9D1C4336A75A,063-000-002,33333333,SPOTIFY CBA,93.96,0,1139331.57,DR,REF758667,CBA,Current
10-09-2025 05:35,CBA52EDDF0694BE4E4D88BA,063-000-002,33333333,UBER EATS CBA,29.44,0,1139302.13,DR,REF225855,CBA,Current
10-09-2025 05:54,CBA93EF9C77590C45F8A1A4,063-000-002,33333333,MCDONALDS CBA,7.34,0,1139294.79,DR,REF690000,CBA,Current
10-09-2025 05:55,CBA736B130D3BF44163A467,063-000-002,33333333,HARVEY NORMAN CBA,37.54,0,1139257.25,DR,REF431587,CBA,Current
10-09-2025 06:18,CBAA15C3B3D60B041378051,063-000-002,33333333,MENULOG CBA,7.72,0,1139249.53,DR,REF460832,CBA,Current
10-09-2025 06:20,CBAFC7D928B11224C789505,063-000-002,33333333,LIQUORLAND CBA,25.95,0,1139223.58,DR,REF404206,CBA,Current
10-09-2025 06:43,CBA9A1764B7013A4EBB93B7,063-000-002,33333333,STARBUCKS CBA,7.57,0,1139216.01,DR,REF684333,CBA,Current
10-09-2025 07:59,CBAC540C32C54744C339CCA,063-000-002,33333333,PAYROLL CREDIT CBA,0,5313.91,1144529.92,CR,REF261509,CBA,Current
10-09-2025 08:27,CBA9320419BE96E4B63A194,063-000-002,33333333,SALARY PAYMENT CBA,0,512.16,1145042.08,CR,REF356456,CBA,Current
10-09-2025 08:50,CBA1EC1A00FC6FF430F9AB1,063-000-002,33333333,INTERNET TRANSFER CBA,23.03,0,1145019.05,DR,REF458235,CBA,Current
10-09-2025 08:55,CBAD2429A24423C427B8A8C,063-000-002,33333333,SHELL CBA,44.71,0,1144974.34,DR,REF752786,CBA,Current
10-09-2025 08:59,CBACE15339D57384F5FA812,063-000-002,33333333,BWS CBA,35.03,0,1144939.31,DR,REF743488,CBA,Current
10-09-2025 09:06,CBA7A1C4B3133654685AF02,063-000-002,33333333,SPOTIFY CBA,116.07,0,1144823.24,DR,REF973623,CBA,Current
10-09-2025 09:28,INTC53FFB78236C496994C0,063-000-002,33333333,TRANSFER TO ANZ 11111111,1544.31,0,1143278.93,DR,INT-61262,CBA,Current
10-09-2025 09:47,INT0959F00DEFB94FB9AF73,063-000-002,33333333,TRANSFER FROM CBA 22222222,0,161.98,1143440.91,CR,INT-39188,CBA,Current
10-09-2025 11:04,CBAE3019C2D3D1C47C99A56,063-000-002,33333333,HARVEY NORMAN CBA,59.09,0,1143381.82,DR,REF862927,CBA,Current
10-09-2025 11:16,CBA5FC2FF68E4A74105948A,063-000-002,33333333,PAYPAL *NETFLIX CBA,53.73,0,1143328.09,DR,REF888523,CBA,Current
10-09-2025 11:31,CBA603ECC263D2B45948191,063-000-002,33333333,MCDONALDS CBA,29.77,0,1143298.32,DR,REF356861,CBA,Current
10-09-2025 11:36,CBA5BC63ED1EA8A4F05A518,063-000-002,33333333,MENULOG CBA,28.78,0,1143269.54,DR,REF989239,CBA,Current
10-09-2025 12:08,CBAAD42ED748ABE40D5974E,063-000-002,33333333,BANK FEE CBA,43.66,0,1143225.88,DR,REF344619,CBA,Current
10-09-2025 12:59,CBAB2D6CE627E514625949E,063-000-002,33333333,RAILWAY STATION CBA,166.3,0,1143059.58,DR,REF914251,CBA,Current
10-09-2025 13:03,CBA556C1707174147B69482,063-000-002,33333333,BIGW CBA,60.32,0,1142999.26,DR,REF615890,CBA,Current
10-09-2025 13:08,CBA2F0AB4C7CA504F569385,063-000-002,33333333,PAY - SALARY CBA,0,3829.24,1146828.5,CR,REF249897,CBA,Current
10-09-2025 13:14,CBA03A6F855704D4F5D8D75,063-000-002,33333333,BIGW CBA,33.44,0,1146795.06,DR,REF467847,CBA,Current
10-09-2025 13:41,CBA385D9E5C33854A6D832A,063-000-002,33333333,JB HI-FI CBA,38.94,0,1146756.12,DR,REF253168,CBA,Current
10-09-2025 14:04,CBA6A9D6217B54C43178AA1,063-000-002,33333333,TAFE BOOKSHOP CBA,72.92,0,1146683.2,DR,REF987479,CBA,Current
10-09-2025 14:32,CBA9B0A23B594814C3E984C,063-000-002,33333333,RAILWAY STATION CBA,43.93,0,1146639.27,DR,REF791642,CBA,Current
10-09-2025 14:40,CBAC25D080623274265998E,063-000-002,33333333,LIQUORLAND CBA,40.93,0,1146598.34,DR,REF278769,CBA,Current
10-09-2025 14:51,CBAB89EE294C725465CB903,063-000-002,33333333,STARBUCKS CBA,18.48,0,1146579.86,DR,REF352950,CBA,Current
10-09-2025 15:10,CBAEBF87F46E8EF49718F4E,063-000-002,33333333,HARVEY NORMAN CBA,8.17,0,1146571.69,DR,REF161273,CBA,Current
10-09-2025 15:25,CBAF1F6A2A23BF3452E8C3B,063-000-002,33333333,DOMINO'S PIZZA CBA,24.05,0,1146547.64,DR,REF855757,CBA,Current
10-09-2025 15:30,CBAE0A96DD4C476485DA3D7,063-000-002,33333333,MENULOG CBA,22.8,0,1146524.84,DR,REF314085,CBA,Current
10-09-2025 15:37,CBA2373A2169F9146339B4E,063-000-002,33333333,WAGES CREDIT CBA,0,7655.62,1154180.46,CR,REF875111,CBA,Current
10-09-2025 15:43,CBA00D2D4BED1A948759959,063-000-002,33333333,JB HI-FI CBA,31.27,0,1154149.19,DR,REF145494,CBA,Current
10-09-2025 16:45,INT4FDFDB4D4E24479C8744,063-000-002,33333333,TRANSFER TO CBA 22222222,1379.26,0,1152769.93,DR,INT-28693,CBA,Current
10-09-2025 17:05,CBA54CF189245134A4BBBF2,063-000-002,33333333,BANK FEE CBA,62.87,0,1152707.06,DR,REF444043,CBA,Current
10-09-2025 17:11,CBA7E50E9EFCA90418FA8AD,063-000-002,33333333,MCDONALDS CBA,11.08,0,1152695.98,DR,REF884869,CBA,Current
10-09-2025 17:21,CBA0A0B79B54F1E4267844B,063-000-002,33333333,PAYROLL CREDIT CBA,0,7020.09,1159716.07,CR,REF639165,CBA,Current
10-09-2025 17:34,CBAE086D47A5FC04CE08924,063-000-002,33333333,HARVEY NORMAN CBA,24.52,0,1159691.55,DR,REF242527,CBA,Current
10-09-2025 17:38,CBA6E99765B9B2C4E3693E0,063-000-002,33333333,BP CBA,29,0,1159662.55,DR,REF260171,CBA,Current
10-09-2025 18:08,CBA3780F6E4526949628294,063-000-002,33333333,UBER EATS CBA,193.95,0,1159468.6,DR,REF336195,CBA,Current
10-09-2025 18:11,CBADBAD3FDEC1B643A8A987,063-000-002,33333333,ZOOM CBA,43.94,0,1159424.66,DR,REF211235,CBA,Current
10-09-2025 18:21,CBA43B2A11CD51D4AB7BEEB,063-000-002,33333333,ALDI CBA,44.68,0,1159379.98,DR,REF798718,CBA,Current
10-09-2025 18:23,CBA246A4105B3C649D58031,063-000-002,33333333,LIQUORLAND CBA,88.13,0,1159291.85,DR,REF619265,CBA,Current
10-09-2025 18:50,CBA420BDBCF56C04BA0AF86,063-000-002,33333333,PAYPAL *NETFLIX CBA,44.48,0,1159247.37,DR,REF526714,CBA,Current
10-09-2025 18:56,CBA1EC603D9CC0841A79169,063-000-002,33333333,STARBUCKS CBA,72.87,0,1159174.5,DR,REF512823,CBA,Current
10-09-2025 18:57,CBA15EA8D6D7C734DE09179,063-000-002,33333333,WAGES CREDIT CBA,0,6100.53,1165275.03,CR,REF988480,CBA,Current
10-09-2025 19:26,CBA2067DB8718F2443D8EA0,063-000-002,33333333,UBER EATS CBA,81.18,0,1165193.85,DR,REF523134,CBA,Current
10-09-2025 19:38,CBA69434729A9F64A39A6C0,063-000-002,33333333,SALARY PAYMENT CBA,0,4262.35,1169456.2,CR,REF290375,CBA,Current
10-09-2025 19:53,CBA15687F47AB6547C492C3,063-000-002,33333333,MENULOG CBA,9.36,0,1169446.84,DR,REF433246,CBA,Current
10-09-2025 20:01,CBAAEB6CF191A4742CCB081,063-000-002,33333333,HARVEY NORMAN CBA,10.2,0,1169436.64,DR,REF508803,CBA,Current
10-09-2025 20:08,CBA51B442A4852D49FAAD17,063-000-002,33333333,RAILWAY STATION CBA,56.01,0,1169380.63,DR,REF285844,CBA,Current
10-09-2025 20:24,CBA2F3F79F897C046DBAE34,063-000-002,33333333,LIQUORLAND CBA,87.93,0,1169292.7,DR,REF231911,CBA,Current
10-09-2025 20:41,CBA2E2D832557C24A85852B,063-000-002,33333333,MCDONALDS CBA,121.69,0,1169171.01,DR,REF552662,CBA,Current
10-09-2025 21:05,CBA77AB640CF8ED4BBD9446,063-000-002,33333333,LIQUORLAND CBA,49.98,0,1169121.03,DR,REF930583,CBA,Current
10-09-2025 21:30,CBA2E88323F2AE54A98AAB7,063-000-002,33333333,DOMINO'S PIZZA CBA,98.52,0,1169022.51,DR,REF863868,CBA,Current
10-09-2025 21:44,CBA520203FA53F74A5A928E,063-000-002,33333333,BIGW CBA,2.88,0,1169019.63,DR,REF511343,CBA,Current
10-09-2025 21:45,CBA7D03176B2B1D49199AFA,063-000-002,33333333,AMAZON AU CBA,14.72,0,1169004.91,DR,REF377584,CBA,Current
10-09-2025 21:50,INTE6A2E5ADFC3A4F7CABB5,063-000-002,33333333,TRANSFER TO CBA 22222222,417.76,0,1168587.15,DR,INT-80563,CBA,Current
10-09-2025 21:51,CBA6B318EDD042C41A8A54F,063-000-002,33333333,LIQUORLAND CBA,39.91,0,1168547.24,DR,REF617805,CBA,Current
10-09-2025 23:11,CBA239F4C1617DE423AB660,063-000-002,33333333,TAFE BOOKSHOP CBA,119.46,0,1168427.78,DR,REF347936,CBA,Current
10-09-2025 23:15,CBA1F70ED606A5C42B6A198,063-000-002,33333333,PAY - SALARY CBA,0,478.17,1168905.95,CR,REF156379,CBA,Current
10-09-2025 23:22,CBACA09A5DDDE5842808AE2,063-000-002,33333333,TAFE BOOKSHOP CBA,6.7,0,1168899.25,DR,REF354048,CBA,Current
10-09-2025 23:44,CBA0E3672D288BC4D9F8D8D,063-000-002,33333333,CITYLINK CBA,56.34,0,1168842.91,DR,REF134470,CBA,Current
10-09-2025 23:50,CBA11F671DE27F94EB4A580,063-000-002,33333333,7-ELEVEN CBA,27.44,0,1168815.47,DR,REF716485,CBA,Current
11-09-2025 00:21,CBA6018EE968F904A3A8D7C,063-000-002,33333333,7-ELEVEN CBA,51.82,0,1168763.65,DR,REF554860,CBA,Current
11-09-2025 00:24,CBA8D44537585F948E0B492,063-000-002,33333333,ZOOM CBA,32.65,0,1168731,DR,REF173070,CBA,Current
11-09-2025 00:26,CBA2E3CE3CAD03E4F0EA192,063-000-002,33333333,SHELL CBA,11.96,0,1168719.04,DR,REF892860,CBA,Current
11-09-2025 01:18,CBA767D2A384959496C81D9,063-000-002,33333333,7-ELEVEN CBA,16.03,0,1168703.01,DR,REF574879,CBA,Current
11-09-2025 01:19,CBA1DD3FBD7C47E4A6FB83E,063-000-002,33333333,PAYPAL *NETFLIX CBA,47.89,0,1168655.12,DR,REF470036,CBA,Current
11-09-2025 01:37,CBA308877B378004164B1D1,063-000-002,33333333,BANK FEE CBA,65.39,0,1168589.73,DR,REF199047,CBA,Current
11-09-2025 02:02,CBAD3BEB6E03C114D8D9F92,063-000-002,33333333,KFC CBA,75.65,0,1168514.08,DR,REF349300,CBA,Current
11-09-2025 03:15,CBA07E08F90861B4384A1CA,063-000-002,33333333,PAYMENT GATEWAY CBA,156.75,0,1168357.33,DR,REF750010,CBA,Current
11-09-2025 03:28,CBAD2501CDAE77343EB8904,063-000-002,33333333,ZOOM CBA,21.13,0,1168336.2,DR,REF352219,CBA,Current
11-09-2025 03:44,CBA022D434B7FCA4C2D94C1,063-000-002,33333333,WOOLWORTHS CBA,55.64,0,1168280.56,DR,REF483234,CBA,Current
11-09-2025 04:10,CBACD91FFDE080E4E65A5E0,063-000-002,33333333,BP CBA,30.94,0,1168249.62,DR,REF624472,CBA,Current
11-09-2025 04:21,CBAF06A138C22634E618839,063-000-002,33333333,APPLE CBA,73.54,0,1168176.08,DR,REF240593,CBA,Current
11-09-2025 04:51,INTCA464A29EAC84B6A93DE,063-000-002,33333333,TRANSFER FROM ANZ 11111111,0,288.43,1168464.51,CR,INT-23096,CBA,Current
11-09-2025 04:54,CBA2B51D38BE2E04F6EB4A4,063-000-002,33333333,ALDI CBA,38.49,0,1168426.02,DR,REF636116,CBA,Current
11-09-2025 04:58,CBA58D0EBAA96F74302AC66,063-000-002,33333333,COMPANY PAYROLL CBA,0,4511.22,1172937.24,CR,REF347283,CBA,Current
11-09-2025 05:18,CBA6B1843E8BD2A45508E66,063-000-002,33333333,LIQUORLAND CBA,46.65,0,1172890.59,DR,REF436283,CBA,Current
11-09-2025 05:20,CBA80E07C74D4824F4AB67C,063-000-002,33333333,AMAZON AU CBA,33.81,0,1172856.78,DR,REF643460,CBA,Current
11-09-2025 05:24,CBA5A476D6A77C24103853F,063-000-002,33333333,KFC CBA,160.34,0,1172696.44,DR,REF602068,CBA,Current
11-09-2025 05:26,CBA1903E8516CEE493FBC0B,063-000-002,33333333,7-ELEVEN CBA,25.41,0,1172671.03,DR,REF667721,CBA,Current
11-09-2025 05:28,CBA5F0FD3C536BE4F2A8911,063-000-002,33333333,JB HI-FI CBA,82.55,0,1172588.48,DR,REF316331,CBA,Current
11-09-2025 05:54,INT36B4946E344A42B9B32F,063-000-002,33333333,TRANSFER TO CBA 22222222,807.61,0,1171780.87,DR,INT-60298,CBA,Current
11-09-2025 06:01,CBA65613C0E96D84203A0DE,063-000-002,33333333,DOMINO'S PIZZA CBA,60.06,0,1171720.81,DR,REF918265,CBA,Current
11-09-2025 06:06,CBABD08664EFF114C17BFA8,063-000-002,33333333,HARVEY NORMAN CBA,128.23,0,1171592.58,DR,REF722871,CBA,Current
11-09-2025 06:19,CBA270AF80070D844C88312,063-000-002,33333333,MENULOG CBA,66.81,0,1171525.77,DR,REF538539,CBA,Current
11-09-2025 06:19,CBADEA372A1D44E41699F4D,063-000-002,33333333,DOMINO'S PIZZA CBA,50.71,0,1171475.06,DR,REF790297,CBA,Current
11-09-2025 07:26,CBAF31E42D809994511B8E9,063-000-002,33333333,MCDONALDS CBA,2.93,0,1171472.13,DR,REF205187,CBA,Current
11-09-2025 07:47,CBABD2A444DA0694BB39C2E,063-000-002,33333333,WOOLWORTHS CBA,9.18,0,1171462.95,DR,REF500149,CBA,Current
11-09-2025 08:05,CBAEBA287E8F1B342409640,063-000-002,33333333,BANK FEE CBA,24.1,0,1171438.85,DR,REF642717,CBA,Current
11-09-2025 08:13,CBAA9661785836B41A99B24,063-000-002,33333333,AMAZON AU CBA,71.53,0,1171367.32,DR,REF102651,CBA,Current
11-09-2025 08:33,CBABA68ADFB4DF549B1B5C3,063-000-002,33333333,BWS CBA,66.52,0,1171300.8,DR,REF357198,CBA,Current
11-09-2025 09:20,CBAC354CCB0837742E2A89D,063-000-002,33333333,KFC CBA,15.03,0,1171285.77,DR,REF349000,CBA,Current
11-09-2025 09:27,CBA57930E07466D46139ABD,063-000-002,33333333,7-ELEVEN CBA,11.66,0,1171274.11,DR,REF802448,CBA,Current
11-09-2025 09:30,CBAEFCBEE5EFD8C4FD79F2A,063-000-002,33333333,INTERNET TRANSFER CBA,34.38,0,1171239.73,DR,REF926998,CBA,Current
11-09-2025 09:39,CBAB06848489CA440D2BB4C,063-000-002,33333333,MCDONALDS CBA,186.34,0,1171053.39,DR,REF541875,CBA,Current
11-09-2025 09:46,CBA80EA35873C7542458E91,063-000-002,33333333,JB HI-FI CBA,5.53,0,1171047.86,DR,REF441879,CBA,Current
11-09-2025 09:56,CBA6CA4B327C70E45B09C29,063-000-002,33333333,COLES CBA,41.57,0,1171006.29,DR,REF153025,CBA,Current
11-09-2025 10:09,CBAA7EB8D37AD2D4EEC8D6C,063-000-002,33333333,STARBUCKS CBA,19.36,0,1170986.93,DR,REF586121,CBA,Current
11-09-2025 10:45,CBAEC7BAA83323D4B46BBFC,063-000-002,33333333,HARVEY NORMAN CBA,24.72,0,1170962.21,DR,REF975956,CBA,Current
11-09-2025 10:46,CBA36171A4360524DF1A28B,063-000-002,33333333,SPOTIFY CBA,268.18,0,1170694.03,DR,REF620994,CBA,Current
11-09-2025 10:53,CBAB2793D317659482AB2B7,063-000-002,33333333,ALDI CBA,30.1,0,1170663.93,DR,REF311574,CBA,Current
11-09-2025 11:17,CBAD3AFF910AA0C4F27995F,063-000-002,33333333,PAY - SALARY CBA,0,2682.98,1173346.91,CR,REF826671,CBA,Current
11-09-2025 12:07,CBAA492F20F56744D49AAB0,063-000-002,33333333,SPOTIFY CBA,35.31,0,1173311.6,DR,REF442806,CBA,Current
11-09-2025 12:58,CBA79E664B8853F43B69DDB,063-000-002,33333333,PAYMENT GATEWAY CBA,77.67,0,1173233.93,DR,REF942975,CBA,Current
11-09-2025 13:35,CBADEAB0432E3B04EF0A07B,063-000-002,33333333,PAYPAL *NETFLIX CBA,221.95,0,1173011.98,DR,REF151853,CBA,Current
11-09-2025 13:52,CBA2C07528E615A4B5ABC0E,063-000-002,33333333,COLES CBA,1.54,0,1173010.44,DR,REF977841,CBA,Current
11-09-2025 14:00,CBA2182368BD55C4F108674,063-000-002,33333333,KFC CBA,26.59,0,1172983.85,DR,REF213404,CBA,Current
11-09-2025 14:35,CBA87B91FA3EC77429B8187,063-000-002,33333333,ZOOM CBA,21.65,0,1172962.2,DR,REF417781,CBA,Current
11-09-2025 14:36,CBABC289B694B384F46B080,063-000-002,33333333,PAYPAL *NETFLIX CBA,40.4,0,1172921.8,DR,REF734788,CBA,Current
11-09-2025 16:09,CBAA9307037105F4D0D8BC8,063-000-002,33333333,RAILWAY STATION CBA,71.23,0,1172850.57,DR,REF869870,CBA,Current
11-09-2025 16:16,CBAB0D1FBD6AC5F4ADAA6ED,063-000-002,33333333,FLIXBUS CBA,237.22,0,1172613.35,DR,REF203427,CBA,Current
11-09-2025 16:23,CBA1718C2C325894A73A316,063-000-002,33333333,LIQUORLAND CBA,55.02,0,1172558.33,DR,REF325609,CBA,Current
11-09-2025 16:33,CBA37454BA2BF5C47A3B8C3,063-000-002,33333333,KFC CBA,65.81,0,1172492.52,DR,REF860516,CBA,Current
11-09-2025 16:34,CBA2C1B0091E77B4545B7D5,063-000-002,33333333,PAY - SALARY CBA,0,1565.52,1174058.04,CR,REF302722,CBA,Current
11-09-2025 16:46,CBA7B44D89434C248739200,063-000-002,33333333,HARVEY NORMAN CBA,28.6,0,1174029.44,DR,REF982764,CBA,Current
11-09-2025 17:37,CBAD3C3F43E64FB4D2BBF0F,063-000-002,33333333,HARVEY NORMAN CBA,28.47,0,1174000.97,DR,REF950019,CBA,Current
11-09-2025 17:52,CBA651751A9CA5A420594AF,063-000-002,33333333,HARVEY NORMAN CBA,170.97,0,1173830,DR,REF541366,CBA,Current
11-09-2025 18:44,CBA0BFD9C85A13F4F118485,063-000-002,33333333,PAYPAL *NETFLIX CBA,94.07,0,1173735.93,DR,REF160710,CBA,Current
11-09-2025 19:00,CBAD3CBF56133FD43B092B2,063-000-002,33333333,MENULOG CBA,4.32,0,1173731.61,DR,REF659298,CBA,Current
11-09-2025 19:02,INT91D46B8F453D4A039771,063-000-002,33333333,TRANSFER TO NAB 44444444,1916.24,0,1171815.37,DR,INT-91431,CBA,Current
11-09-2025 19:12,CBA6BBFBA1130304DFE9096,063-000-002,33333333,UBER EATS CBA,104.8,0,1171710.57,DR,REF371026,CBA,Current
11-09-2025 19:26,INTB6018E225A79448D9822,063-000-002,33333333,TRANSFER TO CBA 22222222,1549.29,0,1170161.28,DR,INT-78340,CBA,Current
11-09-2025 19:47,CBA9C4CA3F01EE8491F9962,063-000-002,33333333,PAY - SALARY CBA,0,736.59,1170897.87,CR,REF725160,CBA,Current
11-09-2025 20:03,CBA608D88D2C1EC4C758185,063-000-002,33333333,LIQUORLAND CBA,28.17,0,1170869.7,DR,REF573785,CBA,Current
11-09-2025 20:19,CBA62C652C2F3F2470C8A0A,063-000-002,33333333,AMAZON AU CBA,97.42,0,1170772.28,DR,REF660533,CBA,Current
11-09-2025 20:26,CBA597474E259CB41468CEA,063-000-002,33333333,KFC CBA,48.53,0,1170723.75,DR,REF881702,CBA,Current
11-09-2025 20:52,CBAD6E5CA27DA724543B22B,063-000-002,33333333,WOOLWORTHS CBA,177.3,0,1170546.45,DR,REF887796,CBA,Current
11-09-2025 21:11,CBADB506120540A4FC1B0FD,063-000-002,33333333,MENULOG CBA,74.99,0,1170471.46,DR,REF371519,CBA,Current
11-09-2025 21:23,CBA6FB9D6D1AC074BCF8037,063-000-002,33333333,STARBUCKS CBA,5.81,0,1170465.65,DR,REF459590,CBA,Current
11-09-2025 21:32,CBA7425FC4698FB46738B58,063-000-002,33333333,COMPANY PAYROLL CBA,0,4481.34,1174946.99,CR,REF899450,CBA,Current
11-09-2025 22:08,CBAF375EB5055CA46E2A2FB,063-000-002,33333333,LIQUORLAND CBA,60.56,0,1174886.43,DR,REF587551,CBA,Current
11-09-2025 22:25,CBAE930F82376FF452B8266,063-000-002,33333333,FLIXBUS CBA,63.16,0,1174823.27,DR,REF986388,CBA,Current
11-09-2025 22:27,CBA35B72A1AC5414AEE8A38,063-000-002,33333333,COLES CBA,31.69,0,1174791.58,DR,REF969269,CBA,Current
11-09-2025 22:47,CBA3E08F9CF92074955B327,063-000-002,33333333,JB HI-FI CBA,15.19,0,1174776.39,DR,REF678573,CBA,Current
11-09-2025 23:12,CBA81B6078243DA4322B377,063-000-002,33333333,PAYPAL *NETFLIX CBA,8.74,0,1174767.65,DR,REF853721,CBA,Current
11-09-2025 23:27,CBABBB693B89D8C41329D3B,063-000-002,33333333,UBER EATS CBA,93.94,0,1174673.71,DR,REF214201,CBA,Current
11-09-2025 23:28,CBA13254A108BF5424EAC20,063-000-002,33333333,SHELL CBA,74.79,0,1174598.92,DR,REF641643,CBA,Current
11-09-2025 23:39,CBA552670A33AD34DEEBA01,063-000-002,33333333,MCDONALDS CBA,15.46,0,1174583.46,DR,REF113700,CBA,Current
11-09-2025 23:42,CBAB9122689346C42D6B9B6,063-000-002,33333333,RAILWAY STATION CBA,38.81,0,1174544.65,DR,REF623462,CBA,Current
12-09-2025 00:04,CBA4CECAF2EB02045299189,063-000-002,33333333,INTERNET TRANSFER CBA,63.45,0,1174481.2,DR,REF768401,CBA,Current
12-09-2025 00:16,CBA35A5A4075FDC4A2EAC7C,063-000-002,33333333,CITYLINK CBA,89.26,0,1174391.94,DR,REF394843,CBA,Current
12-09-2025 01:34,CBA70FBF50C9955435F93AA,063-000-002,33333333,CITYLINK CBA,56.86,0,1174335.08,DR,REF988704,CBA,Current
12-09-2025 01:34,INT40785384D55D46A8B31B,063-000-002,33333333,TRANSFER TO CBA 22222222,1625.65,0,1172709.43,DR,INT-39429,CBA,Current
12-09-2025 01:55,CBA2982010BC95B4FE5939E,063-000-002,33333333,APPLE CBA,7.08,0,1172702.35,DR,REF392702,CBA,Current
12-09-2025 02:02,CBA05C9DF54E8CA46E9ADE7,063-000-002,33333333,SHELL CBA,24.32,0,1172678.03,DR,REF217145,CBA,Current
12-09-2025 03:06,CBABFE809A9CB1446CCB25C,063-000-002,33333333,ZOOM CBA,133.56,0,1172544.47,DR,REF903952,CBA,Current
12-09-2025 03:25,CBAEFEBDE9254254D05935B,063-000-002,33333333,LIQUORLAND CBA,65.73,0,1172478.74,DR,REF402700,CBA,Current
12-09-2025 03:37,CBA6EF84367F4C34A999D5A,063-000-002,33333333,WAGES CREDIT CBA,0,2569.19,1175047.93,CR,REF402674,CBA,Current
12-09-2025 03:44,CBA2416DBC47216444EB580,063-000-002,33333333,RAILWAY STATION CBA,26.73,0,1175021.2,DR,REF781764,CBA,Current
12-09-2025 04:53,CBA811F0D93403F4A2AAD56,063-000-002,33333333,COLES CBA,28.02,0,1174993.18,DR,REF987608,CBA,Current
12-09-2025 05:10,CBA67182B2F225548CFBE55,063-000-002,33333333,SHELL CBA,11.51,0,1174981.67,DR,REF331941,CBA,Current
12-09-2025 05:12,CBA0A5E625700C54BBCAC6C,063-000-002,33333333,BANK FEE CBA,18.85,0,1174962.82,DR,REF784707,CBA,Current
12-09-2025 06:08,CBA8EC79A7F715C460897C2,063-000-002,33333333,CITYLINK CBA,47.08,0,1174915.74,DR,REF486639,CBA,Current
12-09-2025 06:20,CBA1A2B56A00BA34CDCB4CB,063-000-002,33333333,UBER EATS CBA,54.35,0,1174861.39,DR,REF488036,CBA,Current
12-09-2025 06:20,CBA920DD7202D25435B97D9,063-000-002,33333333,LIQUORLAND CBA,61.66,0,1174799.73,DR,REF679372,CBA,Current
12-09-2025 06:25,INT6BC919D2ACA241F49101,063-000-002,33333333,TRANSFER TO NAB 44444444,103.87,0,1174695.86,DR,INT-10439,CBA,Current
12-09-2025 06:50,CBA625DA1C66DB54A9E9EF3,063-000-002,33333333,PAYPAL *NETFLIX CBA,71.53,0,1174624.33,DR,REF639823,CBA,Current
12-09-2025 06:53,CBAFE3B9EF9E432435581D4,063-000-002,33333333,JB HI-FI CBA,101.67,0,1174522.66,DR,REF752205,CBA,Current
12-09-2025 07:43,CBA55523848F67543DEA4F2,063-000-002,33333333,DOMINO'S PIZZA CBA,26.14,0,1174496.52,DR,REF803515,CBA,Current
12-09-2025 07:54,CBA2A3996ECAB6F4F579667,063-000-002,33333333,PAYMENT GATEWAY CBA,33.94,0,1174462.58,DR,REF346511,CBA,Current
12-09-2025 08:24,CBA1387D8876F2E4573BA23,063-000-002,33333333,RAILWAY STATION CBA,78.19,0,1174384.39,DR,REF549832,CBA,Current
12-09-2025 08:49,CBA170B63BEEB0B4FE8A5FC,063-000-002,33333333,PAYROLL CREDIT CBA,0,4769.55,1179153.94,CR,REF880702,CBA,Current
12-09-2025 09:11,CBA8FE736CD42D144B6A154,063-000-002,33333333,SPOTIFY CBA,216.86,0,1178937.08,DR,REF777836,CBA,Current
12-09-2025 09:27,CBA5AA12A2AB7404AF7B986,063-000-002,33333333,APPLE CBA,131.37,0,1178805.71,DR,REF600833,CBA,Current
12-09-2025 10:00,CBA2FB5E6C512BA4CD0A043,063-000-002,33333333,RAILWAY STATION CBA,17.91,0,1178787.8,DR,REF584965,CBA,Current
12-09-2025 10:05,CBA7929826F88704233A9F1,063-000-002,33333333,AMAZON AU CBA,67.65,0,1178720.15,DR,REF317685,CBA,Current
12-09-2025 10:17,CBA80C76133AF664CCAAB8F,063-000-002,33333333,INTERNET TRANSFER CBA,17.8,0,1178702.35,DR,REF723914,CBA,Current
12-09-2025 10:18,CBA6AA42A8532ED45B7BC07,063-000-002,33333333,DOMINO'S PIZZA CBA,39.11,0,1178663.24,DR,REF313112,CBA,Current
12-09-2025 10:44,CBAF06F52BED24D48538A86,063-000-002,33333333,JB HI-FI CBA,52.8,0,1178610.44,DR,REF596276,CBA,Current
12-09-2025 10:59,CBA6118EAA23E674BDA97F7,063-000-002,33333333,INTERNET TRANSFER CBA,85.02,0,1178525.42,DR,REF764406,CBA,Current
12-09-2025 11:06,CBA5FCE30F2A2314D788F50,063-000-002,33333333,FLIXBUS CBA,10.99,0,1178514.43,DR,REF725754,CBA,Current
12-09-2025 11:31,CBA1C5C4E4B9D3840C1BDD6,063-000-002,33333333,INTERNET TRANSFER CBA,31.92,0,1178482.51,DR,REF165411,CBA,Current
12-09-2025 11:56,CBAB133BA34E70841FFA4E9,063-000-002,33333333,COMPANY PAYROLL CBA,0,465.92,1178948.43,CR,REF458682,CBA,Current
12-09-2025 12:07,CBAF70C13564D0C4B76BC82,063-000-002,33333333,LIQUORLAND CBA,147.49,0,1178800.94,DR,REF662848,CBA,Current
12-09-2025 12:08,CBA787A7E34364A441DA864,063-000-002,33333333,SPOTIFY CBA,8.74,0,1178792.2,DR,REF413501,CBA,Current
12-09-2025 12:53,CBA1764DC2AB8374E5D9A6D,063-000-002,33333333,DOMINO'S PIZZA CBA,10.72,0,1178781.48,DR,REF900298,CBA,Current
12-09-2025 13:05,CBA1EBECC54C2BA4DB196EF,063-000-002,33333333,STARBUCKS CBA,8.94,0,1178772.54,DR,REF206000,CBA,Current
12-09-2025 13:54,CBAA4A5644A701B4C228333,063-000-002,33333333,APPLE CBA,12.46,0,1178760.08,DR,REF694196,CBA,Current
12-09-2025 13:56,CBA18DE001272BB4043BF7F,063-000-002,33333333,LIQUORLAND CBA,57.91,0,1178702.17,DR,REF735168,CBA,Current
12-09-2025 14:05,INT69A41156AAF343AC8ACB,063-000-002,33333333,TRANSFER TO NAB 44444444,759.95,0,1177942.22,DR,INT-31897,CBA,Current
12-09-2025 14:08,CBAD6A926C3D9FB48DD8855,063-000-002,33333333,PAYPAL *NETFLIX CBA,71.31,0,1177870.91,DR,REF659391,CBA,Current
12-09-2025 14:19,CBAEB27E5725CC940988865,063-000-002,33333333,COMPANY PAYROLL CBA,0,233.15,1178104.06,CR,REF487607,CBA,Current
12-09-2025 14:28,CBAE2A5381D19B44A9D8EEA,063-000-002,33333333,BIGW CBA,119.21,0,1177984.85,DR,REF660417,CBA,Current
12-09-2025 14:31,CBA186132BBA2764118AC6A,063-000-002,33333333,SALARY PAYMENT CBA,0,5755.04,1183739.89,CR,REF641539,CBA,Current
12-09-2025 15:00,CBAB5539CBE25FA416CA8AE,063-000-002,33333333,DOMINO'S PIZZA CBA,14.84,0,1183725.05,DR,REF511922,CBA,Current
12-09-2025 15:09,CBA98621B5560B3405196D0,063-000-002,33333333,SPOTIFY CBA,16.28,0,1183708.77,DR,REF160937,CBA,Current
12-09-2025 15:09,CBA65CD59127F344B7DB24C,063-000-002,33333333,SALARY PAYMENT CBA,0,1009.14,1184717.91,CR,REF458186,CBA,Current
12-09-2025 15:21,CBAE598891D3DCA411FA54D,063-000-002,33333333,COLES CBA,65.99,0,1184651.92,DR,REF510079,CBA,Current
12-09-2025 15:24,CBAD2D983CAA5D640249138,063-000-002,33333333,WOOLWORTHS CBA,26.2,0,1184625.72,DR,REF653206,CBA,Current
12-09-2025 15:29,CBAD42FD4B0DD78499FAB6B,063-000-002,33333333,KFC CBA,25.04,0,1184600.68,DR,REF822691,CBA,Current
12-09-2025 15:39,CBA145F6F694C1249789094,063-000-002,33333333,HARVEY NORMAN CBA,144.36,0,1184456.32,DR,REF906866,CBA,Current
12-09-2025 16:43,CBA9B83E9E5584246449756,063-000-002,33333333,DOMINO'S PIZZA CBA,62.6,0,1184393.72,DR,REF668836,CBA,Current
12-09-2025 16:52,CBA79C2A0922D83451E9EC0,063-000-002,33333333,BANK FEE CBA,68.08,0,1184325.64,DR,REF960526,CBA,Current
12-09-2025 17:17,CBA2F89BFDF01EB400EA90E,063-000-002,33333333,MCDONALDS CBA,8.57,0,1184317.07,DR,REF388370,CBA,Current
12-09-2025 17:18,CBA5B5002B41BBF49EF9257,063-000-002,33333333,JB HI-FI CBA,10.16,0,1184306.91,DR,REF478967,CBA,Current
12-09-2025 17:26,CBA568DBE66737A48729B0C,063-000-002,33333333,COLES CBA,21.13,0,1184285.78,DR,REF208254,CBA,Current
12-09-2025 17:30,CBA88E2223FCCAF49CDAC4E,063-000-002,33333333,PAYMENT GATEWAY CBA,49.45,0,1184236.33,DR,REF754612,CBA,Current
12-09-2025 17:41,CBAD3BB5CA7C03F4CAB9FE0,063-000-002,33333333,CITYLINK CBA,82.5,0,1184153.83,DR,REF125879,CBA,Current
12-09-2025 17:50,CBA76692318815B40059F08,063-000-002,33333333,FLIXBUS CBA,18.55,0,1184135.28,DR,REF300593,CBA,Current
12-09-2025 17:55,CBAB13535C65D794DF7BDB3,063-000-002,33333333,UBER EATS CBA,56.61,0,1184078.67,DR,REF249079,CBA,Current
12-09-2025 17:56,CBA1E14F37D9A4E44838386,063-000-002,33333333,CITYLINK CBA,14.48,0,1184064.19,DR,REF740817,CBA,Current
12-09-2025 18:21,CBA96085818771C4121ADE7,063-000-002,33333333,COMPANY PAYROLL CBA,0,5929.26,1189993.45,CR,REF548108,CBA,Current
12-09-2025 18:33,CBAC2213B6E6EDE4DEB8029,063-000-002,33333333,BP CBA,44.55,0,1189948.9,DR,REF994573,CBA,Current
12-09-2025 19:03,CBA683184CF40A247E1873E,063-000-002,33333333,SALARY PAYMENT CBA,0,5818.51,1195767.41,CR,REF979149,CBA,Current
12-09-2025 19:40,CBA02ADB46526924027A989,063-000-002,33333333,PAYMENT GATEWAY CBA,29.73,0,1195737.68,DR,REF932465,CBA,Current
12-09-2025 19:57,CBA19A132572CB2499497A5,063-000-002,33333333,WOOLWORTHS CBA,54.02,0,1195683.66,DR,REF917318,CBA,Current
12-09-2025 20:14,CBA70167C2592324EE4A3C3,063-000-002,33333333,PAYROLL CREDIT CBA,0,7287.62,1202971.28,CR,REF164055,CBA,Current
12-09-2025 20:30,CBAB01765010A1B45FA829E,063-000-002,33333333,7-ELEVEN CBA,81.27,0,1202890.01,DR,REF219917,CBA,Current
12-09-2025 20:44,CBA8DBF122D7D4544FC8B63,063-000-002,33333333,7-ELEVEN CBA,56.57,0,1202833.44,DR,REF462422,CBA,Current
12-09-2025 20:51,CBAB6377B8BAACA4DA9BAE9,063-000-002,33333333,BIGW CBA,28.33,0,1202805.11,DR,REF695159,CBA,Current
12-09-2025 21:09,CBA0B572956013D453BA10A,063-000-002,33333333,PAYPAL *NETFLIX CBA,8.29,0,1202796.82,DR,REF185765,CBA,Current
12-09-2025 21:51,CBA4B48A30B37F44DFA9D4E,063-000-002,33333333,BIGW CBA,23.29,0,1202773.53,DR,REF679824,CBA,Current
12-09-2025 21:57,CBA56D0D76EA54E4A4F8D1B,063-000-002,33333333,ZOOM CBA,21.73,0,1202751.8,DR,REF939030,CBA,Current
12-09-2025 22:12,CBA70C619D7BEB847B1ADE7,063-000-002,33333333,CITYLINK CBA,6.13,0,1202745.67,DR,REF515903,CBA,Current
12-09-2025 22:14,CBA93163C1F188749CE91F9,063-000-002,33333333,MCDONALDS CBA,41.27,0,1202704.4,DR,REF961740,CBA,Current
12-09-2025 22:38,INTB343AC0C209443D88E1C,063-000-002,33333333,TRANSFER FROM NAB 44444444,0,1665.48,1204369.88,CR,INT-88005,CBA,Current
12-09-2025 23:08,CBA6E99EC05AFE74E9FADCF,063-000-002,33333333,SALARY PAYMENT CBA,0,5079.23,1209449.11,CR,REF557709,CBA,Current
12-09-2025 23:29,INT29EB25E672EA45E3B5A6,063-000-002,33333333,TRANSFER TO CBA 22222222,1419.03,0,1208030.08,DR,INT-84628,CBA,Current
12-09-2025 23:36,CBAC1796438D92E48E9BCD7,063-000-002,33333333,7-ELEVEN CBA,32.39,0,1207997.69,DR,REF816018,CBA,Current
13-09-2025 00:24,CBA505496898EC24AFC8FE8,063-000-002,33333333,SALARY PAYMENT CBA,0,801.47,1208799.16,CR,REF298190,CBA,Current
13-09-2025 00:47,INT30EA3FCDA37747C3BC65,063-000-002,33333333,TRANSFER FROM CBA 22222222,0,1985.11,1210784.27,CR,INT-36787,CBA,Current
13-09-2025 02:08,CBAFF4B4907F13741029DD9,063-000-002,33333333,COLES CBA,33.4,0,1210750.87,DR,REF666486,CBA,Current
13-09-2025 02:17,CBA2D9F17FE06554082A1CD,063-000-002,33333333,ZOOM CBA,21.38,0,1210729.49,DR,REF972897,CBA,Current
13-09-2025 03:03,CBA211E6F0C68FB49F4B875,063-000-002,33333333,7-ELEVEN CBA,174.03,0,1210555.46,DR,REF398963,CBA,Current
13-09-2025 04:03,CBA444249102F4C44E48A18,063-000-002,33333333,7-ELEVEN CBA,214.22,0,1210341.24,DR,REF608971,CBA,Current
13-09-2025 04:23,CBA7FE0F49779724073B608,063-000-002,33333333,HARVEY NORMAN CBA,30.91,0,1210310.33,DR,REF935856,CBA,Current
13-09-2025 05:06,CBAEBA268240D8247179E9D,063-000-002,33333333,MCDONALDS CBA,19.17,0,1210291.16,DR,REF891074,CBA,Current
13-09-2025 05:09,CBA367409A430B944588B98,063-000-002,33333333,STARBUCKS CBA,19.37,0,1210271.79,DR,REF473554,CBA,Current
13-09-2025 05:47,CBA2ADDFE7C806048ECB3F5,063-000-002,33333333,COLES CBA,67.46,0,1210204.33,DR,REF328158,CBA,Current
13-09-2025 06:12,CBAB47FE0CF40DF4CB0B385,063-000-002,33333333,DOMINO'S PIZZA CBA,8.3,0,1210196.03,DR,REF761912,CBA,Current
13-09-2025 06:30,CBA96216A6740F14C968359,063-000-002,33333333,PAYROLL CREDIT CBA,0,3865.86,1214061.89,CR,REF777338,CBA,Current
13-09-2025 07:00,CBABBCFD931EB404D698090,063-000-002,33333333,ZOOM CBA,69.46,0,1213992.43,DR,REF624423,CBA,Current
13-09-2025 07:22,INT97979E6BB78C4A7F95CF,063-000-002,33333333,TRANSFER TO ANZ 11111111,112.99,0,1213879.44,DR,INT-69767,CBA,Current
13-09-2025 07:34,CBA68BF527E952149A49D18,063-000-002,33333333,STARBUCKS CBA,24.79,0,1213854.65,DR,REF222052,CBA,Current
13-09-2025 08:16,CBA56BF1C11B0E4446A8FAD,063-000-002,33333333,COLES CBA,67.81,0,1213786.84,DR,REF190039,CBA,Current
13-09-2025 09:49,CBA07AFFFA83D484A6CBE0F,063-000-002,33333333,WOOLWORTHS CBA,75.81,0,1213711.03,DR,REF286616,CBA,Current
13-09-2025 10:09,CBA77A10BF098784B61B7B4,063-000-002,33333333,KFC CBA,36.07,0,1213674.96,DR,REF257150,CBA,Current
13-09-2025 10:56,CBA7B8591EE3ECF4C78A0B1,063-000-002,33333333,PAYPAL *NETFLIX CBA,44.63,0,1213630.33,DR,REF695922,CBA,Current
13-09-2025 10:56,CBA44873264E8704FA8BAF2,063-000-002,33333333,COMPANY PAYROLL CBA,0,2254.46,1215884.79,CR,REF141441,CBA,Current
13-09-2025 11:01,CBA56C6E89A2608453DAF06,063-000-002,33333333,JB HI-FI CBA,15.27,0,1215869.52,DR,REF240984,CBA,Current
13-09-2025 11:27,CBA6EA3F8DB1C924005B3B5,063-000-002,33333333,FLIXBUS CBA,39.84,0,1215829.68,DR,REF621968,CBA,Current
13-09-2025 11:29,CBAC759D40D872D46AAB12B,063-000-002,33333333,BWS CBA,73.67,0,1215756.01,DR,REF830059,CBA,Current
13-09-2025 11:30,CBA19F65AD993CD4138B4E3,063-000-002,33333333,AMAZON AU CBA,85.61,0,1215670.4,DR,REF556538,CBA,Current
13-09-2025 11:37,CBA755CED905559402BB43C,063-000-002,33333333,AMAZON AU CBA,37.18,0,1215633.22,DR,REF220160,CBA,Current
13-09-2025 11:37,CBAB35150DC2C194C73823B,063-000-002,33333333,JB HI-FI CBA,83.78,0,1215549.44,DR,REF874330,CBA,Current
13-09-2025 12:21,INTF3661281B59F4A3AB4F3,063-000-002,33333333,TRANSFER TO NAB 44444444,1495.17,0,1214054.27,DR,INT-91530,CBA,Current
13-09-2025 12:36,CBA87C675D472584E9BBDF2,063-000-002,33333333,COLES CBA,67.34,0,1213986.93,DR,REF960587,CBA,Current
13-09-2025 13:15,CBAB073DD78928C40258AB2,063-000-002,33333333,BANK FEE CBA,23.52,0,1213963.41,DR,REF297273,CBA,Current
13-09-2025 13:29,CBA8A6688EE988146159DFC,063-000-002,33333333,AMAZON AU CBA,8.62,0,1213954.79,DR,REF243280,CBA,Current
13-09-2025 13:42,CBA928DA8CACB08411FA219,063-000-002,33333333,LIQUORLAND CBA,45.5,0,1213909.29,DR,REF909768,CBA,Current
13-09-2025 14:13,CBA6AE211F8C07A41918E65,063-000-002,33333333,SPOTIFY CBA,6.8,0,1213902.49,DR,REF261179,CBA,Current
13-09-2025 14:15,CBAF1D659DB756741BE8B3B,063-000-002,33333333,RAILWAY STATION CBA,21.09,0,1213881.4,DR,REF327260,CBA,Current
13-09-2025 14:29,CBA2E33A97BB5254856B8BB,063-000-002,33333333,FLIXBUS CBA,42.94,0,1213838.46,DR,REF195567,CBA,Current
13-09-2025 15:10,CBAD264E87F655B4BC1B6A3,063-000-002,33333333,PAYMENT GATEWAY CBA,21.62,0,1213816.84,DR,REF439958,CBA,Current
13-09-2025 15:12,INT4E38499A2C77427CB99D,063-000-002,33333333,TRANSFER TO NAB 44444444,543.67,0,1213273.17,DR,INT-63551,CBA,Current
13-09-2025 15:19,CBA8511087D19E847E1956D,063-000-002,33333333,JB HI-FI CBA,26.59,0,1213246.58,DR,REF991962,CBA,Current
13-09-2025 15:35,CBADED008F11CD147B98DDC,063-000-002,33333333,LIQUORLAND CBA,21.79,0,1213224.79,DR,REF618875,CBA,Current
13-09-2025 15:46,CBA5D50FC3A8386455C9E7F,063-000-002,33333333,CITYLINK CBA,31.71,0,1213193.08,DR,REF601331,CBA,Current
13-09-2025 15:54,CBAC640AAC9FBF54BA4A0D5,063-000-002,33333333,COLES CBA,98.04,0,1213095.04,DR,REF805365,CBA,Current
13-09-2025 15:56,CBA6C030323C97846EAA36B,063-000-002,33333333,APPLE CBA,3.4,0,1213091.64,DR,REF880832,CBA,Current
13-09-2025 16:20,CBA674C09F53AD941908636,063-000-002,33333333,SPOTIFY CBA,14.35,0,1213077.29,DR,REF752699,CBA,Current
13-09-2025 16:23,CBA82CC4E92622648298049,063-000-002,33333333,MENULOG CBA,34.58,0,1213042.71,DR,REF534545,CBA,Current
13-09-2025 16:27,CBAB5160FE877704FC49608,063-000-002,33333333,RAILWAY STATION CBA,123.54,0,1212919.17,DR,REF380870,CBA,Current
13-09-2025 16:36,CBA6B1451712EC5429DA288,063-000-002,33333333,WAGES CREDIT CBA,0,5402.28,1218321.45,CR,REF735846,CBA,Current
13-09-2025 16:38,CBA79A36752565446D08E1A,063-000-002,33333333,PAYMENT GATEWAY CBA,40.46,0,1218280.99,DR,REF755354,CBA,Current
13-09-2025 16:44,CBAD507A6E0EB054587BC26,063-000-002,33333333,CITYLINK CBA,6.4,0,1218274.59,DR,REF125449,CBA,Current
13-09-2025 17:14,CBAF7F1DEB416854BF9B0D0,063-000-002,33333333,PAY - SALARY CBA,0,5687.29,1223961.88,CR,REF488382,CBA,Current
13-09-2025 17:20,CBA4DE3538C786A4CF5A626,063-000-002,33333333,CITYLINK CBA,51.39,0,1223910.49,DR,REF131160,CBA,Current
13-09-2025 17:30,CBA006590FA66A749D08A5D,063-000-002,33333333,PAYMENT GATEWAY CBA,83.1,0,1223827.39,DR,REF690094,CBA,Current
13-09-2025 17:30,CBAC8694060A011484FBEFC,063-000-002,33333333,BWS CBA,83.05,0,1223744.34,DR,REF616363,CBA,Current
13-09-2025 17:31,CBA22466C22B9B9442B9688,063-000-002,33333333,ZOOM CBA,30.47,0,1223713.87,DR,REF206603,CBA,Current
13-09-2025 17:41,CBADF61262A9E6F44F0BE76,063-000-002,33333333,SHELL CBA,15.46,0,1223698.41,DR,REF765900,CBA,Current
13-09-2025 17:44,CBAC51F3F5A513344BCA98D,063-000-002,33333333,ZOOM CBA,127.29,0,1223571.12,DR,REF378859,CBA,Current
13-09-2025 18:10,CBA55EE63BE19E041CCAD78,063-000-002,33333333,KFC CBA,158.49,0,1223412.63,DR,REF649058,CBA,Current
13-09-2025 19:14,CBA8C913380D6974816B9B0,063-000-002,33333333,UBER EATS CBA,17.37,0,1223395.26,DR,REF504270,CBA,Current
13-09-2025 19:19,CBA7A3A81ECEC3840A4AFD4,063-000-002,33333333,BP CBA,23.96,0,1223371.3,DR,REF325513,CBA,Current
13-09-2025 19:24,CBA73E9A1A093BB481795D0,063-000-002,33333333,BIGW CBA,138.64,0,1223232.66,DR,REF702910,CBA,Current
13-09-2025 19:31,CBA5CB182D358E04D47BD4D,063-000-002,33333333,HARVEY NORMAN CBA,48.4,0,1223184.26,DR,REF821380,CBA,Current
13-09-2025 19:54,CBAE90FCE9D74334FEA9273,063-000-002,33333333,KFC CBA,55.61,0,1223128.65,DR,REF263575,CBA,Current
13-09-2025 19:55,CBA02557624E13443E1A696,063-000-002,33333333,HARVEY NORMAN CBA,28.6,0,1223100.05,DR,REF182223,CBA,Current
13-09-2025 20:02,CBAF9336524780E4FA4B2F8,063-000-002,33333333,ALDI CBA,81.21,0,1223018.84,DR,REF666703,CBA,Current
13-09-2025 20:08,CBA85BEE5885C7440839F18,063-000-002,33333333,HARVEY NORMAN CBA,81.82,0,1222937.02,DR,REF430094,CBA,Current
13-09-2025 21:52,CBA656D2C5FA5614DE79D6E,063-000-002,33333333,MENULOG CBA,9.23,0,1222927.79,DR,REF214123,CBA,Current
13-09-2025 21:55,CBAA1DA8B634489477CB8F5,063-000-002,33333333,7-ELEVEN CBA,123.88,0,1222803.91,DR,REF983711,CBA,Current
13-09-2025 22:16,CBA9CDB5EBAB626467EB79A,063-000-002,33333333,CITYLINK CBA,11.43,0,1222792.48,DR,REF334100,CBA,Current
13-09-2025 23:04,CBA602077E1B9C6423E92D6,063-000-002,33333333,MCDONALDS CBA,24.45,0,1222768.03,DR,REF765333,CBA,Current
13-09-2025 23:13,CBA5661A41E9F8C4176AFD4,063-000-002,33333333,SALARY PAYMENT CBA,0,620.62,1223388.65,CR,REF842452,CBA,Current
14-09-2025 00:08,CBAA37FBEA553A34A6E822C,063-000-002,33333333,BP CBA,35.99,0,1223352.66,DR,REF104623,CBA,Current
14-09-2025 00:31,CBA1A03EE8708414482B73D,063-000-002,33333333,BANK FEE CBA,14.18,0,1223338.48,DR,REF820893,CBA,Current
14-09-2025 01:02,CBA0BE5307D98794B5F9A46,063-000-002,33333333,UBER EATS CBA,42.12,0,1223296.36,DR,REF297150,CBA,Current
14-09-2025 01:05,CBA4ABBD40E78244A2E826D,063-000-002,33333333,DOMINO'S PIZZA CBA,8.16,0,1223288.2,DR,REF172628,CBA,Current
14-09-2025 01:09,CBA05944CC86C6C4537ADB5,063-000-002,33333333,BANK FEE CBA,24.03,0,1223264.17,DR,REF936811,CBA,Current
14-09-2025 01:49,CBA32C2A0BD7349439B9F4F,063-000-002,33333333,SPOTIFY CBA,118.75,0,1223145.42,DR,REF714580,CBA,Current
14-09-2025 01:49,CBAC56C2984C3C34810A261,063-000-002,33333333,UBER EATS CBA,35.02,0,1223110.4,DR,REF222472,CBA,Current
14-09-2025 02:56,CBA9B8EBE0D6BE34CADBD43,063-000-002,33333333,APPLE CBA,58.01,0,1223052.39,DR,REF102410,CBA,Current
14-09-2025 03:07,INTD7EAA37AD9BD4C9AA0D5,063-000-002,33333333,TRANSFER FROM ANZ 11111111,0,1724.65,1224777.04,CR,INT-97098,CBA,Current
14-09-2025 04:00,CBADFF3486854F542B2B9B6,063-000-002,33333333,WAGES CREDIT CBA,0,7198.14,1231975.18,CR,REF490150,CBA,Current
14-09-2025 04:01,CBAC4541073ECF645C9B532,063-000-002,33333333,ALDI CBA,86.56,0,1231888.62,DR,REF699763,CBA,Current
14-09-2025 04:08,CBA380A64DAA1DE4445AC64,063-000-002,33333333,HARVEY NORMAN CBA,9.95,0,1231878.67,DR,REF349507,CBA,Current
14-09-2025 04:15,CBA2B61C0343DF244CAAB4B,063-000-002,33333333,INTERNET TRANSFER CBA,87.51,0,1231791.16,DR,REF227998,CBA,Current
14-09-2025 04:16,CBA75882DA384824CC9A945,063-000-002,33333333,SHELL CBA,6.68,0,1231784.48,DR,REF646390,CBA,Current
14-09-2025 04:41,CBA9AF5105C98634F6D9F9D,063-000-002,33333333,MENULOG CBA,34.04,0,1231750.44,DR,REF812503,CBA,Current
14-09-2025 05:36,CBA61A743F246D5418BB4BA,063-000-002,33333333,BP CBA,60.53,0,1231689.91,DR,REF546659,CBA,Current
14-09-2025 06:34,CBAA654F3C2D30B47259244,063-000-002,33333333,DOMINO'S PIZZA CBA,10.66,0,1231679.25,DR,REF591676,CBA,Current
14-09-2025 06:35,CBA4FCFA2BC1D654BAA9528,063-000-002,33333333,PAYMENT GATEWAY CBA,43.08,0,1231636.17,DR,REF440241,CBA,Current
14-09-2025 06:37,CBA0347DB9682284F4A94D8,063-000-002,33333333,KFC CBA,2.56,0,1231633.61,DR,REF356907,CBA,Current
14-09-2025 06:39,CBA25CCC2FD1626437982C9,063-000-002,33333333,TAFE BOOKSHOP CBA,60.71,0,1231572.9,DR,REF385888,CBA,Current
14-09-2025 06:39,CBA1DA780DFE7914431911A,063-000-002,33333333,PAYMENT GATEWAY CBA,41.79,0,1231531.11,DR,REF353248,CBA,Current
14-09-2025 06:52,CBAF755C10D4D57433CA1D4,063-000-002,33333333,MENULOG CBA,136.83,0,1231394.28,DR,REF876962,CBA,Current
14-09-2025 07:19,CBACC43834FB03840958A0E,063-000-002,33333333,RAILWAY STATION CBA,13.52,0,1231380.76,DR,REF315296,CBA,Current
14-09-2025 07:32,CBA9EE3C30F231C47048AF6,063-000-002,33333333,SALARY PAYMENT CBA,0,5792.75,1237173.51,CR,REF620029,CBA,Current
14-09-2025 07:39,CBA162FF7EC582547968434,063-000-002,33333333,AMAZON AU CBA,43.55,0,1237129.96,DR,REF170557,CBA,Current
14-09-2025 07:51,CBA5A397F0936104A49BB27,063-000-002,33333333,BIGW CBA,19.46,0,1237110.5,DR,REF341272,CBA,Current
14-09-2025 08:09,CBA30F25846305C41519B5F,063-000-002,33333333,STARBUCKS CBA,6.28,0,1237104.22,DR,REF471338,CBA,Current
14-09-2025 08:54,CBA0A28A46805F343CFA5C8,063-000-002,33333333,MENULOG CBA,16.53,0,1237087.69,DR,REF191879,CBA,Current
14-09-2025 09:02,CBA87445F180B4E42439DF7,063-000-002,33333333,UBER EATS CBA,43.78,0,1237043.91,DR,REF794458,CBA,Current
14-09-2025 09:45,INTEDDADB52C41F47219B30,063-000-002,33333333,TRANSFER TO NAB 44444444,1173.81,0,1235870.1,DR,INT-94856,CBA,Current
14-09-2025 11:04,INTB9534A9F207F4672BA21,063-000-002,33333333,TRANSFER FROM CBA 22222222,0,1560.64,1237430.74,CR,INT-39280,CBA,Current
14-09-2025 11:39,CBAFB9F3175D4054411B3B8,063-000-002,33333333,LIQUORLAND CBA,111.55,0,1237319.19,DR,REF259004,CBA,Current
14-09-2025 11:43,CBAD4160D42F52F4BF6A152,063-000-002,33333333,PAYPAL *NETFLIX CBA,71.61,0,1237247.58,DR,REF915545,CBA,Current
14-09-2025 12:32,CBAB3FD40661FF2441788C0,063-000-002,33333333,TAFE BOOKSHOP CBA,19.13,0,1237228.45,DR,REF287694,CBA,Current
14-09-2025 12:32,CBA651CF89AA66D41B8A908,063-000-002,33333333,MCDONALDS CBA,36.16,0,1237192.29,DR,REF904663,CBA,Current
14-09-2025 12:36,CBA021267926E2A4B49AEB1,063-000-002,33333333,UBER EATS CBA,25.89,0,1237166.4,DR,REF524144,CBA,Current
14-09-2025 12:48,CBAA7025C6CDFBF474A86E6,063-000-002,33333333,HARVEY NORMAN CBA,22.8,0,1237143.6,DR,REF126376,CBA,Current
14-09-2025 12:59,CBA6592626D350948F2A757,063-000-002,33333333,FLIXBUS CBA,40.44,0,1237103.16,DR,REF469132,CBA,Current
14-09-2025 13:12,CBABD3BA0A1350E4795A0C6,063-000-002,33333333,PAY - SALARY CBA,0,800.24,1237903.4,CR,REF743350,CBA,Current
14-09-2025 13:37,CBA23A8E79CA9B444A7AE68,063-000-002,33333333,FLIXBUS CBA,37.36,0,1237866.04,DR,REF247294,CBA,Current
14-09-2025 13:38,CBADECD0301A0C94A6E8A97,063-000-002,33333333,CITYLINK CBA,34.41,0,1237831.63,DR,REF488987,CBA,Current
14-09-2025 13:53,CBA45946E4E75444294ADC1,063-000-002,33333333,BWS CBA,7.12,0,1237824.51,DR,REF334267,CBA,Current
14-09-2025 13:59,CBAAF7E1AD1CB71455EBC7B,063-000-002,33333333,SHELL CBA,137.06,0,1237687.45,DR,REF673521,CBA,Current
14-09-2025 14:11,CBAC0F32DC960CA4F868878,063-000-002,33333333,7-ELEVEN CBA,22.42,0,1237665.03,DR,REF469485,CBA,Current
14-09-2025 14:17,CBAF19CF0EDD8E34352A5CF,063-000-002,33333333,ALDI CBA,74.95,0,1237590.08,DR,REF329772,CBA,Current
14-09-2025 14:27,CBA02615373B0164E12A309,063-000-002,33333333,WAGES CREDIT CBA,0,7404.68,1244994.76,CR,REF788278,CBA,Current
14-09-2025 16:12,CBA41DCAFE216134F67AB12,063-000-002,33333333,HARVEY NORMAN CBA,26.82,0,1244967.94,DR,REF488583,CBA,Current
14-09-2025 16:44,CBAD096A9BD314043E78851,063-000-002,33333333,KFC CBA,40.33,0,1244927.61,DR,REF566733,CBA,Current
14-09-2025 17:13,CBAC173FE77868E4265B53B,063-000-002,33333333,COLES CBA,41.76,0,1244885.85,DR,REF311515,CBA,Current
14-09-2025 17:39,CBAE343608FAE3D4DBFBFCC,063-000-002,33333333,SHELL CBA,73.83,0,1244812.02,DR,REF334029,CBA,Current
14-09-2025 17:41,CBA6A964129EA9F4C3CBB06,063-000-002,33333333,SHELL CBA,22.94,0,1244789.08,DR,REF604572,CBA,Current
14-09-2025 17:51,CBAF6EC6A19BBC84271B674,063-000-002,33333333,APPLE CBA,106.58,0,1244682.5,DR,REF466700,CBA,Current
14-09-2025 18:15,CBAE3F112271D8645EFBAE5,063-000-002,33333333,WOOLWORTHS CBA,5.7,0,1244676.8,DR,REF597775,CBA,Current
14-09-2025 18:18,INTAF5FF48BE6B5421EAB8A,063-000-002,33333333,TRANSFER TO ANZ 11111111,1332.51,0,1243344.29,DR,INT-60869,CBA,Current
14-09-2025 18:29,CBA5886BDC6AB6441A8A16B,063-000-002,33333333,AMAZON AU CBA,9.34,0,1243334.95,DR,REF965253,CBA,Current
14-09-2025 19:23,CBAF1D31951F1FB4EAE8772,063-000-002,33333333,MCDONALDS CBA,52.41,0,1243282.54,DR,REF475694,CBA,Current
14-09-2025 19:29,INT82C070DC3D7B4AB38B61,063-000-002,33333333,TRANSFER TO NAB 44444444,1853.6,0,1241428.94,DR,INT-96287,CBA,Current
14-09-2025 19:31,CBA00FE78E70F254356A05D,063-000-002,33333333,FLIXBUS CBA,155.29,0,1241273.65,DR,REF826919,CBA,Current
14-09-2025 19:36,CBA62301BB552294846B35E,063-000-002,33333333,FLIXBUS CBA,13.38,0,1241260.27,DR,REF866126,CBA,Current
14-09-2025 19:41,CBA67B2F3A5E9584A6CB028,063-000-002,33333333,RAILWAY STATION CBA,34.18,0,1241226.09,DR,REF538504,CBA,Current
14-09-2025 19:54,CBAA05C40368C514005A388,063-000-002,33333333,ALDI CBA,15.76,0,1241210.33,DR,REF934096,CBA,Current
14-09-2025 20:45,CBAB48E2942208D4DC89133,063-000-002,33333333,HARVEY NORMAN CBA,143.25,0,1241067.08,DR,REF591297,CBA,Current
14-09-2025 21:04,CBAA156DDD233B24642BBA8,063-000-002,33333333,FLIXBUS CBA,59.45,0,1241007.63,DR,REF107454,CBA,Current
14-09-2025 21:18,CBA82D6298218CE47848FB8,063-000-002,33333333,MENULOG CBA,16.19,0,1240991.44,DR,REF761058,CBA,Current
14-09-2025 21:18,CBA991BC85D0BCF4A6A8A14,063-000-002,33333333,KFC CBA,87.29,0,1240904.15,DR,REF105271,CBA,Current
14-09-2025 21:48,CBA6E15A4B857B740419B49,063-000-002,33333333,FLIXBUS CBA,16.6,0,1240887.55,DR,REF886951,CBA,Current
14-09-2025 22:13,CBA698BB8EDE715448B9B53,063-000-002,33333333,TAFE BOOKSHOP CBA,187.86,0,1240699.69,DR,REF924265,CBA,Current
14-09-2025 22:25,CBA20EF3160479D4957BA56,063-000-002,33333333,RAILWAY STATION CBA,26.24,0,1240673.45,DR,REF778920,CBA,Current
14-09-2025 22:35,INT2A38F642AA8B4B86AF36,063-000-002,33333333,TRANSFER FROM ANZ 11111111,0,1868.12,1242541.57,CR,INT-26134,CBA,Current
14-09-2025 22:38,CBA2BB0052AFAF844E7A7D6,063-000-002,33333333,ZOOM CBA,56.49,0,1242485.08,DR,REF218690,CBA,Current
14-09-2025 23:30,CBA5A2D8548CCC74ADA8595,063-000-002,33333333,DOMINO'S PIZZA CBA,23.61,0,1242461.47,DR,REF482969,CBA,Current
14-09-2025 23:42,CBAEA3C46F77C5B4A43B2C6,063-000-002,33333333,TAFE BOOKSHOP CBA,26.86,0,1242434.61,DR,REF661846,CBA,Current
14-09-2025 23:57,CBABE76367E826E4BE28E02,063-000-002,33333333,7-ELEVEN CBA,186.61,0,1242248,DR,REF747581,CBA,Current
15-09-2025 00:01,CBA0A9D4984DAC2482DA974,063-000-002,33333333,WAGES CREDIT CBA,0,670.59,1242918.59,CR,REF862248,CBA,Current
15-09-2025 00:02,CBA6A342F82EB6D46D3A3CE,063-000-002,33333333,COLES CBA,63.33,0,1242855.26,DR,REF894563,CBA,Current
15-09-2025 00:27,CBA1C559F1148074D7D8F46,063-000-002,33333333,BANK FEE CBA,115.43,0,1242739.83,DR,REF376646,CBA,Current
15-09-2025 01:11,CBA93C231601999495FAEF1,063-000-002,33333333,INTERNET TRANSFER CBA,6.42,0,1242733.41,DR,REF749995,CBA,Current
15-09-2025 01:32,CBAA5AC5EC4FC5F43868B13,063-000-002,33333333,FLIXBUS CBA,27.54,0,1242705.87,DR,REF279382,CBA,Current
15-09-2025 01:37,CBA00C0BFD7B77B4CEA9A92,063-000-002,33333333,CITYLINK CBA,60.27,0,1242645.6,DR,REF307583,CBA,Current
15-09-2025 01:42,CBAC29F8D7A4C9340B9BE71,063-000-002,33333333,STARBUCKS CBA,27.1,0,1242618.5,DR,REF305066,CBA,Current
15-09-2025 02:20,CBAF9B25ABD3AEF4EBFBCA9,063-000-002,33333333,ZOOM CBA,17.31,0,1242601.19,DR,REF682405,CBA,Current
15-09-2025 02:32,CBA339F3983092145E4BF18,063-000-002,33333333,RAILWAY STATION CBA,24.66,0,1242576.53,DR,REF911701,CBA,Current
15-09-2025 02:35,CBA7BCAB8097AF54D1A8501,063-000-002,33333333,ZOOM CBA,66.71,0,1242509.82,DR,REF866769,CBA,Current
15-09-2025 02:52,CBAA5F003C2B8A646A4B04B,063-000-002,33333333,ALDI CBA,10.42,0,1242499.4,DR,REF135621,CBA,Current
15-09-2025 03:14,CBA36C48084AF924B4FBD11,063-000-002,33333333,UBER EATS CBA,42.82,0,1242456.58,DR,REF689426,CBA,Current
15-09-2025 03:18,CBAE98796A204034916AE24,063-000-002,33333333,DOMINO'S PIZZA CBA,80.15,0,1242376.43,DR,REF854066,CBA,Current
15-09-2025 03:21,CBAB0BB467254344E7182D6,063-000-002,33333333,JB HI-FI CBA,100.03,0,1242276.4,DR,REF992028,CBA,Current
15-09-2025 03:42,CBAA42314C4D5F640E29686,063-000-002,33333333,HARVEY NORMAN CBA,20.1,0,1242256.3,DR,REF139914,CBA,Current
15-09-2025 04:55,CBA7DB507E5EC4F45908742,063-000-002,33333333,ALDI CBA,25.66,0,1242230.64,DR,REF282167,CBA,Current
15-09-2025 05:09,INT0C066872E6DB4444A54D,063-000-002,33333333,TRANSFER TO CBA 22222222,1317.2,0,1240913.44,DR,INT-45363,CBA,Current
15-09-2025 05:16,CBAA16046D78C3E4EB2AC25,063-000-002,33333333,JB HI-FI CBA,29.89,0,1240883.55,DR,REF405891,CBA,Current
15-09-2025 05:29,CBA9992B7F952D540779FD4,063-000-002,33333333,PAYPAL *NETFLIX CBA,20.55,0,1240863,DR,REF542086,CBA,Current
15-09-2025 05:32,CBA03DD9F8610464178B60D,063-000-002,33333333,JB HI-FI CBA,30.31,0,1240832.69,DR,REF695268,CBA,Current
15-09-2025 05:33,CBA6328DBD616F645F58BAE,063-000-002,33333333,UBER EATS CBA,4.86,0,1240827.83,DR,REF990754,CBA,Current
15-09-2025 05:51,CBA45CB3519A5344059A943,063-000-002,33333333,WAGES CREDIT CBA,0,3357.14,1244184.97,CR,REF284807,CBA,Current
15-09-2025 05:53,CBAAF51984DEA7F492597AC,063-000-002,33333333,WOOLWORTHS CBA,174.99,0,1244009.98,DR,REF458322,CBA,Current
15-09-2025 06:00,CBA43289462BF674CD6950B,063-000-002,33333333,MENULOG CBA,31.48,0,1243978.5,DR,REF579165,CBA,Current
15-09-2025 06:17,CBA3F30D79BAED24F2A920C,063-000-002,33333333,ALDI CBA,34.02,0,1243944.48,DR,REF539334,CBA,Current
15-09-2025 06:41,CBAF114D9970346468BA338,063-000-002,33333333,STARBUCKS CBA,49.25,0,1243895.23,DR,REF194423,CBA,Current
15-09-2025 06:55,CBA2175C6A075194894BEAB,063-000-002,33333333,SHELL CBA,32.5,0,1243862.73,DR,REF518774,CBA,Current
15-09-2025 08:04,INTA14337916F5F44E3B8A4,063-000-002,33333333,TRANSFER TO ANZ 11111111,1347.79,0,1242514.94,DR,INT-40113,CBA,Current
15-09-2025 08:12,CBA5FFE4E2029704C48B64B,063-000-002,33333333,APPLE CBA,56.47,0,1242458.47,DR,REF422661,CBA,Current
15-09-2025 08:19,CBA4E8771FC14C24D39B1AD,063-000-002,33333333,UBER EATS CBA,46.46,0,1242412.01,DR,REF942018,CBA,Current
15-09-2025 08:58,CBA0335B31EA67A436CB607,063-000-002,33333333,STARBUCKS CBA,13.61,0,1242398.4,DR,REF936377,CBA,Current
15-09-2025 09:00,CBADF02FDA1CC0D45A499A0,063-000-002,33333333,APPLE CBA,84.08,0,1242314.32,DR,REF918159,CBA,Current
15-09-2025 09:05,CBA20C7D1AEE67D4C1A8640,063-000-002,33333333,BIGW CBA,6,0,1242308.32,DR,REF821797,CBA,Current
15-09-2025 09:08,CBAA320228B2CD8497BAAD7,063-000-002,33333333,STARBUCKS CBA,49.15,0,1242259.17,DR,REF386879,CBA,Current
15-09-2025 09:15,CBA21E0058EE50E45089BDD,063-000-002,33333333,PAY - SALARY CBA,0,1040.83,1243300,CR,REF284631,CBA,Current
15-09-2025 09:25,CBA4DF27A510CBE4D9AADD1,063-000-002,33333333,WAGES CREDIT CBA,0,1884.74,1245184.74,CR,REF916176,CBA,Current
15-09-2025 09:34,CBA29DEC1441483499CBECA,063-000-002,33333333,BWS CBA,80.89,0,1245103.85,DR,REF808020,CBA,Current
15-09-2025 09:42,CBA8A97CD438D0644A48226,063-000-002,33333333,BANK FEE CBA,4.38,0,1245099.47,DR,REF707398,CBA,Current
15-09-2025 09:54,CBA4A221A97957644309C6E,063-000-002,33333333,BIGW CBA,56.21,0,1245043.26,DR,REF468818,CBA,Current
15-09-2025 09:56,CBA3A4724E8548048C0B4F8,063-000-002,33333333,WOOLWORTHS CBA,82.34,0,1244960.92,DR,REF635174,CBA,Current
15-09-2025 10:24,CBA5B8D78088F6F443BB79C,063-000-002,33333333,UBER EATS CBA,33.66,0,1244927.26,DR,REF112150,CBA,Current
15-09-2025 10:33,CBA323001993A7A4888B303,063-000-002,33333333,MENULOG CBA,86.02,0,1244841.24,DR,REF246772,CBA,Current
15-09-2025 10:58,INT7D8F67C05E6E47CC9831,063-000-002,33333333,TRANSFER FROM NAB 44444444,0,1029.54,1245870.78,CR,INT-95418,CBA,Current
15-09-2025 11:00,CBACCF0432504A844CCB9B3,063-000-002,33333333,ZOOM CBA,52.96,0,1245817.82,DR,REF693378,CBA,Current
15-09-2025 11:06,CBACC6EC76EEF274BDB895B,063-000-002,33333333,SHELL CBA,18.58,0,1245799.24,DR,REF937556,CBA,Current
15-09-2025 11:18,CBA2AEF656AE97647089791,063-000-002,33333333,COLES CBA,14.03,0,1245785.21,DR,REF142890,CBA,Current
15-09-2025 11:50,CBA9942D972BB564798B764,063-000-002,33333333,RAILWAY STATION CBA,64.83,0,1245720.38,DR,REF621656,CBA,Current
15-09-2025 12:22,CBAB7E14715A2204FFA9194,063-000-002,33333333,SPOTIFY CBA,11.63,0,1245708.75,DR,REF913417,CBA,Current
15-09-2025 12:23,CBA40A0710A4A60468AA1E3,063-000-002,33333333,CITYLINK CBA,21.92,0,1245686.83,DR,REF821037,CBA,Current
15-09-2025 14:00,CBADA66F094C3434AE2AA9C,063-000-002,33333333,MENULOG CBA,47.38,0,1245639.45,DR,REF151080,CBA,Current
15-09-2025 14:21,CBAC4B152BA767341A9986D,063-000-002,33333333,PAYPAL *NETFLIX CBA,16.8,0,1245622.65,DR,REF492578,CBA,Current
15-09-2025 14:26,CBA26E09706D0EF4119A87F,063-000-002,33333333,MCDONALDS CBA,3.13,0,1245619.52,DR,REF826424,CBA,Current
15-09-2025 14:40,CBAE89284F26F3A4CF2AF49,063-000-002,33333333,TAFE BOOKSHOP CBA,28.74,0,1245590.78,DR,REF769289,CBA,Current
15-09-2025 14:48,CBA0FAB7A2ADC434B63B4AE,063-000-002,33333333,LIQUORLAND CBA,20.75,0,1245570.03,DR,REF973557,CBA,Current
15-09-2025 14:49,CBA474A1FFE3EF841F7922C,063-000-002,33333333,SHELL CBA,6.31,0,1245563.72,DR,REF679397,CBA,Current
15-09-2025 15:10,INT0EB261F219824BEBA52E,063-000-002,33333333,TRANSFER TO ANZ 11111111,918.61,0,1244645.11,DR,INT-62501,CBA,Current
15-09-2025 15:39,CBA59C2B5392C9349B39FBA,063-000-002,33333333,MENULOG CBA,54.4,0,1244590.71,DR,REF468534,CBA,Current
15-09-2025 15:42,CBA66A4CA2527724769A85E,063-000-002,33333333,BANK FEE CBA,69.54,0,1244521.17,DR,REF789690,CBA,Current
15-09-2025 16:45,CBA71188868349044FA8C42,063-000-002,33333333,PAYMENT GATEWAY CBA,58.09,0,1244463.08,DR,REF801245,CBA,Current
15-09-2025 17:19,CBAB1AA1CBD88D0445584E2,063-000-002,33333333,SHELL CBA,9,0,1244454.08,DR,REF248250,CBA,Current
15-09-2025 18:00,CBA853383AE2AA84159BF78,063-000-002,33333333,KFC CBA,49.47,0,1244404.61,DR,REF533089,CBA,Current
15-09-2025 18:16,CBAE5A005A68F2841EE8E97,063-000-002,33333333,AMAZON AU CBA,59.65,0,1244344.96,DR,REF117471,CBA,Current
15-09-2025 18:20,CBA8C93E949CDCC4C839B41,063-000-002,33333333,STARBUCKS CBA,15.52,0,1244329.44,DR,REF248265,CBA,Current
15-09-2025 18:47,CBA6ABC97EEE36A486E8A1D,063-000-002,33333333,CITYLINK CBA,42.31,0,1244287.13,DR,REF887281,CBA,Current
15-09-2025 19:02,CBADD3013AD80404B74AC6E,063-000-002,33333333,BP CBA,31,0,1244256.13,DR,REF676515,CBA,Current
15-09-2025 19:45,CBAE750ABCE8D6E465BB9A3,063-000-002,33333333,PAYPAL *NETFLIX CBA,46.89,0,1244209.24,DR,REF181628,CBA,Current
15-09-2025 19:49,CBA1F8F27C4341844F08EE8,063-000-002,33333333,ALDI CBA,22.6,0,1244186.64,DR,REF785821,CBA,Current
15-09-2025 20:57,CBA841F232B897A4425822E,063-000-002,33333333,LIQUORLAND CBA,12.76,0,1244173.88,DR,REF792095,CBA,Current
15-09-2025 21:33,CBA41F61B414EDF43478776,063-000-002,33333333,AMAZON AU CBA,83.75,0,1244090.13,DR,REF553384,CBA,Current
15-09-2025 21:39,CBA92EA68A8643D4B028774,063-000-002,33333333,MCDONALDS CBA,106.12,0,1243984.01,DR,REF551397,CBA,Current
15-09-2025 22:08,CBA8220BCC91CA5484FABC8,063-000-002,33333333,BP CBA,8.32,0,1243975.69,DR,REF298969,CBA,Current
15-09-2025 22:08,CBA3081FF6539C449D78861,063-000-002,33333333,COMPANY PAYROLL CBA,0,7807.13,1251782.82,CR,REF791248,CBA,Current
15-09-2025 22:34,CBAAAE4E8308B79449795A2,063-000-002,33333333,SALARY PAYMENT CBA,0,4801.44,1256584.26,CR,REF884243,CBA,Current
15-09-2025 22:36,CBAA890860AF3BB46D18A39,063-000-002,33333333,UBER EATS CBA,81.07,0,1256503.19,DR,REF889250,CBA,Current
15-09-2025 22:36,CBA451C56DA56294EC99736,063-000-002,33333333,MENULOG CBA,56.2,0,1256446.99,DR,REF707046,CBA,Current
15-09-2025 23:00,CBAC6D1CA0CC03A40E3A590,063-000-002,33333333,DOMINO'S PIZZA CBA,47.31,0,1256399.68,DR,REF597877,CBA,Current
15-09-2025 23:32,CBAC5BF1D45B972413282DF,063-000-002,33333333,WAGES CREDIT CBA,0,7127.75,1263527.43,CR,REF808977,CBA,Current
15-09-2025 23:54,CBA051CA4D65D6047FA9D78,063-000-002,33333333,UBER EATS CBA,82.14,0,1263445.29,DR,REF113649,CBA,Current
15-09-2025 23:57,CBA5E82A50138994A299C23,063-000-002,33333333,BWS CBA,35.34,0,1263409.95,DR,REF365341,CBA,Current
16-09-2025 00:07,CBA0F690A8B708643EEA98D,063-000-002,33333333,KFC CBA,26.36,0,1263383.59,DR,REF325278,CBA,Current
16-09-2025 00:19,CBA713E6D020C2B44DD8870,063-000-002,33333333,MCDONALDS CBA,128.25,0,1263255.34,DR,REF518001,CBA,Current
16-09-2025 00:23,CBA428F14D82C284C78A6F5,063-000-002,33333333,COMPANY PAYROLL CBA,0,3596.57,1266851.91,CR,REF600402,CBA,Current
16-09-2025 00:47,CBA22F3ECB34D6844B4A5E1,063-000-002,33333333,UBER EATS CBA,65.6,0,1266786.31,DR,REF396354,CBA,Current
16-09-2025 01:00,CBA21AE50B4EFFE4F7A92ED,063-000-002,33333333,CITYLINK CBA,117.54,0,1266668.77,DR,REF746104,CBA,Current
16-09-2025 01:07,CBABF9D11384E034C5AA5C3,063-000-002,33333333,7-ELEVEN CBA,44.8,0,1266623.97,DR,REF693278,CBA,Current
16-09-2025 01:15,CBACD8091606EC04F3A8B01,063-000-002,33333333,MENULOG CBA,53.47,0,1266570.5,DR,REF245838,CBA,Current
16-09-2025 01:21,CBA85E2BBB4FB694F22984F,063-000-002,33333333,SHELL CBA,58.16,0,1266512.34,DR,REF256252,CBA,Current
16-09-2025 02:13,CBA8DEA90AAB1A3438E882C,063-000-002,33333333,BWS CBA,9.79,0,1266502.55,DR,REF329863,CBA,Current
16-09-2025 02:15,CBA10BFF7CB7B3C4CBC945E,063-000-002,33333333,CITYLINK CBA,3.67,0,1266498.88,DR,REF487753,CBA,Current
16-09-2025 02:22,CBAD6C7BC5086CA4F26B55A,063-000-002,33333333,APPLE CBA,43.74,0,1266455.14,DR,REF891484,CBA,Current
16-09-2025 02:29,CBAB00580CBB72141F0ABD4,063-000-002,33333333,ALDI CBA,101.9,0,1266353.24,DR,REF344528,CBA,Current
16-09-2025 02:29,CBADF2012A670BB46609746,063-000-002,33333333,PAYROLL CREDIT CBA,0,849.84,1267203.08,CR,REF614543,CBA,Current
16-09-2025 03:10,CBAFD6C5A089EEE4DAFB29A,063-000-002,33333333,TAFE BOOKSHOP CBA,16.38,0,1267186.7,DR,REF814522,CBA,Current
16-09-2025 03:14,CBA99DD1E541596425B9217,063-000-002,33333333,BWS CBA,4.51,0,1267182.19,DR,REF686823,CBA,Current
16-09-2025 03:26,CBA3FBD2258AC8A48C69EA9,063-000-002,33333333,JB HI-FI CBA,42.15,0,1267140.04,DR,REF756066,CBA,Current
16-09-2025 03:41,CBA438573AF60DC456B980D,063-000-002,33333333,MCDONALDS CBA,60.97,0,1267079.07,DR,REF328010,CBA,Current
16-09-2025 03:51,CBAB0F801AFA6F6461F9EFA,063-000-002,33333333,AMAZON AU CBA,43.74,0,1267035.33,DR,REF835495,CBA,Current
16-09-2025 04:11,CBA060EB82B6FF04A6FB43E,063-000-002,33333333,LIQUORLAND CBA,71.86,0,1266963.47,DR,REF777916,CBA,Current
16-09-2025 04:19,CBA35F0C3A4CE6B43198476,063-000-002,33333333,APPLE CBA,12.07,0,1266951.4,DR,REF603186,CBA,Current
16-09-2025 04:55,CBAD719B29EA6F045D6A3B6,063-000-002,33333333,AMAZON AU CBA,14.61,0,1266936.79,DR,REF823911,CBA,Current
16-09-2025 05:13,CBA3DFB6AA27A8340869FF8,063-000-002,33333333,AMAZON AU CBA,41.1,0,1266895.69,DR,REF560922,CBA,Current
16-09-2025 05:23,INTB6824E9182AA4FF59BB2,063-000-002,33333333,TRANSFER FROM NAB 44444444,0,137.09,1267032.78,CR,INT-43361,CBA,Current
16-09-2025 05:34,CBA5ED1F655B4F14DE9ADA0,063-000-002,33333333,KFC CBA,68.57,0,1266964.21,DR,REF866472,CBA,Current
16-09-2025 06:44,CBAA6594900A9EB454DABB4,063-000-002,33333333,SPOTIFY CBA,6.64,0,1266957.57,DR,REF488185,CBA,Current
16-09-2025 07:47,CBA523E31427694454C95F1,063-000-002,33333333,BWS CBA,26.22,0,1266931.35,DR,REF194781,CBA,Current
16-09-2025 07:50,CBAFC3567B5D58345039A3E,063-000-002,33333333,BWS CBA,114.64,0,1266816.71,DR,REF442651,CBA,Current
16-09-2025 08:10,CBA64132EE2933248F08F60,063-000-002,33333333,KFC CBA,361.44,0,1266455.27,DR,REF252393,CBA,Current
16-09-2025 08:29,CBA62483CC768494659A894,063-000-002,33333333,MENULOG CBA,36.07,0,1266419.2,DR,REF849426,CBA,Current
16-09-2025 08:40,CBA43F19972915B4E8FB85F,063-000-002,33333333,CITYLINK CBA,49.68,0,1266369.52,DR,REF917696,CBA,Current
16-09-2025 08:41,CBA26B1A3ED8A4A4267AAD0,063-000-002,33333333,UBER EATS CBA,46.19,0,1266323.33,DR,REF380412,CBA,Current
16-09-2025 09:14,CBAA1ED9A6C02D54C1586CB,063-000-002,33333333,DOMINO'S PIZZA CBA,19.08,0,1266304.25,DR,REF934970,CBA,Current
16-09-2025 09:30,CBAE57FBC5BA3164A3AADEA,063-000-002,33333333,BANK FEE CBA,10.35,0,1266293.9,DR,REF556399,CBA,Current
16-09-2025 09:39,CBA4FE6BDCDB0FE4B42A810,063-000-002,33333333,COMPANY PAYROLL CBA,0,4181.82,1270475.72,CR,REF236647,CBA,Current
16-09-2025 10:00,CBA19A019451A3D4E519531,063-000-002,33333333,MCDONALDS CBA,40.47,0,1270435.25,DR,REF945844,CBA,Current
16-09-2025 10:06,CBACEB449F8ED5C40D1B58A,063-000-002,33333333,MCDONALDS CBA,35.9,0,1270399.35,DR,REF547235,CBA,Current
16-09-2025 10:07,CBAD9E176CD23F04C30A7AF,063-000-002,33333333,LIQUORLAND CBA,188.3,0,1270211.05,DR,REF278413,CBA,Current
16-09-2025 10:13,CBADFF70314F968435A80C9,063-000-002,33333333,WOOLWORTHS CBA,32.46,0,1270178.59,DR,REF144035,CBA,Current
16-09-2025 10:14,CBA5ABBC47FAB2545EA861B,063-000-002,33333333,PAY - SALARY CBA,0,6765.03,1276943.62,CR,REF228307,CBA,Current
16-09-2025 10:53,CBAF9E55E3A947E4ED18D15,063-000-002,33333333,MENULOG CBA,39.35,0,1276904.27,DR,REF961858,CBA,Current
16-09-2025 10:57,CBA567638740BB149BCB522,063-000-002,33333333,BP CBA,330.52,0,1276573.75,DR,REF239877,CBA,Current
16-09-2025 11:09,CBA6B83D99A99A641EB869C,063-000-002,33333333,LIQUORLAND CBA,9.68,0,1276564.07,DR,REF649192,CBA,Current
16-09-2025 11:10,CBA5F4746C54DC449CA8757,063-000-002,33333333,ALDI CBA,54.53,0,1276509.54,DR,REF640827,CBA,Current
16-09-2025 11:12,CBAB540623B79344F8699C6,063-000-002,33333333,BANK FEE CBA,42.98,0,1276466.56,DR,REF572667,CBA,Current
16-09-2025 11:19,CBA5C88445A4E274A05821A,063-000-002,33333333,SPOTIFY CBA,9.21,0,1276457.35,DR,REF788830,CBA,Current
16-09-2025 11:29,CBA17AB4FB6C9B74B7CB40D,063-000-002,33333333,TAFE BOOKSHOP CBA,5.4,0,1276451.95,DR,REF404228,CBA,Current
16-09-2025 11:45,CBA641333C026594817A0F1,063-000-002,33333333,JB HI-FI CBA,135.2,0,1276316.75,DR,REF167023,CBA,Current
16-09-2025 12:16,CBA8754F8B072264268B3EA,063-000-002,33333333,SALARY PAYMENT CBA,0,7648.88,1283965.63,CR,REF296240,CBA,Current
16-09-2025 12:40,CBAB81D607C007A4A798B56,063-000-002,33333333,ALDI CBA,34.17,0,1283931.46,DR,REF968205,CBA,Current
16-09-2025 13:13,CBAA37CB1139FCF4A5AA087,063-000-002,33333333,HARVEY NORMAN CBA,52.25,0,1283879.21,DR,REF486880,CBA,Current
16-09-2025 13:13,CBA6FA94D939DF14BE08C2A,063-000-002,33333333,SPOTIFY CBA,29.11,0,1283850.1,DR,REF845010,CBA,Current
16-09-2025 13:32,CBA6F0F58C1771C42B9B1F7,063-000-002,33333333,COMPANY PAYROLL CBA,0,2096.41,1285946.51,CR,REF603453,CBA,Current
16-09-2025 13:35,CBAB2E1BB10C3C44B1AA05F,063-000-002,33333333,SHELL CBA,30.23,0,1285916.28,DR,REF825469,CBA,Current
16-09-2025 13:56,CBA1B9D1F6531334BDB8537,063-000-002,33333333,BIGW CBA,16.51,0,1285899.77,DR,REF442418,CBA,Current
16-09-2025 14:29,CBA8BB6708FE2E74038BA29,063-000-002,33333333,BANK FEE CBA,58.74,0,1285841.03,DR,REF777429,CBA,Current
16-09-2025 14:32,CBA52EC7792F63942499ADF,063-000-002,33333333,BANK FEE CBA,18.89,0,1285822.14,DR,REF109829,CBA,Current
16-09-2025 16:40,CBA5AA39ABB7DCB444EA700,063-000-002,33333333,AMAZON AU CBA,15.66,0,1285806.48,DR,REF286887,CBA,Current
16-09-2025 17:05,CBA1E958DB35D8F4BBCBDF0,063-000-002,33333333,BWS CBA,87.33,0,1285719.15,DR,REF516803,CBA,Current
16-09-2025 17:08,CBAA6A0925476B047DC8243,063-000-002,33333333,KFC CBA,244.93,0,1285474.22,DR,REF484477,CBA,Current
16-09-2025 17:23,CBA5B2DCB998FC64C31948B,063-000-002,33333333,COLES CBA,63.22,0,1285411,DR,REF308232,CBA,Current
16-09-2025 17:36,CBA71DF2522EF1341818F6F,063-000-002,33333333,7-ELEVEN CBA,92.9,0,1285318.1,DR,REF204412,CBA,Current
16-09-2025 17:57,CBA6425BA14DBF944E8A817,063-000-002,33333333,AMAZON AU CBA,37.23,0,1285280.87,DR,REF550608,CBA,Current
16-09-2025 18:04,CBAD3CCA6E115874F1EB1A3,063-000-002,33333333,JB HI-FI CBA,10.14,0,1285270.73,DR,REF119604,CBA,Current
16-09-2025 18:12,CBADC96230EE0F34741B94B,063-000-002,33333333,ALDI CBA,38.97,0,1285231.76,DR,REF380600,CBA,Current
16-09-2025 18:17,CBA22AD2BBD63DD411EB118,063-000-002,33333333,STARBUCKS CBA,26.51,0,1285205.25,DR,REF881316,CBA,Current
16-09-2025 18:18,INT00E480D800404070B061,063-000-002,33333333,TRANSFER FROM NAB 44444444,0,1337.7,1286542.95,CR,INT-58689,CBA,Current
16-09-2025 18:41,CBA393AA91987B64B11BBA0,063-000-002,33333333,PAYMENT GATEWAY CBA,53.97,0,1286488.98,DR,REF244042,CBA,Current
16-09-2025 19:42,CBA1788C1DA1E9B438FB3EF,063-000-002,33333333,UBER EATS CBA,67.18,0,1286421.8,DR,REF397841,CBA,Current
16-09-2025 19:45,CBA1E6EEEEED1214BC8BDAE,063-000-002,33333333,BWS CBA,9.07,0,1286412.73,DR,REF975546,CBA,Current
16-09-2025 20:21,CBAAAA2ADD7399D418E82D9,063-000-002,33333333,BWS CBA,116.2,0,1286296.53,DR,REF823130,CBA,Current
16-09-2025 20:27,CBAB5A57735302B43E99EED,063-000-002,33333333,BP CBA,13.06,0,1286283.47,DR,REF360786,CBA,Current
16-09-2025 20:33,CBADC2DF9C17A3140D39CBE,063-000-002,33333333,PAY - SALARY CBA,0,5595.23,1291878.7,CR,REF207159,CBA,Current
16-09-2025 21:04,CBA72366F772F02403A8521,063-000-002,33333333,BANK FEE CBA,54.8,0,1291823.9,DR,REF554002,CBA,Current
16-09-2025 21:54,CBA7FC2F2EFB57E47A29668,063-000-002,33333333,PAY - SALARY CBA,0,417.08,1292240.98,CR,REF916923,CBA,Current
16-09-2025 22:30,CBA2EDA9F69B29D49EBADA3,063-000-002,33333333,MCDONALDS CBA,6.01,0,1292234.97,DR,REF886587,CBA,Current
16-09-2025 22:41,CBAD2D6A7B920E0485A8CE0,063-000-002,33333333,BIGW CBA,12.46,0,1292222.51,DR,REF828366,CBA,Current
16-09-2025 22:59,CBA884B4823F97C48F892CC,063-000-002,33333333,HARVEY NORMAN CBA,74.73,0,1292147.78,DR,REF115651,CBA,Current
16-09-2025 23:02,INTE5F7AB36925F4B94B94E,063-000-002,33333333,TRANSFER FROM ANZ 11111111,0,1774.27,1293922.05,CR,INT-20224,CBA,Current
16-09-2025 23:25,CBA8B592A2B291840DDA57F,063-000-002,33333333,DOMINO'S PIZZA CBA,58.71,0,1293863.34,DR,REF637575,CBA,Current
16-09-2025 23:29,CBAC436738E2D6E445195D5,063-000-002,33333333,PAYMENT GATEWAY CBA,10.6,0,1293852.74,DR,REF301896,CBA,Current
17-09-2025 00:00,CBA036E459B7AE34D8FBF9B,063-000-002,33333333,ALDI CBA,45.97,0,1293806.77,DR,REF432986,CBA,Current
17-09-2025 00:57,INTE9540774E9784F2BBE05,063-000-002,33333333,TRANSFER TO NAB 44444444,1338.94,0,1292467.83,DR,INT-80824,CBA,Current
17-09-2025 01:16,CBAD1101B8371CC4675AF47,063-000-002,33333333,COMPANY PAYROLL CBA,0,4817.02,1297284.85,CR,REF244283,CBA,Current
17-09-2025 01:25,CBA1CCC604F84B0403EA311,063-000-002,33333333,ALDI CBA,41.76,0,1297243.09,DR,REF377524,CBA,Current
17-09-2025 01:40,CBA2E656C5D5E874CD18E31,063-000-002,33333333,7-ELEVEN CBA,62.57,0,1297180.52,DR,REF237750,CBA,Current
17-09-2025 01:54,CBA80C058E5494F449591C5,063-000-002,33333333,UBER EATS CBA,6.98,0,1297173.54,DR,REF472723,CBA,Current
17-09-2025 01:56,CBA29F4C658BCC744F09D3D,063-000-002,33333333,PAYROLL CREDIT CBA,0,105.56,1297279.1,CR,REF275099,CBA,Current
17-09-2025 02:16,CBA6212F2DD022C4D20A015,063-000-002,33333333,INTERNET TRANSFER CBA,8.09,0,1297271.01,DR,REF984430,CBA,Current
17-09-2025 02:43,CBAEA500A949BE14061A9EF,063-000-002,33333333,TAFE BOOKSHOP CBA,12.44,0,1297258.57,DR,REF660888,CBA,Current
17-09-2025 02:54,CBAA7AB1D4650AA4EB69C46,063-000-002,33333333,HARVEY NORMAN CBA,52.72,0,1297205.85,DR,REF596481,CBA,Current
17-09-2025 03:32,CBA0ACEF339EE144A2B82F2,063-000-002,33333333,BANK FEE CBA,37.06,0,1297168.79,DR,REF327630,CBA,Current
17-09-2025 03:58,CBA3362CE3F626B4EC8B265,063-000-002,33333333,SHELL CBA,16.9,0,1297151.89,DR,REF311240,CBA,Current
17-09-2025 04:24,CBA8630A6F570314FC6A518,063-000-002,33333333,FLIXBUS CBA,100.59,0,1297051.3,DR,REF250429,CBA,Current
17-09-2025 04:42,CBAACF8780B25214641B087,063-000-002,33333333,LIQUORLAND CBA,33.56,0,1297017.74,DR,REF878430,CBA,Current
17-09-2025 04:48,CBAA25DFA1739EB40BCA49C,063-000-002,33333333,INTERNET TRANSFER CBA,83.49,0,1296934.25,DR,REF699341,CBA,Current
17-09-2025 05:14,CBADEB2BC9D49A64A7F929E,063-000-002,33333333,BANK FEE CBA,123.88,0,1296810.37,DR,REF311958,CBA,Current
17-09-2025 05:56,CBAAE2F05AC55FE48E6B1A9,063-000-002,33333333,STARBUCKS CBA,72.67,0,1296737.7,DR,REF291665,CBA,Current
17-09-2025 06:30,CBA63657B52B0984C369C43,063-000-002,33333333,KFC CBA,49.98,0,1296687.72,DR,REF239221,CBA,Current
17-09-2025 06:31,CBADFC84C735E5346A9808F,063-000-002,33333333,PAYROLL CREDIT CBA,0,5039.14,1301726.86,CR,REF746781,CBA,Current
17-09-2025 06:47,CBAB3973971B46C40268138,063-000-002,33333333,MCDONALDS CBA,249.65,0,1301477.21,DR,REF986471,CBA,Current
17-09-2025 06:51,CBAC121764988BB4042A287,063-000-002,33333333,INTERNET TRANSFER CBA,65.23,0,1301411.98,DR,REF397395,CBA,Current
17-09-2025 07:19,CBADCAB47CC256A4980983B,063-000-002,33333333,HARVEY NORMAN CBA,45.54,0,1301366.44,DR,REF976945,CBA,Current
17-09-2025 07:20,INT7DAE9EA75F854470A642,063-000-002,33333333,TRANSFER FROM CBA 22222222,0,1823.75,1303190.19,CR,INT-65058,CBA,Current
17-09-2025 08:15,CBAF377CD7AFDD44250910A,063-000-002,33333333,CITYLINK CBA,32.28,0,1303157.91,DR,REF515895,CBA,Current
17-09-2025 08:38,CBA2875479528674549B806,063-000-002,33333333,RAILWAY STATION CBA,6.62,0,1303151.29,DR,REF705264,CBA,Current
17-09-2025 08:43,INT52739D64364F4DD097C9,063-000-002,33333333,TRANSFER FROM ANZ 11111111,0,1138.24,1304289.53,CR,INT-77526,CBA,Current
17-09-2025 11:29,CBA51A52AA4C82745ADAAD1,063-000-002,33333333,PAYPAL *NETFLIX CBA,23.3,0,1304266.23,DR,REF161911,CBA,Current
17-09-2025 11:30,CBA56E6A04344D6486286EB,063-000-002,33333333,MENULOG CBA,47.77,0,1304218.46,DR,REF291512,CBA,Current
17-09-2025 12:00,CBA8363E14F4FE54039AE36,063-000-002,33333333,BP CBA,92.4,0,1304126.06,DR,REF828198,CBA,Current
17-09-2025 12:04,CBA6325971FA2EE4B1AA9E8,063-000-002,33333333,RAILWAY STATION CBA,56.99,0,1304069.07,DR,REF205378,CBA,Current
17-09-2025 13:07,CBAAB322B6C9D124E2CB717,063-000-002,33333333,JB HI-FI CBA,15.74,0,1304053.33,DR,REF877239,CBA,Current
17-09-2025 13:39,CBA265E83BC1F9549409A5D,063-000-002,33333333,LIQUORLAND CBA,65.94,0,1303987.39,DR,REF870068,CBA,Current
17-09-2025 13:45,CBA1E917D31F7874BB1BFC1,063-000-002,33333333,SALARY PAYMENT CBA,0,797.5,1304784.89,CR,REF728866,CBA,Current
17-09-2025 13:51,CBAB7C2DA0B7E2E48D8BCAD,063-000-002,33333333,KFC CBA,91.72,0,1304693.17,DR,REF750242,CBA,Current
17-09-2025 13:54,CBA95D5B39707FE4B209A85,063-000-002,33333333,PAYPAL *NETFLIX CBA,15.73,0,1304677.44,DR,REF875133,CBA,Current
17-09-2025 14:04,CBA0B9D6977363A4915B7E0,063-000-002,33333333,ZOOM CBA,118.09,0,1304559.35,DR,REF728599,CBA,Current
17-09-2025 14:06,CBA94F9E30961584788897E,063-000-002,33333333,AMAZON AU CBA,52.6,0,1304506.75,DR,REF199385,CBA,Current
17-09-2025 14:16,CBACE51D8837A424717B5A4,063-000-002,33333333,KFC CBA,49.4,0,1304457.35,DR,REF217628,CBA,Current
17-09-2025 14:33,CBAA9A5B14FB1BE4E869073,063-000-002,33333333,STARBUCKS CBA,78.68,0,1304378.67,DR,REF563091,CBA,Current
17-09-2025 14:42,CBAB21EBCAC3C6F460AA9AD,063-000-002,33333333,FLIXBUS CBA,18.42,0,1304360.25,DR,REF777740,CBA,Current
17-09-2025 14:52,CBADD2D355443064BFD9194,063-000-002,33333333,WAGES CREDIT CBA,0,3276.34,1307636.59,CR,REF301386,CBA,Current
17-09-2025 14:52,CBA58D06AD0FF90425E83B1,063-000-002,33333333,RAILWAY STATION CBA,58.38,0,1307578.21,DR,REF869315,CBA,Current
17-09-2025 15:05,CBA9723061FA2704697944D,063-000-002,33333333,BWS CBA,19.53,0,1307558.68,DR,REF300554,CBA,Current
17-09-2025 15:57,CBA01A90C21F1154357B1E9,063-000-002,33333333,WOOLWORTHS CBA,106.1,0,1307452.58,DR,REF146221,CBA,Current
17-09-2025 16:17,CBA7521957BA541460EB321,063-000-002,33333333,SALARY PAYMENT CBA,0,6807.91,1314260.49,CR,REF667894,CBA,Current
17-09-2025 16:17,CBA837EAB6A4BD44845BA49,063-000-002,33333333,APPLE CBA,90.76,0,1314169.73,DR,REF683310,CBA,Current
17-09-2025 17:10,CBA7EF33DD8CBA04F64BAE2,063-000-002,33333333,UBER EATS CBA,75.78,0,1314093.95,DR,REF296401,CBA,Current
17-09-2025 17:29,CBA3450DE4C50564E3A98DD,063-000-002,33333333,PAYPAL *NETFLIX CBA,12.14,0,1314081.81,DR,REF296455,CBA,Current
17-09-2025 18:21,CBA3F611076D5D542D5AF25,063-000-002,33333333,SPOTIFY CBA,36.54,0,1314045.27,DR,REF586668,CBA,Current
17-09-2025 19:11,CBA199C04585E914CF5BD4A,063-000-002,33333333,MCDONALDS CBA,85.79,0,1313959.48,DR,REF231381,CBA,Current
17-09-2025 20:45,CBA4BF28AE5C36148F4A4F6,063-000-002,33333333,BANK FEE CBA,19.91,0,1313939.57,DR,REF198858,CBA,Current
17-09-2025 20:50,CBAE90E4FB2E66444B0A6A5,063-000-002,33333333,TAFE BOOKSHOP CBA,42.45,0,1313897.12,DR,REF731686,CBA,Current
17-09-2025 21:08,CBAF3D3E4143C5E44DCA61E,063-000-002,33333333,BANK FEE CBA,22.33,0,1313874.79,DR,REF225200,CBA,Current
17-09-2025 21:14,CBAFE192EAB34144A68AAE8,063-000-002,33333333,BANK FEE CBA,37.63,0,1313837.16,DR,REF207817,CBA,Current
17-09-2025 21:17,CBA45F9E987BB644D6EB4BA,063-000-002,33333333,PAY - SALARY CBA,0,1189.52,1315026.68,CR,REF604872,CBA,Current
17-09-2025 21:26,CBAC31B7338E90B4728BA43,063-000-002,33333333,AMAZON AU CBA,9.19,0,1315017.49,DR,REF619550,CBA,Current
17-09-2025 21:36,INT84BDC1B0E72844989E1E,063-000-002,33333333,TRANSFER FROM CBA 22222222,0,500.72,1315518.21,CR,INT-22550,CBA,Current
17-09-2025 22:26,CBAAC22E4AA868B42798CA1,063-000-002,33333333,HARVEY NORMAN CBA,22.09,0,1315496.12,DR,REF424565,CBA,Current
17-09-2025 22:35,CBA850A5FED09A44030AF56,063-000-002,33333333,COLES CBA,141.63,0,1315354.49,DR,REF433381,CBA,Current
17-09-2025 23:16,CBAD911B57FC9A4405DB565,063-000-002,33333333,MENULOG CBA,23.18,0,1315331.31,DR,REF683405,CBA,Current
17-09-2025 23:36,CBA7C4E4ED6A1EE4A54B0E3,063-000-002,33333333,FLIXBUS CBA,36.74,0,1315294.57,DR,REF799902,CBA,Current
17-09-2025 23:46,CBA97B15CB2A8C54C3791C4,063-000-002,33333333,LIQUORLAND CBA,41.57,0,1315253,DR,REF344908,CBA,Current
17-09-2025 23:54,CBA0A094529EC0D4838B541,063-000-002,33333333,RAILWAY STATION CBA,52.04,0,1315200.96,DR,REF965726,CBA,Current
17-09-2025 23:59,CBA41DB567217F441B69758,063-000-002,33333333,JB HI-FI CBA,13.3,0,1315187.66,DR,REF415245,CBA,Current
18-09-2025 00:41,INT529A2CDC75954991A4CA,063-000-002,33333333,TRANSFER FROM ANZ 11111111,0,1768.25,1316955.91,CR,INT-52121,CBA,Current
18-09-2025 00:42,CBA9DF9FFCB23C1429785B4,063-000-002,33333333,MENULOG CBA,41.16,0,1316914.75,DR,REF450733,CBA,Current
18-09-2025 01:14,CBABB338D8EE59D44A79D41,063-000-002,33333333,STARBUCKS CBA,60.43,0,1316854.32,DR,REF458812,CBA,Current
18-09-2025 01:15,INT8CAF34D145C540668C40,063-000-002,33333333,TRANSFER TO CBA 22222222,225.03,0,1316629.29,DR,INT-10351,CBA,Current
18-09-2025 01:20,CBA700AF36DC6924239869E,063-000-002,33333333,AMAZON AU CBA,47.55,0,1316581.74,DR,REF359878,CBA,Current
18-09-2025 01:24,CBA66E7B70E142944B08238,063-000-002,33333333,MENULOG CBA,12.36,0,1316569.38,DR,REF989948,CBA,Current
18-09-2025 01:50,CBAFC4B1B670C3E4AA2B02A,063-000-002,33333333,WAGES CREDIT CBA,0,221.26,1316790.64,CR,REF868651,CBA,Current
18-09-2025 02:18,CBA3C8BE2934E0C41078DDF,063-000-002,33333333,HARVEY NORMAN CBA,63.23,0,1316727.41,DR,REF688204,CBA,Current
18-09-2025 02:44,CBAA1548858C4944054A622,063-000-002,33333333,BWS CBA,40.44,0,1316686.97,DR,REF784608,CBA,Current
18-09-2025 03:05,CBAAC3A8BC8ACC24A81B31B,063-000-002,33333333,ALDI CBA,27.67,0,1316659.3,DR,REF431157,CBA,Current
18-09-2025 03:09,CBA77C9CC472D2C49259F33,063-000-002,33333333,TAFE BOOKSHOP CBA,238.04,0,1316421.26,DR,REF261532,CBA,Current
18-09-2025 03:30,CBAB58398A470A54E128706,063-000-002,33333333,ALDI CBA,28.34,0,1316392.92,DR,REF794914,CBA,Current
18-09-2025 03:32,CBAC548C7E40A784BEF9B13,063-000-002,33333333,KFC CBA,3.68,0,1316389.24,DR,REF319409,CBA,Current
18-09-2025 03:41,CBAE0FBB2F9141E476F8D68,063-000-002,33333333,PAYMENT GATEWAY CBA,14.97,0,1316374.27,DR,REF741688,CBA,Current
18-09-2025 03:43,CBA827FAEABE02540169412,063-000-002,33333333,INTERNET TRANSFER CBA,16.73,0,1316357.54,DR,REF685476,CBA,Current
18-09-2025 03:54,CBA98A184E8A643422B87ED,063-000-002,33333333,UBER EATS CBA,59.08,0,1316298.46,DR,REF908915,CBA,Current
18-09-2025 04:05,CBA0178D8D1699448A7A016,063-000-002,33333333,COLES CBA,74.22,0,1316224.24,DR,REF214931,CBA,Current
18-09-2025 04:23,CBA6C6B3AE3EB2648FA804E,063-000-002,33333333,PAY - SALARY CBA,0,805.12,1317029.36,CR,REF234452,CBA,Current
18-09-2025 04:24,CBAD16D7DA081374B3EBBEB,063-000-002,33333333,KFC CBA,19.57,0,1317009.79,DR,REF429857,CBA,Current
18-09-2025 04:34,CBACB57418879A54DC6B013,063-000-002,33333333,ALDI CBA,58.14,0,1316951.65,DR,REF217625,CBA,Current
18-09-2025 04:38,CBA781F46EA69A04223AECF,063-000-002,33333333,7-ELEVEN CBA,155.85,0,1316795.8,DR,REF619054,CBA,Current
18-09-2025 05:21,CBA7F5065FC6527456F81C9,063-000-002,33333333,COLES CBA,42.27,0,1316753.53,DR,REF678194,CBA,Current
18-09-2025 05:25,CBAC598DF50E81746AC893E,063-000-002,33333333,AMAZON AU CBA,31.72,0,1316721.81,DR,REF870343,CBA,Current
18-09-2025 06:15,CBAC0D8C3778F0542919467,063-000-002,33333333,RAILWAY STATION CBA,49.26,0,1316672.55,DR,REF600963,CBA,Current
18-09-2025 06:18,CBA3E13D2B6BBA44D39AFE1,063-000-002,33333333,ZOOM CBA,126.52,0,1316546.03,DR,REF257123,CBA,Current
18-09-2025 06:24,CBA6AE74AB46F694E439E25,063-000-002,33333333,BP CBA,98.1,0,1316447.93,DR,REF551727,CBA,Current
18-09-2025 06:31,CBA3906E6D7E9924F3AA2CC,063-000-002,33333333,INTERNET TRANSFER CBA,8.69,0,1316439.24,DR,REF473686,CBA,Current
18-09-2025 06:42,CBAECA17B1382CD4A509838,063-000-002,33333333,CITYLINK CBA,15.2,0,1316424.04,DR,REF641677,CBA,Current
18-09-2025 06:45,CBA6380A510690E445696AC,063-000-002,33333333,INTERNET TRANSFER CBA,62.05,0,1316361.99,DR,REF951903,CBA,Current
18-09-2025 06:49,CBA281DF5D3AD1849DAA8B8,063-000-002,33333333,DOMINO'S PIZZA CBA,9.34,0,1316352.65,DR,REF942151,CBA,Current
18-09-2025 06:53,CBA686B7547141A4BFB8098,063-000-002,33333333,DOMINO'S PIZZA CBA,12.2,0,1316340.45,DR,REF315599,CBA,Current
18-09-2025 07:07,CBAF6650D144A654B73957B,063-000-002,33333333,BP CBA,16.75,0,1316323.7,DR,REF389733,CBA,Current
18-09-2025 07:28,CBA1768F41F27E74979A090,063-000-002,33333333,JB HI-FI CBA,10.73,0,1316312.97,DR,REF434817,CBA,Current
18-09-2025 07:42,CBA2D547C0ED9DC479786E7,063-000-002,33333333,AMAZON AU CBA,81.43,0,1316231.54,DR,REF943791,CBA,Current
18-09-2025 07:43,CBA48C52B5109874F39A054,063-000-002,33333333,7-ELEVEN CBA,35.23,0,1316196.31,DR,REF223638,CBA,Current
18-09-2025 07:54,CBA69AF14892DD14BFE8A60,063-000-002,33333333,INTERNET TRANSFER CBA,11.15,0,1316185.16,DR,REF761882,CBA,Current
18-09-2025 08:23,CBAB1D28F88238C4E1E983D,063-000-002,33333333,PAYMENT GATEWAY CBA,130.89,0,1316054.27,DR,REF758586,CBA,Current
18-09-2025 08:24,CBA5DB259F130AB4F2F9222,063-000-002,33333333,ZOOM CBA,185.07,0,1315869.2,DR,REF946704,CBA,Current
18-09-2025 08:54,CBA55FD8DDB3727473C8183,063-000-002,33333333,BP CBA,51.99,0,1315817.21,DR,REF298704,CBA,Current
18-09-2025 09:05,CBA930ADE18AC2847CCBA04,063-000-002,33333333,PAYPAL *NETFLIX CBA,20.23,0,1315796.98,DR,REF755574,CBA,Current
18-09-2025 09:16,CBAA0E8F46B15FC42CE8C1C,063-000-002,33333333,SALARY PAYMENT CBA,0,5703.86,1321500.84,CR,REF868051,CBA,Current
18-09-2025 09:23,CBABFDAEDD16419422B85CF,063-000-002,33333333,ZOOM CBA,17.99,0,1321482.85,DR,REF236271,CBA,Current
18-09-2025 10:07,CBA99F1A07B15244B809B40,063-000-002,33333333,MCDONALDS CBA,15.18,0,1321467.67,DR,REF845255,CBA,Current
18-09-2025 10:12,CBA6A87F0873CBC407082A8,063-000-002,33333333,WOOLWORTHS CBA,130.65,0,1321337.02,DR,REF455200,CBA,Current
18-09-2025 10:12,CBABDFF8A525D8348029ECA,063-000-002,33333333,STARBUCKS CBA,129.97,0,1321207.05,DR,REF180119,CBA,Current
18-09-2025 11:22,CBA0786F57B31A648FF8BA0,063-000-002,33333333,BIGW CBA,19.84,0,1321187.21,DR,REF366774,CBA,Current
18-09-2025 11:58,CBAB9A62976980B49CEADED,063-000-002,33333333,UBER EATS CBA,20.51,0,1321166.7,DR,REF102547,CBA,Current
18-09-2025 11:58,CBA593D78E1568F424D865C,063-000-002,33333333,LIQUORLAND CBA,19.92,0,1321146.78,DR,REF291981,CBA,Current
18-09-2025 11:59,CBA19363E46FA754A209225,063-000-002,33333333,PAY - SALARY CBA,0,2486.46,1323633.24,CR,REF673041,CBA,Current
18-09-2025 12:28,INTFAD08F327D46478D8347,063-000-002,33333333,TRANSFER TO NAB 44444444,1244.59,0,1322388.65,DR,INT-83857,CBA,Current
18-09-2025 12:33,CBA24BBCC8EDE4E4AEE8059,063-000-002,33333333,UBER EATS CBA,75.91,0,1322312.74,DR,REF671991,CBA,Current
18-09-2025 12:50,CBAC649A06D1984453AAF28,063-000-002,33333333,BIGW CBA,17.75,0,1322294.99,DR,REF551094,CBA,Current
18-09-2025 13:25,CBA8C7B6A6A043D400D8270,063-000-002,33333333,BIGW CBA,59.53,0,1322235.46,DR,REF166895,CBA,Current
18-09-2025 14:01,CBABC0163A0040A4A5397BB,063-000-002,33333333,PAYPAL *NETFLIX CBA,42.69,0,1322192.77,DR,REF433557,CBA,Current
18-09-2025 14:46,CBAAA7713A8902240D5A036,063-000-002,33333333,SPOTIFY CBA,22.61,0,1322170.16,DR,REF508144,CBA,Current
18-09-2025 15:27,CBAC5368EFE25B142F9B6B7,063-000-002,33333333,MENULOG CBA,23.09,0,1322147.07,DR,REF902399,CBA,Current
18-09-2025 15:30,CBA043FAD5A74F842D6AAC2,063-000-002,33333333,WOOLWORTHS CBA,2.57,0,1322144.5,DR,REF111932,CBA,Current
18-09-2025 15:54,CBA167206B0E1084AA8B092,063-000-002,33333333,SALARY PAYMENT CBA,0,559.31,1322703.81,CR,REF719661,CBA,Current
18-09-2025 16:06,CBA7EFB03DDAB6C47A198DB,063-000-002,33333333,BIGW CBA,6.13,0,1322697.68,DR,REF516948,CBA,Current
18-09-2025 16:13,CBA718DBF3FC1DE493E9A9A,063-000-002,33333333,SPOTIFY CBA,38.07,0,1322659.61,DR,REF724374,CBA,Current
18-09-2025 16:19,CBA0BF9A440C9A049E59CE8,063-000-002,33333333,RAILWAY STATION CBA,48.88,0,1322610.73,DR,REF268485,CBA,Current
18-09-2025 16:21,CBAD58866E85E7F4B8B9EEF,063-000-002,33333333,UBER EATS CBA,206.27,0,1322404.46,DR,REF598529,CBA,Current
18-09-2025 16:25,CBAE2FA5E47356E4DA3B7B8,063-000-002,33333333,BP CBA,13.33,0,1322391.13,DR,REF951595,CBA,Current
18-09-2025 16:53,INT5E878771C5904BD5B832,063-000-002,33333333,TRANSFER TO NAB 44444444,651.88,0,1321739.25,DR,INT-69499,CBA,Current
18-09-2025 17:14,CBA6885FDBA6E774077811C,063-000-002,33333333,PAY - SALARY CBA,0,7444.41,1329183.66,CR,REF558595,CBA,Current
18-09-2025 17:16,CBAD6BA826DB2F5496AB668,063-000-002,33333333,COMPANY PAYROLL CBA,0,7900.12,1337083.78,CR,REF907165,CBA,Current
18-09-2025 17:44,CBAEF2C84E3E00D4376895A,063-000-002,33333333,PAYPAL *NETFLIX CBA,25.79,0,1337057.99,DR,REF188297,CBA,Current
18-09-2025 18:08,CBA9542556C2D9A49F899ED,063-000-002,33333333,PAY - SALARY CBA,0,4048.16,1341106.15,CR,REF666897,CBA,Current
18-09-2025 19:03,CBADA9B7ACFE663469BBF34,063-000-002,33333333,KFC CBA,11.87,0,1341094.28,DR,REF515110,CBA,Current
18-09-2025 19:34,CBA5FDFD12CF6A2415E8216,063-000-002,33333333,SPOTIFY CBA,27.1,0,1341067.18,DR,REF535399,CBA,Current
18-09-2025 20:02,CBA9E2EF0123EC041D2A1BE,063-000-002,33333333,SPOTIFY CBA,68.82,0,1340998.36,DR,REF795453,CBA,Current
18-09-2025 20:42,CBA18E033BD30C94CC5B01E,063-000-002,33333333,AMAZON AU CBA,74.86,0,1340923.5,DR,REF499386,CBA,Current
18-09-2025 21:06,CBA81219D39E90D4C7C9E21,063-000-002,33333333,SALARY PAYMENT CBA,0,7267.01,1348190.51,CR,REF305024,CBA,Current
18-09-2025 21:06,CBA588C098E717E4015B9A8,063-000-002,33333333,BANK FEE CBA,14.45,0,1348176.06,DR,REF275407,CBA,Current
18-09-2025 21:11,CBA9F3ED651F8984B7C8E62,063-000-002,33333333,WOOLWORTHS CBA,57.53,0,1348118.53,DR,REF409768,CBA,Current
18-09-2025 21:11,CBA0226C5051AC845B1AFCC,063-000-002,33333333,PAYROLL CREDIT CBA,0,823.82,1348942.35,CR,REF441008,CBA,Current
18-09-2025 21:18,CBA13B9A0A71858400E8481,063-000-002,33333333,UBER EATS CBA,75.26,0,1348867.09,DR,REF149798,CBA,Current
18-09-2025 21:25,CBAC6E53B0138E24F7FB296,063-000-002,33333333,PAYPAL *NETFLIX CBA,105.2,0,1348761.89,DR,REF592678,CBA,Current
18-09-2025 21:34,CBA8FF76F43B3804233AFCF,063-000-002,33333333,FLIXBUS CBA,59.96,0,1348701.93,DR,REF114752,CBA,Current
18-09-2025 21:38,CBA8F00973F666A458C8AD1,063-000-002,33333333,PAYMENT GATEWAY CBA,18.1,0,1348683.83,DR,REF369757,CBA,Current
18-09-2025 22:21,CBAF3BE3AAF5B83490DAF7E,063-000-002,33333333,PAYPAL *NETFLIX CBA,10.88,0,1348672.95,DR,REF417430,CBA,Current
18-09-2025 22:52,CBAD5F0FBFB9300474DB1F9,063-000-002,33333333,BIGW CBA,55.68,0,1348617.27,DR,REF530631,CBA,Current
18-09-2025 23:02,CBA7843F4ECA9CB43A8A6EC,063-000-002,33333333,MCDONALDS CBA,16.76,0,1348600.51,DR,REF187188,CBA,Current
18-09-2025 23:30,CBA52FFC126099B434FA64C,063-000-002,33333333,SPOTIFY CBA,73.12,0,1348527.39,DR,REF203159,CBA,Current
18-09-2025 23:50,INT219E198048C74DEB8C97,063-000-002,33333333,TRANSFER FROM NAB 44444444,0,253.9,1348781.29,CR,INT-55250,CBA,Current
19-09-2025 01:03,CBA9DBC6ED4CADD44CAB166,063-000-002,33333333,SALARY PAYMENT CBA,0,5872.14,1354653.43,CR,REF765141,CBA,Current
19-09-2025 01:38,INT39683165470F4983B0BF,063-000-002,33333333,TRANSFER FROM NAB 44444444,0,1389.23,1356042.66,CR,INT-31426,CBA,Current
19-09-2025 01:47,CBA8F57C29891CE450D94DF,063-000-002,33333333,AMAZON AU CBA,88.28,0,1355954.38,DR,REF605089,CBA,Current
19-09-2025 01:49,CBA1E7E47291D56433EBA1C,063-000-002,33333333,SHELL CBA,1.83,0,1355952.55,DR,REF752134,CBA,Current
19-09-2025 02:02,CBA8C19E371773F405DA40A,063-000-002,33333333,MENULOG CBA,5.89,0,1355946.66,DR,REF827376,CBA,Current
19-09-2025 02:44,CBA990F2A285A6D4AC1BCE5,063-000-002,33333333,LIQUORLAND CBA,30.82,0,1355915.84,DR,REF825377,CBA,Current
19-09-2025 02:45,INT554F2B3373D74EF091D7,063-000-002,33333333,TRANSFER FROM CBA 22222222,0,1514.49,1357430.33,CR,INT-74839,CBA,Current
19-09-2025 03:06,CBA412E474C6A474FD1A06F,063-000-002,33333333,INTERNET TRANSFER CBA,7.55,0,1357422.78,DR,REF572423,CBA,Current
19-09-2025 03:17,CBAE641E132E5D047ABA6BA,063-000-002,33333333,SALARY PAYMENT CBA,0,5371.67,1362794.45,CR,REF782097,CBA,Current
19-09-2025 03:36,CBA2AEF41030E264B058F3D,063-000-002,33333333,RAILWAY STATION CBA,209.69,0,1362584.76,DR,REF184092,CBA,Current
19-09-2025 04:08,CBA0BC3E18316F94B42B8F7,063-000-002,33333333,TAFE BOOKSHOP CBA,59.08,0,1362525.68,DR,REF797212,CBA,Current
19-09-2025 04:15,CBA83018E3CCBF0487A8ACE,063-000-002,33333333,PAYPAL *NETFLIX CBA,63,0,1362462.68,DR,REF266321,CBA,Current
19-09-2025 05:52,CBA860FD792799F497BB764,063-000-002,33333333,BIGW CBA,5.98,0,1362456.7,DR,REF903273,CBA,Current
19-09-2025 06:02,CBA9D5AD947572B4314B7A0,063-000-002,33333333,COMPANY PAYROLL CBA,0,659.71,1363116.41,CR,REF900666,CBA,Current
19-09-2025 06:04,CBA8FD9AD05E36743DD9490,063-000-002,33333333,BWS CBA,47.41,0,1363069,DR,REF940463,CBA,Current
19-09-2025 06:10,INTB3E928E86DED46BF85BB,063-000-002,33333333,TRANSFER TO CBA 22222222,874.2,0,1362194.8,DR,INT-39662,CBA,Current
19-09-2025 06:29,CBAD2A23A8C500841D79A4A,063-000-002,33333333,HARVEY NORMAN CBA,5.61,0,1362189.19,DR,REF374269,CBA,Current
19-09-2025 06:45,CBAE1241103B27744D7A1F8,063-000-002,33333333,SALARY PAYMENT CBA,0,613.06,1362802.25,CR,REF744161,CBA,Current
19-09-2025 06:59,INT7EF817050CF3489B96AB,063-000-002,33333333,TRANSFER FROM NAB 44444444,0,915.39,1363717.64,CR,INT-59237,CBA,Current
19-09-2025 07:16,CBA7605A4788D2F45799BFC,063-000-002,33333333,INTERNET TRANSFER CBA,6.35,0,1363711.29,DR,REF979483,CBA,Current
19-09-2025 07:56,CBAA799F8B00F0C481DA1A8,063-000-002,33333333,DOMINO'S PIZZA CBA,9.25,0,1363702.04,DR,REF855724,CBA,Current
19-09-2025 08:05,CBA1514486C9ECB4B91B44B,063-000-002,33333333,CITYLINK CBA,69.68,0,1363632.36,DR,REF969874,CBA,Current
19-09-2025 08:54,CBAFA8C396A16584BB2AF62,063-000-002,33333333,CITYLINK CBA,32.54,0,1363599.82,DR,REF261452,CBA,Current
19-09-2025 09:12,CBAB2806AAE753D442DADDB,063-000-002,33333333,MENULOG CBA,13.35,0,1363586.47,DR,REF173318,CBA,Current
19-09-2025 09:15,CBA12EC9023731C474D9BAF,063-000-002,33333333,UBER EATS CBA,79.6,0,1363506.87,DR,REF413162,CBA,Current
19-09-2025 09:25,CBAFD5DF5AAB9D0486F851C,063-000-002,33333333,APPLE CBA,117.49,0,1363389.38,DR,REF375764,CBA,Current
19-09-2025 09:47,CBA590E55A4F75448309AEE,063-000-002,33333333,UBER EATS CBA,317.53,0,1363071.85,DR,REF260884,CBA,Current
19-09-2025 10:06,CBA91F07DB94D1740ACB3B8,063-000-002,33333333,MCDONALDS CBA,71.93,0,1362999.92,DR,REF306350,CBA,Current
19-09-2025 10:45,CBA97285582AFA34B17B4C0,063-000-002,33333333,ZOOM CBA,143.51,0,1362856.41,DR,REF386341,CBA,Current
19-09-2025 10:52,CBAADC8546F4B0541399CF5,063-000-002,33333333,ALDI CBA,45.88,0,1362810.53,DR,REF308113,CBA,Current
19-09-2025 12:17,CBA3D8169152B2D4D07B831,063-000-002,33333333,INTERNET TRANSFER CBA,63.16,0,1362747.37,DR,REF677419,CBA,Current
19-09-2025 12:46,CBA9A9D12C8FD994214AE86,063-000-002,33333333,SPOTIFY CBA,6.77,0,1362740.6,DR,REF558292,CBA,Current
19-09-2025 12:57,CBABEDDE8CAAD1040C4B2E1,063-000-002,33333333,DOMINO'S PIZZA CBA,8.16,0,1362732.44,DR,REF237398,CBA,Current
19-09-2025 13:14,CBAE2C5B7DC61784D07B485,063-000-002,33333333,BIGW CBA,181.41,0,1362551.03,DR,REF339200,CBA,Current
19-09-2025 13:23,CBA8CCC76F32034433EBFE4,063-000-002,33333333,PAYMENT GATEWAY CBA,6.74,0,1362544.29,DR,REF730528,CBA,Current
19-09-2025 13:31,CBA48C7F3420309450886DB,063-000-002,33333333,JB HI-FI CBA,14.59,0,1362529.7,DR,REF825949,CBA,Current
19-09-2025 14:02,CBA97E7295FFEFC414086FB,063-000-002,33333333,APPLE CBA,23.02,0,1362506.68,DR,REF719030,CBA,Current
19-09-2025 14:56,INT28A91347BA024CD48029,063-000-002,33333333,TRANSFER TO ANZ 11111111,1859.16,0,1360647.52,DR,INT-26812,CBA,Current
19-09-2025 16:01,CBAACE48FBAE2424613B363,063-000-002,33333333,PAY - SALARY CBA,0,5095.93,1365743.45,CR,REF730683,CBA,Current
19-09-2025 16:04,CBA94F15F977DF644CE907F,063-000-002,33333333,DOMINO'S PIZZA CBA,29.44,0,1365714.01,DR,REF495300,CBA,Current
19-09-2025 16:11,CBAE03D6CA06632445A996B,063-000-002,33333333,PAYPAL *NETFLIX CBA,15.32,0,1365698.69,DR,REF906329,CBA,Current
19-09-2025 16:16,CBA98B9DD94FD1345C98F5A,063-000-002,33333333,LIQUORLAND CBA,12.27,0,1365686.42,DR,REF971726,CBA,Current
19-09-2025 16:19,CBAEF7BA1CAA6AE4F00A3BF,063-000-002,33333333,TAFE BOOKSHOP CBA,24.74,0,1365661.68,DR,REF178616,CBA,Current
19-09-2025 16:44,CBAC962693A905E40578CC2,063-000-002,33333333,SPOTIFY CBA,39.76,0,1365621.92,DR,REF431835,CBA,Current
19-09-2025 16:52,CBA36243F14E2E9425C8888,063-000-002,33333333,KFC CBA,75.59,0,1365546.33,DR,REF326796,CBA,Current
19-09-2025 17:06,CBA244C0284B5D44632BD72,063-000-002,33333333,PAYROLL CREDIT CBA,0,1565.58,1367111.91,CR,REF170601,CBA,Current
19-09-2025 17:20,CBA536C2CB3E0EE4FC1AB2F,063-000-002,33333333,JB HI-FI CBA,45.17,0,1367066.74,DR,REF426384,CBA,Current
19-09-2025 17:36,CBA90B3CCCBB1774D2C9743,063-000-002,33333333,BANK FEE CBA,16.93,0,1367049.81,DR,REF552800,CBA,Current
19-09-2025 18:15,CBA7A6F524B6F4B4A389056,063-000-002,33333333,BWS CBA,2.99,0,1367046.82,DR,REF538839,CBA,Current
19-09-2025 19:02,CBA80B24E220ED04FBFBC4A,063-000-002,33333333,HARVEY NORMAN CBA,92.98,0,1366953.84,DR,REF261103,CBA,Current
19-09-2025 19:08,CBACE503C3079814258BD32,063-000-002,33333333,7-ELEVEN CBA,25.77,0,1366928.07,DR,REF133596,CBA,Current
19-09-2025 19:12,CBAF0C1B2C3780C432CA222,063-000-002,33333333,CITYLINK CBA,9.89,0,1366918.18,DR,REF489710,CBA,Current
19-09-2025 19:29,CBAE5858C8CBD93432F87A3,063-000-002,33333333,FLIXBUS CBA,37.28,0,1366880.9,DR,REF890283,CBA,Current
19-09-2025 19:32,CBA245D7F52E3744C24BAFA,063-000-002,33333333,DOMINO'S PIZZA CBA,16.75,0,1366864.15,DR,REF651390,CBA,Current
19-09-2025 19:33,CBAC6C845FA108A48C6B9A4,063-000-002,33333333,WOOLWORTHS CBA,13.52,0,1366850.63,DR,REF690917,CBA,Current
19-09-2025 19:37,CBA8BBAEEDF12BE47B2A49E,063-000-002,33333333,MENULOG CBA,11.68,0,1366838.95,DR,REF204092,CBA,Current
19-09-2025 19:54,CBACAAD8868282D4B2E9850,063-000-002,33333333,KFC CBA,110.91,0,1366728.04,DR,REF320920,CBA,Current
19-09-2025 20:14,CBAD8A7A350556B45328280,063-000-002,33333333,FLIXBUS CBA,6.52,0,1366721.52,DR,REF628582,CBA,Current
19-09-2025 20:17,CBA1334F8C79ADD4019BD8A,063-000-002,33333333,SALARY PAYMENT CBA,0,6171.12,1372892.64,CR,REF275564,CBA,Current
19-09-2025 20:18,CBA798D1C9F359C40FC9702,063-000-002,33333333,DOMINO'S PIZZA CBA,52.15,0,1372840.49,DR,REF936223,CBA,Current
19-09-2025 20:28,CBAE8DB3826AAD847F78C0D,063-000-002,33333333,PAY - SALARY CBA,0,5099.03,1377939.52,CR,REF692941,CBA,Current
19-09-2025 20:33,CBA952693DA63F54956B5EC,063-000-002,33333333,KFC CBA,6.43,0,1377933.09,DR,REF149307,CBA,Current
19-09-2025 20:49,CBA4F8E5A28E24B4F8293E8,063-000-002,33333333,COLES CBA,2.77,0,1377930.32,DR,REF223501,CBA,Current
19-09-2025 21:24,CBA8104BCB94E5446089592,063-000-002,33333333,DOMINO'S PIZZA CBA,34.4,0,1377895.92,DR,REF733853,CBA,Current
19-09-2025 21:39,CBAB3A851FFB5CC41A88DE0,063-000-002,33333333,LIQUORLAND CBA,72.19,0,1377823.73,DR,REF123529,CBA,Current
19-09-2025 22:08,CBA1AF318209F064EB9A607,063-000-002,33333333,SALARY PAYMENT CBA,0,547.96,1378371.69,CR,REF337067,CBA,Current
19-09-2025 22:15,CBAD661D3742D894E379613,063-000-002,33333333,BANK FEE CBA,15.88,0,1378355.81,DR,REF402110,CBA,Current
19-09-2025 22:24,CBA8B3194AD22834D5EBBE2,063-000-002,33333333,BP CBA,8.39,0,1378347.42,DR,REF841475,CBA,Current
19-09-2025 22:52,CBACB297554405748688818,063-000-002,33333333,PAYROLL CREDIT CBA,0,1683.88,1380031.3,CR,REF144027,CBA,Current
19-09-2025 23:23,CBA2295A83FACA04DFBB4B8,063-000-002,33333333,UBER EATS CBA,71.21,0,1379960.09,DR,REF350345,CBA,Current
19-09-2025 23:23,CBAC0998FEBF687492ABA59,063-000-002,33333333,BWS CBA,30.46,0,1379929.63,DR,REF393076,CBA,Current
19-09-2025 23:38,CBA68F1DD687E494560A43A,063-000-002,33333333,PAYMENT GATEWAY CBA,12.03,0,1379917.6,DR,REF755526,CBA,Current
19-09-2025 23:50,CBA49CE40A38F7E4B0EB035,063-000-002,33333333,ALDI CBA,24.19,0,1379893.41,DR,REF516779,CBA,Current
19-09-2025 23:57,CBA5144A76508C048D38EA9,063-000-002,33333333,PAY - SALARY CBA,0,2019.79,1381913.2,CR,REF671458,CBA,Current
19-09-2025 23:58,CBA1805299CA2D74CC69FF4,063-000-002,33333333,JB HI-FI CBA,43.52,0,1381869.68,DR,REF922417,CBA,Current
20-09-2025 00:03,CBAAA8BD80FE17342B09233,063-000-002,33333333,BWS CBA,22.93,0,1381846.75,DR,REF659941,CBA,Current
20-09-2025 00:16,CBA6B62C861C840487C9552,063-000-002,33333333,CITYLINK CBA,11.22,0,1381835.53,DR,REF859838,CBA,Current
20-09-2025 01:17,CBA9C061061E05E460B82FB,063-000-002,33333333,PAYROLL CREDIT CBA,0,2216.35,1384051.88,CR,REF827768,CBA,Current
20-09-2025 01:54,CBAAD74532D27384A998EE7,063-000-002,33333333,PAYPAL *NETFLIX CBA,101.41,0,1383950.47,DR,REF846635,CBA,Current
20-09-2025 02:20,CBAE8761BF244E84DB6999B,063-000-002,33333333,KFC CBA,95.3,0,1383855.17,DR,REF652746,CBA,Current
20-09-2025 02:29,CBAC7768F3E770345AE846E,063-000-002,33333333,ALDI CBA,97.9,0,1383757.27,DR,REF480583,CBA,Current
20-09-2025 02:45,CBA3FC4B388B3564CC48D90,063-000-002,33333333,STARBUCKS CBA,9.36,0,1383747.91,DR,REF551373,CBA,Current
20-09-2025 02:47,CBAB79BA6F44D7F4E2C98B0,063-000-002,33333333,AMAZON AU CBA,6.21,0,1383741.7,DR,REF132664,CBA,Current
20-09-2025 02:53,CBA90197051F825459B8AB9,063-000-002,33333333,SHELL CBA,56.9,0,1383684.8,DR,REF817895,CBA,Current
20-09-2025 04:24,CBAF849D2B423A44B199E98,063-000-002,33333333,SPOTIFY CBA,34.65,0,1383650.15,DR,REF746483,CBA,Current
20-09-2025 04:40,CBAF516608A9FFD475DB92A,063-000-002,33333333,CITYLINK CBA,196.15,0,1383454,DR,REF479361,CBA,Current
20-09-2025 04:49,INT861338BD5DCF41D19BB7,063-000-002,33333333,TRANSFER FROM CBA 22222222,0,188.1,1383642.1,CR,INT-55287,CBA,Current
20-09-2025 05:07,CBA5640C2E81D5440B99016,063-000-002,33333333,TAFE BOOKSHOP CBA,67.63,0,1383574.47,DR,REF456293,CBA,Current
20-09-2025 05:25,CBA6A2627C38A1448C0AB79,063-000-002,33333333,CITYLINK CBA,106.59,0,1383467.88,DR,REF682618,CBA,Current
20-09-2025 05:37,CBA1F4451E18E724892B58C,063-000-002,33333333,PAYMENT GATEWAY CBA,144.03,0,1383323.85,DR,REF142968,CBA,Current
20-09-2025 06:06,CBACB82CBB2E7E2483CACFD,063-000-002,33333333,WOOLWORTHS CBA,10.63,0,1383313.22,DR,REF820791,CBA,Current
20-09-2025 06:22,CBA4C8812DCA17349758D19,063-000-002,33333333,COMPANY PAYROLL CBA,0,2959.66,1386272.88,CR,REF936788,CBA,Current
20-09-2025 06:48,CBA3AAD270F5DB04ECC98A0,063-000-002,33333333,JB HI-FI CBA,7.97,0,1386264.91,DR,REF284352,CBA,Current
20-09-2025 07:14,CBAC4575108C0E54E3EA59B,063-000-002,33333333,HARVEY NORMAN CBA,80.98,0,1386183.93,DR,REF428105,CBA,Current
20-09-2025 07:17,CBAF21A8708DA134B98B60B,063-000-002,33333333,BIGW CBA,41.14,0,1386142.79,DR,REF995949,CBA,Current
20-09-2025 07:25,CBA5FB74061F01D430194A8,063-000-002,33333333,BP CBA,360.02,0,1385782.77,DR,REF167729,CBA,Current
20-09-2025 07:33,CBA0561EBB420C34438852E,063-000-002,33333333,AMAZON AU CBA,18.97,0,1385763.8,DR,REF475018,CBA,Current
20-09-2025 07:42,CBA9034ED05C99D469C8645,063-000-002,33333333,BIGW CBA,19.87,0,1385743.93,DR,REF393097,CBA,Current
20-09-2025 07:43,CBA4944794749084B58A72E,063-000-002,33333333,SHELL CBA,122.81,0,1385621.12,DR,REF887945,CBA,Current
20-09-2025 08:02,CBABA678ABEA7584438AF58,063-000-002,33333333,FLIXBUS CBA,111.25,0,1385509.87,DR,REF504335,CBA,Current
20-09-2025 08:06,CBA15FE3135B0B9438E8BBD,063-000-002,33333333,MCDONALDS CBA,156.45,0,1385353.42,DR,REF152737,CBA,Current
20-09-2025 08:13,CBA75DB817372444EE6BF26,063-000-002,33333333,BIGW CBA,7.24,0,1385346.18,DR,REF873421,CBA,Current
20-09-2025 08:30,CBABFF58273E7004588AC26,063-000-002,33333333,BP CBA,51.83,0,1385294.35,DR,REF506368,CBA,Current
20-09-2025 08:55,CBAB22CA33DF9C349B3AF2A,063-000-002,33333333,MENULOG CBA,192.08,0,1385102.27,DR,REF249553,CBA,Current
20-09-2025 09:01,CBA6B6A8B059D504E5F9B1C,063-000-002,33333333,MCDONALDS CBA,72.84,0,1385029.43,DR,REF431354,CBA,Current
20-09-2025 09:06,CBA82C7D1216E8E43FE9567,063-000-002,33333333,WOOLWORTHS CBA,52.13,0,1384977.3,DR,REF144090,CBA,Current
20-09-2025 09:45,CBAE10162E1C9324BCFBA54,063-000-002,33333333,KFC CBA,30.72,0,1384946.58,DR,REF328154,CBA,Current
20-09-2025 09:48,CBA5874A65AC0CE4BC39127,063-000-002,33333333,BP CBA,37.47,0,1384909.11,DR,REF411844,CBA,Current
20-09-2025 09:52,CBA491D0494EDD641A9B621,063-000-002,33333333,SPOTIFY CBA,159.35,0,1384749.76,DR,REF490582,CBA,Current
20-09-2025 09:53,CBAC036DBB7A2654173BE52,063-000-002,33333333,ALDI CBA,176.82,0,1384572.94,DR,REF931687,CBA,Current
20-09-2025 10:22,CBAC2828856CC1149009EB6,063-000-002,33333333,APPLE CBA,92.08,0,1384480.86,DR,REF945097,CBA,Current
20-09-2025 10:30,CBAFF0B62CBE0E047C680FC,063-000-002,33333333,RAILWAY STATION CBA,116.14,0,1384364.72,DR,REF122841,CBA,Current
20-09-2025 10:41,CBA48529B3FD572497DA9E5,063-000-002,33333333,PAYPAL *NETFLIX CBA,52.66,0,1384312.06,DR,REF723029,CBA,Current
20-09-2025 10:42,CBA895F06DC146B4330A85E,063-000-002,33333333,JB HI-FI CBA,78.92,0,1384233.14,DR,REF645940,CBA,Current
20-09-2025 11:00,CBA6B9DFE9201FB43A0AF82,063-000-002,33333333,FLIXBUS CBA,31.08,0,1384202.06,DR,REF719915,CBA,Current
20-09-2025 11:08,CBAE5799F27F47A4EE380BC,063-000-002,33333333,APPLE CBA,53.22,0,1384148.84,DR,REF992577,CBA,Current
20-09-2025 11:17,CBAC426F306C9B44705B8DE,063-000-002,33333333,BWS CBA,4.69,0,1384144.15,DR,REF382723,CBA,Current
20-09-2025 11:30,CBABA0EC40A343E4C019664,063-000-002,33333333,BANK FEE CBA,5.29,0,1384138.86,DR,REF664432,CBA,Current
20-09-2025 11:30,CBA13D37787EEF74008968E,063-000-002,33333333,RAILWAY STATION CBA,31.59,0,1384107.27,DR,REF351813,CBA,Current
20-09-2025 11:37,CBA8760EF4EC3F64423B629,063-000-002,33333333,DOMINO'S PIZZA CBA,101.19,0,1384006.08,DR,REF192595,CBA,Current
20-09-2025 11:44,CBAA0D928B44A8F49F29861,063-000-002,33333333,MENULOG CBA,19.37,0,1383986.71,DR,REF901936,CBA,Current
20-09-2025 11:58,CBA16095A363FFE4AB2A57B,063-000-002,33333333,TAFE BOOKSHOP CBA,11.37,0,1383975.34,DR,REF362466,CBA,Current
20-09-2025 13:19,CBA8C12EC08934E4CC9B27A,063-000-002,33333333,PAYROLL CREDIT CBA,0,726.97,1384702.31,CR,REF956204,CBA,Current
20-09-2025 13:30,CBAB0E703B48D414E3EB8CE,063-000-002,33333333,PAYPAL *NETFLIX CBA,158.15,0,1384544.16,DR,REF111818,CBA,Current
20-09-2025 13:35,CBA7BC0E88A64B1438580C3,063-000-002,33333333,PAY - SALARY CBA,0,548.92,1385093.08,CR,REF533341,CBA,Current
20-09-2025 13:48,CBAB1B424AFDA724D2FADDB,063-000-002,33333333,PAYMENT GATEWAY CBA,8.28,0,1385084.8,DR,REF193033,CBA,Current
20-09-2025 14:38,CBA12AD7BDFE4BB49E2B4BB,063-000-002,33333333,FLIXBUS CBA,12.47,0,1385072.33,DR,REF394083,CBA,Current
20-09-2025 14:57,CBAF4CBCE617E3749889191,063-000-002,33333333,BWS CBA,90.81,0,1384981.52,DR,REF107857,CBA,Current
20-09-2025 15:06,CBA9EE3B049159A4D58854B,063-000-002,33333333,RAILWAY STATION CBA,23.67,0,1384957.85,DR,REF666982,CBA,Current
20-09-2025 15:33,CBAD88DBC9ACB5F495291A3,063-000-002,33333333,SPOTIFY CBA,24.71,0,1384933.14,DR,REF730442,CBA,Current
20-09-2025 15:50,CBAB8FD8BC94ADB4B2E8710,063-000-002,33333333,WOOLWORTHS CBA,21.62,0,1384911.52,DR,REF767793,CBA,Current
20-09-2025 16:01,INT3DCBCE058AEB45A695C5,063-000-002,33333333,TRANSFER TO ANZ 11111111,1816.32,0,1383095.2,DR,INT-74566,CBA,Current
20-09-2025 16:01,CBA4967E2FC3B964B72BE5E,063-000-002,33333333,FLIXBUS CBA,28.98,0,1383066.22,DR,REF634982,CBA,Current
20-09-2025 16:03,CBA25D14E595D5C4E698DE1,063-000-002,33333333,BANK FEE CBA,80.46,0,1382985.76,DR,REF130231,CBA,Current
20-09-2025 16:31,CBA0CB8AD2405484F91B34A,063-000-002,33333333,RAILWAY STATION CBA,2.96,0,1382982.8,DR,REF383453,CBA,Current
20-09-2025 16:32,CBAC44073E21E5E4936B342,063-000-002,33333333,BIGW CBA,43.03,0,1382939.77,DR,REF724225,CBA,Current
20-09-2025 16:39,CBA3AD66FE0F017432F818B,063-000-002,33333333,SPOTIFY CBA,81.32,0,1382858.45,DR,REF605890,CBA,Current
20-09-2025 16:41,CBABAA07D9BC67B4D878711,063-000-002,33333333,DOMINO'S PIZZA CBA,62.44,0,1382796.01,DR,REF484049,CBA,Current
20-09-2025 16:54,CBA813778F42183496C9712,063-000-002,33333333,RAILWAY STATION CBA,5.4,0,1382790.61,DR,REF459190,CBA,Current
20-09-2025 17:16,CBAE6DCD919671D4D4889F6,063-000-002,33333333,CITYLINK CBA,11.78,0,1382778.83,DR,REF322522,CBA,Current
20-09-2025 18:37,CBA1C81F179E6514EA99187,063-000-002,33333333,FLIXBUS CBA,73.41,0,1382705.42,DR,REF131160,CBA,Current
20-09-2025 18:48,CBA16A7D4E127DF41248F76,063-000-002,33333333,BANK FEE CBA,17.69,0,1382687.73,DR,REF420587,CBA,Current
20-09-2025 18:50,CBA32B16160AE264CEC888D,063-000-002,33333333,BP CBA,52.02,0,1382635.71,DR,REF531116,CBA,Current
20-09-2025 19:15,CBA84A2E306622C4886A710,063-000-002,33333333,COMPANY PAYROLL CBA,0,1733.48,1384369.19,CR,REF554691,CBA,Current
20-09-2025 19:33,CBAEEFCC79CD33B4545A32B,063-000-002,33333333,PAY - SALARY CBA,0,6177.3,1390546.49,CR,REF138901,CBA,Current
20-09-2025 20:06,CBA6E1D12A962B34F15BDE0,063-000-002,33333333,SHELL CBA,176.25,0,1390370.24,DR,REF530447,CBA,Current
20-09-2025 20:11,CBAE808A1988AF24617AA2A,063-000-002,33333333,INTERNET TRANSFER CBA,59.01,0,1390311.23,DR,REF519938,CBA,Current
20-09-2025 20:41,CBA2F0239F04BAD49AB88F3,063-000-002,33333333,CITYLINK CBA,61.58,0,1390249.65,DR,REF871479,CBA,Current
20-09-2025 20:47,CBAD6B7745C1566427ABF00,063-000-002,33333333,LIQUORLAND CBA,162.71,0,1390086.94,DR,REF933448,CBA,Current
20-09-2025 21:19,CBA5796CA0B5C3A4DF8968B,063-000-002,33333333,BIGW CBA,70.9,0,1390016.04,DR,REF827486,CBA,Current
20-09-2025 21:55,CBAE627350D901A43B49C91,063-000-002,33333333,APPLE CBA,26.49,0,1389989.55,DR,REF427822,CBA,Current
20-09-2025 21:58,CBAB3052E5DE84A402296EE,063-000-002,33333333,AMAZON AU CBA,8.65,0,1389980.9,DR,REF352929,CBA,Current
20-09-2025 22:15,CBAA4B39BF926E142BEBD81,063-000-002,33333333,SALARY PAYMENT CBA,0,6148.94,1396129.84,CR,REF742332,CBA,Current
20-09-2025 22:21,CBAD85F0446C72643DE9B42,063-000-002,33333333,MENULOG CBA,51.36,0,1396078.48,DR,REF192489,CBA,Current
20-09-2025 23:07,INTC810BB610BF54E5C8B19,063-000-002,33333333,TRANSFER TO ANZ 11111111,326.11,0,1395752.37,DR,INT-19219,CBA,Current
20-09-2025 23:15,CBA7DAC1A9C3FA54A01932E,063-000-002,33333333,SHELL CBA,39.85,0,1395712.52,DR,REF158278,CBA,Current
20-09-2025 23:17,CBA2EC95817F1194456B711,063-000-002,33333333,SHELL CBA,18.62,0,1395693.9,DR,REF743626,CBA,Current
20-09-2025 23:29,CBA1F332CA2CDD445FC800A,063-000-002,33333333,ALDI CBA,39.1,0,1395654.8,DR,REF225768,CBA,Current
21-09-2025 00:24,CBA44D879039DB24C6C9F50,063-000-002,33333333,STARBUCKS CBA,38.59,0,1395616.21,DR,REF295688,CBA,Current
21-09-2025 00:37,CBACA71A57E08DE430F8FC0,063-000-002,33333333,ALDI CBA,47.39,0,1395568.82,DR,REF392530,CBA,Current
21-09-2025 01:02,INT1822FB7A6B4F49AFA80B,063-000-002,33333333,TRANSFER TO CBA 22222222,873.39,0,1394695.43,DR,INT-26831,CBA,Current
21-09-2025 01:06,CBA78AE3E77B5324878A9B5,063-000-002,33333333,SHELL CBA,62.32,0,1394633.11,DR,REF189849,CBA,Current
21-09-2025 02:11,CBA2E43892153274669BEF3,063-000-002,33333333,ALDI CBA,46,0,1394587.11,DR,REF751888,CBA,Current
21-09-2025 02:31,CBA183992AFC1C447C6B7D2,063-000-002,33333333,AMAZON AU CBA,228.22,0,1394358.89,DR,REF755839,CBA,Current
21-09-2025 02:31,CBA1D9CC4C2E1F745669364,063-000-002,33333333,COLES CBA,96.15,0,1394262.74,DR,REF928794,CBA,Current
21-09-2025 02:32,CBA2D680D64037D4DEDBEE9,063-000-002,33333333,BIGW CBA,214.62,0,1394048.12,DR,REF285557,CBA,Current
21-09-2025 02:48,CBA66EEBBBCC2624115BE09,063-000-002,33333333,BP CBA,46.3,0,1394001.82,DR,REF586250,CBA,Current
21-09-2025 02:49,CBA35422B6E3CBB4A249176,063-000-002,33333333,LIQUORLAND CBA,3.36,0,1393998.46,DR,REF594032,CBA,Current
21-09-2025 02:50,CBA4A0F289F93D749009B3E,063-000-002,33333333,PAYROLL CREDIT CBA,0,3131.07,1397129.53,CR,REF238300,CBA,Current
21-09-2025 02:57,CBAF1C4C4D6DCD84B25B005,063-000-002,33333333,SHELL CBA,86.64,0,1397042.89,DR,REF614360,CBA,Current
21-09-2025 03:12,CBA4BD2E7612EC34FE283AB,063-000-002,33333333,DOMINO'S PIZZA CBA,58.73,0,1396984.16,DR,REF894905,CBA,Current
21-09-2025 03:26,INT1D92C7F02F60454BA5AA,063-000-002,33333333,TRANSFER FROM ANZ 11111111,0,120.5,1397104.66,CR,INT-52803,CBA,Current
21-09-2025 03:36,CBAA90154E92A0643E1B210,063-000-002,33333333,BP CBA,78.63,0,1397026.03,DR,REF671129,CBA,Current
21-09-2025 04:24,CBA9B66B6CF99A94B64BF70,063-000-002,33333333,PAYROLL CREDIT CBA,0,983.51,1398009.54,CR,REF727760,CBA,Current
21-09-2025 04:26,CBA3C56ACD069B242C8AC52,063-000-002,33333333,BIGW CBA,32.7,0,1397976.84,DR,REF357870,CBA,Current
21-09-2025 04:48,CBA2FB3781C5C964105AF9C,063-000-002,33333333,SALARY PAYMENT CBA,0,6102.68,1404079.52,CR,REF176324,CBA,Current
21-09-2025 04:56,CBA28A8AD3665044C09AAE9,063-000-002,33333333,LIQUORLAND CBA,14.94,0,1404064.58,DR,REF333290,CBA,Current
21-09-2025 04:59,CBA375D68417BF84A4BB6AF,063-000-002,33333333,JB HI-FI CBA,145.9,0,1403918.68,DR,REF621405,CBA,Current
21-09-2025 05:47,CBA84712534ADC04983B217,063-000-002,33333333,PAY - SALARY CBA,0,673.89,1404592.57,CR,REF935797,CBA,Current
21-09-2025 05:54,CBACDB36A5467DB400EBFBC,063-000-002,33333333,LIQUORLAND CBA,9.22,0,1404583.35,DR,REF334797,CBA,Current
21-09-2025 06:01,CBABEC196F28D8F42F493A0,063-000-002,33333333,TAFE BOOKSHOP CBA,117.31,0,1404466.04,DR,REF198958,CBA,Current
21-09-2025 06:08,CBAB7D4D9A362C646DEAE54,063-000-002,33333333,BANK FEE CBA,94.01,0,1404372.03,DR,REF427473,CBA,Current
21-09-2025 06:17,CBAADBE2A910AA643C98F12,063-000-002,33333333,CITYLINK CBA,111.46,0,1404260.57,DR,REF501743,CBA,Current
21-09-2025 06:40,CBABC337ED4643747AA8082,063-000-002,33333333,BWS CBA,14.67,0,1404245.9,DR,REF179928,CBA,Current
21-09-2025 06:58,CBAB792C899C92146039858,063-000-002,33333333,ALDI CBA,87.48,0,1404158.42,DR,REF871669,CBA,Current
21-09-2025 07:05,CBABC99E1D74C3F4805A421,063-000-002,33333333,KFC CBA,154.07,0,1404004.35,DR,REF636074,CBA,Current
21-09-2025 07:07,INTF171601A2DF64140BDDE,063-000-002,33333333,TRANSFER TO ANZ 11111111,451.29,0,1403553.06,DR,INT-98802,CBA,Current
21-09-2025 07:38,CBA11C4F55F1DBB48C6BED7,063-000-002,33333333,TAFE BOOKSHOP CBA,29.76,0,1403523.3,DR,REF266727,CBA,Current
21-09-2025 07:53,CBAB0E277CDD1CE4E85B716,063-000-002,33333333,SALARY PAYMENT CBA,0,3149.29,1406672.59,CR,REF515523,CBA,Current
21-09-2025 08:03,CBA9B0698F673E24106A3C6,063-000-002,33333333,RAILWAY STATION CBA,23.04,0,1406649.55,DR,REF764926,CBA,Current
21-09-2025 08:07,CBA590933ADF19C43978960,063-000-002,33333333,COLES CBA,137.17,0,1406512.38,DR,REF255383,CBA,Current
21-09-2025 08:14,CBABBFF8FD2EF2644068406,063-000-002,33333333,FLIXBUS CBA,19.63,0,1406492.75,DR,REF590938,CBA,Current
21-09-2025 08:34,CBAA0B18FB102A14006A82D,063-000-002,33333333,SHELL CBA,30.24,0,1406462.51,DR,REF419604,CBA,Current
21-09-2025 08:40,CBAE3150D46802648C4ACBF,063-000-002,33333333,AMAZON AU CBA,18.64,0,1406443.87,DR,REF227026,CBA,Current
21-09-2025 09:26,CBA00D5F143D11B43EE880B,063-000-002,33333333,APPLE CBA,64.49,0,1406379.38,DR,REF218506,CBA,Current
21-09-2025 09:55,CBAF69CB1B6B14648C4AF26,063-000-002,33333333,ALDI CBA,71.71,0,1406307.67,DR,REF702850,CBA,Current
21-09-2025 09:55,CBA67D314F591F841E69FBE,063-000-002,33333333,FLIXBUS CBA,8.95,0,1406298.72,DR,REF293503,CBA,Current
21-09-2025 11:46,CBABE78356CB4DD42F5849B,063-000-002,33333333,BP CBA,27.8,0,1406270.92,DR,REF522476,CBA,Current
21-09-2025 12:28,CBAA39E72EEBB144BB4881E,063-000-002,33333333,FLIXBUS CBA,48.96,0,1406221.96,DR,REF634224,CBA,Current
21-09-2025 12:39,CBA834A0EA4BB5C42A6A823,063-000-002,33333333,PAYPAL *NETFLIX CBA,113.41,0,1406108.55,DR,REF945300,CBA,Current
21-09-2025 12:50,CBAD023D2708B1948F2963E,063-000-002,33333333,WAGES CREDIT CBA,0,53.69,1406162.24,CR,REF577024,CBA,Current
21-09-2025 13:10,CBAB5B2A443E45E42D88CCA,063-000-002,33333333,WAGES CREDIT CBA,0,2842.47,1409004.71,CR,REF396977,CBA,Current
21-09-2025 13:32,CBA65609943B1EA4A0DBA66,063-000-002,33333333,MENULOG CBA,35.09,0,1408969.62,DR,REF294844,CBA,Current
21-09-2025 13:40,INTCCCBE706956C4066B3A9,063-000-002,33333333,TRANSFER FROM ANZ 11111111,0,261.94,1409231.56,CR,INT-81719,CBA,Current
21-09-2025 13:42,CBA76591C4C9B934A428E12,063-000-002,33333333,SHELL CBA,175.64,0,1409055.92,DR,REF242650,CBA,Current
21-09-2025 14:43,CBAD738A50B6F6A402B9812,063-000-002,33333333,7-ELEVEN CBA,33.23,0,1409022.69,DR,REF199558,CBA,Current
21-09-2025 15:24,CBA98F319E7F75C4988B214,063-000-002,33333333,INTERNET TRANSFER CBA,138.33,0,1408884.36,DR,REF696219,CBA,Current
21-09-2025 15:32,CBAAD0AF3A0F9E943BDB136,063-000-002,33333333,APPLE CBA,24.84,0,1408859.52,DR,REF422656,CBA,Current
21-09-2025 15:42,CBA13C5659D67E14407B529,063-000-002,33333333,COLES CBA,15.99,0,1408843.53,DR,REF146701,CBA,Current
21-09-2025 16:05,CBA22B0F79CB6E8472A976A,063-000-002,33333333,BWS CBA,31.23,0,1408812.3,DR,REF228299,CBA,Current
21-09-2025 16:06,CBAC9AFA71F324F436EBE29,063-000-002,33333333,PAYMENT GATEWAY CBA,27.58,0,1408784.72,DR,REF160083,CBA,Current
21-09-2025 16:24,CBA44BF4DCEA9C04AC99EED,063-000-002,33333333,ZOOM CBA,37.65,0,1408747.07,DR,REF150678,CBA,Current
21-09-2025 16:28,CBA2C435CB9C91C4D37931D,063-000-002,33333333,SHELL CBA,62.24,0,1408684.83,DR,REF745451,CBA,Current
21-09-2025 16:35,CBADE7E8E612CF242309FE4,063-000-002,33333333,BWS CBA,12.85,0,1408671.98,DR,REF155677,CBA,Current
21-09-2025 16:49,CBAFAD1A94F543C41AA9C92,063-000-002,33333333,SHELL CBA,18.96,0,1408653.02,DR,REF629140,CBA,Current
21-09-2025 16:56,CBABEF328EF2AC7406AB4B7,063-000-002,33333333,RAILWAY STATION CBA,74.93,0,1408578.09,DR,REF896313,CBA,Current
21-09-2025 17:08,CBAA097FAD082D04B068CC7,063-000-002,33333333,FLIXBUS CBA,20.16,0,1408557.93,DR,REF396180,CBA,Current
21-09-2025 17:17,CBA75D184A9FE624A489071,063-000-002,33333333,INTERNET TRANSFER CBA,84.02,0,1408473.91,DR,REF945911,CBA,Current
21-09-2025 17:40,CBA17995EDD31AB45608908,063-000-002,33333333,PAYMENT GATEWAY CBA,4.91,0,1408469,DR,REF238126,CBA,Current
21-09-2025 17:54,CBA6C592C099A4B4C30BA5C,063-000-002,33333333,JB HI-FI CBA,73.14,0,1408395.86,DR,REF554881,CBA,Current
21-09-2025 18:06,CBA155A6A0E1CC2419CAD48,063-000-002,33333333,STARBUCKS CBA,22.1,0,1408373.76,DR,REF429686,CBA,Current
21-09-2025 18:08,CBA69E4BF5515ED492EB98D,063-000-002,33333333,INTERNET TRANSFER CBA,48.43,0,1408325.33,DR,REF945623,CBA,Current
21-09-2025 18:28,CBA0212289EA0FA4003BA16,063-000-002,33333333,TAFE BOOKSHOP CBA,15.93,0,1408309.4,DR,REF906674,CBA,Current
21-09-2025 18:41,CBAAD09D23E24CA489F8C96,063-000-002,33333333,7-ELEVEN CBA,93.53,0,1408215.87,DR,REF725333,CBA,Current
21-09-2025 18:52,CBA8EB0BA515B184F199E3B,063-000-002,33333333,AMAZON AU CBA,98.65,0,1408117.22,DR,REF508844,CBA,Current
21-09-2025 20:57,CBA9BEA99411DDE4F4C98E1,063-000-002,33333333,BWS CBA,1.93,0,1408115.29,DR,REF160377,CBA,Current
21-09-2025 21:16,INTEF35513F90834D7DBD22,063-000-002,33333333,TRANSFER FROM NAB 44444444,0,977.26,1409092.55,CR,INT-43513,CBA,Current
21-09-2025 21:21,CBA62A2D3EC956440968178,063-000-002,33333333,MCDONALDS CBA,98.68,0,1408993.87,DR,REF704283,CBA,Current
21-09-2025 21:47,CBA8DEC4B3D32334E359AD0,063-000-002,33333333,PAYMENT GATEWAY CBA,186.23,0,1408807.64,DR,REF488009,CBA,Current
21-09-2025 21:53,CBA4B7A3C413472449B927A,063-000-002,33333333,AMAZON AU CBA,107.15,0,1408700.49,DR,REF661349,CBA,Current
21-09-2025 22:02,CBA9F11F395EF9B4CBBA79A,063-000-002,33333333,AMAZON AU CBA,30.87,0,1408669.62,DR,REF684169,CBA,Current
21-09-2025 22:18,INT3255290B3117475E83D6,063-000-002,33333333,TRANSFER TO NAB 44444444,1294.55,0,1407375.07,DR,INT-63534,CBA,Current
21-09-2025 22:34,CBA4E1097C759954B11B3DF,063-000-002,33333333,STARBUCKS CBA,28.65,0,1407346.42,DR,REF622643,CBA,Current
21-09-2025 22:40,CBAD87F72DAC9CD47B7B10C,063-000-002,33333333,PAYMENT GATEWAY CBA,369.92,0,1406976.5,DR,REF249560,CBA,Current
21-09-2025 22:46,CBAAB0C85F9B9E14BBDA8CD,063-000-002,33333333,LIQUORLAND CBA,30.68,0,1406945.82,DR,REF527547,CBA,Current
21-09-2025 22:50,CBABBA00FB3A59F4034BDD3,063-000-002,33333333,RAILWAY STATION CBA,32.73,0,1406913.09,DR,REF993576,CBA,Current
21-09-2025 23:30,CBA1A00793915614ED1946B,063-000-002,33333333,CITYLINK CBA,35.72,0,1406877.37,DR,REF358329,CBA,Current
21-09-2025 23:37,CBA1C53E5A5399D4DFDBD12,063-000-002,33333333,BIGW CBA,7.7,0,1406869.67,DR,REF189664,CBA,Current
21-09-2025 23:56,CBA74B1412F14CC4F4983A8,063-000-002,33333333,7-ELEVEN CBA,38.8,0,1406830.87,DR,REF438553,CBA,Current
22-09-2025 00:34,CBA30FE7F0E181A4CD39621,063-000-002,33333333,AMAZON AU CBA,43.39,0,1406787.48,DR,REF872576,CBA,Current
22-09-2025 00:50,CBA4BD68700C9044BF1A91F,063-000-002,33333333,BWS CBA,41.73,0,1406745.75,DR,REF343894,CBA,Current
22-09-2025 01:03,CBA33AD5983118C4AB5A43E,063-000-002,33333333,PAY - SALARY CBA,0,794.18,1407539.93,CR,REF791324,CBA,Current
22-09-2025 01:11,CBABCF7BE3ACBB647579AC8,063-000-002,33333333,FLIXBUS CBA,83.68,0,1407456.25,DR,REF183260,CBA,Current
22-09-2025 01:22,CBAD6526E1B6C4E4477AA61,063-000-002,33333333,BWS CBA,68.68,0,1407387.57,DR,REF735429,CBA,Current
22-09-2025 01:33,CBA4BA4B98B803D45EFA92C,063-000-002,33333333,MENULOG CBA,20.91,0,1407366.66,DR,REF732188,CBA,Current
22-09-2025 02:14,CBAD1D5A0C5A0E74DED8C01,063-000-002,33333333,SPOTIFY CBA,25.42,0,1407341.24,DR,REF698595,CBA,Current
22-09-2025 02:15,CBA5BB8130787BF42139DEA,063-000-002,33333333,MENULOG CBA,28.94,0,1407312.3,DR,REF257855,CBA,Current
22-09-2025 02:21,CBAB52B856BECCE4893B978,063-000-002,33333333,7-ELEVEN CBA,39.11,0,1407273.19,DR,REF237503,CBA,Current
22-09-2025 02:28,CBA4726D45493F647F0854A,063-000-002,33333333,WAGES CREDIT CBA,0,7482.51,1414755.7,CR,REF761361,CBA,Current
22-09-2025 02:35,CBAC0B22BF6533B48808F55,063-000-002,33333333,HARVEY NORMAN CBA,53.07,0,1414702.63,DR,REF902424,CBA,Current
22-09-2025 02:56,CBAE6C786C17A9645428B66,063-000-002,33333333,BP CBA,2.71,0,1414699.92,DR,REF656350,CBA,Current
22-09-2025 02:58,INT86962786595B4F979C92,063-000-002,33333333,TRANSFER TO ANZ 11111111,314.84,0,1414385.08,DR,INT-78863,CBA,Current
22-09-2025 03:27,CBAE7E349BA0B8648C9B247,063-000-002,33333333,7-ELEVEN CBA,28.05,0,1414357.03,DR,REF742134,CBA,Current
22-09-2025 04:55,CBACC3F4E082344418690D7,063-000-002,33333333,JB HI-FI CBA,51.36,0,1414305.67,DR,REF221615,CBA,Current
22-09-2025 05:11,CBA7AAEC690A3B847AD9C2F,063-000-002,33333333,COMPANY PAYROLL CBA,0,5224.69,1419530.36,CR,REF946765,CBA,Current
22-09-2025 05:16,INT3B5E813A93794354A986,063-000-002,33333333,TRANSFER FROM NAB 44444444,0,1398.64,1420929,CR,INT-51414,CBA,Current
22-09-2025 05:28,CBA87CC1EF9CB1B47DCBA1E,063-000-002,33333333,BANK FEE CBA,51.18,0,1420877.82,DR,REF672912,CBA,Current
22-09-2025 06:07,CBAA9DB2A3E73114253AE5A,063-000-002,33333333,FLIXBUS CBA,4.63,0,1420873.19,DR,REF348530,CBA,Current
22-09-2025 06:32,CBA73ECCEB7B200474199B2,063-000-002,33333333,WOOLWORTHS CBA,67.69,0,1420805.5,DR,REF239209,CBA,Current
22-09-2025 07:15,CBA3CF154E3EA4845069339,063-000-002,33333333,RAILWAY STATION CBA,19.83,0,1420785.67,DR,REF664317,CBA,Current
22-09-2025 07:29,CBA0559C89F0F2A41D2B6BB,063-000-002,33333333,SPOTIFY CBA,149.74,0,1420635.93,DR,REF680732,CBA,Current
22-09-2025 07:33,CBA2836EB6A6BD04391AFCC,063-000-002,33333333,BWS CBA,40.53,0,1420595.4,DR,REF630905,CBA,Current
22-09-2025 07:37,INTF748187F44F748ACA916,063-000-002,33333333,TRANSFER TO ANZ 11111111,725.56,0,1419869.84,DR,INT-63696,CBA,Current
22-09-2025 07:43,CBA3C3EF56D87CA4D05A78C,063-000-002,33333333,AMAZON AU CBA,70.05,0,1419799.79,DR,REF241755,CBA,Current
22-09-2025 07:48,CBA46D4DE066AF847579585,063-000-002,33333333,LIQUORLAND CBA,14.3,0,1419785.49,DR,REF128099,CBA,Current
22-09-2025 08:05,CBA0B643F7D02D84A84BA5E,063-000-002,33333333,BIGW CBA,137.9,0,1419647.59,DR,REF423199,CBA,Current
22-09-2025 08:13,CBA10C74F0F000B4A2796F3,063-000-002,33333333,APPLE CBA,99.83,0,1419547.76,DR,REF579237,CBA,Current
22-09-2025 08:20,CBA9B907D35B2B047B295E4,063-000-002,33333333,FLIXBUS CBA,17.29,0,1419530.47,DR,REF156858,CBA,Current
22-09-2025 08:34,INTF69605B6449C402CA545,063-000-002,33333333,TRANSFER TO CBA 22222222,1986.89,0,1417543.58,DR,INT-37500,CBA,Current
22-09-2025 08:59,CBAEF3721136DE94EB9AF1E,063-000-002,33333333,FLIXBUS CBA,72.25,0,1417471.33,DR,REF151110,CBA,Current
22-09-2025 10:38,CBA172CA92D84C549FE80F4,063-000-002,33333333,BIGW CBA,56.24,0,1417415.09,DR,REF516331,CBA,Current
22-09-2025 10:51,CBA5F6A8D4A27EB450DA1D6,063-000-002,33333333,7-ELEVEN CBA,147.06,0,1417268.03,DR,REF747919,CBA,Current
22-09-2025 10:58,CBAA954AE3D115C4C04BE01,063-000-002,33333333,COLES CBA,30.83,0,1417237.2,DR,REF313593,CBA,Current
22-09-2025 11:18,CBA2F9495D1688244A8A78C,063-000-002,33333333,UBER EATS CBA,64.34,0,1417172.86,DR,REF328231,CBA,Current
22-09-2025 11:27,CBA93298B308A3A4EE883BA,063-000-002,33333333,BANK FEE CBA,68.19,0,1417104.67,DR,REF298676,CBA,Current
22-09-2025 11:37,CBAD9EE4CA9FDFA408B8582,063-000-002,33333333,ZOOM CBA,35.76,0,1417068.91,DR,REF704193,CBA,Current
22-09-2025 11:40,CBA449A7CFA040C4D6C80DE,063-000-002,33333333,SPOTIFY CBA,15.1,0,1417053.81,DR,REF783025,CBA,Current
22-09-2025 11:49,CBAC1100667B16D473F8CAD,063-000-002,33333333,UBER EATS CBA,9.45,0,1417044.36,DR,REF476452,CBA,Current
22-09-2025 11:52,CBA95F528DA51444B9EAA56,063-000-002,33333333,PAYMENT GATEWAY CBA,75.39,0,1416968.97,DR,REF426435,CBA,Current
22-09-2025 11:54,CBA49274D1CB7034E14A960,063-000-002,33333333,APPLE CBA,138.2,0,1416830.77,DR,REF832166,CBA,Current
22-09-2025 12:05,CBA2080566E6C1547659634,063-000-002,33333333,SPOTIFY CBA,93.45,0,1416737.32,DR,REF704359,CBA,Current
22-09-2025 12:38,CBA8B9EFF917CB74DF99F87,063-000-002,33333333,BANK FEE CBA,21.03,0,1416716.29,DR,REF621531,CBA,Current
22-09-2025 12:50,CBA652B1058B0D94A68B488,063-000-002,33333333,HARVEY NORMAN CBA,48.8,0,1416667.49,DR,REF196879,CBA,Current
22-09-2025 13:01,CBAF8D535417247421DAC16,063-000-002,33333333,BANK FEE CBA,38.2,0,1416629.29,DR,REF340270,CBA,Current
22-09-2025 13:39,CBA206E0643EC2342C58C9B,063-000-002,33333333,BIGW CBA,38.44,0,1416590.85,DR,REF868400,CBA,Current
22-09-2025 13:39,CBA4829A5E4AECB4E469426,063-000-002,33333333,PAY - SALARY CBA,0,3355.23,1419946.08,CR,REF825104,CBA,Current
22-09-2025 13:41,INT8CE4979CA6B44481B7DA,063-000-002,33333333,TRANSFER FROM NAB 44444444,0,881.59,1420827.67,CR,INT-45388,CBA,Current
22-09-2025 13:48,CBAB861833BF66D4A949325,063-000-002,33333333,MENULOG CBA,6.55,0,1420821.12,DR,REF483989,CBA,Current
22-09-2025 14:24,CBAAFF9F97E49B54D7AB8EF,063-000-002,33333333,COLES CBA,38.66,0,1420782.46,DR,REF489951,CBA,Current
22-09-2025 14:24,CBA121D9B0DB8BC4601A1E2,063-000-002,33333333,BWS CBA,9.19,0,1420773.27,DR,REF265707,CBA,Current
22-09-2025 14:38,CBA116F33E65FFE407EB37A,063-000-002,33333333,BP CBA,27.62,0,1420745.65,DR,REF764787,CBA,Current
22-09-2025 15:07,CBAB53C6347CD5F47D6AC20,063-000-002,33333333,RAILWAY STATION CBA,72.55,0,1420673.1,DR,REF491027,CBA,Current
22-09-2025 15:38,CBA8FC51DC5B7284E5FB2D4,063-000-002,33333333,COMPANY PAYROLL CBA,0,2905.53,1423578.63,CR,REF905755,CBA,Current
22-09-2025 16:05,CBA08FEB3788F8B435B8ADB,063-000-002,33333333,COMPANY PAYROLL CBA,0,7738.75,1431317.38,CR,REF322171,CBA,Current
22-09-2025 16:46,CBABFB8F43C03204212B54B,063-000-002,33333333,7-ELEVEN CBA,10,0,1431307.38,DR,REF596153,CBA,Current
22-09-2025 16:56,CBA65218CF874B1488D88F5,063-000-002,33333333,WAGES CREDIT CBA,0,5898.62,1437206,CR,REF521344,CBA,Current
22-09-2025 16:59,CBA1C7BC9642CD74A17A25A,063-000-002,33333333,STARBUCKS CBA,184.85,0,1437021.15,DR,REF455944,CBA,Current
22-09-2025 17:17,CBA9F58B298E59E46CCA608,063-000-002,33333333,ALDI CBA,166.71,0,1436854.44,DR,REF599598,CBA,Current
22-09-2025 17:31,CBA962EBDD8D8BE42018C64,063-000-002,33333333,7-ELEVEN CBA,6.73,0,1436847.71,DR,REF341903,CBA,Current
22-09-2025 17:58,CBAD472C8B283654ED88A4E,063-000-002,33333333,SALARY PAYMENT CBA,0,3252.88,1440100.59,CR,REF820628,CBA,Current
22-09-2025 18:21,CBA2C5014BB37DE4B98BDEE,063-000-002,33333333,PAYMENT GATEWAY CBA,32.6,0,1440067.99,DR,REF665153,CBA,Current
22-09-2025 18:25,CBA8C20E268C51D43C7B3CC,063-000-002,33333333,JB HI-FI CBA,16.89,0,1440051.1,DR,REF151001,CBA,Current
22-09-2025 18:43,CBADD1CDBB66FDF4019B959,063-000-002,33333333,PAYPAL *NETFLIX CBA,17.62,0,1440033.48,DR,REF474647,CBA,Current
22-09-2025 18:47,CBA2606C6EF20634EDDAFE8,063-000-002,33333333,BANK FEE CBA,76.54,0,1439956.94,DR,REF504331,CBA,Current
22-09-2025 19:35,CBA69D0A8B6C2A54263AF49,063-000-002,33333333,SHELL CBA,23.15,0,1439933.79,DR,REF165463,CBA,Current
22-09-2025 19:59,CBA6EF78CEC99B8419EB9EC,063-000-002,33333333,DOMINO'S PIZZA CBA,60.03,0,1439873.76,DR,REF768801,CBA,Current
22-09-2025 20:37,CBAC8A82566C2C947FEB362,063-000-002,33333333,ZOOM CBA,261.62,0,1439612.14,DR,REF914854,CBA,Current
22-09-2025 20:49,CBA99DAE99C0637454A97AE,063-000-002,33333333,BANK FEE CBA,50.56,0,1439561.58,DR,REF112979,CBA,Current
22-09-2025 20:50,CBAF8CA924C9D1E46EB967D,063-000-002,33333333,PAYROLL CREDIT CBA,0,2919,1442480.58,CR,REF182012,CBA,Current
22-09-2025 20:50,CBADB33F378B68B49B5A56F,063-000-002,33333333,BP CBA,5.51,0,1442475.07,DR,REF954901,CBA,Current
22-09-2025 21:47,CBAA162181A17EA45F0A13C,063-000-002,33333333,BANK FEE CBA,79.92,0,1442395.15,DR,REF366414,CBA,Current
22-09-2025 21:58,CBA766B34B8B36C4BAFA9E5,063-000-002,33333333,TAFE BOOKSHOP CBA,15.47,0,1442379.68,DR,REF680567,CBA,Current
22-09-2025 22:01,CBABD495BF0A0904E4DA8DE,063-000-002,33333333,WOOLWORTHS CBA,27.9,0,1442351.78,DR,REF334207,CBA,Current
22-09-2025 22:29,CBAE62FF15AE05D4FC0A171,063-000-002,33333333,COLES CBA,37.94,0,1442313.84,DR,REF434626,CBA,Current
22-09-2025 22:32,CBAF583166A46EE4937921A,063-000-002,33333333,ALDI CBA,76.46,0,1442237.38,DR,REF929577,CBA,Current
22-09-2025 23:00,CBA3375C554511D4058A32A,063-000-002,33333333,BANK FEE CBA,93.44,0,1442143.94,DR,REF147782,CBA,Current
22-09-2025 23:42,CBA07B0C9EF9666470F9EB9,063-000-002,33333333,PAYPAL *NETFLIX CBA,65.59,0,1442078.35,DR,REF910561,CBA,Current
23-09-2025 00:01,CBA20D12D7F80E24B1EBDE4,063-000-002,33333333,BP CBA,102.87,0,1441975.48,DR,REF178042,CBA,Current
23-09-2025 00:02,CBA90EAD906CF4746D2A918,063-000-002,33333333,INTERNET TRANSFER CBA,38.8,0,1441936.68,DR,REF375633,CBA,Current
23-09-2025 00:12,CBA2C6D0DD48F80425C8AEF,063-000-002,33333333,BP CBA,93.36,0,1441843.32,DR,REF275365,CBA,Current
23-09-2025 00:20,CBADE2D0EBDA361469DB64A,063-000-002,33333333,COLES CBA,57.27,0,1441786.05,DR,REF223385,CBA,Current
23-09-2025 00:28,CBA33DA2CCD10D8407B84D0,063-000-002,33333333,FLIXBUS CBA,112.89,0,1441673.16,DR,REF699614,CBA,Current
23-09-2025 00:37,CBAF851B2F4FFA943DDB72C,063-000-002,33333333,SPOTIFY CBA,18.46,0,1441654.7,DR,REF637097,CBA,Current
23-09-2025 00:44,CBA80605BD99FD04C8EA223,063-000-002,33333333,ALDI CBA,71.37,0,1441583.33,DR,REF389233,CBA,Current
23-09-2025 01:48,CBA894016A1669146719342,063-000-002,33333333,BIGW CBA,3.41,0,1441579.92,DR,REF386994,CBA,Current
23-09-2025 02:03,CBAFDC627FFB90449BBB9B5,063-000-002,33333333,SPOTIFY CBA,34.31,0,1441545.61,DR,REF706479,CBA,Current
23-09-2025 02:17,CBA282E1021B5C74114982A,063-000-002,33333333,COLES CBA,11.07,0,1441534.54,DR,REF150798,CBA,Current
23-09-2025 02:52,CBA360BBA309C214961992D,063-000-002,33333333,PAYMENT GATEWAY CBA,10.64,0,1441523.9,DR,REF152800,CBA,Current
23-09-2025 03:07,CBA13137FBFC9034B70B185,063-000-002,33333333,TAFE BOOKSHOP CBA,20.35,0,1441503.55,DR,REF437386,CBA,Current
23-09-2025 03:26,CBA28516344C2EF49E29B85,063-000-002,33333333,COMPANY PAYROLL CBA,0,6486.35,1447989.9,CR,REF610370,CBA,Current
23-09-2025 03:36,CBA2B150190A267448CA972,063-000-002,33333333,CITYLINK CBA,238.38,0,1447751.52,DR,REF764770,CBA,Current
23-09-2025 03:49,CBA6A33C46ADF0A4435B406,063-000-002,33333333,HARVEY NORMAN CBA,16.1,0,1447735.42,DR,REF764266,CBA,Current
23-09-2025 03:56,CBA50FF9C508DAD4AFABC6C,063-000-002,33333333,MCDONALDS CBA,25.74,0,1447709.68,DR,REF747704,CBA,Current
23-09-2025 03:58,CBA0DBEA3C3BD6D44D696E5,063-000-002,33333333,LIQUORLAND CBA,5.34,0,1447704.34,DR,REF944823,CBA,Current
23-09-2025 04:00,CBA637C6EABBC4D45B8B602,063-000-002,33333333,BANK FEE CBA,64.28,0,1447640.06,DR,REF574577,CBA,Current
23-09-2025 04:02,CBA2E9BD5A860D04952B3AA,063-000-002,33333333,PAYROLL CREDIT CBA,0,315.93,1447955.99,CR,REF734495,CBA,Current
23-09-2025 05:11,CBAA44313AA04694DBE84D7,063-000-002,33333333,MENULOG CBA,123.14,0,1447832.85,DR,REF526925,CBA,Current
23-09-2025 05:22,CBA5C1EF8FD09A84B3CBF3E,063-000-002,33333333,WOOLWORTHS CBA,5.29,0,1447827.56,DR,REF990166,CBA,Current
23-09-2025 05:27,CBA87596B7CDD2E46389E86,063-000-002,33333333,INTERNET TRANSFER CBA,19.2,0,1447808.36,DR,REF352495,CBA,Current
23-09-2025 05:36,CBACDED276260D74C2380AC,063-000-002,33333333,SPOTIFY CBA,31.89,0,1447776.47,DR,REF402548,CBA,Current
23-09-2025 05:53,CBA5C958984105D4B9C9473,063-000-002,33333333,KFC CBA,33.99,0,1447742.48,DR,REF614594,CBA,Current
23-09-2025 05:58,CBA416ED59B42EA4434ADAD,063-000-002,33333333,PAYPAL *NETFLIX CBA,63.49,0,1447678.99,DR,REF579983,CBA,Current
23-09-2025 06:29,CBA68AB00E5F54C4607B121,063-000-002,33333333,INTERNET TRANSFER CBA,63.91,0,1447615.08,DR,REF802887,CBA,Current
23-09-2025 07:59,CBAC2752B6EEA004314B492,063-000-002,33333333,COMPANY PAYROLL CBA,0,5830.45,1453445.53,CR,REF980116,CBA,Current
23-09-2025 08:51,CBA99B53953CD184D848034,063-000-002,33333333,BP CBA,6.97,0,1453438.56,DR,REF831069,CBA,Current
23-09-2025 09:27,CBADD1BA243C9624E3283FE,063-000-002,33333333,WOOLWORTHS CBA,11.31,0,1453427.25,DR,REF292669,CBA,Current
23-09-2025 09:34,INT86D587EC8DC94F419E6E,063-000-002,33333333,TRANSFER FROM ANZ 11111111,0,508.11,1453935.36,CR,INT-56407,CBA,Current
23-09-2025 09:57,CBAECA96799A1A94C17812C,063-000-002,33333333,INTERNET TRANSFER CBA,11.37,0,1453923.99,DR,REF776468,CBA,Current
23-09-2025 10:03,CBA6A2206F00131483AB591,063-000-002,33333333,SPOTIFY CBA,80.29,0,1453843.7,DR,REF991421,CBA,Current
23-09-2025 10:15,CBAF91ABB7B93E7406D8C7C,063-000-002,33333333,PAYPAL *NETFLIX CBA,21.46,0,1453822.24,DR,REF767254,CBA,Current
23-09-2025 11:14,CBA218AB5B262884C0EAB49,063-000-002,33333333,BANK FEE CBA,21.23,0,1453801.01,DR,REF866580,CBA,Current
23-09-2025 11:14,CBA3C9336FF2C6C4C5F93C3,063-000-002,33333333,COMPANY PAYROLL CBA,0,982.2,1454783.21,CR,REF980542,CBA,Current
23-09-2025 11:31,CBA720C5DF634884385840A,063-000-002,33333333,PAYROLL CREDIT CBA,0,426.13,1455209.34,CR,REF551420,CBA,Current
23-09-2025 11:54,CBA53E584ECCC2E43D6BF7C,063-000-002,33333333,WOOLWORTHS CBA,38.47,0,1455170.87,DR,REF730603,CBA,Current
23-09-2025 12:12,CBAFF5A6CCB00A946109618,063-000-002,33333333,BIGW CBA,104.26,0,1455066.61,DR,REF475834,CBA,Current
23-09-2025 12:52,CBA4BBE240122014F3F8133,063-000-002,33333333,STARBUCKS CBA,48.68,0,1455017.93,DR,REF574756,CBA,Current
23-09-2025 12:53,CBAD61D940CB5194437ABFA,063-000-002,33333333,WAGES CREDIT CBA,0,840.85,1455858.78,CR,REF528331,CBA,Current
23-09-2025 12:57,CBAC3741329754043C5A0CC,063-000-002,33333333,SPOTIFY CBA,11.57,0,1455847.21,DR,REF258633,CBA,Current
23-09-2025 12:59,CBA0D2AAEB37D074BDAA42E,063-000-002,33333333,TAFE BOOKSHOP CBA,6.41,0,1455840.8,DR,REF797209,CBA,Current
23-09-2025 13:05,CBA9192CC97844D4C9AAC61,063-000-002,33333333,ALDI CBA,11.81,0,1455828.99,DR,REF988760,CBA,Current
23-09-2025 14:27,CBA3656602906CD44BF82AE,063-000-002,33333333,UBER EATS CBA,35.52,0,1455793.47,DR,REF601086,CBA,Current
23-09-2025 14:34,CBA15A7028672F147139605,063-000-002,33333333,DOMINO'S PIZZA CBA,66.37,0,1455727.1,DR,REF869753,CBA,Current
23-09-2025 14:51,CBA6398D0E742E940B1B525,063-000-002,33333333,TAFE BOOKSHOP CBA,8.5,0,1455718.6,DR,REF673493,CBA,Current
23-09-2025 15:06,CBA3EB36E567AB5427696C9,063-000-002,33333333,INTERNET TRANSFER CBA,130.9,0,1455587.7,DR,REF524905,CBA,Current
23-09-2025 15:07,CBAE4777806162045E39732,063-000-002,33333333,WOOLWORTHS CBA,66.14,0,1455521.56,DR,REF154508,CBA,Current
23-09-2025 15:45,CBA4F21ECA679024C458466,063-000-002,33333333,APPLE CBA,105.4,0,1455416.16,DR,REF359739,CBA,Current
23-09-2025 16:36,CBA1F4BE24431EC4711BA08,063-000-002,33333333,KFC CBA,16.69,0,1455399.47,DR,REF682692,CBA,Current
23-09-2025 16:38,CBAFE6867DCBB724CCDBCD7,063-000-002,33333333,MENULOG CBA,88.17,0,1455311.3,DR,REF434691,CBA,Current
23-09-2025 17:28,CBA9601F82F7D644F80B7BE,063-000-002,33333333,WOOLWORTHS CBA,25.66,0,1455285.64,DR,REF797937,CBA,Current
23-09-2025 18:20,CBA0B9AE9B0E7AB4B2C929C,063-000-002,33333333,DOMINO'S PIZZA CBA,25.86,0,1455259.78,DR,REF218141,CBA,Current
23-09-2025 19:50,CBAD67F19A48A5947D1A904,063-000-002,33333333,BP CBA,11.36,0,1455248.42,DR,REF552526,CBA,Current
23-09-2025 19:54,CBA1010C6D5183E48BBAE13,063-000-002,33333333,STARBUCKS CBA,75.79,0,1455172.63,DR,REF859736,CBA,Current
23-09-2025 20:22,CBA82A4C3CB52604E078F42,063-000-002,33333333,ZOOM CBA,6.52,0,1455166.11,DR,REF398096,CBA,Current
23-09-2025 20:29,CBAC7BF992FD12D431897B6,063-000-002,33333333,BP CBA,8.1,0,1455158.01,DR,REF439061,CBA,Current
23-09-2025 20:34,CBAB5B6F3FD81404FAFAF2D,063-000-002,33333333,BANK FEE CBA,45.67,0,1455112.34,DR,REF767854,CBA,Current
23-09-2025 20:46,CBAF25733D854B24E6CBDF5,063-000-002,33333333,PAYPAL *NETFLIX CBA,43.93,0,1455068.41,DR,REF798550,CBA,Current
23-09-2025 21:53,CBA6A306F6E5C5D4634BDD1,063-000-002,33333333,BWS CBA,22.28,0,1455046.13,DR,REF625399,CBA,Current
23-09-2025 21:55,CBA48D35123FA4E4F7FB831,063-000-002,33333333,CITYLINK CBA,86.96,0,1454959.17,DR,REF888638,CBA,Current
23-09-2025 22:11,CBA175851A02FBB40E18A4F,063-000-002,33333333,TAFE BOOKSHOP CBA,5.05,0,1454954.12,DR,REF636191,CBA,Current
23-09-2025 22:12,CBA06BED46974494B97B5E5,063-000-002,33333333,UBER EATS CBA,231.42,0,1454722.7,DR,REF609961,CBA,Current
23-09-2025 22:41,CBA558C45003E06432FA6CE,063-000-002,33333333,LIQUORLAND CBA,49.62,0,1454673.08,DR,REF717238,CBA,Current
23-09-2025 22:52,CBA47D162B6F5B443B0B978,063-000-002,33333333,SHELL CBA,45.08,0,1454628,DR,REF609340,CBA,Current
23-09-2025 23:15,CBAC801BB70714949BD84B9,063-000-002,33333333,COMPANY PAYROLL CBA,0,932.53,1455560.53,CR,REF622117,CBA,Current
23-09-2025 23:56,CBAF6CF0267AF614AA99DCF,063-000-002,33333333,UBER EATS CBA,17.59,0,1455542.94,DR,REF695857,CBA,Current
24-09-2025 01:36,CBAB53037C8CD3543B2BC71,063-000-002,33333333,DOMINO'S PIZZA CBA,42.89,0,1455500.05,DR,REF801687,CBA,Current
24-09-2025 01:45,INT7AD2FA6F7CCA4DFBACF0,063-000-002,33333333,TRANSFER TO NAB 44444444,378.28,0,1455121.77,DR,INT-91661,CBA,Current
24-09-2025 03:10,CBA403165B4805D40AC8C23,063-000-002,33333333,KFC CBA,7.95,0,1455113.82,DR,REF133018,CBA,Current
24-09-2025 03:21,CBA812865D173E54AAFAF1C,063-000-002,33333333,PAYPAL *NETFLIX CBA,121.58,0,1454992.24,DR,REF412165,CBA,Current
24-09-2025 03:35,CBAADC117B37FBB4DA08FD3,063-000-002,33333333,AMAZON AU CBA,16.9,0,1454975.34,DR,REF613232,CBA,Current
24-09-2025 04:55,CBA56C69E5CD67F40799C77,063-000-002,33333333,MCDONALDS CBA,42.58,0,1454932.76,DR,REF956819,CBA,Current
24-09-2025 05:11,CBAE76592232A3843EE9A24,063-000-002,33333333,DOMINO'S PIZZA CBA,3.73,0,1454929.03,DR,REF580587,CBA,Current
24-09-2025 05:19,CBA7E7076CD9A4543EA9B83,063-000-002,33333333,WOOLWORTHS CBA,19.18,0,1454909.85,DR,REF238028,CBA,Current
24-09-2025 05:19,CBA3BB87BB297CB4CD9A966,063-000-002,33333333,COLES CBA,31.74,0,1454878.11,DR,REF977661,CBA,Current
24-09-2025 05:23,CBADFA59E28B12246BD9F5D,063-000-002,33333333,INTERNET TRANSFER CBA,69.68,0,1454808.43,DR,REF226654,CBA,Current
24-09-2025 06:05,CBA86EA5A6405114812B394,063-000-002,33333333,BWS CBA,22.61,0,1454785.82,DR,REF152446,CBA,Current
24-09-2025 06:25,CBA5AFE21AC404C4F829256,063-000-002,33333333,MCDONALDS CBA,76.11,0,1454709.71,DR,REF710394,CBA,Current
24-09-2025 06:43,CBAF2E5F919512D4DFCA7CF,063-000-002,33333333,SALARY PAYMENT CBA,0,5678.93,1460388.64,CR,REF198728,CBA,Current
24-09-2025 06:47,CBA5007EA713D394103AE43,063-000-002,33333333,MENULOG CBA,57.26,0,1460331.38,DR,REF998237,CBA,Current
24-09-2025 06:59,CBA5278DEA2B60946B8A87C,063-000-002,33333333,PAYMENT GATEWAY CBA,87.11,0,1460244.27,DR,REF612594,CBA,Current
24-09-2025 07:00,CBA5785D9AB6F9743569979,063-000-002,33333333,PAYROLL CREDIT CBA,0,1098.47,1461342.74,CR,REF584250,CBA,Current
24-09-2025 07:17,CBA07C3478E6C2D434C8727,063-000-002,33333333,WAGES CREDIT CBA,0,4898.68,1466241.42,CR,REF316761,CBA,Current
24-09-2025 07:28,CBA7145A86E3E60486AB888,063-000-002,33333333,INTERNET TRANSFER CBA,35.61,0,1466205.81,DR,REF850327,CBA,Current
24-09-2025 07:53,CBAFA1A4A99106E43E79FA4,063-000-002,33333333,MENULOG CBA,89.4,0,1466116.41,DR,REF558998,CBA,Current
24-09-2025 08:03,CBACFAAF4A10D5A45B08CF1,063-000-002,33333333,WOOLWORTHS CBA,9.53,0,1466106.88,DR,REF616726,CBA,Current
24-09-2025 08:30,CBAD44D545B03904D8389AB,063-000-002,33333333,ZOOM CBA,38.54,0,1466068.34,DR,REF128583,CBA,Current
24-09-2025 08:58,CBAD50ADA2B7B084F979506,063-000-002,33333333,COLES CBA,81.02,0,1465987.32,DR,REF321179,CBA,Current
24-09-2025 09:11,CBAAADE7DDFA92A4949BBD5,063-000-002,33333333,UBER EATS CBA,85.5,0,1465901.82,DR,REF894469,CBA,Current
24-09-2025 09:39,CBA1BCAF7821D644F76BA6D,063-000-002,33333333,BANK FEE CBA,74.34,0,1465827.48,DR,REF412836,CBA,Current
24-09-2025 09:59,CBAB9657DBD63644BC39950,063-000-002,33333333,PAYROLL CREDIT CBA,0,556.36,1466383.84,CR,REF730810,CBA,Current
24-09-2025 10:02,CBAB76415831AA34844AF7D,063-000-002,33333333,7-ELEVEN CBA,64.49,0,1466319.35,DR,REF988093,CBA,Current
24-09-2025 10:05,INTE02900C472A64348B5D3,063-000-002,33333333,TRANSFER TO CBA 22222222,329.43,0,1465989.92,DR,INT-62647,CBA,Current
24-09-2025 10:31,CBAE2A2B391A7984EBA9A8F,063-000-002,33333333,APPLE CBA,9.53,0,1465980.39,DR,REF318543,CBA,Current
24-09-2025 10:40,CBA73A9BEE092BB45739075,063-000-002,33333333,ALDI CBA,49.48,0,1465930.91,DR,REF670945,CBA,Current
24-09-2025 11:01,CBA665FB25880CB45EB9235,063-000-002,33333333,JB HI-FI CBA,3.35,0,1465927.56,DR,REF552301,CBA,Current
24-09-2025 11:06,CBA8584679BA26C4AF88BEC,063-000-002,33333333,PAYMENT GATEWAY CBA,4.55,0,1465923.01,DR,REF629498,CBA,Current
24-09-2025 11:25,CBA2F6A69C5ED744552966C,063-000-002,33333333,PAYMENT GATEWAY CBA,17.79,0,1465905.22,DR,REF648900,CBA,Current
24-09-2025 11:33,CBA882F199BA7CA47098346,063-000-002,33333333,KFC CBA,50.4,0,1465854.82,DR,REF398060,CBA,Current
24-09-2025 11:45,CBAB08998AB00324DB88241,063-000-002,33333333,APPLE CBA,97.38,0,1465757.44,DR,REF865664,CBA,Current
24-09-2025 11:59,CBAFA6B6DE248DF48EC8362,063-000-002,33333333,ZOOM CBA,155.14,0,1465602.3,DR,REF996561,CBA,Current
24-09-2025 12:22,CBA863791B6610845C7BE90,063-000-002,33333333,RAILWAY STATION CBA,43.5,0,1465558.8,DR,REF858037,CBA,Current
24-09-2025 12:26,CBAC15DEF9DA74F464A8152,063-000-002,33333333,JB HI-FI CBA,15.08,0,1465543.72,DR,REF817352,CBA,Current
24-09-2025 12:30,CBA93E1E6809F8743279FFA,063-000-002,33333333,WOOLWORTHS CBA,31.53,0,1465512.19,DR,REF170702,CBA,Current
24-09-2025 13:30,CBA6AD46B2C72B44BA8B2C3,063-000-002,33333333,BWS CBA,34.1,0,1465478.09,DR,REF952794,CBA,Current
24-09-2025 13:39,CBA791BC12B54A34BB4AA51,063-000-002,33333333,PAYROLL CREDIT CBA,0,207.74,1465685.83,CR,REF413361,CBA,Current
24-09-2025 13:46,CBA0461D7D6EE49481EBCB1,063-000-002,33333333,HARVEY NORMAN CBA,8.46,0,1465677.37,DR,REF910823,CBA,Current
24-09-2025 13:51,CBA65F2492B84CA43BA9A47,063-000-002,33333333,ZOOM CBA,24.51,0,1465652.86,DR,REF294180,CBA,Current
24-09-2025 14:00,CBAAF654FC3C1504E50B104,063-000-002,33333333,PAYPAL *NETFLIX CBA,37.73,0,1465615.13,DR,REF663392,CBA,Current
24-09-2025 14:16,CBA20DE5101986A41669030,063-000-002,33333333,FLIXBUS CBA,9.76,0,1465605.37,DR,REF523454,CBA,Current
24-09-2025 14:32,CBA864D9C3CFBAE423FBF8F,063-000-002,33333333,WOOLWORTHS CBA,34.99,0,1465570.38,DR,REF760293,CBA,Current
24-09-2025 14:41,CBA66DF920D31D44BC090C1,063-000-002,33333333,JB HI-FI CBA,14.56,0,1465555.82,DR,REF540297,CBA,Current
24-09-2025 14:42,CBAF858283DE510451989FF,063-000-002,33333333,BWS CBA,93.74,0,1465462.08,DR,REF968390,CBA,Current
24-09-2025 15:23,CBA8571227F611E47B5A105,063-000-002,33333333,ALDI CBA,7.19,0,1465454.89,DR,REF239356,CBA,Current
24-09-2025 15:57,CBA7CC2610DFC194D009792,063-000-002,33333333,MENULOG CBA,38.45,0,1465416.44,DR,REF693268,CBA,Current
24-09-2025 15:58,CBA72CDE6A1DE2E4A0D9F05,063-000-002,33333333,WAGES CREDIT CBA,0,2473.9,1467890.34,CR,REF373739,CBA,Current
24-09-2025 16:06,CBAE6558932970B4EEDB979,063-000-002,33333333,7-ELEVEN CBA,73.98,0,1467816.36,DR,REF639287,CBA,Current
24-09-2025 16:25,INT0412DE67C40E4096A76F,063-000-002,33333333,TRANSFER TO CBA 22222222,1232.84,0,1466583.52,DR,INT-62433,CBA,Current
24-09-2025 16:32,CBA057AD4FC7CD243F3BAE8,063-000-002,33333333,LIQUORLAND CBA,18.5,0,1466565.02,DR,REF582978,CBA,Current
24-09-2025 16:35,CBAD054A905843B4E10821E,063-000-002,33333333,APPLE CBA,234.87,0,1466330.15,DR,REF218202,CBA,Current
24-09-2025 16:35,CBA474AA36E14A643348802,063-000-002,33333333,WAGES CREDIT CBA,0,544.99,1466875.14,CR,REF405366,CBA,Current
24-09-2025 17:17,CBA07EDFEFBC01841958A1F,063-000-002,33333333,LIQUORLAND CBA,2.98,0,1466872.16,DR,REF516634,CBA,Current
24-09-2025 18:19,CBA0AB1E94C90EF49F1A88B,063-000-002,33333333,SHELL CBA,7.92,0,1466864.24,DR,REF591917,CBA,Current
24-09-2025 20:32,CBAF06F2327C7BE42B48C24,063-000-002,33333333,ALDI CBA,28.08,0,1466836.16,DR,REF126365,CBA,Current
24-09-2025 20:38,CBAF6C1E2575B6440AB944B,063-000-002,33333333,MENULOG CBA,166.34,0,1466669.82,DR,REF345079,CBA,Current
24-09-2025 20:52,CBA0EA3EF6628AA4D51A9C2,063-000-002,33333333,BP CBA,45.14,0,1466624.68,DR,REF303983,CBA,Current
24-09-2025 21:00,CBA5BF569AF0D1544449D00,063-000-002,33333333,SALARY PAYMENT CBA,0,4691.33,1471316.01,CR,REF963560,CBA,Current
24-09-2025 21:47,CBA84BD5109D24B4BA48C77,063-000-002,33333333,CITYLINK CBA,10.8,0,1471305.21,DR,REF702093,CBA,Current
24-09-2025 21:47,CBAC4710821931B4D25898F,063-000-002,33333333,DOMINO'S PIZZA CBA,85.68,0,1471219.53,DR,REF906977,CBA,Current
24-09-2025 21:53,CBA6F678CF4F78D4E8B92A4,063-000-002,33333333,WOOLWORTHS CBA,55.18,0,1471164.35,DR,REF199258,CBA,Current
24-09-2025 22:27,CBA68B7292F5C72452E8BFF,063-000-002,33333333,MCDONALDS CBA,3.49,0,1471160.86,DR,REF491101,CBA,Current
24-09-2025 22:56,INT765AAC677A864BF19A95,063-000-002,33333333,TRANSFER FROM CBA 22222222,0,305.27,1471466.13,CR,INT-99105,CBA,Current
24-09-2025 23:00,CBAFA6D34362D2440158CCB,063-000-002,33333333,RAILWAY STATION CBA,48.45,0,1471417.68,DR,REF352475,CBA,Current
24-09-2025 23:12,CBA03BB566E33DF4B1C8D3A,063-000-002,33333333,INTERNET TRANSFER CBA,80.17,0,1471337.51,DR,REF263922,CBA,Current
24-09-2025 23:49,CBA946218D10AD34D3896C7,063-000-002,33333333,WOOLWORTHS CBA,7.89,0,1471329.62,DR,REF825127,CBA,Current
25-09-2025 00:18,CBA8ED5E6D474764AF59537,063-000-002,33333333,DOMINO'S PIZZA CBA,32.1,0,1471297.52,DR,REF936197,CBA,Current
25-09-2025 00:31,CBAF2853638857244E8AF85,063-000-002,33333333,JB HI-FI CBA,4.28,0,1471293.24,DR,REF537189,CBA,Current
25-09-2025 00:46,CBAB51A85D58DE04DEEB03E,063-000-002,33333333,BWS CBA,82.76,0,1471210.48,DR,REF737024,CBA,Current
25-09-2025 01:04,CBA066468D31AB6493B8129,063-000-002,33333333,SHELL CBA,133.21,0,1471077.27,DR,REF130905,CBA,Current
25-09-2025 01:43,CBA8475CFC1C5AA48DD9957,063-000-002,33333333,DOMINO'S PIZZA CBA,121.36,0,1470955.91,DR,REF353355,CBA,Current
25-09-2025 01:51,CBA9CB9F96B09994A9F965A,063-000-002,33333333,BP CBA,20.84,0,1470935.07,DR,REF479386,CBA,Current
25-09-2025 02:05,CBA008032A53F3B45DEA7E4,063-000-002,33333333,HARVEY NORMAN CBA,12.92,0,1470922.15,DR,REF744048,CBA,Current
25-09-2025 02:24,CBAB1D31F275F1A46D79214,063-000-002,33333333,RAILWAY STATION CBA,16.98,0,1470905.17,DR,REF127762,CBA,Current
25-09-2025 02:53,CBADC631B6170304F199CDE,063-000-002,33333333,WAGES CREDIT CBA,0,5147.76,1476052.93,CR,REF979013,CBA,Current
25-09-2025 03:02,CBACD4F4CDD87D94157BA66,063-000-002,33333333,ALDI CBA,150.18,0,1475902.75,DR,REF854451,CBA,Current
25-09-2025 03:03,CBA4B0E76BDB61F4585B40D,063-000-002,33333333,COMPANY PAYROLL CBA,0,7574.4,1483477.15,CR,REF668127,CBA,Current
25-09-2025 03:31,CBA4939E4585DD8453B9690,063-000-002,33333333,WAGES CREDIT CBA,0,185.7,1483662.85,CR,REF199456,CBA,Current
25-09-2025 03:42,CBA96E8E5B082474AE4981F,063-000-002,33333333,CITYLINK CBA,38.61,0,1483624.24,DR,REF532249,CBA,Current
25-09-2025 03:43,CBAECA06BDB89D54444976E,063-000-002,33333333,MENULOG CBA,26.23,0,1483598.01,DR,REF414307,CBA,Current
25-09-2025 04:16,CBA5CE6C0C5587347F0ACD2,063-000-002,33333333,MENULOG CBA,13.74,0,1483584.27,DR,REF268617,CBA,Current
25-09-2025 04:22,CBA33B29204C6C544AD8F4D,063-000-002,33333333,BANK FEE CBA,48.94,0,1483535.33,DR,REF481508,CBA,Current
25-09-2025 04:35,CBA0B325BD2E853447FA8AB,063-000-002,33333333,MCDONALDS CBA,33.66,0,1483501.67,DR,REF322558,CBA,Current
25-09-2025 05:08,CBA64764CBA8D634EC5A9FF,063-000-002,33333333,PAYROLL CREDIT CBA,0,7290.79,1490792.46,CR,REF519658,CBA,Current
25-09-2025 05:14,CBA9DBC49C759064ABCA3BF,063-000-002,33333333,BANK FEE CBA,235.43,0,1490557.03,DR,REF122362,CBA,Current
25-09-2025 05:19,CBA222A304B51B0479E90D4,063-000-002,33333333,APPLE CBA,65.7,0,1490491.33,DR,REF722409,CBA,Current
25-09-2025 05:30,CBA9CBE436A3B7840DCA30B,063-000-002,33333333,DOMINO'S PIZZA CBA,3.96,0,1490487.37,DR,REF900351,CBA,Current
25-09-2025 06:24,CBA08095D77A4914389B17E,063-000-002,33333333,APPLE CBA,54.64,0,1490432.73,DR,REF450783,CBA,Current
25-09-2025 06:50,CBAD969B64436D44F1F9FAB,063-000-002,33333333,APPLE CBA,50.05,0,1490382.68,DR,REF244160,CBA,Current
25-09-2025 06:51,CBA150D122E6D2746ACB3CF,063-000-002,33333333,COLES CBA,55.1,0,1490327.58,DR,REF590766,CBA,Current
25-09-2025 06:55,CBAABB19FDC9CA54E03BA6B,063-000-002,33333333,ALDI CBA,150.98,0,1490176.6,DR,REF674579,CBA,Current
25-09-2025 07:08,CBA8CE97DADEFB046F0AA29,063-000-002,33333333,ZOOM CBA,50.65,0,1490125.95,DR,REF250995,CBA,Current
25-09-2025 07:23,CBA71B4B45850CA441B8367,063-000-002,33333333,WAGES CREDIT CBA,0,1061.79,1491187.74,CR,REF604167,CBA,Current
25-09-2025 07:24,CBAC5191885AAC943B4A40A,063-000-002,33333333,7-ELEVEN CBA,144.99,0,1491042.75,DR,REF190118,CBA,Current
25-09-2025 07:36,CBAEC3733CD0F9440669A0B,063-000-002,33333333,INTERNET TRANSFER CBA,69.19,0,1490973.56,DR,REF362108,CBA,Current
25-09-2025 08:05,CBAA60DFFF773564BD5AD38,063-000-002,33333333,TAFE BOOKSHOP CBA,25.73,0,1490947.83,DR,REF583483,CBA,Current
25-09-2025 09:00,CBA21B5D7AB6D57475B90A6,063-000-002,33333333,SPOTIFY CBA,18.21,0,1490929.62,DR,REF514203,CBA,Current
25-09-2025 09:06,CBA911E17D5CADA4ED888D9,063-000-002,33333333,JB HI-FI CBA,37.03,0,1490892.59,DR,REF167256,CBA,Current
25-09-2025 09:25,CBA60F1175A704544AD9967,063-000-002,33333333,HARVEY NORMAN CBA,36.09,0,1490856.5,DR,REF382998,CBA,Current
25-09-2025 09:42,CBAD32AFEA900CC4B65A819,063-000-002,33333333,SPOTIFY CBA,16.89,0,1490839.61,DR,REF513324,CBA,Current
25-09-2025 09:58,CBA74B231531CA845B4A19B,063-000-002,33333333,SPOTIFY CBA,44.59,0,1490795.02,DR,REF159870,CBA,Current
25-09-2025 10:05,CBABA7CC6E261944A24B929,063-000-002,33333333,BP CBA,133.18,0,1490661.84,DR,REF377954,CBA,Current
25-09-2025 10:33,CBA2A6D970BDD444536BC5B,063-000-002,33333333,STARBUCKS CBA,2.72,0,1490659.12,DR,REF354276,CBA,Current
25-09-2025 10:37,CBA3F3CDC7D4BCC46BBBE8A,063-000-002,33333333,MCDONALDS CBA,46.92,0,1490612.2,DR,REF593040,CBA,Current
25-09-2025 11:15,CBAAC71E1B73AC84B5998A4,063-000-002,33333333,PAYMENT GATEWAY CBA,24.06,0,1490588.14,DR,REF373008,CBA,Current
25-09-2025 11:39,CBA068B341CA855443EB931,063-000-002,33333333,COMPANY PAYROLL CBA,0,2908.03,1493496.17,CR,REF385292,CBA,Current
25-09-2025 11:46,CBABB83A428411B4E9E8C14,063-000-002,33333333,FLIXBUS CBA,9.89,0,1493486.28,DR,REF309412,CBA,Current
25-09-2025 11:55,CBA67006B41263A49F6993E,063-000-002,33333333,COMPANY PAYROLL CBA,0,4229.82,1497716.1,CR,REF129671,CBA,Current
25-09-2025 12:05,CBA7FC48738168745FC8C92,063-000-002,33333333,SHELL CBA,91.14,0,1497624.96,DR,REF771993,CBA,Current
25-09-2025 12:26,CBA569B60939DB045368C9B,063-000-002,33333333,DOMINO'S PIZZA CBA,16.97,0,1497607.99,DR,REF692524,CBA,Current
25-09-2025 12:37,CBA43F122BBF14B480DBE3B,063-000-002,33333333,MCDONALDS CBA,55.74,0,1497552.25,DR,REF372196,CBA,Current
25-09-2025 12:42,INT1D988BE707954402BB58,063-000-002,33333333,TRANSFER FROM ANZ 11111111,0,1299.83,1498852.08,CR,INT-17023,CBA,Current
25-09-2025 12:44,CBA4A439FE3E2A841459A27,063-000-002,33333333,SHELL CBA,46.13,0,1498805.95,DR,REF613157,CBA,Current
25-09-2025 13:06,CBA429AF15878C34F81B9B7,063-000-002,33333333,FLIXBUS CBA,7.73,0,1498798.22,DR,REF138477,CBA,Current
25-09-2025 13:19,CBA133852EB45B049ABB20C,063-000-002,33333333,COLES CBA,14.46,0,1498783.76,DR,REF873679,CBA,Current
25-09-2025 14:58,CBA577ABBB1FE954D4AB427,063-000-002,33333333,7-ELEVEN CBA,22.36,0,1498761.4,DR,REF127274,CBA,Current
25-09-2025 15:09,INT0A2BA372470846DF9CF8,063-000-002,33333333,TRANSFER FROM ANZ 11111111,0,1205.68,1499967.08,CR,INT-28455,CBA,Current
25-09-2025 15:24,CBA3FE7E03A808447A1B6CD,063-000-002,33333333,APPLE CBA,24.14,0,1499942.94,DR,REF258943,CBA,Current
25-09-2025 15:55,CBA86BE741DAE21420A82B4,063-000-002,33333333,BANK FEE CBA,45.85,0,1499897.09,DR,REF532235,CBA,Current
25-09-2025 15:55,CBA3247974D77F14E658110,063-000-002,33333333,WOOLWORTHS CBA,34.3,0,1499862.79,DR,REF778388,CBA,Current
25-09-2025 16:26,CBA500FB95B8655401BA88B,063-000-002,33333333,DOMINO'S PIZZA CBA,80.38,0,1499782.41,DR,REF693627,CBA,Current
25-09-2025 16:33,CBAA9DDDF5FE32A40E18BA5,063-000-002,33333333,BP CBA,162.74,0,1499619.67,DR,REF700346,CBA,Current
25-09-2025 17:01,CBA76D2A4E38AC843378886,063-000-002,33333333,PAYPAL *NETFLIX CBA,105.41,0,1499514.26,DR,REF524019,CBA,Current
25-09-2025 17:05,CBA8AC11B001DA54F48BECA,063-000-002,33333333,ALDI CBA,72.4,0,1499441.86,DR,REF417362,CBA,Current
25-09-2025 17:25,CBA057CFDE719084F68B6DC,063-000-002,33333333,CITYLINK CBA,3.9,0,1499437.96,DR,REF807818,CBA,Current
25-09-2025 17:40,CBA461A84641F1A439ABC67,063-000-002,33333333,KFC CBA,48.91,0,1499389.05,DR,REF107575,CBA,Current
25-09-2025 18:23,CBA10C8187BA2E74900ABA6,063-000-002,33333333,SPOTIFY CBA,14.38,0,1499374.67,DR,REF509629,CBA,Current
25-09-2025 18:25,CBA292447607CCC44B6BD27,063-000-002,33333333,CITYLINK CBA,42.87,0,1499331.8,DR,REF316101,CBA,Current
25-09-2025 18:38,CBAFD8B5EDE17544DC1945B,063-000-002,33333333,BP CBA,40.89,0,1499290.91,DR,REF330789,CBA,Current
25-09-2025 18:41,CBA8B5CB3B8ECA74DC681E9,063-000-002,33333333,HARVEY NORMAN CBA,60.87,0,1499230.04,DR,REF346653,CBA,Current
25-09-2025 19:01,CBA02395B8B75684952916D,063-000-002,33333333,MCDONALDS CBA,30.62,0,1499199.42,DR,REF244148,CBA,Current
25-09-2025 20:14,CBA93469FB7AD874985B515,063-000-002,33333333,TAFE BOOKSHOP CBA,40.65,0,1499158.77,DR,REF922801,CBA,Current
25-09-2025 20:59,CBA523E15E27210436AADD6,063-000-002,33333333,SHELL CBA,8.84,0,1499149.93,DR,REF106427,CBA,Current
25-09-2025 21:23,CBA66F3E60F99824EBC96D4,063-000-002,33333333,LIQUORLAND CBA,11.86,0,1499138.07,DR,REF423980,CBA,Current
25-09-2025 21:25,CBA3AF9A363C82441F6AD76,063-000-002,33333333,KFC CBA,101.9,0,1499036.17,DR,REF161029,CBA,Current
25-09-2025 21:43,CBA0C6C6449B6A844F1A478,063-000-002,33333333,SPOTIFY CBA,10.67,0,1499025.5,DR,REF792968,CBA,Current
25-09-2025 22:01,CBACE1FB704EC3A4350BEEA,063-000-002,33333333,ALDI CBA,135.9,0,1498889.6,DR,REF659519,CBA,Current
25-09-2025 22:24,CBA88A828C969B14987BA90,063-000-002,33333333,DOMINO'S PIZZA CBA,41.6,0,1498848,DR,REF596788,CBA,Current
25-09-2025 22:30,INTC8A0C4B1D56143B0AC23,063-000-002,33333333,TRANSFER TO NAB 44444444,1084.23,0,1497763.77,DR,INT-94684,CBA,Current
25-09-2025 22:35,CBA505379DC059E4E3489ED,063-000-002,33333333,LIQUORLAND CBA,42.32,0,1497721.45,DR,REF541807,CBA,Current
25-09-2025 23:00,CBAB2036F19F2764F89A441,063-000-002,33333333,ALDI CBA,25.04,0,1497696.41,DR,REF283752,CBA,Current
25-09-2025 23:02,CBAD1BEB66FE4D64E6C87A6,063-000-002,33333333,MENULOG CBA,25.72,0,1497670.69,DR,REF566085,CBA,Current
25-09-2025 23:04,CBAF84642C5CEA74031985E,063-000-002,33333333,MCDONALDS CBA,146.56,0,1497524.13,DR,REF178412,CBA,Current
25-09-2025 23:08,CBA6607B652EB04406BA98C,063-000-002,33333333,ZOOM CBA,9.68,0,1497514.45,DR,REF565013,CBA,Current
26-09-2025 00:36,CBA65C8C5AEC7C744C09DD8,063-000-002,33333333,COLES CBA,32.22,0,1497482.23,DR,REF927792,CBA,Current
26-09-2025 00:36,CBAF1C5EC102EDE4D649715,063-000-002,33333333,ALDI CBA,19.08,0,1497463.15,DR,REF724709,CBA,Current
26-09-2025 00:48,CBA97BF56C9F92649F5AA03,063-000-002,33333333,INTERNET TRANSFER CBA,186.62,0,1497276.53,DR,REF394595,CBA,Current
26-09-2025 00:54,INTDCDEE37E2B6B40D49085,063-000-002,33333333,TRANSFER TO ANZ 11111111,1475.33,0,1495801.2,DR,INT-72153,CBA,Current
26-09-2025 02:06,CBA0290CD48A9D34380A71E,063-000-002,33333333,COLES CBA,138.86,0,1495662.34,DR,REF789744,CBA,Current
26-09-2025 02:10,CBA3BBE53D780B040E69B4A,063-000-002,33333333,LIQUORLAND CBA,50.18,0,1495612.16,DR,REF888479,CBA,Current
26-09-2025 02:25,CBAD9DDF49DE6F1476D8F86,063-000-002,33333333,INTERNET TRANSFER CBA,4.63,0,1495607.53,DR,REF794891,CBA,Current
26-09-2025 02:43,CBAD3D90B65454943E78FF3,063-000-002,33333333,7-ELEVEN CBA,48.98,0,1495558.55,DR,REF566130,CBA,Current
26-09-2025 02:45,CBA3E807EF63017420DA8A2,063-000-002,33333333,BIGW CBA,145.53,0,1495413.02,DR,REF495575,CBA,Current
26-09-2025 02:47,CBADF6EA500B52C4DED9A03,063-000-002,33333333,SALARY PAYMENT CBA,0,4411.62,1499824.64,CR,REF265741,CBA,Current
26-09-2025 03:13,CBA2AE24879FFE047AFADD3,063-000-002,33333333,AMAZON AU CBA,66.89,0,1499757.75,DR,REF846178,CBA,Current
26-09-2025 03:20,CBA5546470553244790942B,063-000-002,33333333,PAY - SALARY CBA,0,5796.94,1505554.69,CR,REF762320,CBA,Current
26-09-2025 04:07,CBA4753FF25DECC4F669DBF,063-000-002,33333333,CITYLINK CBA,21,0,1505533.69,DR,REF405166,CBA,Current
26-09-2025 04:20,CBAE19E9D1113F34D88AC75,063-000-002,33333333,COMPANY PAYROLL CBA,0,3857.12,1509390.81,CR,REF811993,CBA,Current
26-09-2025 04:52,CBAD8696042F5A842FD9FA7,063-000-002,33333333,SALARY PAYMENT CBA,0,4875.82,1514266.63,CR,REF695105,CBA,Current
26-09-2025 04:59,CBA080F6DA871044E7EA6FC,063-000-002,33333333,TAFE BOOKSHOP CBA,23.64,0,1514242.99,DR,REF896138,CBA,Current
26-09-2025 05:13,CBA4F0399EB90D345E7802F,063-000-002,33333333,STARBUCKS CBA,20.78,0,1514222.21,DR,REF739463,CBA,Current
26-09-2025 05:21,CBA7C2AB85F6BB14466BAC6,063-000-002,33333333,PAYROLL CREDIT CBA,0,1062.03,1515284.24,CR,REF928020,CBA,Current
26-09-2025 05:48,CBAC700E7DFA264486BB48B,063-000-002,33333333,LIQUORLAND CBA,80.34,0,1515203.9,DR,REF714079,CBA,Current
26-09-2025 06:16,CBA98AD20B3D99D4EE99DD6,063-000-002,33333333,WAGES CREDIT CBA,0,4837.14,1520041.04,CR,REF481682,CBA,Current
26-09-2025 06:26,CBAAA8B4F955E2842CE8AC1,063-000-002,33333333,PAYROLL CREDIT CBA,0,5073.3,1525114.34,CR,REF263941,CBA,Current
26-09-2025 06:44,CBA5D96C14E045D43D1AD19,063-000-002,33333333,FLIXBUS CBA,11.36,0,1525102.98,DR,REF109499,CBA,Current
26-09-2025 06:57,CBA7E18B24BCF53410C8C32,063-000-002,33333333,KFC CBA,48.15,0,1525054.83,DR,REF216022,CBA,Current
26-09-2025 07:03,CBACD20D2A46D7E4087AA01,063-000-002,33333333,TAFE BOOKSHOP CBA,11.59,0,1525043.24,DR,REF238651,CBA,Current
26-09-2025 07:42,CBA7DE09F8929F946DA9CB2,063-000-002,33333333,WOOLWORTHS CBA,101.11,0,1524942.13,DR,REF414426,CBA,Current
26-09-2025 08:54,CBAAF2EBE9ECC3B42F280BB,063-000-002,33333333,SHELL CBA,18.89,0,1524923.24,DR,REF727206,CBA,Current
26-09-2025 09:07,CBA6495AA07C186465A8F45,063-000-002,33333333,DOMINO'S PIZZA CBA,127.38,0,1524795.86,DR,REF440723,CBA,Current
26-09-2025 09:32,CBA70E7C896DBDB47CD94FE,063-000-002,33333333,UBER EATS CBA,21.05,0,1524774.81,DR,REF999009,CBA,Current
26-09-2025 09:36,CBA99DC742E04DF49D6BC32,063-000-002,33333333,WAGES CREDIT CBA,0,6646.73,1531421.54,CR,REF405107,CBA,Current
26-09-2025 09:42,CBA976A60987944495CBD9D,063-000-002,33333333,APPLE CBA,12.48,0,1531409.06,DR,REF963783,CBA,Current
26-09-2025 10:20,CBA5F93C14075CE4E8F803E,063-000-002,33333333,LIQUORLAND CBA,92.15,0,1531316.91,DR,REF266547,CBA,Current
26-09-2025 10:28,CBA32595D2FEB274BCD8526,063-000-002,33333333,SHELL CBA,41.68,0,1531275.23,DR,REF850967,CBA,Current
26-09-2025 10:41,CBA3A3B1C0B5E554E64AFF3,063-000-002,33333333,RAILWAY STATION CBA,20.84,0,1531254.39,DR,REF778237,CBA,Current
26-09-2025 11:11,CBAA7696D88DEFE41A492CA,063-000-002,33333333,PAY - SALARY CBA,0,4123.7,1535378.09,CR,REF508111,CBA,Current
26-09-2025 11:30,CBABCAE98D90DD24FA6A6FB,063-000-002,33333333,APPLE CBA,26.66,0,1535351.43,DR,REF543423,CBA,Current
26-09-2025 11:44,CBA034CA996FEE74DF68AE4,063-000-002,33333333,BANK FEE CBA,11.42,0,1535340.01,DR,REF829702,CBA,Current
26-09-2025 11:51,CBADE64C856465A405C9816,063-000-002,33333333,MCDONALDS CBA,24.82,0,1535315.19,DR,REF281537,CBA,Current
26-09-2025 12:41,CBA183E7954861E468E9CB5,063-000-002,33333333,PAYMENT GATEWAY CBA,42.42,0,1535272.77,DR,REF812317,CBA,Current
26-09-2025 12:43,CBA81C530C584AF4F1CBD7D,063-000-002,33333333,RAILWAY STATION CBA,8.06,0,1535264.71,DR,REF961976,CBA,Current
26-09-2025 13:38,CBA01B4E38D88FF4880BC0C,063-000-002,33333333,COMPANY PAYROLL CBA,0,5362.06,1540626.77,CR,REF795483,CBA,Current
26-09-2025 13:49,CBAA64C1C55921842DEA782,063-000-002,33333333,TAFE BOOKSHOP CBA,57.03,0,1540569.74,DR,REF510220,CBA,Current
26-09-2025 13:52,CBAC7E192D838954C5CB21A,063-000-002,33333333,BP CBA,68.52,0,1540501.22,DR,REF469276,CBA,Current
26-09-2025 13:56,CBA67F73CA264AB420ABF2B,063-000-002,33333333,PAYPAL *NETFLIX CBA,92.12,0,1540409.1,DR,REF542463,CBA,Current
26-09-2025 13:57,CBADB1E1ECDCAB545928058,063-000-002,33333333,7-ELEVEN CBA,2.14,0,1540406.96,DR,REF445615,CBA,Current
26-09-2025 15:20,CBA7630D1DB1CED4786A84F,063-000-002,33333333,WOOLWORTHS CBA,57.05,0,1540349.91,DR,REF996523,CBA,Current
26-09-2025 15:39,CBA3E7A98F81BC7460C8EFB,063-000-002,33333333,PAY - SALARY CBA,0,1911.61,1542261.52,CR,REF786908,CBA,Current
26-09-2025 15:54,INT5BCD87B6BBDE44CB9E81,063-000-002,33333333,TRANSFER FROM NAB 44444444,0,1433.23,1543694.75,CR,INT-21262,CBA,Current
26-09-2025 16:03,CBA96E5EBA2F5D543D19C38,063-000-002,33333333,MENULOG CBA,6.21,0,1543688.54,DR,REF312957,CBA,Current
26-09-2025 16:37,CBA1C1AEC85EA144997B224,063-000-002,33333333,FLIXBUS CBA,142.3,0,1543546.24,DR,REF279116,CBA,Current
26-09-2025 17:18,CBA8A33EE04A56F4D22AB17,063-000-002,33333333,CITYLINK CBA,4.43,0,1543541.81,DR,REF620485,CBA,Current
26-09-2025 17:22,CBA3F344C5104284A1383A7,063-000-002,33333333,WOOLWORTHS CBA,19.9,0,1543521.91,DR,REF359082,CBA,Current
26-09-2025 17:22,CBAC39B8F89B662421FBBF0,063-000-002,33333333,7-ELEVEN CBA,9.8,0,1543512.11,DR,REF688120,CBA,Current
26-09-2025 17:30,CBA16D80575E7644F6B88AA,063-000-002,33333333,STARBUCKS CBA,46.7,0,1543465.41,DR,REF823757,CBA,Current
26-09-2025 17:41,CBAAD9AF7716F2F4996B535,063-000-002,33333333,COMPANY PAYROLL CBA,0,2343.79,1545809.2,CR,REF477888,CBA,Current
26-09-2025 18:00,CBA69E83334BB214C178596,063-000-002,33333333,COLES CBA,12.97,0,1545796.23,DR,REF887418,CBA,Current
26-09-2025 18:44,CBA5FD7F7604CB1442E85C7,063-000-002,33333333,ALDI CBA,33.2,0,1545763.03,DR,REF906776,CBA,Current
26-09-2025 18:57,CBA38632844DBE947FFB08B,063-000-002,33333333,COLES CBA,12.99,0,1545750.04,DR,REF421894,CBA,Current
26-09-2025 19:02,CBA2E0D843716A94412840C,063-000-002,33333333,SALARY PAYMENT CBA,0,6755.94,1552505.98,CR,REF399559,CBA,Current
26-09-2025 19:50,CBA0C4FBC7378A74F5B9B3B,063-000-002,33333333,SHELL CBA,85.5,0,1552420.48,DR,REF266437,CBA,Current
26-09-2025 20:29,CBA95EC598751DA4B2A9A6C,063-000-002,33333333,UBER EATS CBA,63.77,0,1552356.71,DR,REF434363,CBA,Current
26-09-2025 21:20,CBAC45253E173F04158A760,063-000-002,33333333,STARBUCKS CBA,13.6,0,1552343.11,DR,REF471069,CBA,Current
26-09-2025 21:20,INTC27B6B34C555439A9E9C,063-000-002,33333333,TRANSFER FROM CBA 22222222,0,1076.11,1553419.22,CR,INT-12977,CBA,Current
26-09-2025 21:28,CBAD1B2A2A998A743AF9982,063-000-002,33333333,DOMINO'S PIZZA CBA,111.39,0,1553307.83,DR,REF142312,CBA,Current
26-09-2025 21:37,CBA6CA9D023503E4FD8A8C6,063-000-002,33333333,PAY - SALARY CBA,0,6915.93,1560223.76,CR,REF928801,CBA,Current
26-09-2025 21:52,CBA68A0FEAE55D24BA6B25A,063-000-002,33333333,UBER EATS CBA,68.54,0,1560155.22,DR,REF895542,CBA,Current
26-09-2025 22:13,CBA6FDEEBE7538E45208F79,063-000-002,33333333,PAYPAL *NETFLIX CBA,10.93,0,1560144.29,DR,REF289242,CBA,Current
26-09-2025 22:22,CBAF474A6A1869D4356B9F8,063-000-002,33333333,TAFE BOOKSHOP CBA,43.14,0,1560101.15,DR,REF981946,CBA,Current
26-09-2025 23:32,CBA6BC74772B7B34B04B1BD,063-000-002,33333333,COMPANY PAYROLL CBA,0,1066.83,1561167.98,CR,REF631212,CBA,Current
26-09-2025 23:44,INTBD6306FE79F24369989C,063-000-002,33333333,TRANSFER FROM CBA 22222222,0,1485.02,1562653,CR,INT-15873,CBA,Current
26-09-2025 23:46,CBA0CE89C5D304C4575977C,063-000-002,33333333,RAILWAY STATION CBA,32.84,0,1562620.16,DR,REF754623,CBA,Current
26-09-2025 23:54,CBA62BE21D252EA47CBA0C0,063-000-002,33333333,BIGW CBA,19.88,0,1562600.28,DR,REF540611,CBA,Current
27-09-2025 00:11,CBAF9C3B4E5D7AE478892C7,063-000-002,33333333,ZOOM CBA,71.29,0,1562528.99,DR,REF121210,CBA,Current
27-09-2025 00:12,CBA54C6CB4C4BA143469843,063-000-002,33333333,BP CBA,77.65,0,1562451.34,DR,REF106779,CBA,Current
27-09-2025 00:15,CBA2D85072F18CC45FEA5ED,063-000-002,33333333,DOMINO'S PIZZA CBA,29.1,0,1562422.24,DR,REF614948,CBA,Current
27-09-2025 00:35,INTBBECFD5C81B641598669,063-000-002,33333333,TRANSFER TO CBA 22222222,1336.7,0,1561085.54,DR,INT-78440,CBA,Current
27-09-2025 00:59,INTB4ECA70BC86042E18499,063-000-002,33333333,TRANSFER FROM ANZ 11111111,0,723.14,1561808.68,CR,INT-98210,CBA,Current
27-09-2025 01:14,CBA2415DF494FEC41A19BBC,063-000-002,33333333,HARVEY NORMAN CBA,79.05,0,1561729.63,DR,REF425074,CBA,Current
27-09-2025 01:24,CBA75CB78FC4EA14ECA9FCC,063-000-002,33333333,TAFE BOOKSHOP CBA,99.73,0,1561629.9,DR,REF893627,CBA,Current
27-09-2025 02:18,CBAFC3D5B047E584A9AB18C,063-000-002,33333333,SHELL CBA,170.37,0,1561459.53,DR,REF148306,CBA,Current
27-09-2025 02:18,CBA112021D59C8D4BEF8D1C,063-000-002,33333333,WAGES CREDIT CBA,0,6543.85,1568003.38,CR,REF125438,CBA,Current
27-09-2025 02:23,CBA137A539281B84A87BAA5,063-000-002,33333333,JB HI-FI CBA,36.48,0,1567966.9,DR,REF774774,CBA,Current
27-09-2025 02:32,CBAE38684E8A50244ED9118,063-000-002,33333333,ZOOM CBA,9.65,0,1567957.25,DR,REF618180,CBA,Current
27-09-2025 02:38,CBA99317210A299440C84AE,063-000-002,33333333,SHELL CBA,163.85,0,1567793.4,DR,REF424629,CBA,Current
27-09-2025 02:47,CBA862FB482EAB7480E8B13,063-000-002,33333333,WOOLWORTHS CBA,46.69,0,1567746.71,DR,REF977939,CBA,Current
27-09-2025 02:55,CBAF3D7CE21DED448728B28,063-000-002,33333333,DOMINO'S PIZZA CBA,28.77,0,1567717.94,DR,REF535999,CBA,Current
27-09-2025 03:26,CBAF8F35185A3D44E0E8E01,063-000-002,33333333,PAY - SALARY CBA,0,5009.34,1572727.28,CR,REF887945,CBA,Current
27-09-2025 04:40,CBA1230C202CBE34E5F8E47,063-000-002,33333333,SPOTIFY CBA,37.29,0,1572689.99,DR,REF393037,CBA,Current
27-09-2025 05:05,CBA501B4B3A181A45BC9A99,063-000-002,33333333,RAILWAY STATION CBA,11.57,0,1572678.42,DR,REF236337,CBA,Current
27-09-2025 05:41,CBA0117AEB7F7D7492FA794,063-000-002,33333333,DOMINO'S PIZZA CBA,26.03,0,1572652.39,DR,REF294910,CBA,Current
27-09-2025 05:46,CBA0E3917BF136B480D8348,063-000-002,33333333,BIGW CBA,3.07,0,1572649.32,DR,REF287420,CBA,Current
27-09-2025 06:17,CBAE0B99CC09DE946E88028,063-000-002,33333333,KFC CBA,20.48,0,1572628.84,DR,REF478868,CBA,Current
27-09-2025 06:18,CBAE0F888EAC31143148321,063-000-002,33333333,SALARY PAYMENT CBA,0,7843.04,1580471.88,CR,REF408020,CBA,Current
27-09-2025 06:30,CBA297C82FDC8954A9CA6F3,063-000-002,33333333,LIQUORLAND CBA,22.19,0,1580449.69,DR,REF147025,CBA,Current
27-09-2025 06:33,CBADE53248A98344FC0BA63,063-000-002,33333333,PAYMENT GATEWAY CBA,36.32,0,1580413.37,DR,REF335715,CBA,Current
27-09-2025 06:33,INT1343D9CAF43F4FCC968B,063-000-002,33333333,TRANSFER FROM NAB 44444444,0,1012.02,1581425.39,CR,INT-77797,CBA,Current
27-09-2025 06:43,CBAC807CAC752124594A7C6,063-000-002,33333333,COMPANY PAYROLL CBA,0,471.4,1581896.79,CR,REF672419,CBA,Current
27-09-2025 07:23,CBA7050A463440A43DCBEAD,063-000-002,33333333,PAYPAL *NETFLIX CBA,55.82,0,1581840.97,DR,REF471055,CBA,Current
27-09-2025 07:41,CBA71D3A30A58794F1D9208,063-000-002,33333333,BANK FEE CBA,71.53,0,1581769.44,DR,REF444146,CBA,Current
27-09-2025 08:08,CBA27BF8086896B4940B0E5,063-000-002,33333333,ALDI CBA,103.28,0,1581666.16,DR,REF541017,CBA,Current
27-09-2025 08:17,CBAD89A0A9AEC3447F1A55F,063-000-002,33333333,UBER EATS CBA,101.13,0,1581565.03,DR,REF426495,CBA,Current
27-09-2025 08:37,CBAD030CAB05E44415583A0,063-000-002,33333333,RAILWAY STATION CBA,42.3,0,1581522.73,DR,REF854619,CBA,Current
27-09-2025 08:50,CBA0C88D67122014891872F,063-000-002,33333333,BWS CBA,3,0,1581519.73,DR,REF384790,CBA,Current
27-09-2025 09:11,CBA2D38C57C3B1443D99E76,063-000-002,33333333,7-ELEVEN CBA,72.47,0,1581447.26,DR,REF747181,CBA,Current
27-09-2025 09:18,CBA8810FD8A49274F7197FB,063-000-002,33333333,ALDI CBA,29.39,0,1581417.87,DR,REF110206,CBA,Current
27-09-2025 10:53,CBA101D97DEEE43460E85B0,063-000-002,33333333,SHELL CBA,26.77,0,1581391.1,DR,REF950221,CBA,Current
27-09-2025 11:56,CBAFF7FD216B55C47D6961A,063-000-002,33333333,SALARY PAYMENT CBA,0,769.78,1582160.88,CR,REF579925,CBA,Current
27-09-2025 12:09,CBA007E4CB19D06469C8023,063-000-002,33333333,CITYLINK CBA,5.91,0,1582154.97,DR,REF562077,CBA,Current
27-09-2025 12:10,CBAD0E1B551E948451F9F7D,063-000-002,33333333,PAY - SALARY CBA,0,7111.68,1589266.65,CR,REF208405,CBA,Current
27-09-2025 12:54,CBAD80E2ECC3EA14F71AEFC,063-000-002,33333333,PAYPAL *NETFLIX CBA,7.11,0,1589259.54,DR,REF562862,CBA,Current
27-09-2025 13:46,CBA9F9276CF3C1949AE8A1F,063-000-002,33333333,WOOLWORTHS CBA,44.9,0,1589214.64,DR,REF869453,CBA,Current
27-09-2025 14:06,INT21D767BEBA2B4ED097B7,063-000-002,33333333,TRANSFER TO ANZ 11111111,1940.58,0,1587274.06,DR,INT-48109,CBA,Current
27-09-2025 16:17,CBAF9730F53D5F1418996E1,063-000-002,33333333,AMAZON AU CBA,65.97,0,1587208.09,DR,REF336781,CBA,Current
27-09-2025 16:21,CBA1C2B54CA520D47D691D9,063-000-002,33333333,KFC CBA,106.51,0,1587101.58,DR,REF655533,CBA,Current
27-09-2025 16:38,CBA3F5510A7CCB84609A2DF,063-000-002,33333333,AMAZON AU CBA,58.52,0,1587043.06,DR,REF520086,CBA,Current
27-09-2025 16:40,CBA58EA371CA31B438F8C8B,063-000-002,33333333,INTERNET TRANSFER CBA,116.35,0,1586926.71,DR,REF969281,CBA,Current
27-09-2025 16:57,INT02CE33280ED24DB08880,063-000-002,33333333,TRANSFER FROM NAB 44444444,0,993.38,1587920.09,CR,INT-91035,CBA,Current
27-09-2025 17:10,CBAD7BDB25084234D799444,063-000-002,33333333,RAILWAY STATION CBA,18.39,0,1587901.7,DR,REF882422,CBA,Current
27-09-2025 17:13,CBA97381FE02A464CE399CD,063-000-002,33333333,BWS CBA,25.03,0,1587876.67,DR,REF306825,CBA,Current
27-09-2025 17:25,CBA93AEC8D7E8F34A9FAC12,063-000-002,33333333,7-ELEVEN CBA,78.59,0,1587798.08,DR,REF398180,CBA,Current
27-09-2025 17:28,CBAA5DB383A43A84D86BBD3,063-000-002,33333333,7-ELEVEN CBA,12.49,0,1587785.59,DR,REF710031,CBA,Current
27-09-2025 17:31,CBAC7C552BCFAD34FE89E40,063-000-002,33333333,BP CBA,31.37,0,1587754.22,DR,REF212233,CBA,Current
27-09-2025 17:42,CBA4A48B6F8546C4C1F9B6E,063-000-002,33333333,BANK FEE CBA,114.27,0,1587639.95,DR,REF610212,CBA,Current
27-09-2025 17:46,CBAFCC2C204FC8948A59478,063-000-002,33333333,COLES CBA,25.38,0,1587614.57,DR,REF264129,CBA,Current
27-09-2025 17:49,CBA87059256601144378A67,063-000-002,33333333,FLIXBUS CBA,11.34,0,1587603.23,DR,REF255010,CBA,Current
27-09-2025 18:29,CBA6AB9CAC3F29C493EBEF6,063-000-002,33333333,COMPANY PAYROLL CBA,0,3204.38,1590807.61,CR,REF698748,CBA,Current
27-09-2025 18:30,CBA6A4EFCA0FE9F4D558097,063-000-002,33333333,WAGES CREDIT CBA,0,989.65,1591797.26,CR,REF395035,CBA,Current
27-09-2025 18:45,CBADD80DF19038948D08FAE,063-000-002,33333333,PAYPAL *NETFLIX CBA,91.24,0,1591706.02,DR,REF820763,CBA,Current
27-09-2025 19:04,CBA4E90039B92014EAC993E,063-000-002,33333333,BWS CBA,28.47,0,1591677.55,DR,REF487328,CBA,Current
27-09-2025 19:27,CBA6BA5682A17184BC4ACC6,063-000-002,33333333,PAYPAL *NETFLIX CBA,133.63,0,1591543.92,DR,REF700915,CBA,Current
27-09-2025 19:56,CBA1575D38A429C4D79800C,063-000-002,33333333,STARBUCKS CBA,42.96,0,1591500.96,DR,REF944345,CBA,Current
27-09-2025 20:06,CBA4F5AA65868994FB292FA,063-000-002,33333333,BWS CBA,79.57,0,1591421.39,DR,REF207542,CBA,Current
27-09-2025 20:19,CBA798256180EDB4468A52D,063-000-002,33333333,BWS CBA,13.15,0,1591408.24,DR,REF610387,CBA,Current
27-09-2025 20:47,CBAAC984F552BF3487D9767,063-000-002,33333333,WOOLWORTHS CBA,7.63,0,1591400.61,DR,REF767677,CBA,Current
27-09-2025 20:54,CBADAFDF6FD401B4A1BB832,063-000-002,33333333,7-ELEVEN CBA,50.78,0,1591349.83,DR,REF864760,CBA,Current
27-09-2025 20:59,CBAAFA922B906E64876A486,063-000-002,33333333,CITYLINK CBA,53.12,0,1591296.71,DR,REF596369,CBA,Current
27-09-2025 21:07,CBACEC73B75DAF8422EAC97,063-000-002,33333333,ALDI CBA,15.46,0,1591281.25,DR,REF871774,CBA,Current
27-09-2025 21:09,CBA30BABA046F3F4CD0A529,063-000-002,33333333,SPOTIFY CBA,39.75,0,1591241.5,DR,REF464987,CBA,Current
27-09-2025 21:43,CBAB4C281AEC0514D189674,063-000-002,33333333,MENULOG CBA,9.38,0,1591232.12,DR,REF901428,CBA,Current
27-09-2025 22:05,CBA1F437724189C4C9CA46A,063-000-002,33333333,7-ELEVEN CBA,17.67,0,1591214.45,DR,REF324116,CBA,Current
27-09-2025 22:06,CBA19554F6CB3234C4CA4EF,063-000-002,33333333,LIQUORLAND CBA,209.29,0,1591005.16,DR,REF747400,CBA,Current
27-09-2025 22:07,CBA33151351EC8F4783B8A8,063-000-002,33333333,BANK FEE CBA,145.02,0,1590860.14,DR,REF814219,CBA,Current
27-09-2025 22:08,CBA2344064DCA154A8A92D0,063-000-002,33333333,COLES CBA,153.7,0,1590706.44,DR,REF602666,CBA,Current
27-09-2025 22:42,CBA7B8BC6FB6A6F4742A661,063-000-002,33333333,RAILWAY STATION CBA,84.67,0,1590621.77,DR,REF614778,CBA,Current
27-09-2025 22:43,INT780F6B0372A245FE907C,063-000-002,33333333,TRANSFER FROM ANZ 11111111,0,1993.29,1592615.06,CR,INT-64581,CBA,Current
27-09-2025 22:47,CBA07FE7C069F9C4258ABE0,063-000-002,33333333,PAY - SALARY CBA,0,2984.54,1595599.6,CR,REF177668,CBA,Current
27-09-2025 22:51,CBA19A76CBF363045F8BDF6,063-000-002,33333333,APPLE CBA,10.63,0,1595588.97,DR,REF497700,CBA,Current
27-09-2025 22:53,INT2951E541B31E49A5B42D,063-000-002,33333333,TRANSFER TO NAB 44444444,305.55,0,1595283.42,DR,INT-32226,CBA,Current
27-09-2025 23:04,CBA84ED74E5A0F74DA29F0B,063-000-002,33333333,BIGW CBA,100.14,0,1595183.28,DR,REF774266,CBA,Current
27-09-2025 23:14,CBAC446C4DD22254A608DDA,063-000-002,33333333,MCDONALDS CBA,20.42,0,1595162.86,DR,REF122146,CBA,Current
28-09-2025 00:05,CBAB1E6461EBA4D4F9DA396,063-000-002,33333333,WOOLWORTHS CBA,113,0,1595049.86,DR,REF280835,CBA,Current
28-09-2025 00:15,CBA767253282856457E84CA,063-000-002,33333333,BIGW CBA,196.08,0,1594853.78,DR,REF794623,CBA,Current
28-09-2025 00:25,CBA0F0EF58B8FA64A5E94E7,063-000-002,33333333,BWS CBA,135.87,0,1594717.91,DR,REF423425,CBA,Current
28-09-2025 00:43,CBA6E53A6D651C643218D83,063-000-002,33333333,MCDONALDS CBA,6.86,0,1594711.05,DR,REF809257,CBA,Current
28-09-2025 00:47,CBA29E65AA6BA6B43118518,063-000-002,33333333,PAYMENT GATEWAY CBA,75.37,0,1594635.68,DR,REF999714,CBA,Current
28-09-2025 01:10,CBA0E41FA136D0442868705,063-000-002,33333333,BIGW CBA,25.39,0,1594610.29,DR,REF327877,CBA,Current
28-09-2025 01:16,CBA1C38D58526044F90A4DA,063-000-002,33333333,MENULOG CBA,215.93,0,1594394.36,DR,REF981622,CBA,Current
28-09-2025 01:19,CBA0A4B0E51A16A491EAAB3,063-000-002,33333333,MENULOG CBA,11.1,0,1594383.26,DR,REF833382,CBA,Current
28-09-2025 01:19,CBA636E2035DB124AAFB4D9,063-000-002,33333333,BP CBA,114.68,0,1594268.58,DR,REF798572,CBA,Current
28-09-2025 01:42,CBA727F70D1C6F64BE5B00C,063-000-002,33333333,BP CBA,6.16,0,1594262.42,DR,REF588254,CBA,Current
28-09-2025 01:47,CBACBC34C22E5EB47F3AEFF,063-000-002,33333333,WOOLWORTHS CBA,142.92,0,1594119.5,DR,REF709250,CBA,Current
28-09-2025 02:44,CBA05264CCBF02A474ABF70,063-000-002,33333333,WOOLWORTHS CBA,15.51,0,1594103.99,DR,REF465861,CBA,Current
28-09-2025 02:48,INT1B366B54B30240F78CFC,063-000-002,33333333,TRANSFER FROM CBA 22222222,0,801.8,1594905.79,CR,INT-48486,CBA,Current
28-09-2025 02:50,CBA09B4911A3AFD4404AB4D,063-000-002,33333333,ZOOM CBA,39.86,0,1594865.93,DR,REF865477,CBA,Current
28-09-2025 02:57,CBA5251EA65107A4997976B,063-000-002,33333333,BANK FEE CBA,49.05,0,1594816.88,DR,REF280955,CBA,Current
28-09-2025 03:05,CBAFA4E4F9942C84247B960,063-000-002,33333333,MENULOG CBA,219.69,0,1594597.19,DR,REF657634,CBA,Current
28-09-2025 03:19,CBAE7C098683927455E840A,063-000-002,33333333,AMAZON AU CBA,5.81,0,1594591.38,DR,REF260623,CBA,Current
28-09-2025 05:08,CBAC5FB76121FFE4783A93B,063-000-002,33333333,SPOTIFY CBA,30.63,0,1594560.75,DR,REF881907,CBA,Current
28-09-2025 05:14,CBA3C589E452EC1493FAEE6,063-000-002,33333333,LIQUORLAND CBA,63.78,0,1594496.97,DR,REF851369,CBA,Current
28-09-2025 05:29,CBA8D9C525246C641979D2E,063-000-002,33333333,CITYLINK CBA,17.53,0,1594479.44,DR,REF390107,CBA,Current
28-09-2025 06:02,CBABD649B1336994947BA2D,063-000-002,33333333,PAY - SALARY CBA,0,995.18,1595474.62,CR,REF977388,CBA,Current
28-09-2025 06:58,CBAAECE7D6A984D4F27926E,063-000-002,33333333,7-ELEVEN CBA,97.28,0,1595377.34,DR,REF821240,CBA,Current
28-09-2025 07:05,CBA4B459AD4361B417DAC92,063-000-002,33333333,CITYLINK CBA,13.52,0,1595363.82,DR,REF257118,CBA,Current
28-09-2025 07:26,CBA6DA777A9678842748425,063-000-002,33333333,BP CBA,81.3,0,1595282.52,DR,REF410096,CBA,Current
28-09-2025 07:36,CBAAA52FBAF11B2404085F9,063-000-002,33333333,BANK FEE CBA,47.91,0,1595234.61,DR,REF588297,CBA,Current
28-09-2025 08:11,CBAA7121F94C7D549588F22,063-000-002,33333333,AMAZON AU CBA,184.05,0,1595050.56,DR,REF473886,CBA,Current
28-09-2025 08:11,CBAC947007B71FB4D29A9AF,063-000-002,33333333,BIGW CBA,17.12,0,1595033.44,DR,REF399047,CBA,Current
28-09-2025 08:36,CBAFE662D86E0C54B10AFC5,063-000-002,33333333,WAGES CREDIT CBA,0,2244.46,1597277.9,CR,REF467949,CBA,Current
28-09-2025 08:38,CBA5690C67DF4EB4C689051,063-000-002,33333333,PAY - SALARY CBA,0,306.58,1597584.48,CR,REF838617,CBA,Current
28-09-2025 08:42,CBADE80A5E5A04A46849A49,063-000-002,33333333,SALARY PAYMENT CBA,0,3322.77,1600907.25,CR,REF837842,CBA,Current
28-09-2025 09:19,CBA963055DD397D43FF9E1A,063-000-002,33333333,KFC CBA,5.77,0,1600901.48,DR,REF923152,CBA,Current
28-09-2025 09:21,CBA0ADDD1D746584F1DBC5C,063-000-002,33333333,UBER EATS CBA,27.72,0,1600873.76,DR,REF494829,CBA,Current
28-09-2025 09:22,CBAD6C9F8EBF4F845FEBCF7,063-000-002,33333333,KFC CBA,60.76,0,1600813,DR,REF761160,CBA,Current
28-09-2025 09:44,CBAA30D7E3C84BD4507A847,063-000-002,33333333,DOMINO'S PIZZA CBA,251.09,0,1600561.91,DR,REF702624,CBA,Current
28-09-2025 09:53,CBAC883FC97810F4377A7A2,063-000-002,33333333,LIQUORLAND CBA,96.32,0,1600465.59,DR,REF672705,CBA,Current
28-09-2025 10:12,CBA85A8B214C4754AED9A97,063-000-002,33333333,HARVEY NORMAN CBA,19.3,0,1600446.29,DR,REF473927,CBA,Current
28-09-2025 10:21,CBAD12BB37D360E48DFB685,063-000-002,33333333,STARBUCKS CBA,64.64,0,1600381.65,DR,REF192457,CBA,Current
28-09-2025 10:22,CBA8E971A6C705E4DD3AAAF,063-000-002,33333333,SPOTIFY CBA,9.29,0,1600372.36,DR,REF308941,CBA,Current
28-09-2025 10:24,CBA3C5803F81E084B5F93BF,063-000-002,33333333,KFC CBA,71.39,0,1600300.97,DR,REF264987,CBA,Current
28-09-2025 12:26,CBA079BA931A1674895B108,063-000-002,33333333,DOMINO'S PIZZA CBA,70.45,0,1600230.52,DR,REF964930,CBA,Current
28-09-2025 12:36,CBABD7878410A09453B8661,063-000-002,33333333,ZOOM CBA,26.56,0,1600203.96,DR,REF461559,CBA,Current
28-09-2025 12:49,CBA7F2F009AAF934C6A9D83,063-000-002,33333333,AMAZON AU CBA,26.75,0,1600177.21,DR,REF353992,CBA,Current
28-09-2025 13:16,CBAE289B7FFD4304C7FA4DA,063-000-002,33333333,COMPANY PAYROLL CBA,0,1061.53,1601238.74,CR,REF448536,CBA,Current
28-09-2025 13:17,INTF7BCEBC06F714A6E9671,063-000-002,33333333,TRANSFER FROM ANZ 11111111,0,1987.78,1603226.52,CR,INT-60037,CBA,Current
28-09-2025 13:37,CBA86DB7C2B31A94D4484B6,063-000-002,33333333,TAFE BOOKSHOP CBA,19.23,0,1603207.29,DR,REF905728,CBA,Current
28-09-2025 13:41,CBA27FF28985EFC4FC9AF20,063-000-002,33333333,BWS CBA,8.86,0,1603198.43,DR,REF926105,CBA,Current
28-09-2025 14:27,CBA1DE275E1CB174A24B9F3,063-000-002,33333333,ZOOM CBA,72.08,0,1603126.35,DR,REF478975,CBA,Current
28-09-2025 14:27,CBAC97F9938B068475B8600,063-000-002,33333333,APPLE CBA,29.6,0,1603096.75,DR,REF393745,CBA,Current
28-09-2025 15:14,INT2E94399107CD49E789EF,063-000-002,33333333,TRANSFER FROM NAB 44444444,0,1663.96,1604760.71,CR,INT-99437,CBA,Current
28-09-2025 15:26,CBA520A596A4848454DA472,063-000-002,33333333,CITYLINK CBA,31.22,0,1604729.49,DR,REF199176,CBA,Current
28-09-2025 15:58,CBAADF6438872B74703BF01,063-000-002,33333333,LIQUORLAND CBA,31.34,0,1604698.15,DR,REF415014,CBA,Current
28-09-2025 16:12,CBA012486412771491FA233,063-000-002,33333333,BWS CBA,88.41,0,1604609.74,DR,REF849373,CBA,Current
28-09-2025 16:20,CBAF72E1A47E3A3482F9E24,063-000-002,33333333,INTERNET TRANSFER CBA,85.59,0,1604524.15,DR,REF271548,CBA,Current
28-09-2025 16:51,INT4072C797AFB34678B3C6,063-000-002,33333333,TRANSFER FROM ANZ 11111111,0,683.29,1605207.44,CR,INT-82405,CBA,Current
28-09-2025 17:34,CBAE408941747384474B358,063-000-002,33333333,BIGW CBA,108.8,0,1605098.64,DR,REF176120,CBA,Current
28-09-2025 18:31,CBA176707BA605949DAAA06,063-000-002,33333333,HARVEY NORMAN CBA,217.03,0,1604881.61,DR,REF961557,CBA,Current
28-09-2025 19:29,CBA9CEFE17660494073A9E0,063-000-002,33333333,MENULOG CBA,43.09,0,1604838.52,DR,REF547100,CBA,Current
28-09-2025 19:44,CBA5E89A64E820F49FEAF42,063-000-002,33333333,PAYPAL *NETFLIX CBA,70.34,0,1604768.18,DR,REF350548,CBA,Current
28-09-2025 19:50,CBAF1E53878A7B445098F5A,063-000-002,33333333,ALDI CBA,65.05,0,1604703.13,DR,REF892840,CBA,Current
28-09-2025 19:56,CBAEFCA2AA703934EF7980C,063-000-002,33333333,FLIXBUS CBA,41.73,0,1604661.4,DR,REF454569,CBA,Current
28-09-2025 19:56,CBA1D51C4B9E31848BFB15C,063-000-002,33333333,DOMINO'S PIZZA CBA,33.8,0,1604627.6,DR,REF584817,CBA,Current
28-09-2025 20:40,CBA78B217875504480C9E13,063-000-002,33333333,SHELL CBA,7.03,0,1604620.57,DR,REF899836,CBA,Current
28-09-2025 21:27,CBA13546394F2B842EEBF1A,063-000-002,33333333,SPOTIFY CBA,37.69,0,1604582.88,DR,REF616920,CBA,Current
28-09-2025 21:35,CBA521C2DA8399B47B5AAE5,063-000-002,33333333,ALDI CBA,16.37,0,1604566.51,DR,REF967238,CBA,Current
28-09-2025 21:49,INT1C2BBD45B26749EAAA4E,063-000-002,33333333,TRANSFER TO ANZ 11111111,349.13,0,1604217.38,DR,INT-62391,CBA,Current
28-09-2025 22:46,CBA1D6EF7979BBB496DB1B2,063-000-002,33333333,BIGW CBA,127.04,0,1604090.34,DR,REF564588,CBA,Current
28-09-2025 22:55,CBA0507FF54BFDE42B090A0,063-000-002,33333333,DOMINO'S PIZZA CBA,175.54,0,1603914.8,DR,REF728130,CBA,Current
28-09-2025 22:59,CBA8F81E87F7A2E4EBDBBC4,063-000-002,33333333,FLIXBUS CBA,23.43,0,1603891.37,DR,REF512263,CBA,Current
28-09-2025 23:07,CBABE0CD1395ACD44AE87A5,063-000-002,33333333,WOOLWORTHS CBA,64.26,0,1603827.11,DR,REF724151,CBA,Current
28-09-2025 23:46,CBA2BB40BC532184E3BAA67,063-000-002,33333333,PAYROLL CREDIT CBA,0,6753.98,1610581.09,CR,REF683572,CBA,Current
28-09-2025 23:49,CBA55EF964A9F454938B17A,063-000-002,33333333,HARVEY NORMAN CBA,221.85,0,1610359.24,DR,REF677273,CBA,Current
28-09-2025 23:57,CBAF9C5E00EA46A4073B99D,063-000-002,33333333,PAYMENT GATEWAY CBA,14.86,0,1610344.38,DR,REF597541,CBA,Current
29-09-2025 00:27,CBAB10B63F3F96745B7A774,063-000-002,33333333,ALDI CBA,3.74,0,1610340.64,DR,REF398767,CBA,Current
29-09-2025 01:11,CBA574D6EEDF633430FA3C2,063-000-002,33333333,CITYLINK CBA,18.36,0,1610322.28,DR,REF874120,CBA,Current
29-09-2025 01:21,CBAA97B6BEBD64F49878B31,063-000-002,33333333,KFC CBA,48.4,0,1610273.88,DR,REF572522,CBA,Current
29-09-2025 01:23,CBACCF5D2C05DE240F9A286,063-000-002,33333333,MENULOG CBA,46.67,0,1610227.21,DR,REF794649,CBA,Current
29-09-2025 01:44,CBA6E62D3A1049E43129910,063-000-002,33333333,7-ELEVEN CBA,10.07,0,1610217.14,DR,REF452695,CBA,Current
29-09-2025 01:49,CBA3FA43C75DD694991AE52,063-000-002,33333333,BANK FEE CBA,239.43,0,1609977.71,DR,REF612081,CBA,Current
29-09-2025 01:54,CBACC5DD5E60B754F8DAEA1,063-000-002,33333333,7-ELEVEN CBA,11.68,0,1609966.03,DR,REF639425,CBA,Current
29-09-2025 02:43,CBACA422D58D9384C09AEDF,063-000-002,33333333,INTERNET TRANSFER CBA,43.11,0,1609922.92,DR,REF828280,CBA,Current
29-09-2025 02:48,CBA2876AD0744BD49398D49,063-000-002,33333333,PAYMENT GATEWAY CBA,28.59,0,1609894.33,DR,REF705300,CBA,Current
29-09-2025 02:48,CBA268D6808A15346EDB534,063-000-002,33333333,BANK FEE CBA,54.59,0,1609839.74,DR,REF973323,CBA,Current
29-09-2025 02:48,CBA38C7A954582E4634A582,063-000-002,33333333,KFC CBA,43.88,0,1609795.86,DR,REF394813,CBA,Current
29-09-2025 03:07,CBA85B9077CA9A6425CAD9D,063-000-002,33333333,PAYROLL CREDIT CBA,0,2450.61,1612246.47,CR,REF433509,CBA,Current
29-09-2025 03:27,CBA25525FCE1012452B8EB5,063-000-002,33333333,SHELL CBA,59.02,0,1612187.45,DR,REF682520,CBA,Current
29-09-2025 03:32,CBA1EA34FD057634E12B93B,063-000-002,33333333,AMAZON AU CBA,25.3,0,1612162.15,DR,REF629065,CBA,Current
29-09-2025 03:35,CBA97DD259E44B140E183F0,063-000-002,33333333,INTERNET TRANSFER CBA,27.78,0,1612134.37,DR,REF245108,CBA,Current
29-09-2025 04:15,CBA9B33DF49EE25469D8C92,063-000-002,33333333,DOMINO'S PIZZA CBA,60.44,0,1612073.93,DR,REF472451,CBA,Current
29-09-2025 05:27,CBA9A5ACE0D98C04F458BA1,063-000-002,33333333,PAYROLL CREDIT CBA,0,2364.25,1614438.18,CR,REF809260,CBA,Current
29-09-2025 05:59,CBA4DB72243508C40A6B391,063-000-002,33333333,BWS CBA,174.61,0,1614263.57,DR,REF545040,CBA,Current
29-09-2025 06:30,CBA1C1C12796792487D9BC4,063-000-002,33333333,LIQUORLAND CBA,22.85,0,1614240.72,DR,REF323381,CBA,Current
29-09-2025 07:07,INT43BAA03DBC834FE9A51E,063-000-002,33333333,TRANSFER FROM ANZ 11111111,0,173.5,1614414.22,CR,INT-45539,CBA,Current
29-09-2025 07:15,CBA485A034AFE9F444D9F3B,063-000-002,33333333,PAYPAL *NETFLIX CBA,61.85,0,1614352.37,DR,REF443882,CBA,Current
29-09-2025 07:37,CBA3527A7E8AF6C4F64895B,063-000-002,33333333,LIQUORLAND CBA,16.93,0,1614335.44,DR,REF205325,CBA,Current
29-09-2025 08:44,CBA8A9D4AA64E59407DA747,063-000-002,33333333,ZOOM CBA,70.96,0,1614264.48,DR,REF435838,CBA,Current
29-09-2025 08:47,CBA8DA870FB59FB471FA31B,063-000-002,33333333,HARVEY NORMAN CBA,58.24,0,1614206.24,DR,REF258605,CBA,Current
29-09-2025 08:52,CBA07E5C9A7D72245A29305,063-000-002,33333333,ZOOM CBA,23.04,0,1614183.2,DR,REF729298,CBA,Current
29-09-2025 08:57,CBADD5143950C784E749B43,063-000-002,33333333,SALARY PAYMENT CBA,0,25.16,1614208.36,CR,REF633614,CBA,Current
29-09-2025 09:06,CBACEA65B2DD2274E09B69C,063-000-002,33333333,KFC CBA,18.84,0,1614189.52,DR,REF158465,CBA,Current
29-09-2025 09:07,CBAD80E0FCD5D05416A92B7,063-000-002,33333333,STARBUCKS CBA,142.33,0,1614047.19,DR,REF768476,CBA,Current
29-09-2025 09:12,CBA92876E2763AB42B4A54C,063-000-002,33333333,BWS CBA,169.24,0,1613877.95,DR,REF423058,CBA,Current
29-09-2025 10:04,CBAED6BA8DF928446B9BB5B,063-000-002,33333333,SHELL CBA,33.24,0,1613844.71,DR,REF132646,CBA,Current
29-09-2025 10:41,CBAD489054F43A1421B8C99,063-000-002,33333333,FLIXBUS CBA,193.93,0,1613650.78,DR,REF892914,CBA,Current
29-09-2025 10:48,CBA2DB5ED2C5A6C4D51B335,063-000-002,33333333,FLIXBUS CBA,101.62,0,1613549.16,DR,REF957092,CBA,Current
29-09-2025 11:06,CBA052680D8E88049D6A7AA,063-000-002,33333333,APPLE CBA,41.32,0,1613507.84,DR,REF326627,CBA,Current
29-09-2025 11:14,CBA68537261F2AF4E398B91,063-000-002,33333333,PAYROLL CREDIT CBA,0,7634.74,1621142.58,CR,REF695680,CBA,Current
29-09-2025 11:46,INT4E5F23072FB74DD4A590,063-000-002,33333333,TRANSFER FROM NAB 44444444,0,1258.58,1622401.16,CR,INT-85865,CBA,Current
29-09-2025 12:30,CBA5A41A1F0B43A4EFBA254,063-000-002,33333333,MENULOG CBA,148.25,0,1622252.91,DR,REF886759,CBA,Current
29-09-2025 12:36,CBA2F0D877D1ECA4D9C98C5,063-000-002,33333333,PAY - SALARY CBA,0,823.91,1623076.82,CR,REF359295,CBA,Current
29-09-2025 12:46,CBA4A741691F6FA46888F45,063-000-002,33333333,AMAZON AU CBA,41.41,0,1623035.41,DR,REF379804,CBA,Current
29-09-2025 13:11,CBA15224916965248C2BDA7,063-000-002,33333333,ZOOM CBA,25.93,0,1623009.48,DR,REF418684,CBA,Current
29-09-2025 13:14,CBA52A247C490D74C7EB15A,063-000-002,33333333,FLIXBUS CBA,20.34,0,1622989.14,DR,REF823309,CBA,Current
29-09-2025 13:18,CBA50689DA3E741482ABAB9,063-000-002,33333333,BP CBA,97.38,0,1622891.76,DR,REF177066,CBA,Current
29-09-2025 13:28,CBA7A73AD5070024953A8BB,063-000-002,33333333,BP CBA,57.68,0,1622834.08,DR,REF470394,CBA,Current
29-09-2025 14:16,CBA4EB55BE1F4B141AC98C8,063-000-002,33333333,STARBUCKS CBA,12.18,0,1622821.9,DR,REF610211,CBA,Current
29-09-2025 14:49,CBA045FF2112387455A983E,063-000-002,33333333,KFC CBA,58.42,0,1622763.48,DR,REF413012,CBA,Current
29-09-2025 14:50,CBA0A1E9D7237A34E318ECD,063-000-002,33333333,FLIXBUS CBA,117.72,0,1622645.76,DR,REF349021,CBA,Current
29-09-2025 15:14,CBAD2343383406E4445A8E6,063-000-002,33333333,PAYMENT GATEWAY CBA,36.26,0,1622609.5,DR,REF654476,CBA,Current
29-09-2025 16:04,CBAEB1B41DCF5494770B68D,063-000-002,33333333,SHELL CBA,43.49,0,1622566.01,DR,REF448051,CBA,Current
29-09-2025 16:14,INT9003AA8A55EA45F297A3,063-000-002,33333333,TRANSFER TO NAB 44444444,240.19,0,1622325.82,DR,INT-71030,CBA,Current
29-09-2025 17:01,CBABDC69199041F400ABB33,063-000-002,33333333,PAYROLL CREDIT CBA,0,6533.23,1628859.05,CR,REF179531,CBA,Current
29-09-2025 17:10,CBA562603E91A4D422BAED4,063-000-002,33333333,WOOLWORTHS CBA,12.29,0,1628846.76,DR,REF483485,CBA,Current
29-09-2025 17:41,CBAAA13EE49671949119EEA,063-000-002,33333333,PAYMENT GATEWAY CBA,22.66,0,1628824.1,DR,REF201569,CBA,Current
29-09-2025 17:52,CBA31312CCF1F2B4A0CA7B4,063-000-002,33333333,CITYLINK CBA,11.9,0,1628812.2,DR,REF812836,CBA,Current
29-09-2025 18:07,CBAEB6DF3D442BF4E83AE9C,063-000-002,33333333,LIQUORLAND CBA,39.61,0,1628772.59,DR,REF687731,CBA,Current
29-09-2025 19:02,CBA747CD13935944685A45E,063-000-002,33333333,WOOLWORTHS CBA,178.46,0,1628594.13,DR,REF176782,CBA,Current
29-09-2025 19:48,INTBDFBED7749434AE09FBE,063-000-002,33333333,TRANSFER TO ANZ 11111111,846.58,0,1627747.55,DR,INT-72941,CBA,Current
29-09-2025 19:49,CBAAB680C95A19341E58928,063-000-002,33333333,APPLE CBA,105.44,0,1627642.11,DR,REF166786,CBA,Current
29-09-2025 20:20,CBAA7B8CA7E522D4C7D873F,063-000-002,33333333,BP CBA,48.82,0,1627593.29,DR,REF582358,CBA,Current
29-09-2025 20:46,CBAB578688F7A1444F8B8C0,063-000-002,33333333,7-ELEVEN CBA,26.42,0,1627566.87,DR,REF673611,CBA,Current
29-09-2025 20:48,CBA7A69DAB12DE74E18867D,063-000-002,33333333,HARVEY NORMAN CBA,90.72,0,1627476.15,DR,REF116696,CBA,Current
29-09-2025 20:50,CBA23687AB1C5EB49668476,063-000-002,33333333,INTERNET TRANSFER CBA,68.52,0,1627407.63,DR,REF500491,CBA,Current
29-09-2025 21:33,CBAAF5D8700792B440F8151,063-000-002,33333333,JB HI-FI CBA,104.65,0,1627302.98,DR,REF772831,CBA,Current
29-09-2025 22:45,CBA72FE174A8E0E457DA0B9,063-000-002,33333333,MENULOG CBA,27.67,0,1627275.31,DR,REF787198,CBA,Current
29-09-2025 22:49,CBAA97DE776009443F3B1B9,063-000-002,33333333,ZOOM CBA,144.49,0,1627130.82,DR,REF907899,CBA,Current
29-09-2025 23:09,CBA08A89DBCE8F741F3ADFF,063-000-002,33333333,KFC CBA,74.05,0,1627056.77,DR,REF477585,CBA,Current
29-09-2025 23:21,CBAE3840CAE30B04526B421,063-000-002,33333333,INTERNET TRANSFER CBA,57.14,0,1626999.63,DR,REF725716,CBA,Current
29-09-2025 23:59,CBA4424BA58CE1948F1B4DD,063-000-002,33333333,LIQUORLAND CBA,117.06,0,1626882.57,DR,REF178458,CBA,Current
30-09-2025 00:36,CBA559D231F2A3C4C80A5DA,063-000-002,33333333,HARVEY NORMAN CBA,69.82,0,1626812.75,DR,REF943921,CBA,Current
30-09-2025 00:53,CBACD084C4EAD87466CB25E,063-000-002,33333333,BANK FEE CBA,39.71,0,1626773.04,DR,REF853492,CBA,Current
30-09-2025 01:08,CBA207BF5452FED4440986B,063-000-002,33333333,PAYROLL CREDIT CBA,0,5893.12,1632666.16,CR,REF154815,CBA,Current
30-09-2025 01:10,CBA209B838DD9404E4AB07C,063-000-002,33333333,ZOOM CBA,95.8,0,1632570.36,DR,REF414168,CBA,Current
30-09-2025 01:15,CBAF10DFBD049B34C7F9275,063-000-002,33333333,COLES CBA,19.26,0,1632551.1,DR,REF961669,CBA,Current
30-09-2025 01:24,CBA31DEE90B81A64ED3BCE4,063-000-002,33333333,TAFE BOOKSHOP CBA,17.39,0,1632533.71,DR,REF920547,CBA,Current
30-09-2025 01:24,CBA996F2A95C05844E692D5,063-000-002,33333333,SALARY PAYMENT CBA,0,5411.63,1637945.34,CR,REF356002,CBA,Current
30-09-2025 01:47,CBAE04C7D81945A4129AFC5,063-000-002,33333333,PAYROLL CREDIT CBA,0,94.86,1638040.2,CR,REF696879,CBA,Current
30-09-2025 01:52,CBA3B9855267B8D498A9812,063-000-002,33333333,TAFE BOOKSHOP CBA,20.62,0,1638019.58,DR,REF383418,CBA,Current
30-09-2025 02:08,CBA847180EDD44D487EAD37,063-000-002,33333333,INTERNET TRANSFER CBA,9.44,0,1638010.14,DR,REF904298,CBA,Current
30-09-2025 02:48,CBA7850460DF1094D9D98CA,063-000-002,33333333,FLIXBUS CBA,6.31,0,1638003.83,DR,REF390354,CBA,Current
30-09-2025 03:23,CBAE53AF79B385C41148C49,063-000-002,33333333,AMAZON AU CBA,12.92,0,1637990.91,DR,REF443125,CBA,Current
30-09-2025 03:46,CBA264739DFAD4349CCBE82,063-000-002,33333333,AMAZON AU CBA,175.35,0,1637815.56,DR,REF887366,CBA,Current
30-09-2025 03:54,CBA4C1DDD7934DC454E8AF0,063-000-002,33333333,ZOOM CBA,20.1,0,1637795.46,DR,REF136663,CBA,Current
30-09-2025 04:01,CBADE9B995732574CCFA88F,063-000-002,33333333,JB HI-FI CBA,105.67,0,1637689.79,DR,REF537108,CBA,Current
30-09-2025 04:12,CBA330A0EFB097F4D12A79B,063-000-002,33333333,LIQUORLAND CBA,9.32,0,1637680.47,DR,REF533888,CBA,Current
30-09-2025 04:28,INTDAB9DB32ED404E5EA802,063-000-002,33333333,TRANSFER TO ANZ 11111111,1069.53,0,1636610.94,DR,INT-45708,CBA,Current
30-09-2025 04:56,CBA102CB43E520745958F07,063-000-002,33333333,HARVEY NORMAN CBA,10.31,0,1636600.63,DR,REF979596,CBA,Current
30-09-2025 05:07,CBA100E7E304DA548A684B6,063-000-002,33333333,MCDONALDS CBA,60.42,0,1636540.21,DR,REF342728,CBA,Current
30-09-2025 05:12,CBA074D59BD86B646E7AAA1,063-000-002,33333333,INTERNET TRANSFER CBA,91.33,0,1636448.88,DR,REF639478,CBA,Current
30-09-2025 05:18,CBA9B3AD81D5696456199E9,063-000-002,33333333,FLIXBUS CBA,4.95,0,1636443.93,DR,REF410676,CBA,Current
30-09-2025 05:24,CBABAF090453CA54E3BBBFC,063-000-002,33333333,BANK FEE CBA,43.65,0,1636400.28,DR,REF978479,CBA,Current
30-09-2025 05:25,CBAE47D2680A0A84095BDFB,063-000-002,33333333,PAYMENT GATEWAY CBA,35.51,0,1636364.77,DR,REF282091,CBA,Current
30-09-2025 05:31,CBA579F8D111AB6449E845E,063-000-002,33333333,7-ELEVEN CBA,7.79,0,1636356.98,DR,REF455839,CBA,Current
30-09-2025 05:52,CBAFB74C88F1DCA4F01B8EE,063-000-002,33333333,KFC CBA,5.62,0,1636351.36,DR,REF933776,CBA,Current
30-09-2025 05:56,CBA3C4B0428B5C24CD28FFF,063-000-002,33333333,TAFE BOOKSHOP CBA,118.12,0,1636233.24,DR,REF979974,CBA,Current
30-09-2025 06:02,CBA9ED978C1BA20405B9E6A,063-000-002,33333333,BIGW CBA,26.45,0,1636206.79,DR,REF506887,CBA,Current
30-09-2025 07:17,INT04780741D38E4F1F8B23,063-000-002,33333333,TRANSFER FROM NAB 44444444,0,1059.1,1637265.89,CR,INT-28217,CBA,Current
30-09-2025 08:06,CBA18D30801980F4EB38A15,063-000-002,33333333,PAYPAL *NETFLIX CBA,8.29,0,1637257.6,DR,REF264081,CBA,Current
30-09-2025 08:20,CBAE0A916BE03944C25B06E,063-000-002,33333333,AMAZON AU CBA,55.71,0,1637201.89,DR,REF722093,CBA,Current
30-09-2025 08:21,CBA3FD78F42D98B4C6B9F31,063-000-002,33333333,APPLE CBA,34.87,0,1637167.02,DR,REF214022,CBA,Current
30-09-2025 08:59,CBAD57D17C1EF2C49459ED0,063-000-002,33333333,PAYPAL *NETFLIX CBA,19.48,0,1637147.54,DR,REF674554,CBA,Current
30-09-2025 09:13,CBA9CDBBADBA506498D8D36,063-000-002,33333333,SHELL CBA,72.66,0,1637074.88,DR,REF206998,CBA,Current
30-09-2025 09:24,CBA7831E4E873904D69A07A,063-000-002,33333333,PAY - SALARY CBA,0,4582.7,1641657.58,CR,REF719886,CBA,Current
30-09-2025 10:01,CBAD675F8C7E6DA429A9D4C,063-000-002,33333333,LIQUORLAND CBA,13.97,0,1641643.61,DR,REF657926,CBA,Current
30-09-2025 10:14,CBAB0FC8AA0AB5F43E28A41,063-000-002,33333333,COMPANY PAYROLL CBA,0,2300.48,1643944.09,CR,REF498728,CBA,Current
30-09-2025 10:14,CBA05E59848A3734A88AB95,063-000-002,33333333,ZOOM CBA,107.4,0,1643836.69,DR,REF474532,CBA,Current
30-09-2025 10:28,CBA2EF629C4EF894EE1BC17,063-000-002,33333333,ZOOM CBA,47.43,0,1643789.26,DR,REF614657,CBA,Current
30-09-2025 10:32,CBABEFF5BD43D064B3E98A8,063-000-002,33333333,DOMINO'S PIZZA CBA,54.68,0,1643734.58,DR,REF111476,CBA,Current
30-09-2025 10:44,CBA99BE939294D444EA849E,063-000-002,33333333,7-ELEVEN CBA,5.34,0,1643729.24,DR,REF927391,CBA,Current
30-09-2025 10:52,CBA343D14AB391C4E42B262,063-000-002,33333333,BP CBA,22.54,0,1643706.7,DR,REF738186,CBA,Current
30-09-2025 11:08,CBA688F33FB0ABB4985A77F,063-000-002,33333333,7-ELEVEN CBA,101.92,0,1643604.78,DR,REF958123,CBA,Current
30-09-2025 11:28,INTA448D01F81024544A46F,063-000-002,33333333,TRANSFER FROM ANZ 11111111,0,1976.37,1645581.15,CR,INT-94252,CBA,Current
30-09-2025 11:33,CBA35A023B4DFBD451F9041,063-000-002,33333333,ALDI CBA,16.04,0,1645565.11,DR,REF110694,CBA,Current
30-09-2025 12:29,CBA049D45C7E57B44F6AAF7,063-000-002,33333333,TAFE BOOKSHOP CBA,18.34,0,1645546.77,DR,REF725857,CBA,Current
30-09-2025 12:32,CBAB8F756E78EB7403D93BF,063-000-002,33333333,PAYROLL CREDIT CBA,0,319.25,1645866.02,CR,REF308464,CBA,Current
30-09-2025 12:39,CBAFA71BE07204B4C568EA8,063-000-002,33333333,JB HI-FI CBA,107.25,0,1645758.77,DR,REF116260,CBA,Current
30-09-2025 12:40,CBA6B31F853744E46BFA46D,063-000-002,33333333,COLES CBA,19.95,0,1645738.82,DR,REF162810,CBA,Current
30-09-2025 13:02,CBAC74842994E6D4DD7B967,063-000-002,33333333,BIGW CBA,8.95,0,1645729.87,DR,REF718418,CBA,Current
30-09-2025 13:53,CBAD2413D35D0734F608DA4,063-000-002,33333333,COMPANY PAYROLL CBA,0,2323.8,1648053.67,CR,REF680522,CBA,Current
30-09-2025 13:58,CBA34E039F3BF2C4852A9E0,063-000-002,33333333,BANK FEE CBA,173.26,0,1647880.41,DR,REF610376,CBA,Current
30-09-2025 14:00,CBA0FA93CA7C3144A33BBAA,063-000-002,33333333,SALARY PAYMENT CBA,0,5263.86,1653144.27,CR,REF863201,CBA,Current
30-09-2025 14:13,CBAA8247091132644BAA5CE,063-000-002,33333333,STARBUCKS CBA,11.62,0,1653132.65,DR,REF765398,CBA,Current
30-09-2025 14:16,CBAB1DA0DB74CDB4D05B177,063-000-002,33333333,BP CBA,10.19,0,1653122.46,DR,REF983937,CBA,Current
30-09-2025 14:27,CBA779C898CCA0943D78AB8,063-000-002,33333333,COMPANY PAYROLL CBA,0,715.17,1653837.63,CR,REF753349,CBA,Current
30-09-2025 14:28,CBA9FF0C2C8B81C457E8657,063-000-002,33333333,SPOTIFY CBA,13.88,0,1653823.75,DR,REF281252,CBA,Current
30-09-2025 15:03,CBA1F4BEB0F97394B88B1F2,063-000-002,33333333,BP CBA,9.42,0,1653814.33,DR,REF687172,CBA,Current
30-09-2025 15:11,INT801F8262CDD6446D8CD8,063-000-002,33333333,TRANSFER TO NAB 44444444,107.17,0,1653707.16,DR,INT-26728,CBA,Current
30-09-2025 15:24,CBA84016F38541841FA8058,063-000-002,33333333,PAYPAL *NETFLIX CBA,12.11,0,1653695.05,DR,REF347307,CBA,Current
30-09-2025 15:29,CBA9E19FAE0EF734FE0B12C,063-000-002,33333333,ALDI CBA,21.55,0,1653673.5,DR,REF972267,CBA,Current
30-09-2025 15:44,CBA370B01B012FF45EFA69C,063-000-002,33333333,KFC CBA,64.23,0,1653609.27,DR,REF411214,CBA,Current
30-09-2025 16:15,CBA52184E70062749728954,063-000-002,33333333,CITYLINK CBA,14.33,0,1653594.94,DR,REF884511,CBA,Current
30-09-2025 16:23,CBAC03A9005361045AAB53A,063-000-002,33333333,DOMINO'S PIZZA CBA,48.46,0,1653546.48,DR,REF306557,CBA,Current
30-09-2025 16:32,CBAE86873E7439147D09D6E,063-000-002,33333333,MCDONALDS CBA,124.98,0,1653421.5,DR,REF284621,CBA,Current
30-09-2025 16:47,CBA2E8004D3FC07427081C1,063-000-002,33333333,PAY - SALARY CBA,0,5315.1,1658736.6,CR,REF185649,CBA,Current
30-09-2025 16:53,CBAD604F5FA3BE3442B8C8E,063-000-002,33333333,MCDONALDS CBA,26.48,0,1658710.12,DR,REF345855,CBA,Current
30-09-2025 17:15,CBA7A8317960DAA48DA81A8,063-000-002,33333333,INTERNET TRANSFER CBA,146,0,1658564.12,DR,REF756846,CBA,Current
30-09-2025 18:07,CBA0BDDA498C2EA40999034,063-000-002,33333333,PAYPAL *NETFLIX CBA,11.94,0,1658552.18,DR,REF447633,CBA,Current
30-09-2025 18:25,CBA41CF73E687944E46B1A8,063-000-002,33333333,HARVEY NORMAN CBA,15.59,0,1658536.59,DR,REF445114,CBA,Current
30-09-2025 19:23,CBA504085DB81A94D58BA77,063-000-002,33333333,PAYPAL *NETFLIX CBA,53.89,0,1658482.7,DR,REF420856,CBA,Current
30-09-2025 19:37,CBA15B77D423E9943269851,063-000-002,33333333,TAFE BOOKSHOP CBA,9.29,0,1658473.41,DR,REF547598,CBA,Current
30-09-2025 19:48,CBA9CB5498EABBF404AA81F,063-000-002,33333333,PAYPAL *NETFLIX CBA,24.59,0,1658448.82,DR,REF127610,CBA,Current
30-09-2025 20:14,CBA20CA0B4307064F6D9070,063-000-002,33333333,UBER EATS CBA,5.52,0,1658443.3,DR,REF184839,CBA,Current
30-09-2025 20:50,CBAF94B4E90396E4E848784,063-000-002,33333333,SPOTIFY CBA,42.75,0,1658400.55,DR,REF806036,CBA,Current
30-09-2025 21:07,CBA8A5339BFB38C4F7D886B,063-000-002,33333333,JB HI-FI CBA,147.92,0,1658252.63,DR,REF209497,CBA,Current
30-09-2025 21:17,CBA070F290BC81E4F95BC98,063-000-002,33333333,INTERNET TRANSFER CBA,56.94,0,1658195.69,DR,REF935505,CBA,Current
30-09-2025 21:29,CBA20498EF68C544B679CA9,063-000-002,33333333,BP CBA,54.01,0,1658141.68,DR,REF424025,CBA,Current
30-09-2025 21:39,CBA9DD65FAE2B1D4CAC93FA,063-000-002,33333333,KFC CBA,39.39,0,1658102.29,DR,REF165191,CBA,Current
30-09-2025 21:48,CBA86CBE4A8D1714A519F11,063-000-002,33333333,BP CBA,40.83,0,1658061.46,DR,REF984936,CBA,Current
30-09-2025 21:51,CBAE0928A48988941A79DE7,063-000-002,33333333,BANK FEE CBA,34.99,0,1658026.47,DR,REF517381,CBA,Current
30-09-2025 22:28,CBA1E55E28B85C0439D847E,063-000-002,33333333,MCDONALDS CBA,22.34,0,1658004.13,DR,REF758615,CBA,Current
30-09-2025 22:35,CBA42CFA0E888D34DFEB223,063-000-002,33333333,MCDONALDS CBA,7.36,0,1657996.77,DR,REF748040,CBA,Current
30-09-2025 22:42,CBA2384CF22B3C741218C3F,063-000-002,33333333,PAY - SALARY CBA,0,5721.76,1663718.53,CR,REF597690,CBA,Current
30-09-2025 22:47,CBAC26804C310E9474CB310,063-000-002,33333333,JB HI-FI CBA,61.7,0,1663656.83,DR,REF592105,CBA,Current
30-09-2025 23:18,CBA04CCE0EFD0C240E9A073,063-000-002,33333333,PAY - SALARY CBA,0,2218.9,1665875.73,CR,REF656422,CBA,Current
30-09-2025 23:22,CBAD5A1C3D7C5024A7B8325,063-000-002,33333333,ALDI CBA,51.23,0,1665824.5,DR,REF278072,CBA,Current
30-09-2025 23:26,CBA8A4423BD096346A8A2D7,063-000-002,33333333,COLES CBA,47.88,0,1665776.62,DR,REF742782,CBA,Current
30-09-2025 23:42,CBA63661ECC1DA54A159358,063-000-002,33333333,AMAZON AU CBA,13.97,0,1665762.65,DR,REF925917,CBA,Current
