Date,TransactionID,BSB,AccountNumber,Description,Debit,Credit,Balance,Type,Reference,Bank,AccountType
01-08-2025 00:03,INTCB485F415ED9488FAFBD,082-900-001,44444444,TRANSFER TO CBA 33333333,1055.57,0,213.46,DR,INT-91580,NAB,Business
01-08-2025 00:32,NAB5C755471CA254068A8A0,082-900-001,44444444,PAYPAL *NETFLIX NAB,199.11,0,14.35,DR,REF298683,NAB,Business
01-08-2025 00:39,NABEC55C604628F4BDF9429,082-900-001,44444444,JB HI-FI NAB,106.27,0,-91.92,DR,REF778520,NAB,Business
01-08-2025 01:04,NABD9D699EC790947DFA89E,082-900-001,44444444,MCDONALDS NAB,42.04,0,-133.96,DR,REF481437,NAB,Business
01-08-2025 01:41,NAB976F16D298DF48328705,082-900-001,44444444,DOMINO'S PIZZA NAB,138.36,0,-272.32,DR,REF638092,NAB,Business
01-08-2025 01:43,NAB1663771BFCBD41A6B95E,082-900-001,44444444,DOMINO'S PIZZA NAB,187.11,0,-459.43,DR,REF443271,NAB,Business
01-08-2025 01:44,NAB1FCC1A3AF26A46EB8C2D,082-900-001,44444444,FLIXBUS NAB,137.99,0,-597.42,DR,REF701711,NAB,Business
01-08-2025 01:55,NAB26F504C4B1584256B032,082-900-001,44444444,JB HI-FI NAB,238.49,0,-835.91,DR,REF151438,NAB,Business
01-08-2025 02:26,NAB3F3BDEB8796B4CDE9D6F,082-900-001,44444444,COLES NAB,168.33,0,-1004.24,DR,REF747206,NAB,Business
01-08-2025 02:44,NAB5B891E7EC3B3429491B7,082-900-001,44444444,APPLE NAB,151.47,0,-1155.71,DR,REF146856,NAB,Business
01-08-2025 02:45,NABB5BFBEBFA51D4BF3935F,082-900-001,44444444,JB HI-FI NAB,67.98,0,-1223.69,DR,REF986950,NAB,Business
01-08-2025 03:16,NABEBD135AF87E940CAA484,082-900-001,44444444,WOOLWORTHS NAB,60.85,0,-1284.54,DR,REF132447,NAB,Business
01-08-2025 04:15,NABEDE820CF357F4DE898B8,082-900-001,44444444,RAILWAY STATION NAB,46.5,0,-1331.04,DR,REF107235,NAB,Business
01-08-2025 04:15,NAB188D983CA6DD4DE29A93,082-900-001,44444444,UBER EATS NAB,35.94,0,-1366.98,DR,REF732378,NAB,Business
01-08-2025 04:31,NAB2C9C75D9A73543EE80E6,082-900-001,44444444,SPOTIFY NAB,619.41,0,-1986.39,DR,REF113362,NAB,Business
01-08-2025 05:07,NABEF42D2738B8D4D5084E0,082-900-001,44444444,SPOTIFY NAB,51.41,0,-2037.8,DR,REF151227,NAB,Business
01-08-2025 05:23,NAB9901FA6B8B31474B93BD,082-900-001,44444444,APPLE NAB,72.68,0,-2110.48,DR,REF194850,NAB,Business
01-08-2025 05:25,NAB33B6F119C6D74CEB9405,082-900-001,44444444,ALDI NAB,110.21,0,-2220.69,DR,REF527137,NAB,Business
01-08-2025 05:47,NABEE40793FB13148AE8431,082-900-001,44444444,RAILWAY STATION NAB,147.45,0,-2368.14,DR,REF944701,NAB,Business
01-08-2025 05:54,NAB63FEC800B2694D9C9B57,082-900-001,44444444,SPOTIFY NAB,321.97,0,-2690.11,DR,REF874199,NAB,Business
01-08-2025 07:34,NAB7EA3E736A85941529564,082-900-001,44444444,JB HI-FI NAB,690.96,0,-3381.07,DR,REF224550,NAB,Business
01-08-2025 08:25,NAB041675E2A3A2418A866B,082-900-001,44444444,AMAZON AU NAB,57.68,0,-3438.75,DR,REF676166,NAB,Business
01-08-2025 09:21,NAB73F5EFA399DB4AC09A4E,082-900-001,44444444,PAY - SALARY NAB,0,1855.78,-1582.97,CR,REF477717,NAB,Business
01-08-2025 09:29,NAB011F93BE1EF9452FAC03,082-900-001,44444444,KFC NAB,338.61,0,-1921.58,DR,REF399184,NAB,Business
01-08-2025 10:35,INTBBFAC6E160E44573BD2B,082-900-001,44444444,TRANSFER TO CBA 22222222,1225.3,0,-3146.88,DR,INT-51084,NAB,Business
01-08-2025 10:47,NAB6466D5FEEC1C4E47ADB9,082-900-001,44444444,APPLE NAB,498.53,0,-3645.41,DR,REF373869,NAB,Business
01-08-2025 10:56,NABD08BD2112B5B4EE0BBBD,082-900-001,44444444,WAGES CREDIT NAB,0,4562.46,917.05,CR,REF863111,NAB,Business
01-08-2025 11:46,NABDCEFCFFF60A541A89CF5,082-900-001,44444444,ZOOM NAB,429.53,0,487.52,DR,REF961516,NAB,Business
01-08-2025 12:06,NAB5354D6E0641B4B8085E2,082-900-001,44444444,CITYLINK NAB,158.94,0,328.58,DR,REF633889,NAB,Business
01-08-2025 12:28,NAB260DC65AF8CD494FA6F6,082-900-001,44444444,UBER EATS NAB,92.35,0,236.23,DR,REF489920,NAB,Business
01-08-2025 12:35,NAB80A0B20862584C6FBE76,082-900-001,44444444,SALARY PAYMENT NAB,0,773.05,1009.28,CR,REF219902,NAB,Business
01-08-2025 13:24,NABD9035399E75F4438BBD0,082-900-001,44444444,MENULOG NAB,933.55,0,75.73,DR,REF609483,NAB,Business
01-08-2025 13:59,NABA7AA9D682B0646E292D3,082-900-001,44444444,INTERNET TRANSFER NAB,339,0,-263.27,DR,REF652692,NAB,Business
01-08-2025 14:17,NABF1E427DA3BD7495F956C,082-900-001,44444444,ALDI NAB,1177.21,0,-1440.48,DR,REF500746,NAB,Business
01-08-2025 14:21,NAB1E5B74E623F643B7B58F,082-900-001,44444444,LIQUORLAND NAB,52.86,0,-1493.34,DR,REF936738,NAB,Business
01-08-2025 14:38,NABA74542C15B6F45D1BBC3,082-900-001,44444444,SPOTIFY NAB,770.55,0,-2263.89,DR,REF921908,NAB,Business
01-08-2025 14:50,NAB0D78BA8ED56B43578B62,082-900-001,44444444,KFC NAB,339.01,0,-2602.9,DR,REF916132,NAB,Business
01-08-2025 15:13,NAB875789E16A14433CA6F3,082-900-001,44444444,ALDI NAB,77.38,0,-2680.28,DR,REF130809,NAB,Business
01-08-2025 15:31,NAB8CE1BBD8FE3E4FC1A3F9,082-900-001,44444444,STARBUCKS NAB,95.15,0,-2775.43,DR,REF512817,NAB,Business
01-08-2025 16:53,NAB3C248CA558C543C3ABA0,082-900-001,44444444,HARVEY NORMAN NAB,75.47,0,-2850.9,DR,REF763517,NAB,Business
01-08-2025 16:56,INTA3D175BF8AEE4E8FA851,082-900-001,44444444,TRANSFER FROM CBA 22222222,0,995.36,-1855.54,CR,INT-43672,NAB,Business
01-08-2025 17:57,NAB17E58104D856454CBDED,082-900-001,44444444,TAFE BOOKSHOP NAB,263.16,0,-2118.7,DR,REF610170,NAB,Business
01-08-2025 18:40,NAB3E7B56CFD8724BF889F7,082-900-001,44444444,RAILWAY STATION NAB,124.06,0,-2242.76,DR,REF157901,NAB,Business
01-08-2025 18:47,NAB3286048A6AEF419C988A,082-900-001,44444444,BIGW NAB,257.75,0,-2500.51,DR,REF841826,NAB,Business
01-08-2025 18:53,NAB2CC8D6F72A204B29A913,082-900-001,44444444,AMAZON AU NAB,420.69,0,-2921.2,DR,REF233058,NAB,Business
01-08-2025 19:10,NAB56E76F9634B64498B620,082-900-001,44444444,CITYLINK NAB,373.6,0,-3294.8,DR,REF694396,NAB,Business
01-08-2025 19:11,NABE046304E48844F5196C5,082-900-001,44444444,DOMINO'S PIZZA NAB,145.32,0,-3440.12,DR,REF989726,NAB,Business
01-08-2025 19:13,NAB43445A340629470A8818,082-900-001,44444444,JB HI-FI NAB,108.6,0,-3548.72,DR,REF524217,NAB,Business
01-08-2025 19:43,NAB0D1F7998CC9F456AA5E0,082-900-001,44444444,PAY - SALARY NAB,0,3128.15,-420.57,CR,REF637642,NAB,Business
01-08-2025 20:00,NAB7D33ED77DC31452BBE81,082-900-001,44444444,AMAZON AU NAB,50.05,0,-470.62,DR,REF468917,NAB,Business
01-08-2025 20:16,NAB1679BD5EC98D44D9BF49,082-900-001,44444444,MENULOG NAB,355.86,0,-826.48,DR,REF598997,NAB,Business
01-08-2025 20:31,NAB3E26844DB6D94382ADC8,082-900-001,44444444,ALDI NAB,58.66,0,-885.14,DR,REF176193,NAB,Business
01-08-2025 20:42,NAB1E224584033B4417B4BB,082-900-001,44444444,BANK FEE NAB,55.22,0,-940.36,DR,REF848523,NAB,Business
01-08-2025 21:11,NAB8D892F8B2A7044E08B97,082-900-001,44444444,CITYLINK NAB,356.28,0,-1296.64,DR,REF108877,NAB,Business
01-08-2025 21:15,NABECDB46B3FD7B4ECDB638,082-900-001,44444444,STARBUCKS NAB,450.43,0,-1747.07,DR,REF406863,NAB,Business
01-08-2025 21:20,NABF860213F0F644C9888ED,082-900-001,44444444,7-ELEVEN NAB,39.93,0,-1787,DR,REF502149,NAB,Business
01-08-2025 21:21,NAB1DF2D52AF623418B8ED4,082-900-001,44444444,CITYLINK NAB,733.34,0,-2520.34,DR,REF542190,NAB,Business
01-08-2025 21:22,NAB342F2AA124FE4CCDADD6,082-900-001,44444444,7-ELEVEN NAB,558.31,0,-3078.65,DR,REF759034,NAB,Business
01-08-2025 21:32,NABFC72135B57DE4C1985E1,082-900-001,44444444,JB HI-FI NAB,67.38,0,-3146.03,DR,REF993629,NAB,Business
01-08-2025 23:18,NABA37BC62B1D39486B8990,082-900-001,44444444,PAYROLL CREDIT NAB,0,7766.28,4620.25,CR,REF907164,NAB,Business
02-08-2025 00:26,NAB125C988A6C1543F293B3,082-900-001,44444444,COLES NAB,447.34,0,4172.91,DR,REF311910,NAB,Business
02-08-2025 00:33,NABECC904B4D4024CE9BB05,082-900-001,44444444,APPLE NAB,411.56,0,3761.35,DR,REF569642,NAB,Business
02-08-2025 00:43,NAB5EC0290ABD8A42AC905C,082-900-001,44444444,TAFE BOOKSHOP NAB,211.45,0,3549.9,DR,REF452236,NAB,Business
02-08-2025 01:16,NAB4F6604B8F2714A9E9D68,082-900-001,44444444,BIGW NAB,76.7,0,3473.2,DR,REF706285,NAB,Business
02-08-2025 01:43,NAB076AA4F995664663B83F,082-900-001,44444444,PAYPAL *NETFLIX NAB,1216.96,0,2256.24,DR,REF729653,NAB,Business
02-08-2025 02:24,NABE9CF30DF16934EBAAB9C,082-900-001,44444444,ALDI NAB,108.35,0,2147.89,DR,REF576606,NAB,Business
02-08-2025 02:32,NABE9BC40B72A7045AC9C39,082-900-001,44444444,SALARY PAYMENT NAB,0,90.57,2238.46,CR,REF304822,NAB,Business
02-08-2025 02:35,NAB3B264397D2C84464B4C0,082-900-001,44444444,JB HI-FI NAB,21,0,2217.46,DR,REF315676,NAB,Business
02-08-2025 02:45,NABAE6FA14BDBBF40BB8D85,082-900-001,44444444,ALDI NAB,523.88,0,1693.58,DR,REF283449,NAB,Business
02-08-2025 02:48,NAB78E3328071FE40BEA776,082-900-001,44444444,PAYMENT GATEWAY NAB,1093.07,0,600.51,DR,REF173037,NAB,Business
02-08-2025 03:10,INTE87DEAB57BEA4AFE9C8D,082-900-001,44444444,TRANSFER FROM CBA 33333333,0,1666.9,2267.41,CR,INT-74689,NAB,Business
02-08-2025 03:36,NAB605E14352884405C8ECC,082-900-001,44444444,BWS NAB,319.71,0,1947.7,DR,REF917607,NAB,Business
02-08-2025 04:02,NABD5963B659FEF4881AE44,082-900-001,44444444,MCDONALDS NAB,525.51,0,1422.19,DR,REF464741,NAB,Business
02-08-2025 04:03,NABBAA819054B554C4D9386,082-900-001,44444444,AMAZON AU NAB,26.45,0,1395.74,DR,REF576099,NAB,Business
02-08-2025 04:23,NABE9789915DC6D49A3B1DB,082-900-001,44444444,STARBUCKS NAB,600.09,0,795.65,DR,REF961353,NAB,Business
02-08-2025 05:09,NAB10DF4D8BFA35492BBCEF,082-900-001,44444444,PAYROLL CREDIT NAB,0,4670.13,5465.78,CR,REF138573,NAB,Business
02-08-2025 05:25,NABC4A1B851D8964FC58675,082-900-001,44444444,PAYMENT GATEWAY NAB,146.71,0,5319.07,DR,REF354507,NAB,Business
02-08-2025 05:26,NAB330DB82946C141C7BB8B,082-900-001,44444444,UBER EATS NAB,549.09,0,4769.98,DR,REF761957,NAB,Business
02-08-2025 05:43,NAB35917E069B9A4EDF847B,082-900-001,44444444,MCDONALDS NAB,246.86,0,4523.12,DR,REF115501,NAB,Business
02-08-2025 05:45,NAB84FAF9D828854AC78EF6,082-900-001,44444444,LIQUORLAND NAB,246.94,0,4276.18,DR,REF918389,NAB,Business
02-08-2025 05:49,NABAD614D13B6EC413DBE6C,082-900-001,44444444,MENULOG NAB,199.68,0,4076.5,DR,REF544589,NAB,Business
02-08-2025 06:33,NAB39F672BEEC224B51A9B7,082-900-001,44444444,LIQUORLAND NAB,187.24,0,3889.26,DR,REF560812,NAB,Business
02-08-2025 06:44,NAB4E6A094A2E814F049846,082-900-001,44444444,FLIXBUS NAB,78.6,0,3810.66,DR,REF444918,NAB,Business
02-08-2025 08:03,NAB7BA3410A751B4F829A42,082-900-001,44444444,BIGW NAB,314.65,0,3496.01,DR,REF762306,NAB,Business
02-08-2025 08:24,NAB588E1479132D4123B858,082-900-001,44444444,PAY - SALARY NAB,0,736.98,4232.99,CR,REF939840,NAB,Business
02-08-2025 08:32,NAB8F7431226A1C4BA7B27A,082-900-001,44444444,APPLE NAB,90.64,0,4142.35,DR,REF877156,NAB,Business
02-08-2025 09:06,NABA8CC2631A2A64C4B8309,082-900-001,44444444,TAFE BOOKSHOP NAB,52.23,0,4090.12,DR,REF710319,NAB,Business
02-08-2025 09:09,NAB713E880D210A40E6BB14,082-900-001,44444444,HARVEY NORMAN NAB,274.86,0,3815.26,DR,REF330016,NAB,Business
02-08-2025 09:19,NAB38AE1FFA23614BB08137,082-900-001,44444444,HARVEY NORMAN NAB,406.08,0,3409.18,DR,REF936269,NAB,Business
02-08-2025 09:20,NABFA6DFA1268EA41A4A919,082-900-001,44444444,JB HI-FI NAB,474.59,0,2934.59,DR,REF601382,NAB,Business
02-08-2025 09:36,NABE3F1C38E53B1461980AB,082-900-001,44444444,PAYPAL *NETFLIX NAB,153.82,0,2780.77,DR,REF592706,NAB,Business
02-08-2025 10:08,NAB7D450A5942EA4039B6E0,082-900-001,44444444,7-ELEVEN NAB,618.07,0,2162.7,DR,REF317729,NAB,Business
02-08-2025 10:09,NAB47E519DAEF0046F4B360,082-900-001,44444444,LIQUORLAND NAB,102.66,0,2060.04,DR,REF253494,NAB,Business
02-08-2025 10:36,NAB7EEC03A85F6B441383B3,082-900-001,44444444,PAYPAL *NETFLIX NAB,90.56,0,1969.48,DR,REF475731,NAB,Business
02-08-2025 11:27,NAB0BE638DBDCF64830A523,082-900-001,44444444,BIGW NAB,833.41,0,1136.07,DR,REF683251,NAB,Business
02-08-2025 11:29,NAB3F1B9621BB7E4F27BD7E,082-900-001,44444444,BWS NAB,103.86,0,1032.21,DR,REF558473,NAB,Business
02-08-2025 11:32,NAB87851F90EB6C4AB1835F,082-900-001,44444444,WAGES CREDIT NAB,0,4068.49,5100.7,CR,REF888055,NAB,Business
02-08-2025 11:36,NAB6BE825E982B348479EC7,082-900-001,44444444,MENULOG NAB,877.77,0,4222.93,DR,REF716845,NAB,Business
02-08-2025 12:01,NABE464DD479F65452F9013,082-900-001,44444444,BWS NAB,105.12,0,4117.81,DR,REF577636,NAB,Business
02-08-2025 12:16,NAB5B49F68417014FE8BCB5,082-900-001,44444444,MENULOG NAB,98.6,0,4019.21,DR,REF619410,NAB,Business
02-08-2025 12:29,NAB495851DA3A1C4460B2C1,082-900-001,44444444,TAFE BOOKSHOP NAB,192.61,0,3826.6,DR,REF404880,NAB,Business
02-08-2025 12:45,NABD9D788BF1273422B9D64,082-900-001,44444444,COMPANY PAYROLL NAB,0,789.09,4615.69,CR,REF309743,NAB,Business
02-08-2025 13:05,NAB379FF72719D24C93B371,082-900-001,44444444,BP NAB,525.05,0,4090.64,DR,REF721861,NAB,Business
02-08-2025 13:24,NAB5E6D598C0B0348A5AF36,082-900-001,44444444,RAILWAY STATION NAB,106.82,0,3983.82,DR,REF131868,NAB,Business
02-08-2025 13:43,NAB7D8C61115108479586F4,082-900-001,44444444,BANK FEE NAB,629.68,0,3354.14,DR,REF718259,NAB,Business
02-08-2025 13:55,NABD04449C059D945DFA6DD,082-900-001,44444444,WAGES CREDIT NAB,0,3293.49,6647.63,CR,REF655359,NAB,Business
02-08-2025 14:33,INT87E87345BEF942429100,082-900-001,44444444,TRANSFER TO ANZ 11111111,1462.75,0,5184.88,DR,INT-52083,NAB,Business
02-08-2025 14:47,NABDA70C2808C74486FACEB,082-900-001,44444444,MENULOG NAB,266.27,0,4918.61,DR,REF612003,NAB,Business
02-08-2025 14:52,NAB0775A37C591F4C7692EA,082-900-001,44444444,FLIXBUS NAB,482.8,0,4435.81,DR,REF691364,NAB,Business
02-08-2025 15:03,NAB9B6532DDBB774EE0A064,082-900-001,44444444,STARBUCKS NAB,49.55,0,4386.26,DR,REF931477,NAB,Business
02-08-2025 15:07,NAB9D77C323A9BA4B20B649,082-900-001,44444444,CITYLINK NAB,229.94,0,4156.32,DR,REF767291,NAB,Business
02-08-2025 15:14,NAB31397335B7C4468D9602,082-900-001,44444444,PAY - SALARY NAB,0,155.06,4311.38,CR,REF482647,NAB,Business
02-08-2025 15:25,NAB566A94F689C84F199187,082-900-001,44444444,JB HI-FI NAB,317.22,0,3994.16,DR,REF722398,NAB,Business
02-08-2025 15:30,NAB0ABFDA04B1A842AA8F06,082-900-001,44444444,WOOLWORTHS NAB,59.18,0,3934.98,DR,REF776581,NAB,Business
02-08-2025 15:31,NABE56F8019B5014A6099DD,082-900-001,44444444,COMPANY PAYROLL NAB,0,5551.5,9486.48,CR,REF256486,NAB,Business
02-08-2025 16:16,NAB819DADF3689F44FCA987,082-900-001,44444444,PAYPAL *NETFLIX NAB,307.47,0,9179.01,DR,REF426063,NAB,Business
02-08-2025 16:19,NABC3831E3F713648D1ABA7,082-900-001,44444444,JB HI-FI NAB,889.99,0,8289.02,DR,REF905443,NAB,Business
02-08-2025 16:50,NAB500598ADEE2C44289889,082-900-001,44444444,WAGES CREDIT NAB,0,1937.55,10226.57,CR,REF451847,NAB,Business
02-08-2025 17:26,NABF045DBFC70554618AED4,082-900-001,44444444,LIQUORLAND NAB,326.16,0,9900.41,DR,REF397573,NAB,Business
02-08-2025 18:03,NABEF78C2A18E5E41ABB4CD,082-900-001,44444444,COMPANY PAYROLL NAB,0,5721.67,15622.08,CR,REF315277,NAB,Business
02-08-2025 18:29,NAB5D085DB90CCF4817B5C7,082-900-001,44444444,MENULOG NAB,591.78,0,15030.3,DR,REF685085,NAB,Business
02-08-2025 19:08,NABB36DA1F7549B49C48023,082-900-001,44444444,WOOLWORTHS NAB,310.3,0,14720,DR,REF149883,NAB,Business
02-08-2025 19:14,NABE1BA682018174FC8ADC0,082-900-001,44444444,SPOTIFY NAB,297.43,0,14422.57,DR,REF342068,NAB,Business
02-08-2025 19:20,NABCB51393EE7D94C548B13,082-900-001,44444444,BWS NAB,117.64,0,14304.93,DR,REF248144,NAB,Business
02-08-2025 19:31,INT70F4CFB547A446B98079,082-900-001,44444444,TRANSFER TO CBA 22222222,1772.91,0,12532.02,DR,INT-61712,NAB,Business
02-08-2025 19:45,NABFDDBD456EAE644E49BA7,082-900-001,44444444,ZOOM NAB,61.3,0,12470.72,DR,REF731655,NAB,Business
02-08-2025 19:47,NAB537BE9BEB1BE437BADFA,082-900-001,44444444,COMPANY PAYROLL NAB,0,1081.17,13551.89,CR,REF910002,NAB,Business
02-08-2025 19:50,NAB472DA600A3E642B7A7EB,082-900-001,44444444,PAYMENT GATEWAY NAB,517.03,0,13034.86,DR,REF553267,NAB,Business
02-08-2025 19:52,NAB9D0B9C45E2E14734B9ED,082-900-001,44444444,TAFE BOOKSHOP NAB,18.04,0,13016.82,DR,REF475134,NAB,Business
02-08-2025 19:56,NAB57E7C416804A4AC59E48,082-900-001,44444444,FLIXBUS NAB,387.87,0,12628.95,DR,REF781380,NAB,Business
02-08-2025 20:13,NAB3DBACA1199A54AF882E9,082-900-001,44444444,SALARY PAYMENT NAB,0,4869.46,17498.41,CR,REF549061,NAB,Business
02-08-2025 20:35,NABEE080BB67A884228A683,082-900-001,44444444,UBER EATS NAB,150.66,0,17347.75,DR,REF641501,NAB,Business
02-08-2025 20:39,NAB11882176D098468EB75D,082-900-001,44444444,PAYPAL *NETFLIX NAB,1016.22,0,16331.53,DR,REF575685,NAB,Business
02-08-2025 20:45,NAB698A12409F5F407194AF,082-900-001,44444444,LIQUORLAND NAB,930.78,0,15400.75,DR,REF534172,NAB,Business
02-08-2025 20:58,NAB189BB7E341764354B92B,082-900-001,44444444,PAYPAL *NETFLIX NAB,440.91,0,14959.84,DR,REF319080,NAB,Business
02-08-2025 21:14,NABE666CC6C515447449FA6,082-900-001,44444444,CITYLINK NAB,649.78,0,14310.06,DR,REF489454,NAB,Business
02-08-2025 22:06,NAB9694DF09ED8D49EFBE45,082-900-001,44444444,MENULOG NAB,314.11,0,13995.95,DR,REF899179,NAB,Business
02-08-2025 22:15,NABFFF0EDAD4429455D94E4,082-900-001,44444444,PAYROLL CREDIT NAB,0,6973.59,20969.54,CR,REF610107,NAB,Business
02-08-2025 22:24,NABDB99CCF3C21242EF9A57,082-900-001,44444444,BIGW NAB,79.97,0,20889.57,DR,REF855843,NAB,Business
02-08-2025 22:29,NAB9C7D9ACAE5984F899F00,082-900-001,44444444,BIGW NAB,380.63,0,20508.94,DR,REF430397,NAB,Business
02-08-2025 22:49,NABFE74CD1FF61D41D58ACF,082-900-001,44444444,JB HI-FI NAB,405.26,0,20103.68,DR,REF673717,NAB,Business
02-08-2025 22:58,NABCCB50E505E6D4D6D8665,082-900-001,44444444,AMAZON AU NAB,656.21,0,19447.47,DR,REF895526,NAB,Business
02-08-2025 23:26,NAB08BD7E284FAC483C8F63,082-900-001,44444444,DOMINO'S PIZZA NAB,177.09,0,19270.38,DR,REF111302,NAB,Business
02-08-2025 23:54,INTA3BB57E6B031436DBBEF,082-900-001,44444444,TRANSFER TO CBA 33333333,351.6,0,18918.78,DR,INT-28874,NAB,Business
02-08-2025 23:58,NAB82531D16D4C54A4A95C9,082-900-001,44444444,ALDI NAB,188.8,0,18729.98,DR,REF831213,NAB,Business
03-08-2025 00:21,NAB7A24C558AF3C427DB429,082-900-001,44444444,APPLE NAB,187.83,0,18542.15,DR,REF877382,NAB,Business
03-08-2025 00:42,NAB09BBEAF839734284916A,082-900-001,44444444,PAYPAL *NETFLIX NAB,343.86,0,18198.29,DR,REF468255,NAB,Business
03-08-2025 01:27,NABD2C0553DAA344231B42B,082-900-001,44444444,UBER EATS NAB,296.22,0,17902.07,DR,REF618868,NAB,Business
03-08-2025 01:43,NAB956CE36A62894CD680EB,082-900-001,44444444,PAYMENT GATEWAY NAB,678.47,0,17223.6,DR,REF751679,NAB,Business
03-08-2025 01:50,NAB76394F3F598740309196,082-900-001,44444444,CITYLINK NAB,124.18,0,17099.42,DR,REF836312,NAB,Business
03-08-2025 02:59,NAB07101B54B4A7487585EF,082-900-001,44444444,RAILWAY STATION NAB,1002.82,0,16096.6,DR,REF744027,NAB,Business
03-08-2025 03:12,NAB27CCBE2C694049B48529,082-900-001,44444444,PAYPAL *NETFLIX NAB,343.16,0,15753.44,DR,REF237099,NAB,Business
03-08-2025 03:16,NAB4099A01EA5F54A65948C,082-900-001,44444444,LIQUORLAND NAB,58.23,0,15695.21,DR,REF847548,NAB,Business
03-08-2025 03:27,NABA86BAF8890194F1D87F0,082-900-001,44444444,MENULOG NAB,183.87,0,15511.34,DR,REF755578,NAB,Business
03-08-2025 03:43,NAB77BEFC55EF1C40D59B3E,082-900-001,44444444,DOMINO'S PIZZA NAB,109.95,0,15401.39,DR,REF898431,NAB,Business
03-08-2025 03:47,NAB8D420EEDA57545A8B50D,082-900-001,44444444,JB HI-FI NAB,739.12,0,14662.27,DR,REF466953,NAB,Business
03-08-2025 05:06,NABF176640729CD4F10877C,082-900-001,44444444,APPLE NAB,166.87,0,14495.4,DR,REF842341,NAB,Business
03-08-2025 05:09,NAB226F8A90121F4468A4E4,082-900-001,44444444,LIQUORLAND NAB,88.86,0,14406.54,DR,REF859652,NAB,Business
03-08-2025 05:13,NAB51D016F9887B46B28066,082-900-001,44444444,TAFE BOOKSHOP NAB,123.41,0,14283.13,DR,REF304863,NAB,Business
03-08-2025 05:14,NABA34A5FC497894D23AAFA,082-900-001,44444444,SPOTIFY NAB,113.34,0,14169.79,DR,REF334616,NAB,Business
03-08-2025 05:23,NAB549F646EB1424918837F,082-900-001,44444444,AMAZON AU NAB,160.64,0,14009.15,DR,REF908417,NAB,Business
03-08-2025 05:32,NAB0AAEA7D31AAA49AEBA8C,082-900-001,44444444,SPOTIFY NAB,405.7,0,13603.45,DR,REF471866,NAB,Business
03-08-2025 05:43,NABE9C3CDCD42864F7B853C,082-900-001,44444444,COLES NAB,80.6,0,13522.85,DR,REF251013,NAB,Business
03-08-2025 06:03,NAB073550F07F6E4457AAF5,082-900-001,44444444,BANK FEE NAB,336.27,0,13186.58,DR,REF833869,NAB,Business
03-08-2025 06:33,NAB6AAA9D9EB15B4EE7AC5C,082-900-001,44444444,SHELL NAB,202.82,0,12983.76,DR,REF650665,NAB,Business
03-08-2025 06:46,NAB674E110BFB124248A465,082-900-001,44444444,TAFE BOOKSHOP NAB,45.02,0,12938.74,DR,REF992723,NAB,Business
03-08-2025 06:46,NABD73D3C4560D64468B96B,082-900-001,44444444,PAYROLL CREDIT NAB,0,6910.37,19849.11,CR,REF298734,NAB,Business
03-08-2025 06:54,NABC838BF02A2134CBCA3B5,082-900-001,44444444,LIQUORLAND NAB,374.44,0,19474.67,DR,REF490029,NAB,Business
03-08-2025 06:55,NABCAAFD6836EE943039B6B,082-900-001,44444444,PAYROLL CREDIT NAB,0,2894.27,22368.94,CR,REF206805,NAB,Business
03-08-2025 06:58,NAB6C7662EFF1D345C2B521,082-900-001,44444444,SALARY PAYMENT NAB,0,608.07,22977.01,CR,REF838288,NAB,Business
03-08-2025 07:06,NAB072CD15BFF3B477CA5B4,082-900-001,44444444,DOMINO'S PIZZA NAB,98.95,0,22878.06,DR,REF461739,NAB,Business
03-08-2025 07:28,NAB6A23CC21F05F4BD49EC0,082-900-001,44444444,COLES NAB,329.49,0,22548.57,DR,REF794619,NAB,Business
03-08-2025 08:14,NAB616FC3C8CE634078B730,082-900-001,44444444,TAFE BOOKSHOP NAB,284.98,0,22263.59,DR,REF799526,NAB,Business
03-08-2025 08:27,NAB9F8C4A2BD7A64C798878,082-900-001,44444444,WOOLWORTHS NAB,132.7,0,22130.89,DR,REF964360,NAB,Business
03-08-2025 09:25,NAB593F26ADA2414CCEA3A5,082-900-001,44444444,MCDONALDS NAB,201.37,0,21929.52,DR,REF852995,NAB,Business
03-08-2025 10:38,NAB4E8BD43BE49C412BABDF,082-900-001,44444444,PAYMENT GATEWAY NAB,444.64,0,21484.88,DR,REF747039,NAB,Business
03-08-2025 10:38,NABAF7D151EB9194C2C9FD9,082-900-001,44444444,WOOLWORTHS NAB,51.12,0,21433.76,DR,REF911437,NAB,Business
03-08-2025 10:43,NABF7953F06BFC3423B958B,082-900-001,44444444,WOOLWORTHS NAB,765.32,0,20668.44,DR,REF991769,NAB,Business
03-08-2025 10:54,NAB9EED97062BAE40109871,082-900-001,44444444,7-ELEVEN NAB,93.66,0,20574.78,DR,REF776952,NAB,Business
03-08-2025 11:21,NAB8B824D1B950A4602A008,082-900-001,44444444,PAYPAL *NETFLIX NAB,321.42,0,20253.36,DR,REF969684,NAB,Business
03-08-2025 11:31,NABEB84A0589DD741E59134,082-900-001,44444444,WAGES CREDIT NAB,0,1179.72,21433.08,CR,REF780150,NAB,Business
03-08-2025 11:37,NABDC3CEE8C1D2843058C11,082-900-001,44444444,ALDI NAB,1860.68,0,19572.4,DR,REF919581,NAB,Business
03-08-2025 11:55,NAB42905F186C0E463CAB46,082-900-001,44444444,MENULOG NAB,454.52,0,19117.88,DR,REF950552,NAB,Business
03-08-2025 11:59,NABA3F22DC22BFD4465A1AE,082-900-001,44444444,DOMINO'S PIZZA NAB,535.85,0,18582.03,DR,REF884340,NAB,Business
03-08-2025 12:17,NABA79EDC16388F45DAAF62,082-900-001,44444444,MCDONALDS NAB,166.23,0,18415.8,DR,REF457445,NAB,Business
03-08-2025 12:23,NAB0714DF271B8240258D79,082-900-001,44444444,RAILWAY STATION NAB,628.73,0,17787.07,DR,REF487044,NAB,Business
03-08-2025 12:44,NAB043CD49A89AB43BDB9D4,082-900-001,44444444,SPOTIFY NAB,102.04,0,17685.03,DR,REF942536,NAB,Business
03-08-2025 12:46,NABA387223210404D5CAF75,082-900-001,44444444,ALDI NAB,277.98,0,17407.05,DR,REF563785,NAB,Business
03-08-2025 12:50,NAB8092E407AA14465D8DA4,082-900-001,44444444,PAYPAL *NETFLIX NAB,198.9,0,17208.15,DR,REF989949,NAB,Business
03-08-2025 12:52,NABAA8BFB8C2CEB420288FD,082-900-001,44444444,MCDONALDS NAB,113.52,0,17094.63,DR,REF729885,NAB,Business
03-08-2025 13:18,NAB5BC6ABD792254C87A37B,082-900-001,44444444,KFC NAB,147.14,0,16947.49,DR,REF289047,NAB,Business
03-08-2025 13:26,NAB88445BF886C740F58071,082-900-001,44444444,WOOLWORTHS NAB,301.23,0,16646.26,DR,REF587593,NAB,Business
03-08-2025 13:29,NABEE5B405AB56244F68DF1,082-900-001,44444444,KFC NAB,123.9,0,16522.36,DR,REF469448,NAB,Business
03-08-2025 13:36,NAB5073F4A4AE024CFAAF89,082-900-001,44444444,JB HI-FI NAB,68.59,0,16453.77,DR,REF977539,NAB,Business
03-08-2025 13:50,NAB2E2CF503A4324F8781F4,082-900-001,44444444,PAYROLL CREDIT NAB,0,2484.52,18938.29,CR,REF703630,NAB,Business
03-08-2025 14:56,NAB75C35809AE6A475096FF,082-900-001,44444444,ZOOM NAB,242.57,0,18695.72,DR,REF392932,NAB,Business
03-08-2025 14:57,INT9A52C00CC5D442958CED,082-900-001,44444444,TRANSFER TO CBA 33333333,1776.73,0,16918.99,DR,INT-35928,NAB,Business
03-08-2025 15:01,NAB9994685FA38745C08D87,082-900-001,44444444,BIGW NAB,100.23,0,16818.76,DR,REF386861,NAB,Business
03-08-2025 15:11,NAB35066646A9174F8AB95F,082-900-001,44444444,INTERNET TRANSFER NAB,250.64,0,16568.12,DR,REF755369,NAB,Business
03-08-2025 15:17,NAB064EE8367CD646C7BCD0,082-900-001,44444444,AMAZON AU NAB,287.98,0,16280.14,DR,REF999964,NAB,Business
03-08-2025 15:48,NAB0A4863AD2A444263825E,082-900-001,44444444,KFC NAB,92.27,0,16187.87,DR,REF555030,NAB,Business
03-08-2025 15:50,NAB36B77157B37942D0AA76,082-900-001,44444444,BWS NAB,560.43,0,15627.44,DR,REF546099,NAB,Business
03-08-2025 16:01,INT87E3CA9A396741D5A4CD,082-900-001,44444444,TRANSFER FROM CBA 33333333,0,67.25,15694.69,CR,INT-75497,NAB,Business
03-08-2025 16:06,NAB2956087660E5459297B8,082-900-001,44444444,JB HI-FI NAB,53.35,0,15641.34,DR,REF143592,NAB,Business
03-08-2025 16:10,INT238E7AE110CB492D8491,082-900-001,44444444,TRANSFER FROM CBA 33333333,0,177.35,15818.69,CR,INT-92285,NAB,Business
03-08-2025 16:17,NABFE76F8173B1942558941,082-900-001,44444444,STARBUCKS NAB,262.22,0,15556.47,DR,REF855004,NAB,Business
03-08-2025 16:17,NAB237F5E6D1A8A46F49A9E,082-900-001,44444444,KFC NAB,145.7,0,15410.77,DR,REF232682,NAB,Business
03-08-2025 16:19,NAB894F566B9CAF4EAF955C,082-900-001,44444444,BANK FEE NAB,133.52,0,15277.25,DR,REF474171,NAB,Business
03-08-2025 16:24,NAB287E05BFFA2F417C831C,082-900-001,44444444,MCDONALDS NAB,102.43,0,15174.82,DR,REF742700,NAB,Business
03-08-2025 16:49,NABFDAC6C7756B64379A5F2,082-900-001,44444444,ALDI NAB,603.91,0,14570.91,DR,REF373428,NAB,Business
03-08-2025 16:51,NAB1D635A202C0E4BFAA766,082-900-001,44444444,AMAZON AU NAB,124.13,0,14446.78,DR,REF929867,NAB,Business
03-08-2025 17:08,NAB44ACCB3564E24300A79E,082-900-001,44444444,CITYLINK NAB,71.06,0,14375.72,DR,REF329163,NAB,Business
03-08-2025 17:34,NABBFF5062F6A214C2E81A6,082-900-001,44444444,LIQUORLAND NAB,375.24,0,14000.48,DR,REF631913,NAB,Business
03-08-2025 17:50,NAB8A55565C08EE4C48A79B,082-900-001,44444444,MENULOG NAB,577.44,0,13423.04,DR,REF549530,NAB,Business
03-08-2025 18:11,NAB65268BEE879C445A9EF0,082-900-001,44444444,HARVEY NORMAN NAB,576.89,0,12846.15,DR,REF830644,NAB,Business
03-08-2025 18:38,NAB241189D96DEA4C7B8BC6,082-900-001,44444444,HARVEY NORMAN NAB,202.02,0,12644.13,DR,REF687975,NAB,Business
03-08-2025 18:59,NABB6E8B380CEDA46C29935,082-900-001,44444444,KFC NAB,407.23,0,12236.9,DR,REF721429,NAB,Business
03-08-2025 19:02,NAB93D51018769F44F280CE,082-900-001,44444444,APPLE NAB,276.25,0,11960.65,DR,REF496574,NAB,Business
03-08-2025 19:04,NABC2192C61E9EE41239571,082-900-001,44444444,ALDI NAB,272.85,0,11687.8,DR,REF374543,NAB,Business
03-08-2025 19:29,NAB2B0C04C259764E868C05,082-900-001,44444444,SHELL NAB,499.77,0,11188.03,DR,REF468584,NAB,Business
03-08-2025 19:53,NAB09CB4F8C3F8A48D99C3D,082-900-001,44444444,PAY - SALARY NAB,0,4227.88,15415.91,CR,REF811627,NAB,Business
03-08-2025 20:05,NAB8791CD71924F4DA499BF,082-900-001,44444444,JB HI-FI NAB,988.11,0,14427.8,DR,REF172995,NAB,Business
03-08-2025 20:21,NAB1BDB44B27F294E319120,082-900-001,44444444,TAFE BOOKSHOP NAB,32.98,0,14394.82,DR,REF427995,NAB,Business
03-08-2025 20:25,INT741EA6CEB09D438C962D,082-900-001,44444444,TRANSFER FROM CBA 22222222,0,1481.97,15876.79,CR,INT-35605,NAB,Business
03-08-2025 20:38,NABE5A039385FF840DE8A96,082-900-001,44444444,PAY - SALARY NAB,0,7372.76,23249.55,CR,REF184370,NAB,Business
03-08-2025 20:41,NABF1D869A8CD61426382E5,082-900-001,44444444,UBER EATS NAB,312.12,0,22937.43,DR,REF527359,NAB,Business
03-08-2025 20:48,NABD79E16571E554A7AA8EC,082-900-001,44444444,7-ELEVEN NAB,113.66,0,22823.77,DR,REF759267,NAB,Business
03-08-2025 20:49,NABDEB9016BF83E467F97BE,082-900-001,44444444,MCDONALDS NAB,914.24,0,21909.53,DR,REF429107,NAB,Business
03-08-2025 20:53,NABEEF469C646EE4F34B1A1,082-900-001,44444444,PAYPAL *NETFLIX NAB,128.09,0,21781.44,DR,REF896883,NAB,Business
03-08-2025 21:46,INTC219F9DB10E742F2A1B6,082-900-001,44444444,TRANSFER FROM ANZ 11111111,0,467.99,22249.43,CR,INT-53574,NAB,Business
03-08-2025 21:55,NAB35963F40C77F4718B1FB,082-900-001,44444444,LIQUORLAND NAB,715.68,0,21533.75,DR,REF476902,NAB,Business
03-08-2025 21:56,NAB50D2CFAC0C574D99A760,082-900-001,44444444,JB HI-FI NAB,765.45,0,20768.3,DR,REF410565,NAB,Business
03-08-2025 22:19,NAB89DD1879C50A4B119EF5,082-900-001,44444444,ZOOM NAB,194.86,0,20573.44,DR,REF102119,NAB,Business
03-08-2025 22:26,NAB9085DF65CFE9463EA0A9,082-900-001,44444444,CITYLINK NAB,39.39,0,20534.05,DR,REF737373,NAB,Business
03-08-2025 22:52,NABB0D88ED681D2401A9350,082-900-001,44444444,COLES NAB,510.48,0,20023.57,DR,REF616418,NAB,Business
03-08-2025 22:58,NAB35F4EECB233240ACB606,082-900-001,44444444,AMAZON AU NAB,244.8,0,19778.77,DR,REF834028,NAB,Business
03-08-2025 23:34,NAB2C30A59A20E246108611,082-900-001,44444444,TAFE BOOKSHOP NAB,33.63,0,19745.14,DR,REF492093,NAB,Business
04-08-2025 00:11,NABAE26C8DB5F124705BDB8,082-900-001,44444444,BP NAB,398.61,0,19346.53,DR,REF277229,NAB,Business
04-08-2025 00:16,NAB05671297BF6049D296E9,082-900-001,44444444,UBER EATS NAB,287.62,0,19058.91,DR,REF628635,NAB,Business
04-08-2025 00:17,NAB60E137276B0640279CD2,082-900-001,44444444,COMPANY PAYROLL NAB,0,2103.9,21162.81,CR,REF180815,NAB,Business
04-08-2025 01:54,NAB1F96AEDC89B547338AB4,082-900-001,44444444,HARVEY NORMAN NAB,176.51,0,20986.3,DR,REF626431,NAB,Business
04-08-2025 03:29,NABEE08E7EFE68645F29D41,082-900-001,44444444,COMPANY PAYROLL NAB,0,7772.15,28758.45,CR,REF629256,NAB,Business
04-08-2025 03:42,NAB0C21D818E2FF44A3982F,082-900-001,44444444,BIGW NAB,81.02,0,28677.43,DR,REF943633,NAB,Business
04-08-2025 03:48,NAB519333A8EAEF41AE9263,082-900-001,44444444,KFC NAB,723.59,0,27953.84,DR,REF109207,NAB,Business
04-08-2025 05:00,INT44179E5231254B80A046,082-900-001,44444444,TRANSFER TO ANZ 11111111,879.62,0,27074.22,DR,INT-22138,NAB,Business
04-08-2025 05:12,NAB2B5E4DD40DB844F7BC7A,082-900-001,44444444,APPLE NAB,178.83,0,26895.39,DR,REF210947,NAB,Business
04-08-2025 05:14,NABB03CC27DD7F74A9CA6FE,082-900-001,44444444,7-ELEVEN NAB,509.2,0,26386.19,DR,REF588698,NAB,Business
04-08-2025 05:31,NAB53703531C05A4BCEAE3D,082-900-001,44444444,COLES NAB,566.17,0,25820.02,DR,REF146057,NAB,Business
04-08-2025 05:42,NAB3AE8E1E8EA3D47808224,082-900-001,44444444,LIQUORLAND NAB,719.25,0,25100.77,DR,REF812956,NAB,Business
04-08-2025 05:44,NAB695903D8A0EF4BAC9562,082-900-001,44444444,SALARY PAYMENT NAB,0,404.84,25505.61,CR,REF378693,NAB,Business
04-08-2025 05:55,NAB99441E214FEB44AC9ED0,082-900-001,44444444,JB HI-FI NAB,257.62,0,25247.99,DR,REF904139,NAB,Business
04-08-2025 06:18,NAB0F0D40A828B04FFDA744,082-900-001,44444444,STARBUCKS NAB,891.32,0,24356.67,DR,REF839252,NAB,Business
04-08-2025 07:02,NAB663B5309601A4B548D96,082-900-001,44444444,COMPANY PAYROLL NAB,0,5370.76,29727.43,CR,REF217210,NAB,Business
04-08-2025 07:09,NAB6389DC514BEE48A69D4B,082-900-001,44444444,SPOTIFY NAB,104.81,0,29622.62,DR,REF753192,NAB,Business
04-08-2025 07:42,NABDF0E16304ECD4A9ABA30,082-900-001,44444444,KFC NAB,355.83,0,29266.79,DR,REF732600,NAB,Business
04-08-2025 07:57,NAB8A4BE165CB7640CFA35B,082-900-001,44444444,UBER EATS NAB,177.4,0,29089.39,DR,REF201968,NAB,Business
04-08-2025 08:47,NAB9982874980BF4923BDD5,082-900-001,44444444,BP NAB,186.61,0,28902.78,DR,REF503332,NAB,Business
04-08-2025 08:58,NAB3CBCD0DBFB6F49D58191,082-900-001,44444444,KFC NAB,508.49,0,28394.29,DR,REF686505,NAB,Business
04-08-2025 09:01,NAB2FB94198707940358B1B,082-900-001,44444444,DOMINO'S PIZZA NAB,42.31,0,28351.98,DR,REF239660,NAB,Business
04-08-2025 09:58,NAB4792AFD692494D1F8730,082-900-001,44444444,DOMINO'S PIZZA NAB,594.64,0,27757.34,DR,REF746557,NAB,Business
04-08-2025 10:12,NAB8144A5F87C374937BD65,082-900-001,44444444,LIQUORLAND NAB,254.21,0,27503.13,DR,REF152886,NAB,Business
04-08-2025 10:17,NAB588D70D732E74D608883,082-900-001,44444444,DOMINO'S PIZZA NAB,684.23,0,26818.9,DR,REF863219,NAB,Business
04-08-2025 10:30,NAB0EE644915B8B4AA89FBB,082-900-001,44444444,PAYPAL *NETFLIX NAB,115.09,0,26703.81,DR,REF604887,NAB,Business
04-08-2025 10:37,NAB023D36939BEE4519902D,082-900-001,44444444,TAFE BOOKSHOP NAB,133.52,0,26570.29,DR,REF705779,NAB,Business
04-08-2025 10:40,NABBCE079BD606543748813,082-900-001,44444444,BWS NAB,1054.82,0,25515.47,DR,REF387119,NAB,Business
04-08-2025 10:41,NAB5780DEB95EA74342AC79,082-900-001,44444444,RAILWAY STATION NAB,191.61,0,25323.86,DR,REF469336,NAB,Business
04-08-2025 10:50,NAB599AFC0D7E4648078B65,082-900-001,44444444,INTERNET TRANSFER NAB,254.7,0,25069.16,DR,REF677052,NAB,Business
04-08-2025 11:04,NAB0BDDDFD96D534588A709,082-900-001,44444444,WOOLWORTHS NAB,237.2,0,24831.96,DR,REF817782,NAB,Business
04-08-2025 11:41,NAB644C4CC4F53F4745AB6C,082-900-001,44444444,PAYROLL CREDIT NAB,0,3421.06,28253.02,CR,REF408266,NAB,Business
04-08-2025 11:56,NAB9603D17512D64D49BA3C,082-900-001,44444444,TAFE BOOKSHOP NAB,537.52,0,27715.5,DR,REF889081,NAB,Business
04-08-2025 11:56,NAB80BD3AB09F3944B1A81D,082-900-001,44444444,TAFE BOOKSHOP NAB,406.7,0,27308.8,DR,REF180526,NAB,Business
04-08-2025 12:13,INT6F39C2A7695F4593B668,082-900-001,44444444,TRANSFER TO CBA 22222222,527.79,0,26781.01,DR,INT-98000,NAB,Business
04-08-2025 12:47,NAB90775BCEC4884C9F9E7F,082-900-001,44444444,SPOTIFY NAB,782.5,0,25998.51,DR,REF331055,NAB,Business
04-08-2025 12:49,NAB2A6AF3F1DC924FB9958F,082-900-001,44444444,PAYMENT GATEWAY NAB,1288.84,0,24709.67,DR,REF345370,NAB,Business
04-08-2025 13:11,NABA54F9299633948319C42,082-900-001,44444444,BIGW NAB,457.91,0,24251.76,DR,REF864528,NAB,Business
04-08-2025 13:15,NABE62A0E48030342D7BD53,082-900-001,44444444,BWS NAB,399.61,0,23852.15,DR,REF933831,NAB,Business
04-08-2025 13:25,NAB6D5A97CEC8124F52BEA2,082-900-001,44444444,DOMINO'S PIZZA NAB,125.17,0,23726.98,DR,REF813028,NAB,Business
04-08-2025 13:42,NABCB9A016EACD14F1DA12C,082-900-001,44444444,FLIXBUS NAB,381.4,0,23345.58,DR,REF273015,NAB,Business
04-08-2025 14:03,NAB7E6C2C1C755E4FC99839,082-900-001,44444444,PAY - SALARY NAB,0,3155.61,26501.19,CR,REF419721,NAB,Business
04-08-2025 14:20,INTF38E05C66BD84013A981,082-900-001,44444444,TRANSFER FROM CBA 33333333,0,388.81,26890,CR,INT-40160,NAB,Business
04-08-2025 14:26,NAB123690095EDA448B800C,082-900-001,44444444,BANK FEE NAB,405.82,0,26484.18,DR,REF833164,NAB,Business
04-08-2025 14:26,NABE5F6D257DD704413A3CB,082-900-001,44444444,MENULOG NAB,40.52,0,26443.66,DR,REF400388,NAB,Business
04-08-2025 15:39,NAB1F2920BA68AA435EA3D8,082-900-001,44444444,SHELL NAB,83.03,0,26360.63,DR,REF535060,NAB,Business
04-08-2025 15:41,NABF08179E4681B4EE2AFEF,082-900-001,44444444,BANK FEE NAB,504.03,0,25856.6,DR,REF201585,NAB,Business
04-08-2025 15:44,NABD0ED31F415D34EE497DF,082-900-001,44444444,LIQUORLAND NAB,269.67,0,25586.93,DR,REF370046,NAB,Business
04-08-2025 15:44,NAB030060DAA1794F118E3F,082-900-001,44444444,WOOLWORTHS NAB,264.16,0,25322.77,DR,REF962733,NAB,Business
04-08-2025 16:08,NAB30CF2AFDA4DA4B35988B,082-900-001,44444444,SPOTIFY NAB,54.8,0,25267.97,DR,REF707156,NAB,Business
04-08-2025 16:17,INT25BA876FEAD1432BA629,082-900-001,44444444,TRANSFER FROM CBA 22222222,0,1174.16,26442.13,CR,INT-44504,NAB,Business
04-08-2025 16:51,NABA5194BFB204A43F6BB02,082-900-001,44444444,MENULOG NAB,261.55,0,26180.58,DR,REF600019,NAB,Business
04-08-2025 17:20,NAB4D23785C3F0B43E98E3E,082-900-001,44444444,7-ELEVEN NAB,111.83,0,26068.75,DR,REF485069,NAB,Business
04-08-2025 17:21,NABACCF7ABD745A4810B61C,082-900-001,44444444,TAFE BOOKSHOP NAB,644.93,0,25423.82,DR,REF939313,NAB,Business
04-08-2025 17:26,NAB5868C8352CA8450FB82D,082-900-001,44444444,TAFE BOOKSHOP NAB,43.67,0,25380.15,DR,REF212577,NAB,Business
04-08-2025 17:30,NABD17BEC531C53486C9DB7,082-900-001,44444444,COMPANY PAYROLL NAB,0,4393.83,29773.98,CR,REF609202,NAB,Business
04-08-2025 17:47,NAB85AF0869204B472986E4,082-900-001,44444444,COLES NAB,1039.32,0,28734.66,DR,REF908980,NAB,Business
04-08-2025 18:02,NAB2748B725BE2D47F8A927,082-900-001,44444444,LIQUORLAND NAB,293.62,0,28441.04,DR,REF426044,NAB,Business
04-08-2025 18:04,NABDC2DFE6A195A4A6A8373,082-900-001,44444444,HARVEY NORMAN NAB,267.04,0,28174,DR,REF525502,NAB,Business
04-08-2025 19:07,NABC9400F607DD84CD09F01,082-900-001,44444444,JB HI-FI NAB,217.92,0,27956.08,DR,REF118159,NAB,Business
04-08-2025 19:46,NAB2B0B9B3219084F13A244,082-900-001,44444444,APPLE NAB,719.61,0,27236.47,DR,REF917608,NAB,Business
04-08-2025 19:55,NABD823C90055234D528AFA,082-900-001,44444444,ZOOM NAB,767.68,0,26468.79,DR,REF606482,NAB,Business
04-08-2025 19:56,NABCFF109F6185740B4B509,082-900-001,44444444,MENULOG NAB,133.76,0,26335.03,DR,REF624138,NAB,Business
04-08-2025 19:59,NAB27662BBAB569413992D6,082-900-001,44444444,PAYPAL *NETFLIX NAB,164.31,0,26170.72,DR,REF699120,NAB,Business
04-08-2025 20:27,NAB2F24088A449F4216B547,082-900-001,44444444,INTERNET TRANSFER NAB,61.98,0,26108.74,DR,REF691279,NAB,Business
04-08-2025 20:40,NAB7F80ECC9B9284CF4B971,082-900-001,44444444,KFC NAB,886.94,0,25221.8,DR,REF562449,NAB,Business
04-08-2025 20:53,INT6822D0DA5EA640E2B3C2,082-900-001,44444444,TRANSFER TO ANZ 11111111,1967.79,0,23254.01,DR,INT-59650,NAB,Business
04-08-2025 21:16,NAB634841724F544BAC9F55,082-900-001,44444444,KFC NAB,306.03,0,22947.98,DR,REF657053,NAB,Business
04-08-2025 21:33,NABFA6DF08A24854650B13E,082-900-001,44444444,PAYPAL *NETFLIX NAB,53.14,0,22894.84,DR,REF712304,NAB,Business
04-08-2025 21:38,NABA2FE799B933C43399959,082-900-001,44444444,UBER EATS NAB,23.24,0,22871.6,DR,REF170499,NAB,Business
04-08-2025 22:04,NABCE6666BC81124A9CAC72,082-900-001,44444444,SALARY PAYMENT NAB,0,563.31,23434.91,CR,REF949363,NAB,Business
04-08-2025 22:12,NAB6CD8BE909469409CA0AC,082-900-001,44444444,AMAZON AU NAB,104.99,0,23329.92,DR,REF482277,NAB,Business
04-08-2025 22:24,NAB62BACABCF05940C9B705,082-900-001,44444444,BWS NAB,115.73,0,23214.19,DR,REF572901,NAB,Business
04-08-2025 22:35,NABBBAB0F1FD9384BA68CE4,082-900-001,44444444,COLES NAB,229.31,0,22984.88,DR,REF973467,NAB,Business
04-08-2025 22:57,NAB4EF05D9D68CF4664A505,082-900-001,44444444,HARVEY NORMAN NAB,338.52,0,22646.36,DR,REF746182,NAB,Business
04-08-2025 23:16,NABE0D38CB50A764E7EAB93,082-900-001,44444444,HARVEY NORMAN NAB,456.94,0,22189.42,DR,REF684256,NAB,Business
04-08-2025 23:57,NABB3F3D700DFE948918C20,082-900-001,44444444,BWS NAB,670.2,0,21519.22,DR,REF719511,NAB,Business
05-08-2025 00:01,NAB4D2379AEFE1E4BF0B3AD,082-900-001,44444444,DOMINO'S PIZZA NAB,78.95,0,21440.27,DR,REF394061,NAB,Business
05-08-2025 00:16,NABA9F7F5572A8E400CAEFC,082-900-001,44444444,SALARY PAYMENT NAB,0,4937.37,26377.64,CR,REF384039,NAB,Business
05-08-2025 01:25,NAB2E03F59DA44143FFB9E0,082-900-001,44444444,CITYLINK NAB,992.68,0,25384.96,DR,REF210351,NAB,Business
05-08-2025 01:45,NAB25249019F10E4AB9BA7A,082-900-001,44444444,BIGW NAB,925.56,0,24459.4,DR,REF350737,NAB,Business
05-08-2025 01:58,NABE83E3C0870374E33AA6A,082-900-001,44444444,BP NAB,198.87,0,24260.53,DR,REF285691,NAB,Business
05-08-2025 02:00,NAB3CBB4DF8766546298D79,082-900-001,44444444,BWS NAB,78.67,0,24181.86,DR,REF248552,NAB,Business
05-08-2025 02:02,NAB6290C55AE41F474CB977,082-900-001,44444444,COMPANY PAYROLL NAB,0,385.01,24566.87,CR,REF803037,NAB,Business
05-08-2025 02:31,NAB6D103A42326F4E028803,082-900-001,44444444,STARBUCKS NAB,87.27,0,24479.6,DR,REF606119,NAB,Business
05-08-2025 02:35,INTBBB7028550BC40BD8545,082-900-001,44444444,TRANSFER FROM CBA 33333333,0,306.37,24785.97,CR,INT-76824,NAB,Business
05-08-2025 02:43,NAB8FEFD60D1ABF4BB0B2FD,082-900-001,44444444,CITYLINK NAB,100.29,0,24685.68,DR,REF283853,NAB,Business
05-08-2025 02:45,NAB61A18A8B824D407581FE,082-900-001,44444444,COLES NAB,155.73,0,24529.95,DR,REF606799,NAB,Business
05-08-2025 03:01,NAB8EF77F74B52948C6A8C9,082-900-001,44444444,RAILWAY STATION NAB,32.86,0,24497.09,DR,REF829132,NAB,Business
05-08-2025 03:17,INT791C6F42CE0746218158,082-900-001,44444444,TRANSFER TO CBA 33333333,1100.31,0,23396.78,DR,INT-62432,NAB,Business
05-08-2025 03:22,NAB10841BAF9F3B4D168B5C,082-900-001,44444444,TAFE BOOKSHOP NAB,154.91,0,23241.87,DR,REF136438,NAB,Business
05-08-2025 03:50,NABDECA9C1AE2DA47A5A587,082-900-001,44444444,DOMINO'S PIZZA NAB,102.95,0,23138.92,DR,REF945116,NAB,Business
05-08-2025 04:08,NABE0B93AC8AF684DE5B7A1,082-900-001,44444444,DOMINO'S PIZZA NAB,1011.58,0,22127.34,DR,REF575228,NAB,Business
05-08-2025 04:35,NAB91559F2D218D473DA185,082-900-001,44444444,BIGW NAB,20.85,0,22106.49,DR,REF896515,NAB,Business
05-08-2025 05:40,NAB3B1F99077A1643999C6E,082-900-001,44444444,SPOTIFY NAB,311.65,0,21794.84,DR,REF978093,NAB,Business
05-08-2025 05:56,NABE6463674700E4FDB881D,082-900-001,44444444,7-ELEVEN NAB,135.94,0,21658.9,DR,REF205511,NAB,Business
05-08-2025 05:59,NABC6D2ADE3DB4F42A6ABFB,082-900-001,44444444,WAGES CREDIT NAB,0,1522.97,23181.87,CR,REF511109,NAB,Business
05-08-2025 06:01,NAB556CBDE482A548C6BE19,082-900-001,44444444,UBER EATS NAB,220.71,0,22961.16,DR,REF501992,NAB,Business
05-08-2025 06:10,NAB323FAD9B3C5544E4AACB,082-900-001,44444444,SALARY PAYMENT NAB,0,3698.31,26659.47,CR,REF117245,NAB,Business
05-08-2025 06:10,NAB67A2C8767B764D8F806D,082-900-001,44444444,7-ELEVEN NAB,110.83,0,26548.64,DR,REF474548,NAB,Business
05-08-2025 06:24,INTEA20665BCD104E46BA63,082-900-001,44444444,TRANSFER FROM ANZ 11111111,0,1433.78,27982.42,CR,INT-87567,NAB,Business
05-08-2025 06:53,NAB49312464A2D14918B89B,082-900-001,44444444,UBER EATS NAB,262.5,0,27719.92,DR,REF554674,NAB,Business
05-08-2025 07:00,NAB51A929710941401283ED,082-900-001,44444444,APPLE NAB,43.2,0,27676.72,DR,REF467250,NAB,Business
05-08-2025 07:15,NABFA6E04DE831D4BA8BD22,082-900-001,44444444,JB HI-FI NAB,34.45,0,27642.27,DR,REF523367,NAB,Business
05-08-2025 07:25,NAB556313B7063247508E95,082-900-001,44444444,PAYROLL CREDIT NAB,0,696.04,28338.31,CR,REF507084,NAB,Business
05-08-2025 07:57,INTEA6B7B35DA99406AB2A3,082-900-001,44444444,TRANSFER TO CBA 33333333,181.87,0,28156.44,DR,INT-46432,NAB,Business
05-08-2025 08:24,INT5E408C6B2D0346338D46,082-900-001,44444444,TRANSFER FROM CBA 22222222,0,497.26,28653.7,CR,INT-20674,NAB,Business
05-08-2025 08:42,NABDB75417276D9460DAC44,082-900-001,44444444,COLES NAB,126.96,0,28526.74,DR,REF579815,NAB,Business
05-08-2025 08:45,NAB4F7061D3ACD24C949B7A,082-900-001,44444444,RAILWAY STATION NAB,44.63,0,28482.11,DR,REF730538,NAB,Business
05-08-2025 08:55,INTECACF026267D41AD903E,082-900-001,44444444,TRANSFER FROM ANZ 11111111,0,1440.17,29922.28,CR,INT-15101,NAB,Business
05-08-2025 09:07,NABACEFDE3E87A14250B50A,082-900-001,44444444,STARBUCKS NAB,180.07,0,29742.21,DR,REF440983,NAB,Business
05-08-2025 09:31,NAB02D612435D0D421E9498,082-900-001,44444444,UBER EATS NAB,71.82,0,29670.39,DR,REF894466,NAB,Business
05-08-2025 09:43,NABC298E70033F746C08813,082-900-001,44444444,ALDI NAB,690.94,0,28979.45,DR,REF423880,NAB,Business
05-08-2025 10:07,NAB9A14AC2FD8EE42D48D7F,082-900-001,44444444,LIQUORLAND NAB,209.97,0,28769.48,DR,REF561840,NAB,Business
05-08-2025 10:40,NAB653B0728EFED4BFAA0C7,082-900-001,44444444,PAYMENT GATEWAY NAB,396.88,0,28372.6,DR,REF235931,NAB,Business
05-08-2025 11:31,NAB3756A412AB544EFE901B,082-900-001,44444444,MENULOG NAB,95.26,0,28277.34,DR,REF266917,NAB,Business
05-08-2025 13:17,NAB099FB4F68F6C40CE83C1,082-900-001,44444444,COLES NAB,348.06,0,27929.28,DR,REF743047,NAB,Business
05-08-2025 13:18,NAB0C5CD0137F444964A451,082-900-001,44444444,UBER EATS NAB,1294.64,0,26634.64,DR,REF169541,NAB,Business
05-08-2025 13:19,INTD32CBB4374384EE8B948,082-900-001,44444444,TRANSFER FROM ANZ 11111111,0,1364.04,27998.68,CR,INT-61207,NAB,Business
05-08-2025 14:30,NAB469E0EAC0E344C389A48,082-900-001,44444444,BANK FEE NAB,68.62,0,27930.06,DR,REF184078,NAB,Business
05-08-2025 14:36,NAB9A7DDDAC7D1641AC8596,082-900-001,44444444,ZOOM NAB,135.12,0,27794.94,DR,REF545876,NAB,Business
05-08-2025 14:54,NAB0405575ACBEA459B871D,082-900-001,44444444,ZOOM NAB,958.31,0,26836.63,DR,REF881419,NAB,Business
05-08-2025 14:54,NAB0192BF2ED9134002ABEE,082-900-001,44444444,PAYPAL *NETFLIX NAB,37.15,0,26799.48,DR,REF164988,NAB,Business
05-08-2025 16:44,NAB8BCFD7A63D364E31B549,082-900-001,44444444,MENULOG NAB,372.69,0,26426.79,DR,REF916980,NAB,Business
05-08-2025 16:53,NAB9F50B07F414F48ADAD84,082-900-001,44444444,BP NAB,160.81,0,26265.98,DR,REF649659,NAB,Business
05-08-2025 17:11,NAB61A1D95646CD4CBB834E,082-900-001,44444444,JB HI-FI NAB,41.55,0,26224.43,DR,REF348234,NAB,Business
05-08-2025 17:16,NAB350CCE34F22B4ABC8BB8,082-900-001,44444444,PAYMENT GATEWAY NAB,460.51,0,25763.92,DR,REF521930,NAB,Business
05-08-2025 17:24,NAB070CF902A5484ECB82FA,082-900-001,44444444,CITYLINK NAB,767.65,0,24996.27,DR,REF888982,NAB,Business
05-08-2025 17:32,NAB175423D932D74A75A675,082-900-001,44444444,WOOLWORTHS NAB,189.59,0,24806.68,DR,REF962388,NAB,Business
05-08-2025 17:34,NAB9AADB5B1880748BC9053,082-900-001,44444444,COLES NAB,303.73,0,24502.95,DR,REF478112,NAB,Business
05-08-2025 17:44,NABC8CA47829B52422290F2,082-900-001,44444444,TAFE BOOKSHOP NAB,954.86,0,23548.09,DR,REF814907,NAB,Business
05-08-2025 17:46,NABBCB91C2AC2D34C118A05,082-900-001,44444444,SPOTIFY NAB,251.16,0,23296.93,DR,REF213752,NAB,Business
05-08-2025 17:55,NAB8B7B2E95900A4424A3BF,082-900-001,44444444,SHELL NAB,321.69,0,22975.24,DR,REF899833,NAB,Business
05-08-2025 18:03,NAB9CDFB07BE3B940E2974A,082-900-001,44444444,MENULOG NAB,281.66,0,22693.58,DR,REF913705,NAB,Business
05-08-2025 18:13,NABF355F13F02E04C74B6AC,082-900-001,44444444,STARBUCKS NAB,407.33,0,22286.25,DR,REF557990,NAB,Business
05-08-2025 18:13,NAB634D487C2CA549D0BF65,082-900-001,44444444,COLES NAB,1467.15,0,20819.1,DR,REF659968,NAB,Business
05-08-2025 18:24,NABB045C2710C6C4A179472,082-900-001,44444444,JB HI-FI NAB,169.09,0,20650.01,DR,REF512167,NAB,Business
05-08-2025 19:07,NAB3D630C1950E4471C8F21,082-900-001,44444444,KFC NAB,278.71,0,20371.3,DR,REF777146,NAB,Business
05-08-2025 19:12,NAB0EF89C5B905B465589BE,082-900-001,44444444,PAYMENT GATEWAY NAB,895.36,0,19475.94,DR,REF566207,NAB,Business
05-08-2025 19:31,NAB6CC5417364134F168C6D,082-900-001,44444444,ZOOM NAB,93.07,0,19382.87,DR,REF872312,NAB,Business
05-08-2025 19:40,NAB1D0EB7012AE049198892,082-900-001,44444444,7-ELEVEN NAB,76.55,0,19306.32,DR,REF200682,NAB,Business
05-08-2025 20:00,NAB93940F404624401484EA,082-900-001,44444444,PAYPAL *NETFLIX NAB,488.34,0,18817.98,DR,REF902511,NAB,Business
05-08-2025 20:27,NAB12FA317C2AD540C4AC78,082-900-001,44444444,UBER EATS NAB,217.17,0,18600.81,DR,REF685476,NAB,Business
05-08-2025 20:33,NABF5DD911EE65E48DFA90F,082-900-001,44444444,LIQUORLAND NAB,720.03,0,17880.78,DR,REF817408,NAB,Business
05-08-2025 21:03,NAB3B06B186ADAC4C5B90D0,082-900-001,44444444,MENULOG NAB,1109.64,0,16771.14,DR,REF517954,NAB,Business
05-08-2025 21:31,INT0F282371E2A141109648,082-900-001,44444444,TRANSFER FROM ANZ 11111111,0,1985.48,18756.62,CR,INT-35806,NAB,Business
05-08-2025 21:58,NAB458053D456934B91B280,082-900-001,44444444,MCDONALDS NAB,602.6,0,18154.02,DR,REF474558,NAB,Business
05-08-2025 22:26,NAB4AFBEE54650D4A1E90B7,082-900-001,44444444,BWS NAB,275.44,0,17878.58,DR,REF396895,NAB,Business
05-08-2025 23:29,NAB1B40E97A76BF4AE1AFCC,082-900-001,44444444,BIGW NAB,595.14,0,17283.44,DR,REF876301,NAB,Business
06-08-2025 00:43,NAB5E5FE5BDED764547BED7,082-900-001,44444444,RAILWAY STATION NAB,414.83,0,16868.61,DR,REF146400,NAB,Business
06-08-2025 01:07,NAB9EA2FBED42D246EAAEAB,082-900-001,44444444,FLIXBUS NAB,259.39,0,16609.22,DR,REF189370,NAB,Business
06-08-2025 01:15,NABB1608426EFE1417C950A,082-900-001,44444444,SHELL NAB,48.35,0,16560.87,DR,REF201384,NAB,Business
06-08-2025 01:55,NABD3CDB4CF6DCE4BC9B97D,082-900-001,44444444,RAILWAY STATION NAB,510.07,0,16050.8,DR,REF729746,NAB,Business
06-08-2025 02:11,NAB80F9976220094C4692E3,082-900-001,44444444,SPOTIFY NAB,346.1,0,15704.7,DR,REF499710,NAB,Business
06-08-2025 02:20,NABE8882F4CA853423592F2,082-900-001,44444444,MCDONALDS NAB,214.51,0,15490.19,DR,REF918075,NAB,Business
06-08-2025 02:33,NAB5DA64474AB3E4CA0A08A,082-900-001,44444444,MENULOG NAB,85.79,0,15404.4,DR,REF668475,NAB,Business
06-08-2025 02:56,NAB0DC59E134AF642B09AC7,082-900-001,44444444,WOOLWORTHS NAB,51.07,0,15353.33,DR,REF625271,NAB,Business
06-08-2025 03:04,NAB9EB417778696438EB87D,082-900-001,44444444,PAYROLL CREDIT NAB,0,1566.26,16919.59,CR,REF890242,NAB,Business
06-08-2025 03:29,NAB93CE553104654522854D,082-900-001,44444444,ZOOM NAB,23.12,0,16896.47,DR,REF721337,NAB,Business
06-08-2025 03:55,INT4EDC239799AE4EDFAD07,082-900-001,44444444,TRANSFER FROM CBA 33333333,0,529.99,17426.46,CR,INT-35242,NAB,Business
06-08-2025 05:06,NAB17093C849F10403B9F81,082-900-001,44444444,BANK FEE NAB,226.51,0,17199.95,DR,REF281218,NAB,Business
06-08-2025 05:11,NAB4028D21859954998BE44,082-900-001,44444444,PAY - SALARY NAB,0,5355.33,22555.28,CR,REF553226,NAB,Business
06-08-2025 05:17,NAB12D63AAB21C6430B8C74,082-900-001,44444444,AMAZON AU NAB,119.53,0,22435.75,DR,REF768866,NAB,Business
06-08-2025 05:25,NAB421C4F8B5E2D409DAC87,082-900-001,44444444,COMPANY PAYROLL NAB,0,4656.36,27092.11,CR,REF195652,NAB,Business
06-08-2025 05:42,NAB26A388BF060D4DC8A1C9,082-900-001,44444444,SALARY PAYMENT NAB,0,142.73,27234.84,CR,REF488731,NAB,Business
06-08-2025 06:12,NAB2AA8BE2B989740F2B10B,082-900-001,44444444,7-ELEVEN NAB,526.27,0,26708.57,DR,REF591275,NAB,Business
06-08-2025 06:26,NABF81888136A0544FD8BAC,082-900-001,44444444,SPOTIFY NAB,114.14,0,26594.43,DR,REF917281,NAB,Business
06-08-2025 06:43,NAB1E3F45CA67344981AFC7,082-900-001,44444444,WAGES CREDIT NAB,0,6529.48,33123.91,CR,REF664260,NAB,Business
06-08-2025 06:48,NAB9EE494EEFEE64CF78840,082-900-001,44444444,MENULOG NAB,299.68,0,32824.23,DR,REF244780,NAB,Business
06-08-2025 06:55,NABC07BB642E2E04AECA550,082-900-001,44444444,BANK FEE NAB,81.57,0,32742.66,DR,REF797422,NAB,Business
06-08-2025 07:16,NABBBE29B7F647A40158F45,082-900-001,44444444,PAYPAL *NETFLIX NAB,59.69,0,32682.97,DR,REF304055,NAB,Business
06-08-2025 07:18,NABC0F63B65CE5C4A8AAB2B,082-900-001,44444444,DOMINO'S PIZZA NAB,38.72,0,32644.25,DR,REF247716,NAB,Business
06-08-2025 07:29,NABB4DECAEF1BCC46B989A0,082-900-001,44444444,WAGES CREDIT NAB,0,7011.76,39656.01,CR,REF251464,NAB,Business
06-08-2025 07:39,NAB18664A719ADC434098E1,082-900-001,44444444,COLES NAB,384.59,0,39271.42,DR,REF115317,NAB,Business
06-08-2025 07:41,NABFF728870A1614CF3860D,082-900-001,44444444,COMPANY PAYROLL NAB,0,4493.2,43764.62,CR,REF744008,NAB,Business
06-08-2025 07:43,NAB71AA6BAA47A24AB0A5BB,082-900-001,44444444,INTERNET TRANSFER NAB,346.27,0,43418.35,DR,REF659589,NAB,Business
06-08-2025 07:56,NAB2BCE56526A364A8AB992,082-900-001,44444444,UBER EATS NAB,193.52,0,43224.83,DR,REF170879,NAB,Business
06-08-2025 08:02,NAB000D7B9B0EC04A60AF24,082-900-001,44444444,INTERNET TRANSFER NAB,781.55,0,42443.28,DR,REF718702,NAB,Business
06-08-2025 08:32,NAB0253507093F541E9BCC1,082-900-001,44444444,HARVEY NORMAN NAB,172.47,0,42270.81,DR,REF569197,NAB,Business
06-08-2025 08:43,INT5D09ABB5E2904865B046,082-900-001,44444444,TRANSFER TO CBA 33333333,740.91,0,41529.9,DR,INT-57176,NAB,Business
06-08-2025 09:05,NAB50FF0EC9BE6346DA9ECE,082-900-001,44444444,BP NAB,445.34,0,41084.56,DR,REF804133,NAB,Business
06-08-2025 09:48,NAB394CFE783FB14D9CA906,082-900-001,44444444,7-ELEVEN NAB,199.03,0,40885.53,DR,REF233611,NAB,Business
06-08-2025 10:09,NABDD2D4821B557410C9B82,082-900-001,44444444,COLES NAB,52.93,0,40832.6,DR,REF345986,NAB,Business
06-08-2025 10:32,NAB5A903104E19549E4950D,082-900-001,44444444,DOMINO'S PIZZA NAB,53.69,0,40778.91,DR,REF913122,NAB,Business
06-08-2025 10:37,NAB444291C2300944B2B538,082-900-001,44444444,COMPANY PAYROLL NAB,0,430.08,41208.99,CR,REF359596,NAB,Business
06-08-2025 10:52,INT6711614206BB4DF78BF6,082-900-001,44444444,TRANSFER FROM CBA 22222222,0,1216.58,42425.57,CR,INT-70052,NAB,Business
06-08-2025 10:56,NAB3AD33415ABC147248D7C,082-900-001,44444444,HARVEY NORMAN NAB,283.5,0,42142.07,DR,REF765122,NAB,Business
06-08-2025 11:06,NABC513E6C2533B4EC98908,082-900-001,44444444,JB HI-FI NAB,36.9,0,42105.17,DR,REF969414,NAB,Business
06-08-2025 11:14,NAB5C03CD93309A49AA963D,082-900-001,44444444,DOMINO'S PIZZA NAB,264.55,0,41840.62,DR,REF847852,NAB,Business
06-08-2025 11:28,NAB85C04CC829E2473381F4,082-900-001,44444444,BWS NAB,1297.97,0,40542.65,DR,REF369842,NAB,Business
06-08-2025 11:42,NAB4CA92366B1A344C38D86,082-900-001,44444444,JB HI-FI NAB,487,0,40055.65,DR,REF497990,NAB,Business
06-08-2025 11:46,NAB39CE93771EFE42808324,082-900-001,44444444,PAYROLL CREDIT NAB,0,1542.78,41598.43,CR,REF925405,NAB,Business
06-08-2025 11:55,NAB67C3191C29CF43CDB92C,082-900-001,44444444,WOOLWORTHS NAB,172.27,0,41426.16,DR,REF832507,NAB,Business
06-08-2025 12:15,NAB388AC423DF1D4AEE9569,082-900-001,44444444,BWS NAB,685.06,0,40741.1,DR,REF308923,NAB,Business
06-08-2025 12:22,NAB03843E89AC004C339827,082-900-001,44444444,RAILWAY STATION NAB,40.6,0,40700.5,DR,REF228457,NAB,Business
06-08-2025 12:31,NAB07943C51658C4218AAE5,082-900-001,44444444,UBER EATS NAB,159.73,0,40540.77,DR,REF897272,NAB,Business
06-08-2025 12:39,NABBF56FC4262AC4C6C8146,082-900-001,44444444,PAYPAL *NETFLIX NAB,308.55,0,40232.22,DR,REF446663,NAB,Business
06-08-2025 12:55,NABFB9387B2D3074D6FAF45,082-900-001,44444444,PAY - SALARY NAB,0,6251.34,46483.56,CR,REF190860,NAB,Business
06-08-2025 13:39,NAB7229955599AC4402A1D2,082-900-001,44444444,MCDONALDS NAB,47.43,0,46436.13,DR,REF757038,NAB,Business
06-08-2025 13:42,NAB3C9F34AF23704914AAC7,082-900-001,44444444,ZOOM NAB,800.27,0,45635.86,DR,REF648922,NAB,Business
06-08-2025 14:16,NAB8082A5DCD70C4E98963F,082-900-001,44444444,BWS NAB,473.16,0,45162.7,DR,REF118964,NAB,Business
06-08-2025 14:19,INT12BE209CD6344706BF00,082-900-001,44444444,TRANSFER FROM ANZ 11111111,0,1541.87,46704.57,CR,INT-94759,NAB,Business
06-08-2025 14:26,NABBA55287E076641CF9B9D,082-900-001,44444444,PAY - SALARY NAB,0,7033.76,53738.33,CR,REF462138,NAB,Business
06-08-2025 14:35,INTF7F619CAE47A4F268EA3,082-900-001,44444444,TRANSFER TO ANZ 11111111,837.61,0,52900.72,DR,INT-75113,NAB,Business
06-08-2025 14:54,NAB6F45F3EFA2A3430A8F17,082-900-001,44444444,HARVEY NORMAN NAB,683.49,0,52217.23,DR,REF334049,NAB,Business
06-08-2025 15:12,NAB24AA7A531A2041F99DD1,082-900-001,44444444,ZOOM NAB,334.77,0,51882.46,DR,REF599143,NAB,Business
06-08-2025 15:43,NAB399B88B279C54B81A845,082-900-001,44444444,DOMINO'S PIZZA NAB,171.22,0,51711.24,DR,REF199834,NAB,Business
06-08-2025 15:43,NAB484135874DD44D9FB096,082-900-001,44444444,BANK FEE NAB,325.96,0,51385.28,DR,REF531552,NAB,Business
06-08-2025 15:52,NAB65F487926F09477B95EC,082-900-001,44444444,TAFE BOOKSHOP NAB,230.83,0,51154.45,DR,REF137993,NAB,Business
06-08-2025 17:48,NAB9676116EC0ED453AB2D7,082-900-001,44444444,PAYMENT GATEWAY NAB,1016.53,0,50137.92,DR,REF984681,NAB,Business
06-08-2025 17:52,NAB32F547F2635343968D5B,082-900-001,44444444,WAGES CREDIT NAB,0,454.49,50592.41,CR,REF699383,NAB,Business
06-08-2025 18:28,NAB01BCA82D2C7D49F2BDD5,082-900-001,44444444,JB HI-FI NAB,175.05,0,50417.36,DR,REF881241,NAB,Business
06-08-2025 19:06,INT7256A72172AB4C4EA14F,082-900-001,44444444,TRANSFER TO ANZ 11111111,657.32,0,49760.04,DR,INT-83781,NAB,Business
06-08-2025 19:14,INT1AE514E4C8D347DFA5B9,082-900-001,44444444,TRANSFER TO CBA 33333333,1352.58,0,48407.46,DR,INT-81564,NAB,Business
06-08-2025 20:04,NABCE055493BFC543D5ADB8,082-900-001,44444444,TAFE BOOKSHOP NAB,29.51,0,48377.95,DR,REF176921,NAB,Business
06-08-2025 20:27,NAB0025D24E403C4151AD98,082-900-001,44444444,JB HI-FI NAB,824.69,0,47553.26,DR,REF469527,NAB,Business
06-08-2025 20:34,NAB2F08795F0026409BB085,082-900-001,44444444,JB HI-FI NAB,592.44,0,46960.82,DR,REF389488,NAB,Business
06-08-2025 20:42,NAB6351EA8098E444638362,082-900-001,44444444,APPLE NAB,236.76,0,46724.06,DR,REF214340,NAB,Business
06-08-2025 20:55,NAB7CD96355D85C437DAB91,082-900-001,44444444,AMAZON AU NAB,511.23,0,46212.83,DR,REF230998,NAB,Business
06-08-2025 21:19,INTD8F44AB0812948F7BE83,082-900-001,44444444,TRANSFER TO CBA 22222222,425.75,0,45787.08,DR,INT-26378,NAB,Business
06-08-2025 21:42,NAB518830CEADDE469697CF,082-900-001,44444444,PAYPAL *NETFLIX NAB,682.67,0,45104.41,DR,REF169300,NAB,Business
06-08-2025 22:13,NAB54BFF918A68E4C2ABC6E,082-900-001,44444444,HARVEY NORMAN NAB,14.4,0,45090.01,DR,REF802716,NAB,Business
06-08-2025 22:21,NAB5141B35C24304A3DBBD8,082-900-001,44444444,RAILWAY STATION NAB,550.23,0,44539.78,DR,REF849547,NAB,Business
06-08-2025 22:29,NAB4DB13FE0B8034A65A709,082-900-001,44444444,ALDI NAB,29.48,0,44510.3,DR,REF299346,NAB,Business
06-08-2025 22:57,NABC2B208140C7C44B2A360,082-900-001,44444444,UBER EATS NAB,702.29,0,43808.01,DR,REF203490,NAB,Business
06-08-2025 23:16,NAB1A4FA394AA07424AAD84,082-900-001,44444444,TAFE BOOKSHOP NAB,45.41,0,43762.6,DR,REF665411,NAB,Business
06-08-2025 23:40,NABE1F5A60D22CF46528D3E,082-900-001,44444444,7-ELEVEN NAB,499.91,0,43262.69,DR,REF620533,NAB,Business
07-08-2025 00:14,NABBEFC5D810B4547178141,082-900-001,44444444,PAYMENT GATEWAY NAB,62.83,0,43199.86,DR,REF777167,NAB,Business
07-08-2025 00:26,NAB203D329DC6DF4F00AD17,082-900-001,44444444,PAYPAL *NETFLIX NAB,154.52,0,43045.34,DR,REF882868,NAB,Business
07-08-2025 01:15,NABAFF48E1D9EA24A2E9CA9,082-900-001,44444444,BP NAB,90.06,0,42955.28,DR,REF546722,NAB,Business
07-08-2025 01:15,NAB0528CD09443C493BA0B0,082-900-001,44444444,SHELL NAB,341.26,0,42614.02,DR,REF530171,NAB,Business
07-08-2025 02:02,INT7EEEFC695C8F452C8A75,082-900-001,44444444,TRANSFER FROM CBA 33333333,0,1681.31,44295.33,CR,INT-37093,NAB,Business
07-08-2025 02:05,NAB28452E8156BB4C349802,082-900-001,44444444,7-ELEVEN NAB,292.6,0,44002.73,DR,REF829872,NAB,Business
07-08-2025 02:38,NABD3E3099810C440649683,082-900-001,44444444,KFC NAB,68.41,0,43934.32,DR,REF410732,NAB,Business
07-08-2025 02:45,NAB9D43C09354854725978C,082-900-001,44444444,MENULOG NAB,326.53,0,43607.79,DR,REF211116,NAB,Business
07-08-2025 03:16,NABB92B0C5BEAC6499EB336,082-900-001,44444444,WOOLWORTHS NAB,14.97,0,43592.82,DR,REF640389,NAB,Business
07-08-2025 03:32,NAB2AC5654C5B6E4DB9A43E,082-900-001,44444444,ALDI NAB,18.21,0,43574.61,DR,REF875585,NAB,Business
07-08-2025 03:48,INTF8C804E35E064C28BD13,082-900-001,44444444,TRANSFER TO CBA 33333333,1103.07,0,42471.54,DR,INT-59586,NAB,Business
07-08-2025 04:02,NAB3EFB56E6F9E14C9990BC,082-900-001,44444444,RAILWAY STATION NAB,153.36,0,42318.18,DR,REF914707,NAB,Business
07-08-2025 05:32,NAB018A1808BD65421F912E,082-900-001,44444444,BANK FEE NAB,301.06,0,42017.12,DR,REF566039,NAB,Business
07-08-2025 05:35,NABCE1FFB634F704F85A146,082-900-001,44444444,AMAZON AU NAB,59.57,0,41957.55,DR,REF132420,NAB,Business
07-08-2025 07:06,INT1BD4CC92CD5E4E0BBF64,082-900-001,44444444,TRANSFER FROM ANZ 11111111,0,1416.49,43374.04,CR,INT-93035,NAB,Business
07-08-2025 07:24,NAB590866FDA4CC4E5F9025,082-900-001,44444444,ZOOM NAB,65.32,0,43308.72,DR,REF357467,NAB,Business
07-08-2025 07:27,NABB48AC177568747DC913F,082-900-001,44444444,PAYMENT GATEWAY NAB,50.59,0,43258.13,DR,REF524786,NAB,Business
07-08-2025 07:51,NAB20456FF8DFDE4E9E8C59,082-900-001,44444444,ZOOM NAB,711.47,0,42546.66,DR,REF928054,NAB,Business
07-08-2025 08:44,NABAD5D746AD9654D8ABB9B,082-900-001,44444444,ALDI NAB,555.63,0,41991.03,DR,REF188951,NAB,Business
07-08-2025 09:43,NAB967725789FD548F495C7,082-900-001,44444444,KFC NAB,352.26,0,41638.77,DR,REF466858,NAB,Business
07-08-2025 09:58,NAB6490C2A447C246159983,082-900-001,44444444,SHELL NAB,91.68,0,41547.09,DR,REF300045,NAB,Business
07-08-2025 10:14,NABBA138AF4F3BD44D8A389,082-900-001,44444444,RAILWAY STATION NAB,62.34,0,41484.75,DR,REF737115,NAB,Business
07-08-2025 10:25,NAB56AA7945447C4036B682,082-900-001,44444444,BANK FEE NAB,164.36,0,41320.39,DR,REF706498,NAB,Business
07-08-2025 10:43,NABE7CE4139D6614B1B892B,082-900-001,44444444,COLES NAB,225.01,0,41095.38,DR,REF319014,NAB,Business
07-08-2025 10:48,NAB7179BFE7AF3748D0839E,082-900-001,44444444,INTERNET TRANSFER NAB,122.21,0,40973.17,DR,REF122153,NAB,Business
07-08-2025 10:50,NABFD428924CB454001902F,082-900-001,44444444,INTERNET TRANSFER NAB,1200.44,0,39772.73,DR,REF510584,NAB,Business
07-08-2025 11:19,NABD94D5CA7C7F14227B71A,082-900-001,44444444,MENULOG NAB,116.52,0,39656.21,DR,REF422000,NAB,Business
07-08-2025 11:54,NAB7C350BBAF9E74162A1ED,082-900-001,44444444,CITYLINK NAB,460.06,0,39196.15,DR,REF939756,NAB,Business
07-08-2025 12:19,NAB4C8E8DF2397C4CD9B1CA,082-900-001,44444444,BIGW NAB,205.75,0,38990.4,DR,REF725967,NAB,Business
07-08-2025 12:22,NAB26D066D8F25248A385A7,082-900-001,44444444,MENULOG NAB,134.99,0,38855.41,DR,REF855685,NAB,Business
07-08-2025 12:44,NAB4C892F02846A4F14B1F4,082-900-001,44444444,SPOTIFY NAB,297.94,0,38557.47,DR,REF212353,NAB,Business
07-08-2025 12:52,NAB45FE7181FD4143BD827E,082-900-001,44444444,WAGES CREDIT NAB,0,4919.45,43476.92,CR,REF586577,NAB,Business
07-08-2025 12:58,NABCDE7A5A4462C485E8FE4,082-900-001,44444444,BANK FEE NAB,992.57,0,42484.35,DR,REF961700,NAB,Business
07-08-2025 13:25,NAB2DA2F0474F4543178B02,082-900-001,44444444,DOMINO'S PIZZA NAB,204.73,0,42279.62,DR,REF471525,NAB,Business
07-08-2025 13:42,NAB47CBB4353E654AA0ACB6,082-900-001,44444444,APPLE NAB,443.26,0,41836.36,DR,REF967889,NAB,Business
07-08-2025 14:08,NAB3E10CE19DAE3428A8EFD,082-900-001,44444444,COLES NAB,460.77,0,41375.59,DR,REF193003,NAB,Business
07-08-2025 14:28,NAB3B4C59366D09427CB010,082-900-001,44444444,STARBUCKS NAB,414.29,0,40961.3,DR,REF921480,NAB,Business
07-08-2025 14:41,NAB0C053349C9CF43FCB8F4,082-900-001,44444444,TAFE BOOKSHOP NAB,571.16,0,40390.14,DR,REF548449,NAB,Business
07-08-2025 14:49,NAB5F940763E7A845B5BBC9,082-900-001,44444444,APPLE NAB,379.78,0,40010.36,DR,REF521859,NAB,Business
07-08-2025 15:21,NAB2FEA51958A7B4714A75C,082-900-001,44444444,STARBUCKS NAB,121.19,0,39889.17,DR,REF467169,NAB,Business
07-08-2025 15:24,NAB5493A272F402498CAC8E,082-900-001,44444444,KFC NAB,268.71,0,39620.46,DR,REF693864,NAB,Business
07-08-2025 16:27,NAB305EF728003544E799C3,082-900-001,44444444,MENULOG NAB,105.93,0,39514.53,DR,REF940387,NAB,Business
07-08-2025 16:30,NAB2991BAC2886545139D9E,082-900-001,44444444,PAYROLL CREDIT NAB,0,7283.35,46797.88,CR,REF992328,NAB,Business
07-08-2025 16:37,NABAFC6DC4899174E7BA280,082-900-001,44444444,LIQUORLAND NAB,60.94,0,46736.94,DR,REF507740,NAB,Business
07-08-2025 16:38,NABA1706818086F449D8E5B,082-900-001,44444444,WOOLWORTHS NAB,1364.87,0,45372.07,DR,REF566328,NAB,Business
07-08-2025 16:40,NAB3E346593A1C04B05AE85,082-900-001,44444444,ALDI NAB,120.9,0,45251.17,DR,REF162774,NAB,Business
07-08-2025 16:41,NAB30B830F876304D18B83A,082-900-001,44444444,KFC NAB,267.71,0,44983.46,DR,REF165068,NAB,Business
07-08-2025 17:28,NABF3905236E3F849109156,082-900-001,44444444,BIGW NAB,137.2,0,44846.26,DR,REF359367,NAB,Business
07-08-2025 17:43,NAB6C60E5DFEF784D4C93AB,082-900-001,44444444,STARBUCKS NAB,1412.05,0,43434.21,DR,REF737015,NAB,Business
07-08-2025 17:44,INT16EFF0AEFF684FF297F9,082-900-001,44444444,TRANSFER FROM CBA 22222222,0,776.41,44210.62,CR,INT-23534,NAB,Business
07-08-2025 18:23,NABFE7BB71F94404E24B76F,082-900-001,44444444,BP NAB,347.5,0,43863.12,DR,REF918505,NAB,Business
07-08-2025 18:34,NAB21114B0B887A4ECB9ABD,082-900-001,44444444,STARBUCKS NAB,302.65,0,43560.47,DR,REF665126,NAB,Business
07-08-2025 18:41,NABC2A7ADDF520E4A31930A,082-900-001,44444444,RAILWAY STATION NAB,101.95,0,43458.52,DR,REF573952,NAB,Business
07-08-2025 18:49,NABDA4D5095E16E4917A7C1,082-900-001,44444444,MCDONALDS NAB,389.01,0,43069.51,DR,REF423687,NAB,Business
07-08-2025 19:06,NABF7EBB6C11D9D40C58869,082-900-001,44444444,DOMINO'S PIZZA NAB,300.91,0,42768.6,DR,REF371081,NAB,Business
07-08-2025 19:13,NABFABAFEFCAC93425FB0D7,082-900-001,44444444,UBER EATS NAB,355.79,0,42412.81,DR,REF438690,NAB,Business
07-08-2025 19:17,NAB6A02C10C001949849956,082-900-001,44444444,TAFE BOOKSHOP NAB,58.8,0,42354.01,DR,REF648878,NAB,Business
07-08-2025 20:10,NABE808270BAED04BFAA203,082-900-001,44444444,COLES NAB,102.39,0,42251.62,DR,REF232297,NAB,Business
07-08-2025 20:24,NABBD3FD6E78A4E4F008209,082-900-001,44444444,7-ELEVEN NAB,524.66,0,41726.96,DR,REF877076,NAB,Business
07-08-2025 21:19,NAB2BFE66D6EE7240C7BA4D,082-900-001,44444444,JB HI-FI NAB,305.8,0,41421.16,DR,REF679353,NAB,Business
07-08-2025 21:37,INTD1B0A348E86C452CA4BC,082-900-001,44444444,TRANSFER TO CBA 22222222,1689.4,0,39731.76,DR,INT-92793,NAB,Business
07-08-2025 21:52,NABCB3FD44C08BA48599AD6,082-900-001,44444444,INTERNET TRANSFER NAB,351.06,0,39380.7,DR,REF230833,NAB,Business
07-08-2025 21:59,NAB09FD53FB3BE1455BA342,082-900-001,44444444,AMAZON AU NAB,80.52,0,39300.18,DR,REF143995,NAB,Business
07-08-2025 22:02,NABDBE60A81308448F4BED5,082-900-001,44444444,BWS NAB,193.83,0,39106.35,DR,REF859324,NAB,Business
07-08-2025 22:20,NAB8119A40728A947508ACE,082-900-001,44444444,7-ELEVEN NAB,156.81,0,38949.54,DR,REF447141,NAB,Business
07-08-2025 22:26,NAB464F59BA3B1C49628B97,082-900-001,44444444,SALARY PAYMENT NAB,0,356.23,39305.77,CR,REF102906,NAB,Business
07-08-2025 22:51,NAB6259293E76A647B48B58,082-900-001,44444444,PAY - SALARY NAB,0,3258.71,42564.48,CR,REF237606,NAB,Business
07-08-2025 23:13,NABBC774D38529A457EABDA,082-900-001,44444444,TAFE BOOKSHOP NAB,91.74,0,42472.74,DR,REF757261,NAB,Business
07-08-2025 23:39,NAB7622F492AFA74A7A8C5B,082-900-001,44444444,PAY - SALARY NAB,0,371.71,42844.45,CR,REF169477,NAB,Business
07-08-2025 23:56,NAB6E9A9A3D8AFC4AFE890F,082-900-001,44444444,KFC NAB,152.88,0,42691.57,DR,REF421737,NAB,Business
07-08-2025 23:58,NABE7C5629F7D2B432FA3F9,082-900-001,44444444,BP NAB,133.15,0,42558.42,DR,REF112136,NAB,Business
08-08-2025 00:06,NABB1087699DD5342F28BE3,082-900-001,44444444,7-ELEVEN NAB,751.05,0,41807.37,DR,REF556628,NAB,Business
08-08-2025 00:56,NABD10A4935D6744EEFA9B2,082-900-001,44444444,HARVEY NORMAN NAB,350.42,0,41456.95,DR,REF869336,NAB,Business
08-08-2025 01:00,NAB5F90FDC8E37F4A2BA09C,082-900-001,44444444,BWS NAB,695.98,0,40760.97,DR,REF147107,NAB,Business
08-08-2025 01:02,NAB39DF4F626A5943DFAFED,082-900-001,44444444,PAY - SALARY NAB,0,5669.19,46430.16,CR,REF267585,NAB,Business
08-08-2025 01:04,INT10007AF4C518403E89B2,082-900-001,44444444,TRANSFER TO CBA 22222222,1577.28,0,44852.88,DR,INT-93770,NAB,Business
08-08-2025 01:08,NAB044CA08445ED4769AAE3,082-900-001,44444444,UBER EATS NAB,56.57,0,44796.31,DR,REF806541,NAB,Business
08-08-2025 01:28,NAB123CDA171A424672BD6C,082-900-001,44444444,BP NAB,457.54,0,44338.77,DR,REF146114,NAB,Business
08-08-2025 01:33,NAB2C264E4F332F4D3D8219,082-900-001,44444444,WOOLWORTHS NAB,97.7,0,44241.07,DR,REF785792,NAB,Business
08-08-2025 01:38,NAB2C3F1BC02C744D4C85E4,082-900-001,44444444,TAFE BOOKSHOP NAB,370.37,0,43870.7,DR,REF553487,NAB,Business
08-08-2025 02:09,NABE844EC5A4EFC477D92EF,082-900-001,44444444,LIQUORLAND NAB,245.63,0,43625.07,DR,REF828532,NAB,Business
08-08-2025 02:34,NAB1AA6942DAEA849EF8269,082-900-001,44444444,MENULOG NAB,45.22,0,43579.85,DR,REF388046,NAB,Business
08-08-2025 03:49,NABA9BCBCAC08114A36A96D,082-900-001,44444444,7-ELEVEN NAB,369.39,0,43210.46,DR,REF367177,NAB,Business
08-08-2025 03:52,NAB673EC4220D274CC6A603,082-900-001,44444444,AMAZON AU NAB,367.29,0,42843.17,DR,REF368609,NAB,Business
08-08-2025 04:08,NAB83847950078D4DD88977,082-900-001,44444444,COLES NAB,698.95,0,42144.22,DR,REF983376,NAB,Business
08-08-2025 04:45,NAB2E16EA4A128E4415A87D,082-900-001,44444444,HARVEY NORMAN NAB,342.33,0,41801.89,DR,REF382265,NAB,Business
08-08-2025 05:35,NAB5F71AAEABABC45D99A32,082-900-001,44444444,ZOOM NAB,177.18,0,41624.71,DR,REF842181,NAB,Business
08-08-2025 05:54,NABE98A280E3B274ABBA97E,082-900-001,44444444,FLIXBUS NAB,204.38,0,41420.33,DR,REF295962,NAB,Business
08-08-2025 06:31,NAB315EDC74D8B1438E9591,082-900-001,44444444,SHELL NAB,203.29,0,41217.04,DR,REF253110,NAB,Business
08-08-2025 06:36,NABFAF855D5CC2047C29CAC,082-900-001,44444444,7-ELEVEN NAB,397.01,0,40820.03,DR,REF983270,NAB,Business
08-08-2025 06:50,NAB2061729A35D24C2DA7E3,082-900-001,44444444,FLIXBUS NAB,648.63,0,40171.4,DR,REF843349,NAB,Business
08-08-2025 07:01,NAB97C54A2C5D1B46F0837D,082-900-001,44444444,TAFE BOOKSHOP NAB,112.89,0,40058.51,DR,REF342157,NAB,Business
08-08-2025 07:07,NAB46D7FB91A53644399464,082-900-001,44444444,SPOTIFY NAB,289.87,0,39768.64,DR,REF420073,NAB,Business
08-08-2025 07:24,NABE54D54175B87473690A9,082-900-001,44444444,PAYPAL *NETFLIX NAB,699.78,0,39068.86,DR,REF923303,NAB,Business
08-08-2025 07:31,NABA0B7C9DC0C22434EAAAA,082-900-001,44444444,BP NAB,76.05,0,38992.81,DR,REF617064,NAB,Business
08-08-2025 07:38,NABEC1E14C515A542C38737,082-900-001,44444444,LIQUORLAND NAB,63.95,0,38928.86,DR,REF936879,NAB,Business
08-08-2025 07:43,NABC2D7AE28CDF54EB1869A,082-900-001,44444444,PAYMENT GATEWAY NAB,54.35,0,38874.51,DR,REF422832,NAB,Business
08-08-2025 07:44,NABE778130793F043FFA068,082-900-001,44444444,STARBUCKS NAB,497.15,0,38377.36,DR,REF148253,NAB,Business
08-08-2025 07:57,NAB9D0B5B92F5D64063B902,082-900-001,44444444,WAGES CREDIT NAB,0,5269.22,43646.58,CR,REF783704,NAB,Business
08-08-2025 07:57,NABF4D167AFBC804F43A7A7,082-900-001,44444444,SALARY PAYMENT NAB,0,546.1,44192.68,CR,REF207446,NAB,Business
08-08-2025 08:01,NABE9EE080A51C348DEAAF6,082-900-001,44444444,FLIXBUS NAB,118.67,0,44074.01,DR,REF154667,NAB,Business
08-08-2025 08:06,NABD68BFDED574740A1A2D7,082-900-001,44444444,RAILWAY STATION NAB,31.28,0,44042.73,DR,REF145341,NAB,Business
08-08-2025 08:19,NABA94471F59B3548D28D73,082-900-001,44444444,MENULOG NAB,288.49,0,43754.24,DR,REF260159,NAB,Business
08-08-2025 09:21,NAB7136823DBBD4455F93DD,082-900-001,44444444,ZOOM NAB,298.29,0,43455.95,DR,REF454287,NAB,Business
08-08-2025 09:24,NAB8F8CEF0D0DBA400891DE,082-900-001,44444444,MCDONALDS NAB,265,0,43190.95,DR,REF436135,NAB,Business
08-08-2025 09:38,NABAB45DD71B69B47888063,082-900-001,44444444,WAGES CREDIT NAB,0,6807.36,49998.31,CR,REF600172,NAB,Business
08-08-2025 09:56,NAB441D03F677454D20B12F,082-900-001,44444444,BIGW NAB,44.64,0,49953.67,DR,REF344808,NAB,Business
08-08-2025 10:16,NABD3FAA32BA6E345AB9803,082-900-001,44444444,INTERNET TRANSFER NAB,391.96,0,49561.71,DR,REF426613,NAB,Business
08-08-2025 10:20,INT182162F0FEA148DD97A2,082-900-001,44444444,TRANSFER TO ANZ 11111111,1417.2,0,48144.51,DR,INT-68202,NAB,Business
08-08-2025 10:24,NABF54F6AAC208D4B179C77,082-900-001,44444444,PAYPAL *NETFLIX NAB,946.91,0,47197.6,DR,REF581783,NAB,Business
08-08-2025 10:34,NABC65D06890336427EBB99,082-900-001,44444444,BWS NAB,223.56,0,46974.04,DR,REF630909,NAB,Business
08-08-2025 10:35,NAB7E0FB37C39884ED5BF7C,082-900-001,44444444,WOOLWORTHS NAB,60.74,0,46913.3,DR,REF631537,NAB,Business
08-08-2025 10:42,NABCD992EDFBBDA4698B21F,082-900-001,44444444,MCDONALDS NAB,509.25,0,46404.05,DR,REF135184,NAB,Business
08-08-2025 11:27,NAB7EBF005C7A3142A49FBE,082-900-001,44444444,INTERNET TRANSFER NAB,57.94,0,46346.11,DR,REF727434,NAB,Business
08-08-2025 11:30,NAB237881EEB52547259DED,082-900-001,44444444,LIQUORLAND NAB,101.38,0,46244.73,DR,REF798391,NAB,Business
08-08-2025 11:52,NAB68CB00582F534FCCA6A1,082-900-001,44444444,BIGW NAB,352.92,0,45891.81,DR,REF993239,NAB,Business
08-08-2025 12:48,NAB65F499B8FCF14F0DA85F,082-900-001,44444444,BIGW NAB,349.82,0,45541.99,DR,REF438623,NAB,Business
08-08-2025 13:20,NABDD2BDDEDDB404B349329,082-900-001,44444444,STARBUCKS NAB,37.06,0,45504.93,DR,REF225408,NAB,Business
08-08-2025 13:23,NABF80FCBB38F5B4F91883C,082-900-001,44444444,STARBUCKS NAB,430.51,0,45074.42,DR,REF394820,NAB,Business
08-08-2025 13:45,NABD143BD9342B04B0DA0E9,082-900-001,44444444,DOMINO'S PIZZA NAB,392.42,0,44682,DR,REF352666,NAB,Business
08-08-2025 13:50,NABB8EABDC0593F4A3AAEC9,082-900-001,44444444,WOOLWORTHS NAB,1122.56,0,43559.44,DR,REF813399,NAB,Business
08-08-2025 14:11,NAB9EAC7A4485A94D868D18,082-900-001,44444444,STARBUCKS NAB,436.62,0,43122.82,DR,REF936613,NAB,Business
08-08-2025 14:22,NAB4C898349B9254D1180D6,082-900-001,44444444,WOOLWORTHS NAB,676.8,0,42446.02,DR,REF323771,NAB,Business
08-08-2025 14:24,NAB9DFC4E99616444E6B0CA,082-900-001,44444444,ZOOM NAB,574.8,0,41871.22,DR,REF732211,NAB,Business
08-08-2025 14:25,NAB0AFFB0A5D0A54D5CA763,082-900-001,44444444,TAFE BOOKSHOP NAB,350.22,0,41521,DR,REF494469,NAB,Business
08-08-2025 14:31,NABF6A7BB610EA543299422,082-900-001,44444444,COMPANY PAYROLL NAB,0,992.31,42513.31,CR,REF315964,NAB,Business
08-08-2025 14:38,NAB46BA2469F7FF400DAE5F,082-900-001,44444444,DOMINO'S PIZZA NAB,155.08,0,42358.23,DR,REF746148,NAB,Business
08-08-2025 14:58,NABFECCFD64C4524FFFAD8D,082-900-001,44444444,BANK FEE NAB,209.73,0,42148.5,DR,REF189869,NAB,Business
08-08-2025 15:07,NAB09B9CA06DFA24065B008,082-900-001,44444444,ZOOM NAB,86.83,0,42061.67,DR,REF887114,NAB,Business
08-08-2025 15:16,NAB06CF4E96E1624A8EB41C,082-900-001,44444444,MCDONALDS NAB,150.74,0,41910.93,DR,REF532968,NAB,Business
08-08-2025 15:37,NAB9F6AD129F7B14C5A8D65,082-900-001,44444444,BANK FEE NAB,53.16,0,41857.77,DR,REF575855,NAB,Business
08-08-2025 16:10,NAB1EA14C0F111847E9A77D,082-900-001,44444444,WOOLWORTHS NAB,288.45,0,41569.32,DR,REF349451,NAB,Business
08-08-2025 16:30,NAB746B6750310F4B7A80E5,082-900-001,44444444,BP NAB,648.12,0,40921.2,DR,REF458690,NAB,Business
08-08-2025 16:39,NAB2C9AACB7ECB342B795CA,082-900-001,44444444,PAYPAL *NETFLIX NAB,110.07,0,40811.13,DR,REF756724,NAB,Business
08-08-2025 17:10,INTD7936D6CDD214FB8A0CB,082-900-001,44444444,TRANSFER TO CBA 22222222,301.17,0,40509.96,DR,INT-61792,NAB,Business
08-08-2025 17:14,NAB16E3A87474654727B0FF,082-900-001,44444444,RAILWAY STATION NAB,222.02,0,40287.94,DR,REF927036,NAB,Business
08-08-2025 17:26,NAB750296EA08DD48E5942A,082-900-001,44444444,KFC NAB,71.22,0,40216.72,DR,REF870878,NAB,Business
08-08-2025 17:59,NAB891F56DADD3B467CA449,082-900-001,44444444,COMPANY PAYROLL NAB,0,7143.63,47360.35,CR,REF825995,NAB,Business
08-08-2025 17:59,NABA6A8A61C3ED74717BE5A,082-900-001,44444444,UBER EATS NAB,164.78,0,47195.57,DR,REF571149,NAB,Business
08-08-2025 18:23,NAB9082F78B7A6E4D2FB358,082-900-001,44444444,BIGW NAB,922.69,0,46272.88,DR,REF457690,NAB,Business
08-08-2025 18:24,NABA056AA419DBB4BFBBCEA,082-900-001,44444444,MENULOG NAB,374.84,0,45898.04,DR,REF628670,NAB,Business
08-08-2025 18:27,NAB23D73001890844A4A89D,082-900-001,44444444,ZOOM NAB,168.08,0,45729.96,DR,REF255877,NAB,Business
08-08-2025 18:54,NAB7350288053414F25A78A,082-900-001,44444444,ALDI NAB,651.41,0,45078.55,DR,REF916108,NAB,Business
08-08-2025 18:59,NAB8BD4F6F481B347358ACF,082-900-001,44444444,ZOOM NAB,486.63,0,44591.92,DR,REF937228,NAB,Business
08-08-2025 19:17,NABA335CFF94931414BA545,082-900-001,44444444,UBER EATS NAB,784.94,0,43806.98,DR,REF599290,NAB,Business
08-08-2025 19:24,NAB758C49FFD93246B0BF43,082-900-001,44444444,AMAZON AU NAB,384.05,0,43422.93,DR,REF135786,NAB,Business
08-08-2025 19:51,NABD92A2B44B1304E969F8B,082-900-001,44444444,COMPANY PAYROLL NAB,0,4882.04,48304.97,CR,REF459097,NAB,Business
08-08-2025 19:52,NAB33012F430F9D41DBA6EC,082-900-001,44444444,COLES NAB,58.05,0,48246.92,DR,REF361912,NAB,Business
08-08-2025 20:35,NAB2B305C6FAE5F483684D6,082-900-001,44444444,7-ELEVEN NAB,377.94,0,47868.98,DR,REF962806,NAB,Business
08-08-2025 20:36,NABB79A24C48E944FA89511,082-900-001,44444444,LIQUORLAND NAB,56.21,0,47812.77,DR,REF665522,NAB,Business
08-08-2025 20:42,NAB7D1B5503CFFB4EAE8B4C,082-900-001,44444444,WAGES CREDIT NAB,0,2934.59,50747.36,CR,REF192496,NAB,Business
08-08-2025 20:45,NABDC87F42A15034ACDA265,082-900-001,44444444,MCDONALDS NAB,128.59,0,50618.77,DR,REF315984,NAB,Business
08-08-2025 20:52,NABAB38D8943AE94EC2BFE4,082-900-001,44444444,BANK FEE NAB,1076.78,0,49541.99,DR,REF658628,NAB,Business
08-08-2025 21:11,NAB3C9A7597375C4391BC46,082-900-001,44444444,BANK FEE NAB,178.88,0,49363.11,DR,REF984949,NAB,Business
08-08-2025 21:50,NABFA7AAC00718B4CA8966F,082-900-001,44444444,UBER EATS NAB,902.54,0,48460.57,DR,REF168287,NAB,Business
08-08-2025 22:01,NAB76B582127B984B72AFE0,082-900-001,44444444,LIQUORLAND NAB,852.98,0,47607.59,DR,REF738985,NAB,Business
08-08-2025 22:11,NAB873F2C7794214B718EC9,082-900-001,44444444,DOMINO'S PIZZA NAB,33.64,0,47573.95,DR,REF262320,NAB,Business
08-08-2025 22:17,NAB817D8F4E2A4A435EBED4,082-900-001,44444444,PAYPAL *NETFLIX NAB,67.19,0,47506.76,DR,REF176931,NAB,Business
08-08-2025 22:25,NAB70B7DF9A0F074235A4ED,082-900-001,44444444,STARBUCKS NAB,206.77,0,47299.99,DR,REF313130,NAB,Business
08-08-2025 22:25,NABC18341D62516477D9673,082-900-001,44444444,PAY - SALARY NAB,0,44.49,47344.48,CR,REF933657,NAB,Business
08-08-2025 22:31,NABA7CA6162B0574D8588BB,082-900-001,44444444,RAILWAY STATION NAB,321.81,0,47022.67,DR,REF180690,NAB,Business
08-08-2025 22:55,NABB3448C77C5954AF58CCC,082-900-001,44444444,APPLE NAB,91.63,0,46931.04,DR,REF465776,NAB,Business
08-08-2025 23:08,NABE11F614A576C449FB471,082-900-001,44444444,ALDI NAB,325.53,0,46605.51,DR,REF526862,NAB,Business
08-08-2025 23:13,NAB0F14FE162E724EFD9DBA,082-900-001,44444444,FLIXBUS NAB,120.11,0,46485.4,DR,REF537045,NAB,Business
08-08-2025 23:20,NABDEFB7DA623D14021ADA4,082-900-001,44444444,CITYLINK NAB,402.63,0,46082.77,DR,REF481707,NAB,Business
08-08-2025 23:21,NAB3ED38C5833274E29ABC5,082-900-001,44444444,WAGES CREDIT NAB,0,981.55,47064.32,CR,REF935281,NAB,Business
08-08-2025 23:22,NAB3D27D3E73ABA4E108CF6,082-900-001,44444444,PAY - SALARY NAB,0,1804.39,48868.71,CR,REF524965,NAB,Business
08-08-2025 23:28,NAB16BC2828C31F438992A7,082-900-001,44444444,UBER EATS NAB,100.75,0,48767.96,DR,REF169095,NAB,Business
08-08-2025 23:33,NAB8E1B05F475B64EC6B635,082-900-001,44444444,ZOOM NAB,184.55,0,48583.41,DR,REF474637,NAB,Business
08-08-2025 23:37,NABF805B3EEF89B4E3E857A,082-900-001,44444444,CITYLINK NAB,416.89,0,48166.52,DR,REF269235,NAB,Business
08-08-2025 23:47,NABFDAF9FA8C4324F169E46,082-900-001,44444444,PAYPAL *NETFLIX NAB,292.45,0,47874.07,DR,REF912844,NAB,Business
09-08-2025 00:01,NAB062CDC21E87A4F9BB9E5,082-900-001,44444444,LIQUORLAND NAB,932.6,0,46941.47,DR,REF210108,NAB,Business
09-08-2025 01:10,NABAED670057B6447949450,082-900-001,44444444,RAILWAY STATION NAB,40,0,46901.47,DR,REF375208,NAB,Business
09-08-2025 01:33,NAB75A0C3DE10DE4427B835,082-900-001,44444444,KFC NAB,244.67,0,46656.8,DR,REF991155,NAB,Business
09-08-2025 01:42,NABFB911FBDBF7A43BCBA88,082-900-001,44444444,TAFE BOOKSHOP NAB,37.67,0,46619.13,DR,REF682824,NAB,Business
09-08-2025 01:43,NAB1AFF80B29F944554B6AF,082-900-001,44444444,SALARY PAYMENT NAB,0,6248.66,52867.79,CR,REF336907,NAB,Business
09-08-2025 01:47,NAB070D53338AE1436CB124,082-900-001,44444444,MENULOG NAB,42.19,0,52825.6,DR,REF939781,NAB,Business
09-08-2025 01:55,NAB8082CB7E29DF4C16B546,082-900-001,44444444,BWS NAB,561.22,0,52264.38,DR,REF605949,NAB,Business
09-08-2025 01:58,NAB438D1FFB618742E2A111,082-900-001,44444444,BANK FEE NAB,64.96,0,52199.42,DR,REF978419,NAB,Business
09-08-2025 02:00,NABDD064094715F49A9897C,082-900-001,44444444,KFC NAB,123.92,0,52075.5,DR,REF999221,NAB,Business
09-08-2025 02:38,NAB3FB9E4F0851E4FD1AD68,082-900-001,44444444,JB HI-FI NAB,67.33,0,52008.17,DR,REF213969,NAB,Business
09-08-2025 03:18,NAB8867D97D49AD4FF0B6E6,082-900-001,44444444,INTERNET TRANSFER NAB,150.8,0,51857.37,DR,REF247111,NAB,Business
09-08-2025 03:39,NABB86029A631AE42438BAF,082-900-001,44444444,ALDI NAB,990.06,0,50867.31,DR,REF422288,NAB,Business
09-08-2025 04:31,NAB4C868E307E5A4676B1DF,082-900-001,44444444,FLIXBUS NAB,307.96,0,50559.35,DR,REF462310,NAB,Business
09-08-2025 04:36,NABD73A7805238E434EA774,082-900-001,44444444,MENULOG NAB,716.46,0,49842.89,DR,REF750566,NAB,Business
09-08-2025 05:21,NAB572A6C8582EE491C8172,082-900-001,44444444,LIQUORLAND NAB,59.01,0,49783.88,DR,REF422643,NAB,Business
09-08-2025 05:24,NAB4C077E8970EF4EEDB019,082-900-001,44444444,7-ELEVEN NAB,189.28,0,49594.6,DR,REF689282,NAB,Business
09-08-2025 05:28,NAB3D058D4524E54E9DBA75,082-900-001,44444444,TAFE BOOKSHOP NAB,658.44,0,48936.16,DR,REF580149,NAB,Business
09-08-2025 06:01,NABEE4FB4C7B24B462BB058,082-900-001,44444444,HARVEY NORMAN NAB,349.89,0,48586.27,DR,REF837466,NAB,Business
09-08-2025 06:06,INTC8B5F9FA75EF400D99EA,082-900-001,44444444,TRANSFER TO ANZ 11111111,284.47,0,48301.8,DR,INT-47041,NAB,Business
09-08-2025 06:07,NAB00EAFA1F340048DCA581,082-900-001,44444444,UBER EATS NAB,89.85,0,48211.95,DR,REF249694,NAB,Business
09-08-2025 06:07,NAB7B6494B0ED094D7E93EF,082-900-001,44444444,INTERNET TRANSFER NAB,221.33,0,47990.62,DR,REF174657,NAB,Business
09-08-2025 06:19,NAB234B976CBEAB4CB2916B,082-900-001,44444444,KFC NAB,100.91,0,47889.71,DR,REF851336,NAB,Business
09-08-2025 06:24,NAB3C132B9AD6714783BEC9,082-900-001,44444444,JB HI-FI NAB,567.55,0,47322.16,DR,REF612616,NAB,Business
09-08-2025 06:34,NABEE0F98ADF86B40038877,082-900-001,44444444,LIQUORLAND NAB,210.2,0,47111.96,DR,REF959921,NAB,Business
09-08-2025 06:40,NAB6E8F456260434F17B118,082-900-001,44444444,ZOOM NAB,388.38,0,46723.58,DR,REF443826,NAB,Business
09-08-2025 07:01,NABF72B734E32FD42E6B1A7,082-900-001,44444444,FLIXBUS NAB,366.82,0,46356.76,DR,REF695860,NAB,Business
09-08-2025 07:31,NABA49253DC14464ED08226,082-900-001,44444444,PAYROLL CREDIT NAB,0,7795.23,54151.99,CR,REF844394,NAB,Business
09-08-2025 07:32,NAB3EF753B9F79D42AA8D41,082-900-001,44444444,SPOTIFY NAB,125.13,0,54026.86,DR,REF991573,NAB,Business
09-08-2025 07:43,INTD4EC9361E140485E956C,082-900-001,44444444,TRANSFER TO CBA 22222222,1545.24,0,52481.62,DR,INT-84857,NAB,Business
09-08-2025 08:04,NABC3AA88708A9F409196DB,082-900-001,44444444,CITYLINK NAB,165.99,0,52315.63,DR,REF209347,NAB,Business
09-08-2025 08:10,NAB861E24BA41334193BC6C,082-900-001,44444444,HARVEY NORMAN NAB,603.93,0,51711.7,DR,REF864001,NAB,Business
09-08-2025 09:01,NAB785192F4DF03473AAD95,082-900-001,44444444,BIGW NAB,222.98,0,51488.72,DR,REF414045,NAB,Business
09-08-2025 09:41,NAB0AB90D609AA241EA90CA,082-900-001,44444444,KFC NAB,84.49,0,51404.23,DR,REF645348,NAB,Business
09-08-2025 10:36,NABEE618CE18FC545DC9203,082-900-001,44444444,BANK FEE NAB,1057.24,0,50346.99,DR,REF242064,NAB,Business
09-08-2025 12:15,NAB472186C88F97493EB35F,082-900-001,44444444,BWS NAB,29.94,0,50317.05,DR,REF772227,NAB,Business
09-08-2025 12:56,NABD2CB01F0DBED44F982AB,082-900-001,44444444,WAGES CREDIT NAB,0,4835.35,55152.4,CR,REF741420,NAB,Business
09-08-2025 13:04,NABF3E473D6F9834DEAA914,082-900-001,44444444,FLIXBUS NAB,475.31,0,54677.09,DR,REF791707,NAB,Business
09-08-2025 13:42,NAB786367BDCBF9482A8AA4,082-900-001,44444444,FLIXBUS NAB,786.64,0,53890.45,DR,REF193357,NAB,Business
09-08-2025 13:50,NABCE5DAF548D194D878215,082-900-001,44444444,PAYPAL *NETFLIX NAB,17.91,0,53872.54,DR,REF883334,NAB,Business
09-08-2025 14:02,NABED5E1134832C4E728ACB,082-900-001,44444444,KFC NAB,141.68,0,53730.86,DR,REF210207,NAB,Business
09-08-2025 14:11,INT1A4F2552CCD6419489CA,082-900-001,44444444,TRANSFER FROM CBA 22222222,0,909.78,54640.64,CR,INT-52062,NAB,Business
09-08-2025 14:18,NAB4F8DC76D532F41AC9CCB,082-900-001,44444444,SHELL NAB,165.85,0,54474.79,DR,REF896104,NAB,Business
09-08-2025 14:32,NABB1DA86E3CAB647738AD8,082-900-001,44444444,DOMINO'S PIZZA NAB,25.74,0,54449.05,DR,REF923927,NAB,Business
09-08-2025 14:35,NABB867E46E49254F5381B1,082-900-001,44444444,CITYLINK NAB,144.63,0,54304.42,DR,REF967897,NAB,Business
09-08-2025 15:16,NABFD10168BEFB747D2981E,082-900-001,44444444,ZOOM NAB,634.64,0,53669.78,DR,REF863458,NAB,Business
09-08-2025 15:37,NAB385B39E8BDB84F248330,082-900-001,44444444,TAFE BOOKSHOP NAB,643.92,0,53025.86,DR,REF616052,NAB,Business
09-08-2025 15:49,NAB2C3078C73761482FA845,082-900-001,44444444,BIGW NAB,249.29,0,52776.57,DR,REF684319,NAB,Business
09-08-2025 15:56,NAB11754C34225A47A59DC7,082-900-001,44444444,STARBUCKS NAB,43.69,0,52732.88,DR,REF632236,NAB,Business
09-08-2025 15:59,NABB5E7F3AC3B5A4F84A2B5,082-900-001,44444444,APPLE NAB,171.96,0,52560.92,DR,REF337374,NAB,Business
09-08-2025 16:07,NAB009DD741120B4E1ABC49,082-900-001,44444444,PAYMENT GATEWAY NAB,182.34,0,52378.58,DR,REF579629,NAB,Business
09-08-2025 17:33,NAB156D5E25E3854A09970F,082-900-001,44444444,PAYPAL *NETFLIX NAB,88.15,0,52290.43,DR,REF682476,NAB,Business
09-08-2025 17:40,NAB50583EE51D6F4F1B9CCE,082-900-001,44444444,RAILWAY STATION NAB,211.42,0,52079.01,DR,REF148324,NAB,Business
09-08-2025 18:23,INTC0FAA78C218B42E18E4F,082-900-001,44444444,TRANSFER TO ANZ 11111111,1519.94,0,50559.07,DR,INT-20661,NAB,Business
09-08-2025 18:52,NABF1D8588BC34A4089B6F8,082-900-001,44444444,PAYMENT GATEWAY NAB,125.55,0,50433.52,DR,REF489647,NAB,Business
09-08-2025 19:36,NAB843C2CD4F18740B4A16E,082-900-001,44444444,BANK FEE NAB,1108.69,0,49324.83,DR,REF716057,NAB,Business
09-08-2025 19:57,NAB0F258864FDD64C3CB79F,082-900-001,44444444,BP NAB,90.54,0,49234.29,DR,REF593890,NAB,Business
09-08-2025 20:27,NABC5FAAFD6659E46D39D60,082-900-001,44444444,COMPANY PAYROLL NAB,0,6466.18,55700.47,CR,REF516879,NAB,Business
09-08-2025 21:21,NAB813F3BBD512F4DD9B80F,082-900-001,44444444,BWS NAB,505.92,0,55194.55,DR,REF752927,NAB,Business
09-08-2025 21:24,NAB2B39D3E6F6A74758A4C2,082-900-001,44444444,UBER EATS NAB,37.41,0,55157.14,DR,REF836770,NAB,Business
09-08-2025 21:33,INT0B3BF1C3D47B446FA628,082-900-001,44444444,TRANSFER FROM CBA 22222222,0,1245.56,56402.7,CR,INT-35510,NAB,Business
09-08-2025 21:41,NAB229DB372F5894EACA7BE,082-900-001,44444444,CITYLINK NAB,121.29,0,56281.41,DR,REF877785,NAB,Business
09-08-2025 22:01,NAB2E2108C60A5748119762,082-900-001,44444444,WOOLWORTHS NAB,52.89,0,56228.52,DR,REF115229,NAB,Business
09-08-2025 22:14,NABD646B8061FCF416DA20B,082-900-001,44444444,BWS NAB,135.65,0,56092.87,DR,REF715485,NAB,Business
09-08-2025 22:14,INTCC6E3251D99E443A8F1F,082-900-001,44444444,TRANSFER FROM CBA 33333333,0,1594.98,57687.85,CR,INT-86622,NAB,Business
09-08-2025 22:24,NABDBCCACCAFA9C461384E9,082-900-001,44444444,ZOOM NAB,17.45,0,57670.4,DR,REF941176,NAB,Business
09-08-2025 22:52,NABF56BA0290F42486C8B05,082-900-001,44444444,PAYROLL CREDIT NAB,0,4268.33,61938.73,CR,REF794926,NAB,Business
09-08-2025 22:52,NABBD7455A3BC3342A98374,082-900-001,44444444,COLES NAB,79.63,0,61859.1,DR,REF940597,NAB,Business
09-08-2025 22:58,NAB65CAFFFE59E14ADC8A92,082-900-001,44444444,JB HI-FI NAB,71.71,0,61787.39,DR,REF578809,NAB,Business
09-08-2025 23:00,NAB7118F78348414FEDB6A2,082-900-001,44444444,UBER EATS NAB,137.04,0,61650.35,DR,REF192315,NAB,Business
09-08-2025 23:12,NAB2672992ECC3245B4A650,082-900-001,44444444,JB HI-FI NAB,681.25,0,60969.1,DR,REF966787,NAB,Business
09-08-2025 23:16,NABFEE5BCF50AE84AEFB3A9,082-900-001,44444444,SALARY PAYMENT NAB,0,2387.31,63356.41,CR,REF882484,NAB,Business
09-08-2025 23:36,NAB37D358C8290A4CBC9418,082-900-001,44444444,DOMINO'S PIZZA NAB,290,0,63066.41,DR,REF264309,NAB,Business
09-08-2025 23:56,NAB04053270EDA14D4989CF,082-900-001,44444444,BIGW NAB,217.98,0,62848.43,DR,REF659293,NAB,Business
10-08-2025 00:59,NAB129015735CF9454EA6FC,082-900-001,44444444,INTERNET TRANSFER NAB,643.52,0,62204.91,DR,REF549205,NAB,Business
10-08-2025 01:06,NAB8772238F76C8477090E3,082-900-001,44444444,SALARY PAYMENT NAB,0,6403.52,68608.43,CR,REF476403,NAB,Business
10-08-2025 01:39,NABF516A28BBD7F4461BB7E,082-900-001,44444444,APPLE NAB,105.43,0,68503,DR,REF473831,NAB,Business
10-08-2025 02:05,NABB9ECA06536B04FCF9E06,082-900-001,44444444,PAYPAL *NETFLIX NAB,30.15,0,68472.85,DR,REF515019,NAB,Business
10-08-2025 02:07,NAB8D6438E741DE4ABC96F6,082-900-001,44444444,ZOOM NAB,220.61,0,68252.24,DR,REF848673,NAB,Business
10-08-2025 02:10,NAB8672159E4F544370BEBA,082-900-001,44444444,7-ELEVEN NAB,91.08,0,68161.16,DR,REF105911,NAB,Business
10-08-2025 02:34,NABD563073503194E0A9BCB,082-900-001,44444444,COLES NAB,1389,0,66772.16,DR,REF672974,NAB,Business
10-08-2025 02:47,NAB92E631C2ABAA4B259465,082-900-001,44444444,LIQUORLAND NAB,80.36,0,66691.8,DR,REF430639,NAB,Business
10-08-2025 02:53,NAB23D61A0BFD9847BEBC5D,082-900-001,44444444,BIGW NAB,181.88,0,66509.92,DR,REF423724,NAB,Business
10-08-2025 03:31,NAB7DDA32BBA821430AB87F,082-900-001,44444444,ZOOM NAB,207.84,0,66302.08,DR,REF442634,NAB,Business
10-08-2025 03:41,NABF25F528C528F4D64A162,082-900-001,44444444,AMAZON AU NAB,305.14,0,65996.94,DR,REF875664,NAB,Business
10-08-2025 03:55,NAB398536EE78C34BE0A3AB,082-900-001,44444444,7-ELEVEN NAB,120.47,0,65876.47,DR,REF653000,NAB,Business
10-08-2025 04:24,NAB08C9930DF6C94C6C9C30,082-900-001,44444444,APPLE NAB,660.43,0,65216.04,DR,REF678375,NAB,Business
10-08-2025 04:38,NAB34B2414A26574FF5B391,082-900-001,44444444,APPLE NAB,281.09,0,64934.95,DR,REF505480,NAB,Business
10-08-2025 04:42,NABD5FF4284BAC24CA98276,082-900-001,44444444,PAYMENT GATEWAY NAB,52.44,0,64882.51,DR,REF180013,NAB,Business
10-08-2025 04:42,NAB0BE0FF7F1D724A7AA7B8,082-900-001,44444444,STARBUCKS NAB,470.26,0,64412.25,DR,REF620593,NAB,Business
10-08-2025 04:44,NAB0825D51C605A4BABB1ED,082-900-001,44444444,APPLE NAB,47.8,0,64364.45,DR,REF195162,NAB,Business
10-08-2025 04:50,NABE7A3E1A594A14DFBB992,082-900-001,44444444,TAFE BOOKSHOP NAB,462.27,0,63902.18,DR,REF125642,NAB,Business
10-08-2025 04:52,NAB671D6F31779E479CBCD7,082-900-001,44444444,KFC NAB,1320.69,0,62581.49,DR,REF235541,NAB,Business
10-08-2025 05:22,INT20E7CDBD2FA742539958,082-900-001,44444444,TRANSFER FROM CBA 33333333,0,942.78,63524.27,CR,INT-72919,NAB,Business
10-08-2025 06:10,NAB6135122DABE24D52BA82,082-900-001,44444444,APPLE NAB,229.25,0,63295.02,DR,REF236308,NAB,Business
10-08-2025 06:20,NABDA534E0C5E1F493E818D,082-900-001,44444444,AMAZON AU NAB,469.29,0,62825.73,DR,REF577848,NAB,Business
10-08-2025 06:29,NAB9E213A019B6847F7B3C0,082-900-001,44444444,MENULOG NAB,118.73,0,62707,DR,REF788288,NAB,Business
10-08-2025 06:42,NAB64FAFBEB8F154981AC07,082-900-001,44444444,BIGW NAB,528.42,0,62178.58,DR,REF503050,NAB,Business
10-08-2025 07:40,NAB7053A7E3E67343A6999B,082-900-001,44444444,MENULOG NAB,52,0,62126.58,DR,REF311415,NAB,Business
10-08-2025 07:43,NAB97FCF1BF07FC4C0EA801,082-900-001,44444444,APPLE NAB,366.13,0,61760.45,DR,REF319432,NAB,Business
10-08-2025 07:45,NABDB7F770360C34FE396A0,082-900-001,44444444,MENULOG NAB,440.32,0,61320.13,DR,REF771051,NAB,Business
10-08-2025 07:52,NAB7A9CA89D2D244BA58568,082-900-001,44444444,SALARY PAYMENT NAB,0,4960.16,66280.29,CR,REF897851,NAB,Business
10-08-2025 08:15,NABCA90481E227A4EA3B9D7,082-900-001,44444444,PAYMENT GATEWAY NAB,508.86,0,65771.43,DR,REF906269,NAB,Business
10-08-2025 08:54,NAB526BFFCC9A1E41AFA7B3,082-900-001,44444444,BP NAB,185.02,0,65586.41,DR,REF239593,NAB,Business
10-08-2025 09:17,INT9EC9AE8482AC428EA677,082-900-001,44444444,TRANSFER TO CBA 22222222,832.17,0,64754.24,DR,INT-43757,NAB,Business
10-08-2025 09:25,NAB833B7981634545C0AF83,082-900-001,44444444,DOMINO'S PIZZA NAB,521.98,0,64232.26,DR,REF126853,NAB,Business
10-08-2025 09:35,NABA8714394072A46FA9D40,082-900-001,44444444,SALARY PAYMENT NAB,0,5202.62,69434.88,CR,REF670348,NAB,Business
10-08-2025 09:39,NABF762F2D692294518A386,082-900-001,44444444,SALARY PAYMENT NAB,0,5000.9,74435.78,CR,REF695154,NAB,Business
10-08-2025 09:40,NAB79A623807CD54572ACB0,082-900-001,44444444,BIGW NAB,642.18,0,73793.6,DR,REF752242,NAB,Business
10-08-2025 09:49,NAB9F612C4526D5429099CF,082-900-001,44444444,SPOTIFY NAB,456.3,0,73337.3,DR,REF823957,NAB,Business
10-08-2025 09:55,NABF9E8446CC394497EAE32,082-900-001,44444444,BP NAB,276.38,0,73060.92,DR,REF814317,NAB,Business
10-08-2025 10:21,NAB0393330332284E37827D,082-900-001,44444444,STARBUCKS NAB,28.31,0,73032.61,DR,REF664962,NAB,Business
10-08-2025 10:30,NAB00CA09B069B547DDAAC3,082-900-001,44444444,SPOTIFY NAB,137.76,0,72894.85,DR,REF563977,NAB,Business
10-08-2025 10:31,NAB98B5C06B308A42578DE8,082-900-001,44444444,PAYROLL CREDIT NAB,0,7476.59,80371.44,CR,REF914149,NAB,Business
10-08-2025 11:20,NAB87CC79BBE01B40EE9A6B,082-900-001,44444444,WAGES CREDIT NAB,0,3311.15,83682.59,CR,REF887175,NAB,Business
10-08-2025 11:35,NAB90147350AB504D47B5DE,082-900-001,44444444,COMPANY PAYROLL NAB,0,250.84,83933.43,CR,REF692551,NAB,Business
10-08-2025 11:38,NAB0848205BA84B4272B1EF,082-900-001,44444444,RAILWAY STATION NAB,189.03,0,83744.4,DR,REF657104,NAB,Business
10-08-2025 11:42,NAB4E36CB4665DD47AD90E2,082-900-001,44444444,PAYMENT GATEWAY NAB,385.75,0,83358.65,DR,REF566508,NAB,Business
10-08-2025 12:37,NAB2D43ED4D3730438C924E,082-900-001,44444444,CITYLINK NAB,172.34,0,83186.31,DR,REF376522,NAB,Business
10-08-2025 13:03,NAB3E2A65BBD3EC439EB075,082-900-001,44444444,WAGES CREDIT NAB,0,7889.99,91076.3,CR,REF653220,NAB,Business
10-08-2025 13:12,NABB89B09BBBBB0492497EC,082-900-001,44444444,MENULOG NAB,583.13,0,90493.17,DR,REF496636,NAB,Business
10-08-2025 14:21,NABCB787322457B44238AAD,082-900-001,44444444,SHELL NAB,143,0,90350.17,DR,REF168064,NAB,Business
10-08-2025 14:39,NAB2B6FB23AB1F147A3875B,082-900-001,44444444,DOMINO'S PIZZA NAB,187.83,0,90162.34,DR,REF869067,NAB,Business
10-08-2025 14:46,NABBB3A801EB3A74A019D7C,082-900-001,44444444,LIQUORLAND NAB,260.66,0,89901.68,DR,REF312044,NAB,Business
10-08-2025 15:20,NAB7925D59C6E5241BA80B4,082-900-001,44444444,BANK FEE NAB,158.41,0,89743.27,DR,REF411920,NAB,Business
10-08-2025 15:23,NAB3E7CE0879ACC47B58940,082-900-001,44444444,BIGW NAB,104.93,0,89638.34,DR,REF340093,NAB,Business
10-08-2025 16:32,NAB888D5DC770FA4016A8CC,082-900-001,44444444,PAYPAL *NETFLIX NAB,344.26,0,89294.08,DR,REF800093,NAB,Business
10-08-2025 17:06,NABA0B2BE65FA8E445BBD98,082-900-001,44444444,DOMINO'S PIZZA NAB,350.27,0,88943.81,DR,REF281674,NAB,Business
10-08-2025 17:09,NAB66A43682FFE34658B863,082-900-001,44444444,JB HI-FI NAB,91.62,0,88852.19,DR,REF405774,NAB,Business
10-08-2025 18:48,NAB021FA0EB95054F6590AB,082-900-001,44444444,AMAZON AU NAB,99.86,0,88752.33,DR,REF513092,NAB,Business
10-08-2025 18:55,NAB8073631681164CA187DB,082-900-001,44444444,BANK FEE NAB,311.79,0,88440.54,DR,REF975050,NAB,Business
10-08-2025 19:14,NABB034F2E6F2DE4935BC9E,082-900-001,44444444,PAYMENT GATEWAY NAB,548.16,0,87892.38,DR,REF375360,NAB,Business
10-08-2025 19:37,NAB8AF39197EDE4476EA54E,082-900-001,44444444,PAYPAL *NETFLIX NAB,352.18,0,87540.2,DR,REF849568,NAB,Business
10-08-2025 19:56,NABB93BC369E92642399262,082-900-001,44444444,CITYLINK NAB,309.6,0,87230.6,DR,REF426427,NAB,Business
10-08-2025 20:16,NAB0760316417DE49F6B632,082-900-001,44444444,LIQUORLAND NAB,350.52,0,86880.08,DR,REF849416,NAB,Business
10-08-2025 20:21,NABA75EAC4ECB6C4D27BAA5,082-900-001,44444444,ALDI NAB,252.13,0,86627.95,DR,REF456986,NAB,Business
10-08-2025 20:48,NAB9DC93E54330C442E9ED3,082-900-001,44444444,RAILWAY STATION NAB,55.68,0,86572.27,DR,REF375866,NAB,Business
10-08-2025 21:04,NAB3F56FA7F598A4967B9A7,082-900-001,44444444,INTERNET TRANSFER NAB,160.78,0,86411.49,DR,REF356709,NAB,Business
10-08-2025 21:55,NAB6C49D202DF7F46D0B51E,082-900-001,44444444,AMAZON AU NAB,853.37,0,85558.12,DR,REF195018,NAB,Business
10-08-2025 22:05,NAB8C01F5CAC44B41AD9863,082-900-001,44444444,BP NAB,1137.86,0,84420.26,DR,REF300677,NAB,Business
10-08-2025 22:13,NABE0685A9A871848ECB036,082-900-001,44444444,COMPANY PAYROLL NAB,0,6374.47,90794.73,CR,REF905391,NAB,Business
10-08-2025 23:29,NAB7F9734799B4049A28FD7,082-900-001,44444444,PAY - SALARY NAB,0,2450.9,93245.63,CR,REF514639,NAB,Business
10-08-2025 23:44,NAB74F13147853149AEA294,082-900-001,44444444,MCDONALDS NAB,1123.23,0,92122.4,DR,REF839089,NAB,Business
10-08-2025 23:45,NABD88CD7CB773740FC9BA8,082-900-001,44444444,APPLE NAB,679.67,0,91442.73,DR,REF105374,NAB,Business
10-08-2025 23:52,NAB838FFF2F2D954F96B9BE,082-900-001,44444444,PAYMENT GATEWAY NAB,267.23,0,91175.5,DR,REF251738,NAB,Business
10-08-2025 23:53,NAB839BF1163D674540BEBA,082-900-001,44444444,COLES NAB,325.96,0,90849.54,DR,REF954700,NAB,Business
11-08-2025 00:04,NABBB2BD6CD8D08455898A9,082-900-001,44444444,SPOTIFY NAB,194.31,0,90655.23,DR,REF234211,NAB,Business
11-08-2025 00:18,NABBE516315A07743FAB2CE,082-900-001,44444444,MCDONALDS NAB,58.13,0,90597.1,DR,REF357962,NAB,Business
11-08-2025 00:48,NAB558971145386456B9B3B,082-900-001,44444444,MENULOG NAB,331.2,0,90265.9,DR,REF507005,NAB,Business
11-08-2025 01:05,NAB67EA06BC96C147DE9A89,082-900-001,44444444,SPOTIFY NAB,107.07,0,90158.83,DR,REF869748,NAB,Business
11-08-2025 01:20,NAB5A902B9C25B24658941B,082-900-001,44444444,PAYMENT GATEWAY NAB,860.25,0,89298.58,DR,REF107008,NAB,Business
11-08-2025 01:22,NABA3080594F9904947B1B0,082-900-001,44444444,JB HI-FI NAB,360.24,0,88938.34,DR,REF723420,NAB,Business
11-08-2025 01:28,NAB7ED44FE0F9D24846A4A6,082-900-001,44444444,WOOLWORTHS NAB,867.86,0,88070.48,DR,REF454274,NAB,Business
11-08-2025 01:57,NAB7945EB2F908D45089746,082-900-001,44444444,PAY - SALARY NAB,0,1128.97,89199.45,CR,REF823116,NAB,Business
11-08-2025 02:25,NABA17D816435534E378882,082-900-001,44444444,PAY - SALARY NAB,0,4472.33,93671.78,CR,REF626963,NAB,Business
11-08-2025 03:00,NABA1D73661303249E3B6ED,082-900-001,44444444,SHELL NAB,222.23,0,93449.55,DR,REF799249,NAB,Business
11-08-2025 03:56,NABB02CFFF7FB6C4A56B97B,082-900-001,44444444,UBER EATS NAB,689.61,0,92759.94,DR,REF797470,NAB,Business
11-08-2025 04:02,NAB98F78E357263466DB5DB,082-900-001,44444444,MCDONALDS NAB,734.72,0,92025.22,DR,REF597545,NAB,Business
11-08-2025 04:08,NABB4846C495DFB4141BB78,082-900-001,44444444,LIQUORLAND NAB,599.02,0,91426.2,DR,REF857496,NAB,Business
11-08-2025 04:16,NAB8F5B3F292341443B9C27,082-900-001,44444444,ALDI NAB,688.87,0,90737.33,DR,REF888174,NAB,Business
11-08-2025 04:17,NAB94F5580A94394CD0BA68,082-900-001,44444444,TAFE BOOKSHOP NAB,296.37,0,90440.96,DR,REF740539,NAB,Business
11-08-2025 04:20,NAB06EBCBF4B36948F38F71,082-900-001,44444444,SPOTIFY NAB,37.55,0,90403.41,DR,REF178647,NAB,Business
11-08-2025 04:37,INT576927B4064D422B86A7,082-900-001,44444444,TRANSFER TO ANZ 11111111,84.49,0,90318.92,DR,INT-30504,NAB,Business
11-08-2025 04:39,NAB6F335F87D481455994B6,082-900-001,44444444,STARBUCKS NAB,457.67,0,89861.25,DR,REF558634,NAB,Business
11-08-2025 04:42,NAB7347D1F24E95428A8ABD,082-900-001,44444444,AMAZON AU NAB,734.61,0,89126.64,DR,REF205854,NAB,Business
11-08-2025 05:33,NABD321F1C5FC6140DEACEF,082-900-001,44444444,MCDONALDS NAB,1500.15,0,87626.49,DR,REF694807,NAB,Business
11-08-2025 05:58,NAB37E3326747084D57A08D,082-900-001,44444444,APPLE NAB,728.57,0,86897.92,DR,REF911898,NAB,Business
11-08-2025 06:25,NABCD409964BD1243D3BDA5,082-900-001,44444444,BWS NAB,590.89,0,86307.03,DR,REF554810,NAB,Business
11-08-2025 06:29,NABC9B938396D4549D59B13,082-900-001,44444444,DOMINO'S PIZZA NAB,396.38,0,85910.65,DR,REF704566,NAB,Business
11-08-2025 06:55,NABECA5D6FDB4C8400AAD80,082-900-001,44444444,BIGW NAB,137.83,0,85772.82,DR,REF144637,NAB,Business
11-08-2025 07:27,INT2B6A60E522A0422D9793,082-900-001,44444444,TRANSFER FROM ANZ 11111111,0,1036.22,86809.04,CR,INT-41446,NAB,Business
11-08-2025 07:46,NAB9D2A6D0F9CF14B88B9C0,082-900-001,44444444,PAYPAL *NETFLIX NAB,307.87,0,86501.17,DR,REF834667,NAB,Business
11-08-2025 07:50,NABEE096445B7FA4DC9BAA0,082-900-001,44444444,HARVEY NORMAN NAB,36.85,0,86464.32,DR,REF648562,NAB,Business
11-08-2025 08:14,NAB9EA8E876AE084D5397EF,082-900-001,44444444,RAILWAY STATION NAB,44.94,0,86419.38,DR,REF528635,NAB,Business
11-08-2025 08:47,NAB4D63961CBF204C1187A4,082-900-001,44444444,7-ELEVEN NAB,116.64,0,86302.74,DR,REF757103,NAB,Business
11-08-2025 09:15,NAB67E3D8EAB8B942CD8A97,082-900-001,44444444,KFC NAB,94.1,0,86208.64,DR,REF616858,NAB,Business
11-08-2025 09:43,NAB48927E30C2B543739C71,082-900-001,44444444,BWS NAB,1297.77,0,84910.87,DR,REF287751,NAB,Business
11-08-2025 09:47,NAB3DC679C3D52B45A9B4A9,082-900-001,44444444,INTERNET TRANSFER NAB,142.47,0,84768.4,DR,REF355224,NAB,Business
11-08-2025 10:46,NABAB51EB4083AE4522BA7E,082-900-001,44444444,KFC NAB,590.67,0,84177.73,DR,REF290922,NAB,Business
11-08-2025 11:05,NABA8B2D0221DE14702B30F,082-900-001,44444444,COLES NAB,188.81,0,83988.92,DR,REF692019,NAB,Business
11-08-2025 11:13,NAB4A6BA852ECEC480D9746,082-900-001,44444444,BP NAB,135.08,0,83853.84,DR,REF357148,NAB,Business
11-08-2025 11:41,NAB7B30502EA03B46C4BA0D,082-900-001,44444444,PAYPAL *NETFLIX NAB,235.46,0,83618.38,DR,REF401913,NAB,Business
11-08-2025 11:44,NAB4F7E02094AA74E158FBE,082-900-001,44444444,BWS NAB,380.98,0,83237.4,DR,REF255340,NAB,Business
11-08-2025 12:09,NABAABBB688262246F1921E,082-900-001,44444444,MCDONALDS NAB,144.27,0,83093.13,DR,REF971045,NAB,Business
11-08-2025 12:30,NABEFAC9EBB328C4C7FA1FF,082-900-001,44444444,FLIXBUS NAB,651.72,0,82441.41,DR,REF157322,NAB,Business
11-08-2025 12:37,NAB41801D1135DE40DFA78A,082-900-001,44444444,SPOTIFY NAB,275.17,0,82166.24,DR,REF625989,NAB,Business
11-08-2025 12:54,NAB805194723F944A87A595,082-900-001,44444444,BP NAB,225.09,0,81941.15,DR,REF645454,NAB,Business
11-08-2025 13:14,NAB55570F9B06A74CBCA0DB,082-900-001,44444444,PAYROLL CREDIT NAB,0,1550.44,83491.59,CR,REF646040,NAB,Business
11-08-2025 13:38,NAB5B7342EFE30045538291,082-900-001,44444444,7-ELEVEN NAB,252.23,0,83239.36,DR,REF621096,NAB,Business
11-08-2025 13:41,INT3AFAA314E919485C84F4,082-900-001,44444444,TRANSFER TO CBA 33333333,1288.56,0,81950.8,DR,INT-97139,NAB,Business
11-08-2025 14:12,NAB6D0B6C2AC2C540CB9287,082-900-001,44444444,WAGES CREDIT NAB,0,4718.66,86669.46,CR,REF381913,NAB,Business
11-08-2025 14:39,NAB4B9A93997F704A34A2A5,082-900-001,44444444,WAGES CREDIT NAB,0,6661.24,93330.7,CR,REF162763,NAB,Business
11-08-2025 15:00,NAB3B07B3548E2542099B81,082-900-001,44444444,BIGW NAB,1243.22,0,92087.48,DR,REF184568,NAB,Business
11-08-2025 15:07,NAB45A5915A715840AEAC11,082-900-001,44444444,DOMINO'S PIZZA NAB,235.44,0,91852.04,DR,REF983321,NAB,Business
11-08-2025 15:08,NAB224414DE643B4B978DDF,082-900-001,44444444,ZOOM NAB,138.41,0,91713.63,DR,REF236430,NAB,Business
11-08-2025 16:04,INT06BEDB73384543F799A2,082-900-001,44444444,TRANSFER FROM ANZ 11111111,0,1379.07,93092.7,CR,INT-45757,NAB,Business
11-08-2025 16:28,NABC2CFF96ADA4D412AA116,082-900-001,44444444,MCDONALDS NAB,494,0,92598.7,DR,REF102145,NAB,Business
11-08-2025 17:06,NAB3FDFABBBD20D490CBA7F,082-900-001,44444444,JB HI-FI NAB,1882.13,0,90716.57,DR,REF626603,NAB,Business
11-08-2025 17:41,NAB75F7594019424B798E18,082-900-001,44444444,SPOTIFY NAB,429.57,0,90287,DR,REF523191,NAB,Business
11-08-2025 17:48,NABBB821CDAFAA8481C8931,082-900-001,44444444,APPLE NAB,127.85,0,90159.15,DR,REF804132,NAB,Business
11-08-2025 17:48,NABD6427BBA9C974714A89C,082-900-001,44444444,APPLE NAB,150.75,0,90008.4,DR,REF734213,NAB,Business
11-08-2025 17:53,NAB9629F9DC7F5A40E0A63C,082-900-001,44444444,7-ELEVEN NAB,60.51,0,89947.89,DR,REF237674,NAB,Business
11-08-2025 17:58,NAB7EE7833F780849189192,082-900-001,44444444,FLIXBUS NAB,554.26,0,89393.63,DR,REF613721,NAB,Business
11-08-2025 18:22,NAB1A98D129E19344DF9FD4,082-900-001,44444444,MCDONALDS NAB,402.73,0,88990.9,DR,REF582962,NAB,Business
11-08-2025 19:58,NAB04C7493BDDDC41C88115,082-900-001,44444444,PAYPAL *NETFLIX NAB,48.38,0,88942.52,DR,REF351057,NAB,Business
11-08-2025 20:42,NAB28E6F5E8A065479B9231,082-900-001,44444444,STARBUCKS NAB,104.06,0,88838.46,DR,REF641605,NAB,Business
11-08-2025 20:47,NABABC99213DD7D4254BF0D,082-900-001,44444444,TAFE BOOKSHOP NAB,25.27,0,88813.19,DR,REF990796,NAB,Business
11-08-2025 21:50,NABCF2F7A6AFED14BB88C0C,082-900-001,44444444,AMAZON AU NAB,329.31,0,88483.88,DR,REF999035,NAB,Business
11-08-2025 22:05,INT29E18E4EC91D4B86963A,082-900-001,44444444,TRANSFER FROM CBA 33333333,0,340.55,88824.43,CR,INT-56005,NAB,Business
11-08-2025 22:27,NAB9FA4E73AB30045BBA384,082-900-001,44444444,TAFE BOOKSHOP NAB,37.35,0,88787.08,DR,REF303604,NAB,Business
11-08-2025 22:34,NABA589BD4A705F4F90BA96,082-900-001,44444444,BIGW NAB,94.1,0,88692.98,DR,REF973492,NAB,Business
11-08-2025 22:41,NAB358C1F886CAB4F299F43,082-900-001,44444444,BWS NAB,819.24,0,87873.74,DR,REF488417,NAB,Business
11-08-2025 22:48,NAB3F7CDEA2762B463E9A5F,082-900-001,44444444,MENULOG NAB,127.72,0,87746.02,DR,REF423846,NAB,Business
11-08-2025 23:10,NABAF88FFB525AF42D1B248,082-900-001,44444444,SPOTIFY NAB,65.28,0,87680.74,DR,REF717809,NAB,Business
11-08-2025 23:23,NABD0F8A13FFBEB44E8B035,082-900-001,44444444,WOOLWORTHS NAB,50.88,0,87629.86,DR,REF891276,NAB,Business
11-08-2025 23:28,NABA90D1422422049FCB1B7,082-900-001,44444444,MCDONALDS NAB,37.45,0,87592.41,DR,REF500855,NAB,Business
11-08-2025 23:37,NAB2093C57C140A46CAAA3E,082-900-001,44444444,COMPANY PAYROLL NAB,0,5572,93164.41,CR,REF761921,NAB,Business
11-08-2025 23:38,NABB11528736C5E4F889C0B,082-900-001,44444444,BIGW NAB,117.37,0,93047.04,DR,REF759119,NAB,Business
12-08-2025 00:37,NAB30417867327E44899D4C,082-900-001,44444444,WAGES CREDIT NAB,0,532.64,93579.68,CR,REF123497,NAB,Business
12-08-2025 00:50,NABD86749AF429C4048A8A1,082-900-001,44444444,DOMINO'S PIZZA NAB,78.77,0,93500.91,DR,REF760999,NAB,Business
12-08-2025 01:00,NAB3D529228F21E4EACB749,082-900-001,44444444,INTERNET TRANSFER NAB,606.58,0,92894.33,DR,REF601387,NAB,Business
12-08-2025 01:12,NAB416C58AEE44749B39F81,082-900-001,44444444,PAYPAL *NETFLIX NAB,717.29,0,92177.04,DR,REF515548,NAB,Business
12-08-2025 01:19,NABC37FC56280F549B3BF60,082-900-001,44444444,PAYMENT GATEWAY NAB,314.37,0,91862.67,DR,REF520363,NAB,Business
12-08-2025 01:24,NAB7804B517E30941B5B581,082-900-001,44444444,FLIXBUS NAB,917.8,0,90944.87,DR,REF472287,NAB,Business
12-08-2025 01:27,NAB8952181E0076471796D9,082-900-001,44444444,MCDONALDS NAB,353.92,0,90590.95,DR,REF459770,NAB,Business
12-08-2025 02:01,NAB208F00E86B02488A8661,082-900-001,44444444,SALARY PAYMENT NAB,0,4431.12,95022.07,CR,REF553170,NAB,Business
12-08-2025 02:20,NABEDF7F2B792C84B4680BF,082-900-001,44444444,APPLE NAB,951.01,0,94071.06,DR,REF267889,NAB,Business
12-08-2025 03:25,NABA899EEAC50114234ACE1,082-900-001,44444444,RAILWAY STATION NAB,654.41,0,93416.65,DR,REF849902,NAB,Business
12-08-2025 03:28,NAB11C27BD60EB24C239ABE,082-900-001,44444444,AMAZON AU NAB,336.31,0,93080.34,DR,REF712504,NAB,Business
12-08-2025 03:53,NAB60BE86BA039C4B8C8CA0,082-900-001,44444444,HARVEY NORMAN NAB,336.41,0,92743.93,DR,REF516401,NAB,Business
12-08-2025 04:23,INTA056C108830B4389B4BD,082-900-001,44444444,TRANSFER FROM CBA 22222222,0,436.09,93180.02,CR,INT-62407,NAB,Business
12-08-2025 04:29,NABF7F2513C1E164682ACDA,082-900-001,44444444,UBER EATS NAB,127.38,0,93052.64,DR,REF690776,NAB,Business
12-08-2025 04:32,NABFFF79C0ED2FE406ABDAD,082-900-001,44444444,BWS NAB,180.67,0,92871.97,DR,REF393755,NAB,Business
12-08-2025 04:36,NAB7ACF23554870491AACF9,082-900-001,44444444,SHELL NAB,655.04,0,92216.93,DR,REF557191,NAB,Business
12-08-2025 05:21,NAB3EF395056D7C4235933B,082-900-001,44444444,HARVEY NORMAN NAB,114.99,0,92101.94,DR,REF619886,NAB,Business
12-08-2025 05:35,NABC3B8B395684F4E12915D,082-900-001,44444444,SPOTIFY NAB,283.46,0,91818.48,DR,REF977570,NAB,Business
12-08-2025 05:54,NAB48DB112E133B4406A61A,082-900-001,44444444,LIQUORLAND NAB,22.49,0,91795.99,DR,REF742810,NAB,Business
12-08-2025 06:33,NABE65F00920E864BFCA603,082-900-001,44444444,MENULOG NAB,75.56,0,91720.43,DR,REF357982,NAB,Business
12-08-2025 06:39,NABB5EB727F8A924F6BA947,082-900-001,44444444,LIQUORLAND NAB,288.22,0,91432.21,DR,REF520363,NAB,Business
12-08-2025 06:41,NAB6DD2F2536251450A948F,082-900-001,44444444,FLIXBUS NAB,81.33,0,91350.88,DR,REF758219,NAB,Business
12-08-2025 06:41,NAB607F831B74034F2F8766,082-900-001,44444444,BWS NAB,336.44,0,91014.44,DR,REF392459,NAB,Business
12-08-2025 06:43,NAB6F9B0EC9EA8740DA90DC,082-900-001,44444444,JB HI-FI NAB,99.85,0,90914.59,DR,REF671384,NAB,Business
12-08-2025 06:53,NAB019DF34C375F4E8380DA,082-900-001,44444444,RAILWAY STATION NAB,915.62,0,89998.97,DR,REF248510,NAB,Business
12-08-2025 07:28,NABD1DD1AAC877747BA9EB2,082-900-001,44444444,INTERNET TRANSFER NAB,93.07,0,89905.9,DR,REF985545,NAB,Business
12-08-2025 07:34,NAB5E59D7D3758445C1A54A,082-900-001,44444444,7-ELEVEN NAB,191.23,0,89714.67,DR,REF816873,NAB,Business
12-08-2025 07:51,NAB1273150297674467B494,082-900-001,44444444,WAGES CREDIT NAB,0,5966.51,95681.18,CR,REF469657,NAB,Business
12-08-2025 07:56,NAB5E5FED6B664A4CC9BE6C,082-900-001,44444444,WAGES CREDIT NAB,0,463.82,96145,CR,REF127998,NAB,Business
12-08-2025 07:59,NAB6F1E0E32CEF44E648DDF,082-900-001,44444444,LIQUORLAND NAB,597.12,0,95547.88,DR,REF785914,NAB,Business
12-08-2025 08:03,NAB2A9EE1C6DF3C4022A5F4,082-900-001,44444444,COMPANY PAYROLL NAB,0,5011.46,100559.34,CR,REF512878,NAB,Business
12-08-2025 08:36,NAB981AA8CDE8834D1CA1EE,082-900-001,44444444,BP NAB,93.06,0,100466.28,DR,REF594147,NAB,Business
12-08-2025 08:38,NAB4001C3A92DE2483F8CD5,082-900-001,44444444,ZOOM NAB,20.87,0,100445.41,DR,REF398316,NAB,Business
12-08-2025 08:52,NAB0DE2106FA8C54DC88A8D,082-900-001,44444444,COLES NAB,277.45,0,100167.96,DR,REF351274,NAB,Business
12-08-2025 08:56,NABF66B5793F4514C2BA433,082-900-001,44444444,CITYLINK NAB,180.21,0,99987.75,DR,REF202164,NAB,Business
12-08-2025 08:59,NAB66FCBDBD1AF745D88822,082-900-001,44444444,PAYPAL *NETFLIX NAB,339.27,0,99648.48,DR,REF497530,NAB,Business
12-08-2025 09:34,NAB55B67D42DD6D40368DAE,082-900-001,44444444,ZOOM NAB,407.24,0,99241.24,DR,REF929757,NAB,Business
12-08-2025 10:31,NAB669F946205794E03A09C,082-900-001,44444444,FLIXBUS NAB,101.41,0,99139.83,DR,REF744754,NAB,Business
12-08-2025 10:52,INT1DB96674DD044A529320,082-900-001,44444444,TRANSFER FROM CBA 33333333,0,1490.53,100630.36,CR,INT-64119,NAB,Business
12-08-2025 10:59,NABF19288E3052B4672958D,082-900-001,44444444,7-ELEVEN NAB,54.32,0,100576.04,DR,REF946174,NAB,Business
12-08-2025 11:03,NABD07CEBD01CD147B8B726,082-900-001,44444444,COLES NAB,81.92,0,100494.12,DR,REF179347,NAB,Business
12-08-2025 12:00,NABE17FB32565854CF9A33E,082-900-001,44444444,FLIXBUS NAB,237.35,0,100256.77,DR,REF586837,NAB,Business
12-08-2025 12:56,NAB0BA1E691863F4D08B73E,082-900-001,44444444,SPOTIFY NAB,52.23,0,100204.54,DR,REF901803,NAB,Business
12-08-2025 13:13,NAB00DD769E9C23445EAD4F,082-900-001,44444444,PAYPAL *NETFLIX NAB,200.25,0,100004.29,DR,REF984334,NAB,Business
12-08-2025 13:18,NAB373B068C566E4BF0967F,082-900-001,44444444,INTERNET TRANSFER NAB,60.47,0,99943.82,DR,REF319464,NAB,Business
12-08-2025 13:52,NAB92A320BC93314B70881B,082-900-001,44444444,COLES NAB,101.53,0,99842.29,DR,REF870035,NAB,Business
12-08-2025 14:11,NAB642629D79C52419BB491,082-900-001,44444444,MENULOG NAB,232.07,0,99610.22,DR,REF284282,NAB,Business
12-08-2025 14:28,NABB1AF1CB67AFC4F72945C,082-900-001,44444444,UBER EATS NAB,662.95,0,98947.27,DR,REF138620,NAB,Business
12-08-2025 14:34,NABB15BBACB614B4A108FBC,082-900-001,44444444,ALDI NAB,146.83,0,98800.44,DR,REF789029,NAB,Business
12-08-2025 14:57,NAB898CD258EA4C461BBC2E,082-900-001,44444444,ZOOM NAB,37.76,0,98762.68,DR,REF354336,NAB,Business
12-08-2025 15:34,NAB70613F6EC88F43CF9403,082-900-001,44444444,COMPANY PAYROLL NAB,0,5101.94,103864.62,CR,REF439596,NAB,Business
12-08-2025 16:39,NAB57C1B8F5B8F64FE7AC2D,082-900-001,44444444,SPOTIFY NAB,41.59,0,103823.03,DR,REF248823,NAB,Business
12-08-2025 16:47,NAB9CE307C039BA4A0CAF41,082-900-001,44444444,APPLE NAB,1224.24,0,102598.79,DR,REF372223,NAB,Business
12-08-2025 16:53,NAB6E8C7375DA5B47BE98C0,082-900-001,44444444,UBER EATS NAB,111.61,0,102487.18,DR,REF579064,NAB,Business
12-08-2025 16:55,NAB2B32F6C5A9B844D89CD5,082-900-001,44444444,PAYMENT GATEWAY NAB,191.93,0,102295.25,DR,REF260907,NAB,Business
12-08-2025 17:17,NAB821B06A01A984BF08B81,082-900-001,44444444,BP NAB,91.62,0,102203.63,DR,REF264929,NAB,Business
12-08-2025 17:20,NAB1F8C466B0BF9464A873C,082-900-001,44444444,PAYPAL *NETFLIX NAB,315.74,0,101887.89,DR,REF714176,NAB,Business
12-08-2025 17:34,NAB9900006EC6234137A71F,082-900-001,44444444,HARVEY NORMAN NAB,118.84,0,101769.05,DR,REF998423,NAB,Business
12-08-2025 18:11,NAB5F0802F9A0DB42ABA0B6,082-900-001,44444444,UBER EATS NAB,192.31,0,101576.74,DR,REF546266,NAB,Business
12-08-2025 18:46,INT1FB1D46C04C84C268D33,082-900-001,44444444,TRANSFER FROM CBA 33333333,0,90.93,101667.67,CR,INT-62430,NAB,Business
12-08-2025 18:54,NAB0A8FB5FCE49A4506A241,082-900-001,44444444,ZOOM NAB,527.31,0,101140.36,DR,REF487173,NAB,Business
12-08-2025 18:57,NAB0A354F6EF25643C5B9D6,082-900-001,44444444,PAYROLL CREDIT NAB,0,5233.61,106373.97,CR,REF676071,NAB,Business
12-08-2025 19:27,NABD87D0F5E46DF45C8ABFD,082-900-001,44444444,WAGES CREDIT NAB,0,4211.32,110585.29,CR,REF311482,NAB,Business
12-08-2025 19:29,NAB234920C67C6B4A61AEF0,082-900-001,44444444,BP NAB,197.41,0,110387.88,DR,REF101237,NAB,Business
12-08-2025 19:30,NABEC522F132814480D9E69,082-900-001,44444444,PAY - SALARY NAB,0,4717.92,115105.8,CR,REF414881,NAB,Business
12-08-2025 20:46,NAB98804E07E337477DA145,082-900-001,44444444,DOMINO'S PIZZA NAB,578.66,0,114527.14,DR,REF813830,NAB,Business
12-08-2025 20:53,NABF5E4B3BE3B514FC7B515,082-900-001,44444444,COMPANY PAYROLL NAB,0,3526.13,118053.27,CR,REF344169,NAB,Business
12-08-2025 20:56,NAB284250CD27654C46ABE3,082-900-001,44444444,BWS NAB,213.8,0,117839.47,DR,REF594364,NAB,Business
12-08-2025 21:13,NAB7D4A903C0BA24B4C8FB1,082-900-001,44444444,PAYROLL CREDIT NAB,0,6803.85,124643.32,CR,REF226363,NAB,Business
12-08-2025 21:27,NAB215A7F85EC984E6B8561,082-900-001,44444444,UBER EATS NAB,441.12,0,124202.2,DR,REF298615,NAB,Business
12-08-2025 21:34,NAB8C7E78D9F0684FEBA509,082-900-001,44444444,CITYLINK NAB,163.74,0,124038.46,DR,REF769881,NAB,Business
12-08-2025 21:37,NABA6168FF2654C44A49C3D,082-900-001,44444444,PAYMENT GATEWAY NAB,72.29,0,123966.17,DR,REF350857,NAB,Business
12-08-2025 21:52,NAB24BE89A8D72B4E9CA7F8,082-900-001,44444444,MCDONALDS NAB,100.67,0,123865.5,DR,REF704735,NAB,Business
12-08-2025 22:06,NAB7F74CB97C2474278B002,082-900-001,44444444,FLIXBUS NAB,196.13,0,123669.37,DR,REF651670,NAB,Business
12-08-2025 22:34,NABCEF68101B45C4858A88E,082-900-001,44444444,UBER EATS NAB,400.89,0,123268.48,DR,REF215747,NAB,Business
12-08-2025 22:41,NAB063F12D90A6742FFA961,082-900-001,44444444,STARBUCKS NAB,508.72,0,122759.76,DR,REF886781,NAB,Business
12-08-2025 23:01,NAB56AC20BE2AC54AD0938C,082-900-001,44444444,FLIXBUS NAB,41.19,0,122718.57,DR,REF966823,NAB,Business
12-08-2025 23:33,NABFB95F3B0AD53472BB7C3,082-900-001,44444444,TAFE BOOKSHOP NAB,301.2,0,122417.37,DR,REF187099,NAB,Business
12-08-2025 23:56,NABCF18D389F99D4AF2BF20,082-900-001,44444444,PAYROLL CREDIT NAB,0,2745.35,125162.72,CR,REF949045,NAB,Business
13-08-2025 00:01,NAB147494511C344567A714,082-900-001,44444444,FLIXBUS NAB,214.75,0,124947.97,DR,REF211970,NAB,Business
13-08-2025 00:30,NAB86B0825FB8E440809822,082-900-001,44444444,SHELL NAB,195.17,0,124752.8,DR,REF680564,NAB,Business
13-08-2025 01:00,NAB014E10531046466EA811,082-900-001,44444444,COMPANY PAYROLL NAB,0,3279.55,128032.35,CR,REF893305,NAB,Business
13-08-2025 01:15,NABDE0B186ABAC640CA9304,082-900-001,44444444,APPLE NAB,76,0,127956.35,DR,REF279719,NAB,Business
13-08-2025 02:12,NAB8FC5A1CB43874E2095D6,082-900-001,44444444,PAY - SALARY NAB,0,5999.67,133956.02,CR,REF296890,NAB,Business
13-08-2025 02:15,NAB325F51ACFD674D49B62C,082-900-001,44444444,BIGW NAB,180.21,0,133775.81,DR,REF527133,NAB,Business
13-08-2025 02:25,NAB1A3FB2A0E9DA4820B6B6,082-900-001,44444444,BANK FEE NAB,61.18,0,133714.63,DR,REF926941,NAB,Business
13-08-2025 02:42,NAB0D836F1A05924C3892A7,082-900-001,44444444,UBER EATS NAB,137.64,0,133576.99,DR,REF199297,NAB,Business
13-08-2025 03:16,INTD8ED824A406345DCAF22,082-900-001,44444444,TRANSFER TO CBA 33333333,1867.18,0,131709.81,DR,INT-11893,NAB,Business
13-08-2025 03:35,NAB3339C3EFCCF649ACAD56,082-900-001,44444444,HARVEY NORMAN NAB,334.41,0,131375.4,DR,REF115730,NAB,Business
13-08-2025 04:14,NABAEA818DCA1434392B7AE,082-900-001,44444444,PAYMENT GATEWAY NAB,660.55,0,130714.85,DR,REF792850,NAB,Business
13-08-2025 04:30,NAB811CC84401F748C986C3,082-900-001,44444444,PAYROLL CREDIT NAB,0,4492.79,135207.64,CR,REF133681,NAB,Business
13-08-2025 04:49,NABAAF825E8836A4ABB8B77,082-900-001,44444444,KFC NAB,471,0,134736.64,DR,REF961499,NAB,Business
13-08-2025 05:04,NAB497A9C8C71024A538E09,082-900-001,44444444,TAFE BOOKSHOP NAB,95.51,0,134641.13,DR,REF643531,NAB,Business
13-08-2025 05:11,NABA03115121ACF4F43B9E6,082-900-001,44444444,PAYROLL CREDIT NAB,0,6647,141288.13,CR,REF847578,NAB,Business
13-08-2025 05:31,NABC07B631A3199423A8175,082-900-001,44444444,BIGW NAB,214.75,0,141073.38,DR,REF593566,NAB,Business
13-08-2025 05:59,NABD38CFB8B43A540B09166,082-900-001,44444444,APPLE NAB,38.14,0,141035.24,DR,REF893980,NAB,Business
13-08-2025 06:29,NAB2FCF2C90AB6B4AD887CA,082-900-001,44444444,SALARY PAYMENT NAB,0,724.47,141759.71,CR,REF888923,NAB,Business
13-08-2025 06:48,NAB50075053A9654607ABDA,082-900-001,44444444,JB HI-FI NAB,2081.56,0,139678.15,DR,REF983541,NAB,Business
13-08-2025 07:12,NAB30FBF13548BD4BB9A36B,082-900-001,44444444,ALDI NAB,57.36,0,139620.79,DR,REF485228,NAB,Business
13-08-2025 07:19,NABE387C10CF7B34FB5A97A,082-900-001,44444444,JB HI-FI NAB,232.85,0,139387.94,DR,REF539723,NAB,Business
13-08-2025 07:47,NABD1DA0837CEA64506A203,082-900-001,44444444,PAYMENT GATEWAY NAB,336.12,0,139051.82,DR,REF823332,NAB,Business
13-08-2025 08:08,NAB391554C0A2E64D01BCA3,082-900-001,44444444,PAY - SALARY NAB,0,2739.49,141791.31,CR,REF995106,NAB,Business
13-08-2025 08:10,NABBF7B1BCD99944E1596A2,082-900-001,44444444,MCDONALDS NAB,906.24,0,140885.07,DR,REF805531,NAB,Business
13-08-2025 08:11,NABCB50A32A9977407ABADB,082-900-001,44444444,WAGES CREDIT NAB,0,756.55,141641.62,CR,REF679278,NAB,Business
13-08-2025 08:15,NAB2259F2763E4C4FB1904E,082-900-001,44444444,DOMINO'S PIZZA NAB,1091.96,0,140549.66,DR,REF115326,NAB,Business
13-08-2025 08:15,NAB61A643E8BE7E44CDA02F,082-900-001,44444444,WAGES CREDIT NAB,0,5328.29,145877.95,CR,REF285844,NAB,Business
13-08-2025 08:36,NABBA60C107E1CE4FCE8AB3,082-900-001,44444444,BIGW NAB,1134.08,0,144743.87,DR,REF320115,NAB,Business
13-08-2025 08:39,NAB29A1EF067A8A452286B2,082-900-001,44444444,ALDI NAB,40.45,0,144703.42,DR,REF287378,NAB,Business
13-08-2025 09:06,NABFF9729CF270C46BD96B2,082-900-001,44444444,ZOOM NAB,1117.1,0,143586.32,DR,REF275260,NAB,Business
13-08-2025 09:28,NABC25B6B2D40FB4B4085CD,082-900-001,44444444,LIQUORLAND NAB,95.44,0,143490.88,DR,REF859285,NAB,Business
13-08-2025 10:17,NAB455CAFA789CF4755BCC2,082-900-001,44444444,KFC NAB,974.1,0,142516.78,DR,REF959032,NAB,Business
13-08-2025 10:39,NAB130210977727435DBF68,082-900-001,44444444,PAYPAL *NETFLIX NAB,676.25,0,141840.53,DR,REF546800,NAB,Business
13-08-2025 10:59,NABF2909E9410CC46E28FA3,082-900-001,44444444,SHELL NAB,541.47,0,141299.06,DR,REF794442,NAB,Business
13-08-2025 11:23,NABF62F33289B414FD0B250,082-900-001,44444444,BWS NAB,256.79,0,141042.27,DR,REF325266,NAB,Business
13-08-2025 12:03,NAB5C5D0403964C43EF84C2,082-900-001,44444444,7-ELEVEN NAB,43.92,0,140998.35,DR,REF181080,NAB,Business
13-08-2025 12:26,NAB3540C6DC396F4B3F8A25,082-900-001,44444444,STARBUCKS NAB,79.3,0,140919.05,DR,REF500652,NAB,Business
13-08-2025 12:45,NAB3FF360BC12A34EDF8331,082-900-001,44444444,WOOLWORTHS NAB,247.41,0,140671.64,DR,REF806833,NAB,Business
13-08-2025 12:55,NABEBDD06B0BD3C4C15A436,082-900-001,44444444,COLES NAB,86.42,0,140585.22,DR,REF158500,NAB,Business
13-08-2025 12:57,NABD22B0713BEFE4FE5AE59,082-900-001,44444444,PAYPAL *NETFLIX NAB,200.42,0,140384.8,DR,REF511691,NAB,Business
13-08-2025 13:03,NABEF86BEF54B30406C9E93,082-900-001,44444444,LIQUORLAND NAB,33.34,0,140351.46,DR,REF480080,NAB,Business
13-08-2025 13:10,NAB07E2C696918F46BABDDE,082-900-001,44444444,COLES NAB,76.75,0,140274.71,DR,REF122306,NAB,Business
13-08-2025 14:03,NAB603586444BBB42B8B380,082-900-001,44444444,COMPANY PAYROLL NAB,0,3640.49,143915.2,CR,REF701464,NAB,Business
13-08-2025 14:24,NABD5332588809F4A49A9BA,082-900-001,44444444,STARBUCKS NAB,915.34,0,142999.86,DR,REF609699,NAB,Business
13-08-2025 14:33,NAB53F08598491D4F25ABF2,082-900-001,44444444,COLES NAB,262.17,0,142737.69,DR,REF794686,NAB,Business
13-08-2025 15:05,NAB1AF95085D71541DAAD95,082-900-001,44444444,MENULOG NAB,64.86,0,142672.83,DR,REF665696,NAB,Business
13-08-2025 15:23,NABE2253E459418491E8796,082-900-001,44444444,COLES NAB,403.58,0,142269.25,DR,REF549496,NAB,Business
13-08-2025 15:25,NAB65E54A20CC0944C39089,082-900-001,44444444,INTERNET TRANSFER NAB,361.85,0,141907.4,DR,REF897328,NAB,Business
13-08-2025 15:34,NAB309EC9F1843A41A99D99,082-900-001,44444444,BP NAB,240.15,0,141667.25,DR,REF813186,NAB,Business
13-08-2025 16:01,NABA9706E27B8164BF18A7A,082-900-001,44444444,SPOTIFY NAB,543.92,0,141123.33,DR,REF521363,NAB,Business
13-08-2025 16:02,NABD29BF99B2B7E40188665,082-900-001,44444444,FLIXBUS NAB,953.34,0,140169.99,DR,REF665810,NAB,Business
13-08-2025 16:09,NAB83F752C394734AFCAD7D,082-900-001,44444444,SPOTIFY NAB,56.89,0,140113.1,DR,REF459414,NAB,Business
13-08-2025 16:45,NAB8379EFB3FC08491CB784,082-900-001,44444444,SALARY PAYMENT NAB,0,5071.05,145184.15,CR,REF949453,NAB,Business
13-08-2025 17:10,INT7ADE9477ACEA423ABD26,082-900-001,44444444,TRANSFER FROM CBA 33333333,0,89.6,145273.75,CR,INT-95175,NAB,Business
13-08-2025 17:18,INT62B147F5F2E44A7C962C,082-900-001,44444444,TRANSFER TO ANZ 11111111,1081.66,0,144192.09,DR,INT-72601,NAB,Business
13-08-2025 17:23,INTEDB4721D9A26470A8070,082-900-001,44444444,TRANSFER TO ANZ 11111111,1911.04,0,142281.05,DR,INT-32163,NAB,Business
13-08-2025 17:26,NABF8D5CDE1C42F49F0811C,082-900-001,44444444,ALDI NAB,308.82,0,141972.23,DR,REF560792,NAB,Business
13-08-2025 17:27,NAB05A229C269DF4EBD8193,082-900-001,44444444,7-ELEVEN NAB,128.08,0,141844.15,DR,REF825250,NAB,Business
13-08-2025 17:30,NABBBDBD6466D1D4F12AC89,082-900-001,44444444,UBER EATS NAB,159.35,0,141684.8,DR,REF206111,NAB,Business
13-08-2025 17:44,NAB5F6F8D9904C34E1AA4FF,082-900-001,44444444,STARBUCKS NAB,158.88,0,141525.92,DR,REF335336,NAB,Business
13-08-2025 17:45,NAB7B0387AF41F04E17B207,082-900-001,44444444,WOOLWORTHS NAB,492.78,0,141033.14,DR,REF824254,NAB,Business
13-08-2025 17:50,NABDC179C243BA043AABCD1,082-900-001,44444444,RAILWAY STATION NAB,374.5,0,140658.64,DR,REF277332,NAB,Business
13-08-2025 17:51,NABD010DE36C5964580809B,082-900-001,44444444,ALDI NAB,305.15,0,140353.49,DR,REF867292,NAB,Business
13-08-2025 18:21,NAB5B40292CDEA342A5A93C,082-900-001,44444444,PAYPAL *NETFLIX NAB,156.4,0,140197.09,DR,REF105639,NAB,Business
13-08-2025 18:42,NAB9BCC475E7FC549F6A561,082-900-001,44444444,ZOOM NAB,667.1,0,139529.99,DR,REF652673,NAB,Business
13-08-2025 19:02,NABC139319D1275483BA520,082-900-001,44444444,SPOTIFY NAB,270.64,0,139259.35,DR,REF506479,NAB,Business
13-08-2025 19:18,NAB83CF0E18D8E648EA9C2E,082-900-001,44444444,JB HI-FI NAB,1154.02,0,138105.33,DR,REF144909,NAB,Business
13-08-2025 19:30,NAB7D985FB721C24B6F8E7C,082-900-001,44444444,BP NAB,104.73,0,138000.6,DR,REF631420,NAB,Business
13-08-2025 19:32,INT87C7EA46FA0D4E5ABB0B,082-900-001,44444444,TRANSFER FROM CBA 22222222,0,1808.58,139809.18,CR,INT-18026,NAB,Business
13-08-2025 19:40,NAB1697B062BA604550AEA4,082-900-001,44444444,7-ELEVEN NAB,57.93,0,139751.25,DR,REF640975,NAB,Business
13-08-2025 19:57,NAB1551C42E5E2B448D8116,082-900-001,44444444,BIGW NAB,304.6,0,139446.65,DR,REF473840,NAB,Business
13-08-2025 20:15,NABC0FF7880229747D58C12,082-900-001,44444444,ZOOM NAB,266.46,0,139180.19,DR,REF839109,NAB,Business
13-08-2025 20:56,NAB230CE8C765044477BD50,082-900-001,44444444,PAYPAL *NETFLIX NAB,297.51,0,138882.68,DR,REF918336,NAB,Business
13-08-2025 20:58,NABCE432B71E2604CB1A877,082-900-001,44444444,BIGW NAB,64.74,0,138817.94,DR,REF959596,NAB,Business
13-08-2025 21:10,NABBAFA99A68F9449569F74,082-900-001,44444444,UBER EATS NAB,198.66,0,138619.28,DR,REF256199,NAB,Business
13-08-2025 22:23,NAB830ECEEFC1484948ABD5,082-900-001,44444444,PAYMENT GATEWAY NAB,57.11,0,138562.17,DR,REF519958,NAB,Business
13-08-2025 22:28,NAB61CACA33B6BB4AD6B4CD,082-900-001,44444444,AMAZON AU NAB,190.68,0,138371.49,DR,REF626877,NAB,Business
13-08-2025 22:40,NAB33ADF582B98C405EB0B7,082-900-001,44444444,TAFE BOOKSHOP NAB,796.21,0,137575.28,DR,REF405764,NAB,Business
13-08-2025 23:05,NAB0F0CBEFD667F4127BFED,082-900-001,44444444,AMAZON AU NAB,52.72,0,137522.56,DR,REF301485,NAB,Business
13-08-2025 23:29,NABE7625A5EA45041DB83CB,082-900-001,44444444,BWS NAB,274.19,0,137248.37,DR,REF383451,NAB,Business
13-08-2025 23:42,NAB24508CF9A92A470E8A58,082-900-001,44444444,COLES NAB,287.86,0,136960.51,DR,REF587556,NAB,Business
13-08-2025 23:50,NAB8E21F78E56AE459BA7E9,082-900-001,44444444,HARVEY NORMAN NAB,64.4,0,136896.11,DR,REF262830,NAB,Business
14-08-2025 00:18,NABB26F86B1E4CB4E6CBCA1,082-900-001,44444444,FLIXBUS NAB,276.19,0,136619.92,DR,REF599105,NAB,Business
14-08-2025 00:27,NAB0E409D6359614E13A645,082-900-001,44444444,DOMINO'S PIZZA NAB,131.11,0,136488.81,DR,REF847332,NAB,Business
14-08-2025 00:35,NAB2487636C0B1E462CA650,082-900-001,44444444,UBER EATS NAB,271.41,0,136217.4,DR,REF629814,NAB,Business
14-08-2025 00:50,NABBAC75B1B3DFB482D894C,082-900-001,44444444,CITYLINK NAB,24.17,0,136193.23,DR,REF683053,NAB,Business
14-08-2025 01:24,NAB9CCF8682F6C0446FA324,082-900-001,44444444,CITYLINK NAB,1006.41,0,135186.82,DR,REF199612,NAB,Business
14-08-2025 01:51,NAB993C7A8B1EDD4FA6B543,082-900-001,44444444,BWS NAB,369.25,0,134817.57,DR,REF414187,NAB,Business
14-08-2025 02:13,NAB95B0F19FE3AD41E0B56B,082-900-001,44444444,BWS NAB,125.63,0,134691.94,DR,REF888223,NAB,Business
14-08-2025 02:31,NAB488B910FD1624B1F94C6,082-900-001,44444444,MCDONALDS NAB,54.63,0,134637.31,DR,REF248901,NAB,Business
14-08-2025 02:31,NAB0CB6DC25372A432EAFA2,082-900-001,44444444,BIGW NAB,101.7,0,134535.61,DR,REF307675,NAB,Business
14-08-2025 02:32,NAB3901B6D41D4D47C28A64,082-900-001,44444444,RAILWAY STATION NAB,399.71,0,134135.9,DR,REF405936,NAB,Business
14-08-2025 03:19,NABA47FC1EFC5094BD2A379,082-900-001,44444444,FLIXBUS NAB,297.61,0,133838.29,DR,REF754017,NAB,Business
14-08-2025 03:26,NABA8550EF4D4F24832B5E2,082-900-001,44444444,COLES NAB,152.45,0,133685.84,DR,REF150474,NAB,Business
14-08-2025 03:28,INTD28E634F33FC421A9AF9,082-900-001,44444444,TRANSFER FROM ANZ 11111111,0,360.79,134046.63,CR,INT-49217,NAB,Business
14-08-2025 03:39,NAB94D867A6FE314B5EA1C7,082-900-001,44444444,BWS NAB,160.85,0,133885.78,DR,REF653201,NAB,Business
14-08-2025 03:58,NAB9B814EE881984267B55D,082-900-001,44444444,RAILWAY STATION NAB,245.2,0,133640.58,DR,REF143161,NAB,Business
14-08-2025 04:16,NABBEFE5FB9572A4223A331,082-900-001,44444444,PAYROLL CREDIT NAB,0,6595.71,140236.29,CR,REF999679,NAB,Business
14-08-2025 04:20,NAB205F1737851246F99270,082-900-001,44444444,UBER EATS NAB,333.41,0,139902.88,DR,REF805203,NAB,Business
14-08-2025 04:38,NABACF9EA6575A046058AFA,082-900-001,44444444,PAYROLL CREDIT NAB,0,1857.58,141760.46,CR,REF600119,NAB,Business
14-08-2025 04:42,NAB7F98128792E64E60BC7F,082-900-001,44444444,SHELL NAB,228.33,0,141532.13,DR,REF569167,NAB,Business
14-08-2025 05:23,NABB543A1639CEC4E719C52,082-900-001,44444444,HARVEY NORMAN NAB,219.58,0,141312.55,DR,REF176017,NAB,Business
14-08-2025 05:38,NABD289F6DB4B524F9FAD24,082-900-001,44444444,7-ELEVEN NAB,198.37,0,141114.18,DR,REF386818,NAB,Business
14-08-2025 05:43,NABC69DDD9E18FB4336864A,082-900-001,44444444,LIQUORLAND NAB,250.31,0,140863.87,DR,REF844581,NAB,Business
14-08-2025 05:47,NAB3311F4AA97924CF1BAA6,082-900-001,44444444,COMPANY PAYROLL NAB,0,1056.97,141920.84,CR,REF516036,NAB,Business
14-08-2025 06:05,NAB15BB55EAD2814DCFA809,082-900-001,44444444,WOOLWORTHS NAB,81.84,0,141839,DR,REF440399,NAB,Business
14-08-2025 06:10,NAB39F2F5295476438390F2,082-900-001,44444444,DOMINO'S PIZZA NAB,277.86,0,141561.14,DR,REF396952,NAB,Business
14-08-2025 06:24,NABE23C50229C2D43BC8383,082-900-001,44444444,SPOTIFY NAB,216.21,0,141344.93,DR,REF778219,NAB,Business
14-08-2025 07:04,NAB9D389D7E4A4D43D19556,082-900-001,44444444,CITYLINK NAB,211.53,0,141133.4,DR,REF603891,NAB,Business
14-08-2025 07:12,NAB07715F1D23E94E83B891,082-900-001,44444444,HARVEY NORMAN NAB,259.02,0,140874.38,DR,REF932521,NAB,Business
14-08-2025 07:14,NAB7DBF6F3D1D464B0DB1CD,082-900-001,44444444,COLES NAB,120.35,0,140754.03,DR,REF452013,NAB,Business
14-08-2025 08:03,NAB67093E0644494D75A0C2,082-900-001,44444444,SHELL NAB,113.49,0,140640.54,DR,REF997422,NAB,Business
14-08-2025 08:13,NABA5F3C1AEA4EE4212A513,082-900-001,44444444,INTERNET TRANSFER NAB,350.52,0,140290.02,DR,REF683890,NAB,Business
14-08-2025 08:35,NAB3FD8C8AAE3FB4D83A33F,082-900-001,44444444,COLES NAB,444.4,0,139845.62,DR,REF345294,NAB,Business
14-08-2025 09:24,NABAF8427410AC14D74A80D,082-900-001,44444444,ALDI NAB,155.13,0,139690.49,DR,REF251926,NAB,Business
14-08-2025 09:29,NABC325F841BBC04F6392E9,082-900-001,44444444,SPOTIFY NAB,56.51,0,139633.98,DR,REF693924,NAB,Business
14-08-2025 09:32,NABEE1A59702F2443CA8332,082-900-001,44444444,STARBUCKS NAB,701.44,0,138932.54,DR,REF794319,NAB,Business
14-08-2025 10:11,NAB8905BA1F7B8A431EB80E,082-900-001,44444444,STARBUCKS NAB,474.62,0,138457.92,DR,REF976182,NAB,Business
14-08-2025 10:20,NAB7DC6E1C48D964FE1853C,082-900-001,44444444,AMAZON AU NAB,822.35,0,137635.57,DR,REF870981,NAB,Business
14-08-2025 10:26,NAB881012A4A8794BC08665,082-900-001,44444444,BP NAB,723.92,0,136911.65,DR,REF597876,NAB,Business
14-08-2025 10:56,NAB1DE0F966360847D499CE,082-900-001,44444444,MENULOG NAB,59.34,0,136852.31,DR,REF212677,NAB,Business
14-08-2025 10:58,NABE290B79AF3094A058DCB,082-900-001,44444444,AMAZON AU NAB,128.65,0,136723.66,DR,REF101994,NAB,Business
14-08-2025 11:00,NAB644AB779541D4F199191,082-900-001,44444444,STARBUCKS NAB,210.14,0,136513.52,DR,REF696088,NAB,Business
14-08-2025 11:20,NAB7A76E3226D3E463DA0F5,082-900-001,44444444,DOMINO'S PIZZA NAB,666.09,0,135847.43,DR,REF240096,NAB,Business
14-08-2025 11:24,NAB454B822332264098890E,082-900-001,44444444,KFC NAB,152.22,0,135695.21,DR,REF301594,NAB,Business
14-08-2025 11:38,NAB373F770FB8AA4D7E96D7,082-900-001,44444444,COLES NAB,180.76,0,135514.45,DR,REF884282,NAB,Business
14-08-2025 12:11,NABD00A8889A997485D9EB0,082-900-001,44444444,APPLE NAB,67.96,0,135446.49,DR,REF630732,NAB,Business
14-08-2025 12:18,NAB8B00D42763054CEDAD7E,082-900-001,44444444,TAFE BOOKSHOP NAB,550.88,0,134895.61,DR,REF720465,NAB,Business
14-08-2025 12:37,NAB8D9E706E1E4F40499CC7,082-900-001,44444444,PAY - SALARY NAB,0,151.16,135046.77,CR,REF768796,NAB,Business
14-08-2025 12:54,NAB0B09027447C14F8FBCBA,082-900-001,44444444,PAYPAL *NETFLIX NAB,155.9,0,134890.87,DR,REF540646,NAB,Business
14-08-2025 13:11,NABADC220723380426DA849,082-900-001,44444444,FLIXBUS NAB,85.82,0,134805.05,DR,REF265893,NAB,Business
14-08-2025 13:22,NAB3E053CB700A34A5083E5,082-900-001,44444444,STARBUCKS NAB,196.37,0,134608.68,DR,REF775598,NAB,Business
14-08-2025 13:49,NAB0ADBC0D8ED134D93AC4B,082-900-001,44444444,PAYROLL CREDIT NAB,0,2690.07,137298.75,CR,REF685931,NAB,Business
14-08-2025 14:03,NAB350FA2B90E3249AD99D5,082-900-001,44444444,STARBUCKS NAB,186.35,0,137112.4,DR,REF104952,NAB,Business
14-08-2025 14:31,NAB0535B86497D34EE0887C,082-900-001,44444444,PAY - SALARY NAB,0,7841.47,144953.87,CR,REF129079,NAB,Business
14-08-2025 15:09,NAB414C0662837D481F9190,082-900-001,44444444,DOMINO'S PIZZA NAB,449.71,0,144504.16,DR,REF167255,NAB,Business
14-08-2025 15:17,NABCA5A04381C3446B1AFB9,082-900-001,44444444,TAFE BOOKSHOP NAB,582.23,0,143921.93,DR,REF186440,NAB,Business
14-08-2025 16:26,NABB51B2EC68843445E8585,082-900-001,44444444,PAYMENT GATEWAY NAB,365.5,0,143556.43,DR,REF538669,NAB,Business
14-08-2025 16:44,NAB1DEE26DB8FED440C8F6B,082-900-001,44444444,HARVEY NORMAN NAB,333.37,0,143223.06,DR,REF109237,NAB,Business
14-08-2025 17:05,NABB8A7B435610948A58105,082-900-001,44444444,COMPANY PAYROLL NAB,0,79.2,143302.26,CR,REF513604,NAB,Business
14-08-2025 17:38,NABE4048A1208284414BEED,082-900-001,44444444,7-ELEVEN NAB,119.66,0,143182.6,DR,REF189806,NAB,Business
14-08-2025 19:09,NAB4602BF6BFA8943B7B96E,082-900-001,44444444,FLIXBUS NAB,114.22,0,143068.38,DR,REF602117,NAB,Business
14-08-2025 19:23,NAB833E8225BB8A44FBBED3,082-900-001,44444444,BWS NAB,124.91,0,142943.47,DR,REF651514,NAB,Business
14-08-2025 20:18,NAB12F23FEC437E441789CE,082-900-001,44444444,KFC NAB,101.64,0,142841.83,DR,REF238767,NAB,Business
14-08-2025 21:43,NAB1119B36B85664063A4BB,082-900-001,44444444,SALARY PAYMENT NAB,0,3219.25,146061.08,CR,REF884588,NAB,Business
14-08-2025 21:52,NAB9A63F312CC5341379E32,082-900-001,44444444,DOMINO'S PIZZA NAB,69.74,0,145991.34,DR,REF974199,NAB,Business
14-08-2025 22:32,NAB0B28ECE4C985448A82A9,082-900-001,44444444,BANK FEE NAB,155.18,0,145836.16,DR,REF383536,NAB,Business
14-08-2025 22:53,NAB1D7E90B94ADA49749B1E,082-900-001,44444444,LIQUORLAND NAB,99.02,0,145737.14,DR,REF713475,NAB,Business
15-08-2025 00:05,NABD26EE70F4ED743AFB210,082-900-001,44444444,PAY - SALARY NAB,0,7890.42,153627.56,CR,REF865547,NAB,Business
15-08-2025 00:17,NABF6E21C3045664FF3BEF0,082-900-001,44444444,SHELL NAB,250.22,0,153377.34,DR,REF433013,NAB,Business
15-08-2025 00:34,NAB33B45977E4684B59BD8D,082-900-001,44444444,TAFE BOOKSHOP NAB,61.39,0,153315.95,DR,REF586547,NAB,Business
15-08-2025 01:09,NAB532BF8A58AD249D09762,082-900-001,44444444,BIGW NAB,420.01,0,152895.94,DR,REF254394,NAB,Business
15-08-2025 01:40,NABC9B988108CD24FBA8D8B,082-900-001,44444444,FLIXBUS NAB,861.35,0,152034.59,DR,REF685182,NAB,Business
15-08-2025 01:46,NAB9F325512426143FFB295,082-900-001,44444444,FLIXBUS NAB,212.48,0,151822.11,DR,REF866063,NAB,Business
15-08-2025 02:04,NABC88E70550B074892A5C8,082-900-001,44444444,INTERNET TRANSFER NAB,665.64,0,151156.47,DR,REF605606,NAB,Business
15-08-2025 02:23,NAB535C768715BF418D87BE,082-900-001,44444444,STARBUCKS NAB,79.97,0,151076.5,DR,REF329969,NAB,Business
15-08-2025 02:30,NAB8A0BDA9E3A4644F1BCC2,082-900-001,44444444,PAYPAL *NETFLIX NAB,78.2,0,150998.3,DR,REF980564,NAB,Business
15-08-2025 02:48,NAB83AACC506C14474FBF2A,082-900-001,44444444,JB HI-FI NAB,107.59,0,150890.71,DR,REF102538,NAB,Business
15-08-2025 02:49,NAB2541F7900C684D58A7B3,082-900-001,44444444,TAFE BOOKSHOP NAB,345.73,0,150544.98,DR,REF808303,NAB,Business
15-08-2025 03:20,NAB403D82D594084CCFAED7,082-900-001,44444444,BIGW NAB,297.28,0,150247.7,DR,REF874570,NAB,Business
15-08-2025 03:26,NABC6CB4108A52F4063BDFB,082-900-001,44444444,BIGW NAB,331.95,0,149915.75,DR,REF105309,NAB,Business
15-08-2025 03:35,NAB50A82469E1704397AECC,082-900-001,44444444,PAYROLL CREDIT NAB,0,838.63,150754.38,CR,REF768321,NAB,Business
15-08-2025 03:59,NABA359972393674BFF8982,082-900-001,44444444,AMAZON AU NAB,83.39,0,150670.99,DR,REF756924,NAB,Business
15-08-2025 04:18,NABDA85B6CEA8904350A643,082-900-001,44444444,TAFE BOOKSHOP NAB,43.78,0,150627.21,DR,REF500472,NAB,Business
15-08-2025 05:46,NAB36E4F64CC0E549E19DAC,082-900-001,44444444,CITYLINK NAB,437.74,0,150189.47,DR,REF764310,NAB,Business
15-08-2025 05:56,NAB05642AB260BA4BD3BF97,082-900-001,44444444,BANK FEE NAB,54.85,0,150134.62,DR,REF339542,NAB,Business
15-08-2025 06:07,NAB1923BF3F3C2A417AAB6C,082-900-001,44444444,APPLE NAB,95.56,0,150039.06,DR,REF956505,NAB,Business
15-08-2025 06:56,NAB8B84A787B9D14CD4A15D,082-900-001,44444444,MENULOG NAB,125.8,0,149913.26,DR,REF891127,NAB,Business
15-08-2025 08:10,NABE7B8FC6470CA4FE89A12,082-900-001,44444444,COLES NAB,852.94,0,149060.32,DR,REF948347,NAB,Business
15-08-2025 09:22,NAB149DD9500DC44F939606,082-900-001,44444444,CITYLINK NAB,549.98,0,148510.34,DR,REF695935,NAB,Business
15-08-2025 09:29,NAB837410A38D0A47E6A077,082-900-001,44444444,PAYROLL CREDIT NAB,0,7746.57,156256.91,CR,REF376557,NAB,Business
15-08-2025 09:31,NAB07DA36CAA6AF48649539,082-900-001,44444444,AMAZON AU NAB,475.73,0,155781.18,DR,REF816176,NAB,Business
15-08-2025 10:12,NABC6D2A7609A3C4F6CAE7C,082-900-001,44444444,PAYROLL CREDIT NAB,0,3865.69,159646.87,CR,REF887764,NAB,Business
15-08-2025 10:16,NABC6730D005D1D4C46B7EF,082-900-001,44444444,MCDONALDS NAB,52.4,0,159594.47,DR,REF630193,NAB,Business
15-08-2025 11:35,NAB3E382F00ADC6447C82F3,082-900-001,44444444,CITYLINK NAB,267.9,0,159326.57,DR,REF552782,NAB,Business
15-08-2025 11:52,NAB923ED39F97AC4275A0C0,082-900-001,44444444,CITYLINK NAB,267.7,0,159058.87,DR,REF490001,NAB,Business
15-08-2025 12:11,NAB3745FB04E81F453BA912,082-900-001,44444444,INTERNET TRANSFER NAB,217.3,0,158841.57,DR,REF276950,NAB,Business
15-08-2025 12:19,NABB9FFCC7FE1CF4BB7B333,082-900-001,44444444,PAYPAL *NETFLIX NAB,430.52,0,158411.05,DR,REF370623,NAB,Business
15-08-2025 12:30,NAB04FE44A4619C41B68AB7,082-900-001,44444444,LIQUORLAND NAB,553.81,0,157857.24,DR,REF589149,NAB,Business
15-08-2025 12:33,NAB8C7A40291946462CB68D,082-900-001,44444444,HARVEY NORMAN NAB,43.95,0,157813.29,DR,REF678676,NAB,Business
15-08-2025 13:19,NAB696D0DE11F2543FBA6C2,082-900-001,44444444,PAYMENT GATEWAY NAB,355.59,0,157457.7,DR,REF136853,NAB,Business
15-08-2025 13:30,NAB1B8FA310E85F47A4BCAF,082-900-001,44444444,COLES NAB,590.24,0,156867.46,DR,REF878152,NAB,Business
15-08-2025 13:47,NAB8E2F970093394736808C,082-900-001,44444444,BP NAB,64.34,0,156803.12,DR,REF828551,NAB,Business
15-08-2025 14:36,NAB1B3E198B777F454DBEFA,082-900-001,44444444,BANK FEE NAB,46.14,0,156756.98,DR,REF503274,NAB,Business
15-08-2025 14:51,NAB91461A2698994916BA82,082-900-001,44444444,WAGES CREDIT NAB,0,7472.93,164229.91,CR,REF862450,NAB,Business
15-08-2025 14:59,NABE01A472D0E704800995A,082-900-001,44444444,AMAZON AU NAB,823.24,0,163406.67,DR,REF457397,NAB,Business
15-08-2025 15:12,NAB3F6A3F6398A34E92A644,082-900-001,44444444,APPLE NAB,757.1,0,162649.57,DR,REF692815,NAB,Business
15-08-2025 15:38,NAB24DC76C58EC547B694D6,082-900-001,44444444,INTERNET TRANSFER NAB,66.75,0,162582.82,DR,REF781448,NAB,Business
15-08-2025 15:38,NABC2646553991E4C65BD26,082-900-001,44444444,ALDI NAB,739.37,0,161843.45,DR,REF917967,NAB,Business
15-08-2025 15:39,NAB88BA45713FEC42CBB3F7,082-900-001,44444444,WOOLWORTHS NAB,390.38,0,161453.07,DR,REF310949,NAB,Business
15-08-2025 15:52,INT9E436EC2D92F4545AB0D,082-900-001,44444444,TRANSFER FROM ANZ 11111111,0,394.31,161847.38,CR,INT-48558,NAB,Business
15-08-2025 16:08,INT014667B82A35412A92FB,082-900-001,44444444,TRANSFER TO CBA 22222222,234.99,0,161612.39,DR,INT-28638,NAB,Business
15-08-2025 16:14,NABB8DA6DF7F50C4F92A528,082-900-001,44444444,KFC NAB,1859.13,0,159753.26,DR,REF658187,NAB,Business
15-08-2025 16:17,NABB4F4D2E6A987436B8474,082-900-001,44444444,PAYPAL *NETFLIX NAB,569.59,0,159183.67,DR,REF239954,NAB,Business
15-08-2025 16:18,NAB08AC8FDB85034884A3AD,082-900-001,44444444,PAY - SALARY NAB,0,15.13,159198.8,CR,REF401677,NAB,Business
15-08-2025 16:26,NAB153E135C32B044EBAB12,082-900-001,44444444,ALDI NAB,95.73,0,159103.07,DR,REF861307,NAB,Business
15-08-2025 17:04,INT7FE5248075854C598FD1,082-900-001,44444444,TRANSFER TO ANZ 11111111,1937.77,0,157165.3,DR,INT-34004,NAB,Business
15-08-2025 17:19,NAB0A3CFDEC337B44148F06,082-900-001,44444444,STARBUCKS NAB,331.98,0,156833.32,DR,REF729398,NAB,Business
15-08-2025 17:46,NAB4C1BE515B61B4BA28886,082-900-001,44444444,DOMINO'S PIZZA NAB,148.92,0,156684.4,DR,REF618980,NAB,Business
15-08-2025 17:51,NAB9321D3C432E645C9AC0C,082-900-001,44444444,APPLE NAB,166.66,0,156517.74,DR,REF979560,NAB,Business
15-08-2025 18:27,NAB12729089E4CC43E48EB2,082-900-001,44444444,PAY - SALARY NAB,0,4239.12,160756.86,CR,REF310641,NAB,Business
15-08-2025 19:12,NAB59BC431CB9484F64A4E1,082-900-001,44444444,FLIXBUS NAB,340.31,0,160416.55,DR,REF858161,NAB,Business
15-08-2025 19:41,NAB6C393FE349C044C59294,082-900-001,44444444,PAY - SALARY NAB,0,184.07,160600.62,CR,REF504350,NAB,Business
15-08-2025 19:43,NABD7F96DD4794F4B758D59,082-900-001,44444444,7-ELEVEN NAB,149.55,0,160451.07,DR,REF237818,NAB,Business
15-08-2025 19:51,NABA3776DB834E6400EB28F,082-900-001,44444444,MENULOG NAB,424.2,0,160026.87,DR,REF357043,NAB,Business
15-08-2025 20:15,NABEC88B11149FC49E696ED,082-900-001,44444444,COLES NAB,89.98,0,159936.89,DR,REF906848,NAB,Business
15-08-2025 20:15,INT98A3BCC212B14E87B453,082-900-001,44444444,TRANSFER FROM CBA 33333333,0,1061.51,160998.4,CR,INT-53988,NAB,Business
15-08-2025 20:17,NAB30B66581BF434BCAB5A6,082-900-001,44444444,UBER EATS NAB,166.21,0,160832.19,DR,REF762295,NAB,Business
15-08-2025 21:15,NAB374E0494787844A58DC0,082-900-001,44444444,CITYLINK NAB,84.39,0,160747.8,DR,REF297005,NAB,Business
15-08-2025 21:43,NAB4044F21A771449E99997,082-900-001,44444444,APPLE NAB,641.26,0,160106.54,DR,REF211326,NAB,Business
15-08-2025 22:14,NABE91E7F56FBAF4ADBB6ED,082-900-001,44444444,RAILWAY STATION NAB,924.07,0,159182.47,DR,REF672261,NAB,Business
15-08-2025 22:23,NAB374C5C9E8AD3440BAA8E,082-900-001,44444444,PAYMENT GATEWAY NAB,65.58,0,159116.89,DR,REF454135,NAB,Business
15-08-2025 22:30,NAB1C4D248E27EB4AC39270,082-900-001,44444444,CITYLINK NAB,780.26,0,158336.63,DR,REF440374,NAB,Business
15-08-2025 22:55,NAB8542A113D7924721BCED,082-900-001,44444444,PAYPAL *NETFLIX NAB,338.63,0,157998,DR,REF700912,NAB,Business
15-08-2025 23:19,INT628D38B425944B608470,082-900-001,44444444,TRANSFER FROM CBA 33333333,0,1552.82,159550.82,CR,INT-71493,NAB,Business
15-08-2025 23:45,NAB3141E5036F0D42A1B958,082-900-001,44444444,SALARY PAYMENT NAB,0,3406.06,162956.88,CR,REF889257,NAB,Business
16-08-2025 00:02,NAB91851A90B25B4466B819,082-900-001,44444444,BIGW NAB,479.3,0,162477.58,DR,REF528847,NAB,Business
16-08-2025 00:09,NAB12200CD5E5624FE3903C,082-900-001,44444444,ZOOM NAB,98.62,0,162378.96,DR,REF288434,NAB,Business
16-08-2025 00:35,NABF959BCB90EDC405CB450,082-900-001,44444444,AMAZON AU NAB,103.75,0,162275.21,DR,REF511187,NAB,Business
16-08-2025 00:39,NABE378C3D771FE4D72A88D,082-900-001,44444444,MCDONALDS NAB,170.02,0,162105.19,DR,REF599148,NAB,Business
16-08-2025 01:03,NAB549FFA28E2F1442BB9BF,082-900-001,44444444,INTERNET TRANSFER NAB,189.52,0,161915.67,DR,REF165032,NAB,Business
16-08-2025 01:08,NAB0F122E01B0FC4155B798,082-900-001,44444444,ALDI NAB,135.35,0,161780.32,DR,REF967532,NAB,Business
16-08-2025 01:26,NAB10C498C1F82B44E09991,082-900-001,44444444,PAYMENT GATEWAY NAB,204.81,0,161575.51,DR,REF246287,NAB,Business
16-08-2025 01:50,NAB04DD5756AB1D4AC8810F,082-900-001,44444444,ZOOM NAB,309.17,0,161266.34,DR,REF695368,NAB,Business
16-08-2025 02:20,NABBF896527AC58442DA5AC,082-900-001,44444444,DOMINO'S PIZZA NAB,222.18,0,161044.16,DR,REF316176,NAB,Business
16-08-2025 02:30,NAB5204AB81D7204FED827A,082-900-001,44444444,SHELL NAB,52.4,0,160991.76,DR,REF328308,NAB,Business
16-08-2025 02:31,NAB694FADABA9A545A992F5,082-900-001,44444444,RAILWAY STATION NAB,895.45,0,160096.31,DR,REF112611,NAB,Business
16-08-2025 02:32,NAB5DD9C4EF1E6448A4B676,082-900-001,44444444,BANK FEE NAB,279.59,0,159816.72,DR,REF443983,NAB,Business
16-08-2025 02:52,NAB0B02A55A8AD14E1DA2C3,082-900-001,44444444,COLES NAB,513.9,0,159302.82,DR,REF866782,NAB,Business
16-08-2025 03:11,NAB49E937B09E784C2D960B,082-900-001,44444444,MCDONALDS NAB,98.69,0,159204.13,DR,REF468844,NAB,Business
16-08-2025 03:22,NABA1025318CF1E4F2B8606,082-900-001,44444444,ALDI NAB,113.69,0,159090.44,DR,REF357464,NAB,Business
16-08-2025 03:53,NAB3475159BB6C2447BB8F8,082-900-001,44444444,PAYROLL CREDIT NAB,0,5243.21,164333.65,CR,REF257360,NAB,Business
16-08-2025 04:10,NAB35DDDEB27BBB4F1FB671,082-900-001,44444444,KFC NAB,375.84,0,163957.81,DR,REF541985,NAB,Business
16-08-2025 04:17,NABC4057428E4B640AEA29B,082-900-001,44444444,PAYMENT GATEWAY NAB,529.81,0,163428,DR,REF442327,NAB,Business
16-08-2025 05:06,NAB6F0BF4C42E33496184F3,082-900-001,44444444,SPOTIFY NAB,326,0,163102,DR,REF193960,NAB,Business
16-08-2025 05:25,NAB3F7B467DD4B74B8C8266,082-900-001,44444444,ZOOM NAB,296.57,0,162805.43,DR,REF961761,NAB,Business
16-08-2025 05:43,NAB6C9E2256CD474412A493,082-900-001,44444444,PAYROLL CREDIT NAB,0,4050.11,166855.54,CR,REF646433,NAB,Business
16-08-2025 05:50,NABE917F9EA41114D3AA2C2,082-900-001,44444444,INTERNET TRANSFER NAB,271.37,0,166584.17,DR,REF507923,NAB,Business
16-08-2025 06:08,NAB7E748B32E8FA4A57910D,082-900-001,44444444,PAYMENT GATEWAY NAB,119.07,0,166465.1,DR,REF428202,NAB,Business
16-08-2025 06:10,NABA07CB15B22B44F45BCEB,082-900-001,44444444,AMAZON AU NAB,620.82,0,165844.28,DR,REF286261,NAB,Business
16-08-2025 06:23,NAB58940BA1BCA241FA8366,082-900-001,44444444,DOMINO'S PIZZA NAB,474.21,0,165370.07,DR,REF536962,NAB,Business
16-08-2025 06:24,NAB68E133A45B694139B1E9,082-900-001,44444444,BP NAB,835.07,0,164535,DR,REF262438,NAB,Business
16-08-2025 07:21,NABECA1679AD19D4348B585,082-900-001,44444444,CITYLINK NAB,175.31,0,164359.69,DR,REF790908,NAB,Business
16-08-2025 07:44,NABA3C593F03CE644C6AA79,082-900-001,44444444,PAYMENT GATEWAY NAB,120.23,0,164239.46,DR,REF997414,NAB,Business
16-08-2025 08:06,INT0537B56FE16D40FD933C,082-900-001,44444444,TRANSFER TO CBA 22222222,1085.18,0,163154.28,DR,INT-16541,NAB,Business
16-08-2025 08:21,NAB46996567C5E14A2A8398,082-900-001,44444444,STARBUCKS NAB,125.3,0,163028.98,DR,REF508454,NAB,Business
16-08-2025 09:24,NAB47812837F45E4B8DBBF9,082-900-001,44444444,BANK FEE NAB,404.59,0,162624.39,DR,REF366877,NAB,Business
16-08-2025 09:35,NABA5C5495232F949FAA735,082-900-001,44444444,MENULOG NAB,75.73,0,162548.66,DR,REF490570,NAB,Business
16-08-2025 09:37,NAB18B41F43253C4B0799C9,082-900-001,44444444,APPLE NAB,117.36,0,162431.3,DR,REF249947,NAB,Business
16-08-2025 11:02,NABE5E18A83BF844B45A0D6,082-900-001,44444444,BP NAB,41.2,0,162390.1,DR,REF213017,NAB,Business
16-08-2025 11:25,NAB902A331555464272BF35,082-900-001,44444444,PAYPAL *NETFLIX NAB,436.23,0,161953.87,DR,REF424793,NAB,Business
16-08-2025 11:38,INT8AB81F2D299D404FA318,082-900-001,44444444,TRANSFER FROM ANZ 11111111,0,392.19,162346.06,CR,INT-22237,NAB,Business
16-08-2025 12:28,NABD57350F1CD544E7AB888,082-900-001,44444444,PAYROLL CREDIT NAB,0,719.67,163065.73,CR,REF155653,NAB,Business
16-08-2025 12:47,NAB77FB32FEDBD840A0910B,082-900-001,44444444,DOMINO'S PIZZA NAB,355.99,0,162709.74,DR,REF973007,NAB,Business
16-08-2025 13:22,NAB1373BC40BA43448F87F2,082-900-001,44444444,DOMINO'S PIZZA NAB,69.72,0,162640.02,DR,REF429310,NAB,Business
16-08-2025 13:39,NABB2E447857A51407F8AF2,082-900-001,44444444,MCDONALDS NAB,161.76,0,162478.26,DR,REF518462,NAB,Business
16-08-2025 14:07,NAB8C12395CD3724526AAA4,082-900-001,44444444,TAFE BOOKSHOP NAB,421.08,0,162057.18,DR,REF842912,NAB,Business
16-08-2025 14:26,NABD41D1AF3F90342BBB922,082-900-001,44444444,PAYROLL CREDIT NAB,0,1940.76,163997.94,CR,REF813202,NAB,Business
16-08-2025 14:27,NABA5F21710B3B04B5F8547,082-900-001,44444444,PAYMENT GATEWAY NAB,177.05,0,163820.89,DR,REF253881,NAB,Business
16-08-2025 14:36,NAB1EF68820EB0A4D45B248,082-900-001,44444444,ALDI NAB,47.94,0,163772.95,DR,REF464496,NAB,Business
16-08-2025 15:32,NABF8729D720F23474B933E,082-900-001,44444444,UBER EATS NAB,175.29,0,163597.66,DR,REF576797,NAB,Business
16-08-2025 15:36,NAB5ADD8446F6F6487C8858,082-900-001,44444444,MENULOG NAB,580.73,0,163016.93,DR,REF887003,NAB,Business
16-08-2025 16:08,NAB6BCAF75BCAFB4C46A3DE,082-900-001,44444444,BP NAB,96.26,0,162920.67,DR,REF825572,NAB,Business
16-08-2025 16:24,NAB66B72E41496A4959A857,082-900-001,44444444,MENULOG NAB,305.13,0,162615.54,DR,REF125842,NAB,Business
16-08-2025 17:11,INT361B6D4F597849ED9251,082-900-001,44444444,TRANSFER TO CBA 22222222,1408.19,0,161207.35,DR,INT-28626,NAB,Business
16-08-2025 17:41,NAB9BBBA224A7C942AEB90B,082-900-001,44444444,BP NAB,405.45,0,160801.9,DR,REF503765,NAB,Business
16-08-2025 17:50,INT0E00DDD2F1D74104AF21,082-900-001,44444444,TRANSFER TO ANZ 11111111,799.72,0,160002.18,DR,INT-79990,NAB,Business
16-08-2025 17:53,NAB6A0AA05FD89F4CCBBB8D,082-900-001,44444444,CITYLINK NAB,1334.12,0,158668.06,DR,REF276465,NAB,Business
16-08-2025 18:39,NAB53444ED0C0C24575BE64,082-900-001,44444444,BANK FEE NAB,42.71,0,158625.35,DR,REF875191,NAB,Business
16-08-2025 19:45,NABBAD467D440CA4E25B035,082-900-001,44444444,CITYLINK NAB,947.18,0,157678.17,DR,REF201422,NAB,Business
16-08-2025 19:49,NABD70481A1537A49F9AA97,082-900-001,44444444,STARBUCKS NAB,73.95,0,157604.22,DR,REF852621,NAB,Business
16-08-2025 20:20,NAB24E0BAF7218047FA9298,082-900-001,44444444,JB HI-FI NAB,365.74,0,157238.48,DR,REF265705,NAB,Business
16-08-2025 21:08,NAB990442CE39004F169EDC,082-900-001,44444444,KFC NAB,222.75,0,157015.73,DR,REF600356,NAB,Business
16-08-2025 21:13,NAB103B875CBBCA46E68181,082-900-001,44444444,BIGW NAB,101.79,0,156913.94,DR,REF968682,NAB,Business
16-08-2025 21:25,NAB49E0FBE4CE484202BC46,082-900-001,44444444,BWS NAB,213.6,0,156700.34,DR,REF986569,NAB,Business
16-08-2025 22:12,NAB137D196BB9B24293AE64,082-900-001,44444444,COLES NAB,907.9,0,155792.44,DR,REF411675,NAB,Business
16-08-2025 22:55,NABF5072F91007D448DBC8B,082-900-001,44444444,BWS NAB,1359.85,0,154432.59,DR,REF820086,NAB,Business
16-08-2025 23:00,NABD4AC8740D321460BBE95,082-900-001,44444444,DOMINO'S PIZZA NAB,43.21,0,154389.38,DR,REF823891,NAB,Business
16-08-2025 23:06,NABAF6839CCF05B43A0B149,082-900-001,44444444,PAYPAL *NETFLIX NAB,296.37,0,154093.01,DR,REF120315,NAB,Business
16-08-2025 23:17,NABD38B99A4F8144A26BFC6,082-900-001,44444444,ALDI NAB,349.07,0,153743.94,DR,REF553335,NAB,Business
16-08-2025 23:26,NABEB4CAF4D9A4C4288AE82,082-900-001,44444444,STARBUCKS NAB,255.15,0,153488.79,DR,REF151598,NAB,Business
17-08-2025 00:02,NABF3468B9A3E394F889894,082-900-001,44444444,BWS NAB,303.51,0,153185.28,DR,REF680386,NAB,Business
17-08-2025 00:14,INTE7B267141BFB4BD48423,082-900-001,44444444,TRANSFER TO ANZ 11111111,933.91,0,152251.37,DR,INT-47660,NAB,Business
17-08-2025 00:17,NABC2E0073088FB415BB361,082-900-001,44444444,DOMINO'S PIZZA NAB,299.79,0,151951.58,DR,REF457309,NAB,Business
17-08-2025 00:30,NABEC28E8FE132E4F7B992F,082-900-001,44444444,PAYROLL CREDIT NAB,0,4133.21,156084.79,CR,REF651215,NAB,Business
17-08-2025 00:36,INT5DC6630B4CD94336BA10,082-900-001,44444444,TRANSFER TO CBA 33333333,1195.27,0,154889.52,DR,INT-86761,NAB,Business
17-08-2025 01:22,NAB500D409CEE9E4E40859E,082-900-001,44444444,TAFE BOOKSHOP NAB,530.39,0,154359.13,DR,REF727109,NAB,Business
17-08-2025 01:27,NAB70DBB3DDBDB24C1DA80E,082-900-001,44444444,SALARY PAYMENT NAB,0,3500.24,157859.37,CR,REF694544,NAB,Business
17-08-2025 01:34,NABF1A53B664E1444FC8D77,082-900-001,44444444,MENULOG NAB,340.65,0,157518.72,DR,REF267058,NAB,Business
17-08-2025 01:48,NAB12C04576725A48D28490,082-900-001,44444444,SALARY PAYMENT NAB,0,452.73,157971.45,CR,REF962675,NAB,Business
17-08-2025 02:01,NABC502FBD2D1B04DB8AB3E,082-900-001,44444444,TAFE BOOKSHOP NAB,520.39,0,157451.06,DR,REF669577,NAB,Business
17-08-2025 02:24,NAB327B7B6D29904CE3980A,082-900-001,44444444,MENULOG NAB,1066.29,0,156384.77,DR,REF618009,NAB,Business
17-08-2025 02:25,NABAB53AF50AFEC42CAA128,082-900-001,44444444,CITYLINK NAB,152.55,0,156232.22,DR,REF371992,NAB,Business
17-08-2025 03:09,NABE4E62D34B7B84A2CA247,082-900-001,44444444,LIQUORLAND NAB,50.22,0,156182,DR,REF245808,NAB,Business
17-08-2025 03:11,NAB592ADB71EE3D4C67B347,082-900-001,44444444,INTERNET TRANSFER NAB,232.18,0,155949.82,DR,REF871274,NAB,Business
17-08-2025 03:17,NABE325ACBBE34B4B8C9A5D,082-900-001,44444444,DOMINO'S PIZZA NAB,1659.65,0,154290.17,DR,REF502118,NAB,Business
17-08-2025 03:23,NAB75BB63A8428142D9AF56,082-900-001,44444444,7-ELEVEN NAB,177,0,154113.17,DR,REF523390,NAB,Business
17-08-2025 03:28,NAB07BB8B062B5A443AB6CE,082-900-001,44444444,JB HI-FI NAB,313.8,0,153799.37,DR,REF992264,NAB,Business
17-08-2025 04:17,NAB163A18E06C834598AAB8,082-900-001,44444444,STARBUCKS NAB,118.27,0,153681.1,DR,REF456314,NAB,Business
17-08-2025 04:20,NABC921AB5D2DAC43418C6C,082-900-001,44444444,ZOOM NAB,55.42,0,153625.68,DR,REF292475,NAB,Business
17-08-2025 04:23,NAB8403EF266A6843E8AE87,082-900-001,44444444,BIGW NAB,439.11,0,153186.57,DR,REF413132,NAB,Business
17-08-2025 04:37,NAB52D4F579EC05407FAAE9,082-900-001,44444444,7-ELEVEN NAB,210.68,0,152975.89,DR,REF454032,NAB,Business
17-08-2025 04:41,NABC175D1DF45694421AE7B,082-900-001,44444444,BIGW NAB,905.17,0,152070.72,DR,REF505377,NAB,Business
17-08-2025 04:52,NABD31EC47098574E949AB4,082-900-001,44444444,SPOTIFY NAB,729.07,0,151341.65,DR,REF385015,NAB,Business
17-08-2025 04:58,NAB41EA5AA482144C479756,082-900-001,44444444,UBER EATS NAB,196.96,0,151144.69,DR,REF792406,NAB,Business
17-08-2025 05:09,NAB2D7EDADE8EFC479DAF12,082-900-001,44444444,CITYLINK NAB,147.19,0,150997.5,DR,REF227565,NAB,Business
17-08-2025 05:19,NAB151F3FC7C1634EA5B9EA,082-900-001,44444444,SHELL NAB,140.81,0,150856.69,DR,REF878710,NAB,Business
17-08-2025 05:58,NABEE7C0E149D034D5EA220,082-900-001,44444444,PAY - SALARY NAB,0,6675.09,157531.78,CR,REF704001,NAB,Business
17-08-2025 06:50,NAB384C0BDF69794CC899F2,082-900-001,44444444,7-ELEVEN NAB,24.99,0,157506.79,DR,REF483872,NAB,Business
17-08-2025 07:35,NAB24F2C7CDBF8D465DBCF8,082-900-001,44444444,FLIXBUS NAB,111.92,0,157394.87,DR,REF407792,NAB,Business
17-08-2025 08:28,NAB02D23F5999464BBB87E2,082-900-001,44444444,TAFE BOOKSHOP NAB,214.45,0,157180.42,DR,REF852664,NAB,Business
17-08-2025 09:01,NAB396EDD062B4B4FA9B870,082-900-001,44444444,SHELL NAB,1011.97,0,156168.45,DR,REF920218,NAB,Business
17-08-2025 09:52,NAB25261E038461476197BE,082-900-001,44444444,STARBUCKS NAB,575.52,0,155592.93,DR,REF641015,NAB,Business
17-08-2025 10:05,NABEADF59A6CE44406A97E7,082-900-001,44444444,BWS NAB,187.58,0,155405.35,DR,REF612167,NAB,Business
17-08-2025 10:13,NABB62D5E290EC64E5E9156,082-900-001,44444444,BP NAB,203.86,0,155201.49,DR,REF676387,NAB,Business
17-08-2025 10:21,NAB93F87B3643F245FFA990,082-900-001,44444444,BANK FEE NAB,375.83,0,154825.66,DR,REF984564,NAB,Business
17-08-2025 10:51,NAB440C928828BF4C768378,082-900-001,44444444,FLIXBUS NAB,157.3,0,154668.36,DR,REF309203,NAB,Business
17-08-2025 12:15,NABC2186F1C09424D6DB58E,082-900-001,44444444,AMAZON AU NAB,502.54,0,154165.82,DR,REF361526,NAB,Business
17-08-2025 12:18,NAB852B24320AA84C5DB70C,082-900-001,44444444,SALARY PAYMENT NAB,0,3270.41,157436.23,CR,REF649810,NAB,Business
17-08-2025 12:25,NABFF2E6DB35F104C42BC44,082-900-001,44444444,WAGES CREDIT NAB,0,4379.73,161815.96,CR,REF753664,NAB,Business
17-08-2025 12:34,NAB90EB37CBB1534238ADF9,082-900-001,44444444,HARVEY NORMAN NAB,69.73,0,161746.23,DR,REF688123,NAB,Business
17-08-2025 12:36,NAB5BF6933064784F23A57D,082-900-001,44444444,UBER EATS NAB,19.97,0,161726.26,DR,REF740065,NAB,Business
17-08-2025 12:54,NAB8C6C1E6B72C3496D8603,082-900-001,44444444,HARVEY NORMAN NAB,430.04,0,161296.22,DR,REF411122,NAB,Business
17-08-2025 13:20,NAB8457823E5D914E4984AD,082-900-001,44444444,PAYPAL *NETFLIX NAB,215.32,0,161080.9,DR,REF445779,NAB,Business
17-08-2025 13:29,NAB7CA69C2215DF4699B6C4,082-900-001,44444444,LIQUORLAND NAB,79.81,0,161001.09,DR,REF312455,NAB,Business
17-08-2025 14:26,NABAAC5003DC4D3416AAB94,082-900-001,44444444,BP NAB,74.1,0,160926.99,DR,REF406455,NAB,Business
17-08-2025 14:43,NAB577C1EA8A1824E85870E,082-900-001,44444444,SHELL NAB,308.9,0,160618.09,DR,REF181030,NAB,Business
17-08-2025 14:48,NAB93DBE752A2714632B758,082-900-001,44444444,INTERNET TRANSFER NAB,737.46,0,159880.63,DR,REF282952,NAB,Business
17-08-2025 15:36,INT28FA80F83FEB48278C83,082-900-001,44444444,TRANSFER FROM CBA 33333333,0,787.92,160668.55,CR,INT-54331,NAB,Business
17-08-2025 16:35,NABA56A16C0560445CB9F33,082-900-001,44444444,SPOTIFY NAB,105.79,0,160562.76,DR,REF345295,NAB,Business
17-08-2025 17:58,NABBCE4A45BBBA641BC907F,082-900-001,44444444,RAILWAY STATION NAB,653.21,0,159909.55,DR,REF326546,NAB,Business
17-08-2025 18:04,NABE5A43481B3254510905B,082-900-001,44444444,ALDI NAB,274.56,0,159634.99,DR,REF857786,NAB,Business
17-08-2025 18:09,INTA50DAD5B949A4FAAAE94,082-900-001,44444444,TRANSFER TO CBA 22222222,1875.49,0,157759.5,DR,INT-67101,NAB,Business
17-08-2025 18:24,NABAD99383E7B2147538204,082-900-001,44444444,APPLE NAB,344.73,0,157414.77,DR,REF508098,NAB,Business
17-08-2025 18:41,NAB959CBD667FD945998509,082-900-001,44444444,PAYROLL CREDIT NAB,0,2141.68,159556.45,CR,REF707233,NAB,Business
17-08-2025 19:03,NABCA47487197854325B3EE,082-900-001,44444444,MCDONALDS NAB,251.72,0,159304.73,DR,REF610990,NAB,Business
17-08-2025 19:58,NABAB5C402AB3B6438E8863,082-900-001,44444444,MENULOG NAB,134.38,0,159170.35,DR,REF643889,NAB,Business
17-08-2025 20:03,NAB82F012962B0A475FA993,082-900-001,44444444,7-ELEVEN NAB,68.02,0,159102.33,DR,REF599702,NAB,Business
17-08-2025 20:23,NAB78C6EEDE40B64F7DBFDC,082-900-001,44444444,WAGES CREDIT NAB,0,2063.77,161166.1,CR,REF519442,NAB,Business
17-08-2025 20:24,NAB98F46AE8350248D39F8C,082-900-001,44444444,JB HI-FI NAB,90.25,0,161075.85,DR,REF149249,NAB,Business
17-08-2025 20:39,NAB637F4076672246C8AD90,082-900-001,44444444,JB HI-FI NAB,78.32,0,160997.53,DR,REF154162,NAB,Business
17-08-2025 21:08,NAB3CB2AF04A7424317AF9F,082-900-001,44444444,BIGW NAB,378.04,0,160619.49,DR,REF565830,NAB,Business
17-08-2025 21:10,NAB4DAD4D442AC1454D829E,082-900-001,44444444,PAY - SALARY NAB,0,1723.82,162343.31,CR,REF685515,NAB,Business
17-08-2025 21:38,NAB73F640E6077C4FE88905,082-900-001,44444444,COLES NAB,349.75,0,161993.56,DR,REF998829,NAB,Business
17-08-2025 22:24,NAB7BA4D2BED60F4ECFAE66,082-900-001,44444444,CITYLINK NAB,186.31,0,161807.25,DR,REF302911,NAB,Business
17-08-2025 22:40,NABC9AF2BEE720F4B2FBF7D,082-900-001,44444444,WOOLWORTHS NAB,421.35,0,161385.9,DR,REF598944,NAB,Business
17-08-2025 22:57,NABB858AD82FB6C45E2ACC8,082-900-001,44444444,CITYLINK NAB,52.22,0,161333.68,DR,REF354396,NAB,Business
17-08-2025 23:13,NABA1281729628749A4A149,082-900-001,44444444,BIGW NAB,1248.69,0,160084.99,DR,REF578143,NAB,Business
17-08-2025 23:37,NAB6113B55637C4486F8737,082-900-001,44444444,AMAZON AU NAB,94.45,0,159990.54,DR,REF233975,NAB,Business
17-08-2025 23:40,NAB6FD9AA478D0645AEA42C,082-900-001,44444444,INTERNET TRANSFER NAB,558.97,0,159431.57,DR,REF717553,NAB,Business
18-08-2025 00:14,NAB3FF08D4CC6034110AB97,082-900-001,44444444,AMAZON AU NAB,745.79,0,158685.78,DR,REF279140,NAB,Business
18-08-2025 00:36,NABEEE077ED96AA4ED3AC3F,082-900-001,44444444,HARVEY NORMAN NAB,153.26,0,158532.52,DR,REF975045,NAB,Business
18-08-2025 00:45,NABEEF0C2D27D7B426C9779,082-900-001,44444444,CITYLINK NAB,400.88,0,158131.64,DR,REF315290,NAB,Business
18-08-2025 00:47,NAB924E1B69D8D2440299B7,082-900-001,44444444,SALARY PAYMENT NAB,0,2114.21,160245.85,CR,REF700473,NAB,Business
18-08-2025 00:56,NABB1C216FA0AD2464F9062,082-900-001,44444444,SALARY PAYMENT NAB,0,792.06,161037.91,CR,REF374333,NAB,Business
18-08-2025 00:58,NABFAD7F60EC69742E3AF79,082-900-001,44444444,BWS NAB,137.93,0,160899.98,DR,REF137085,NAB,Business
18-08-2025 01:00,NAB6439D22CBFA24C158BDE,082-900-001,44444444,PAYROLL CREDIT NAB,0,4288.04,165188.02,CR,REF459976,NAB,Business
18-08-2025 01:14,NAB9B977574515C4D5E83CB,082-900-001,44444444,COMPANY PAYROLL NAB,0,3978.72,169166.74,CR,REF392515,NAB,Business
18-08-2025 01:26,NAB973F86004AD84026A114,082-900-001,44444444,PAYROLL CREDIT NAB,0,6457.09,175623.83,CR,REF140458,NAB,Business
18-08-2025 01:28,NAB4F58FD17CA1140429466,082-900-001,44444444,PAY - SALARY NAB,0,6791.12,182414.95,CR,REF656042,NAB,Business
18-08-2025 01:37,NAB87DE1C93FCB44E889C9F,082-900-001,44444444,PAYPAL *NETFLIX NAB,238.16,0,182176.79,DR,REF140739,NAB,Business
18-08-2025 01:39,NABFB4445146C4244C78E49,082-900-001,44444444,FLIXBUS NAB,542.68,0,181634.11,DR,REF400643,NAB,Business
18-08-2025 02:02,NAB6CDE81B72FF84E3E8319,082-900-001,44444444,PAYPAL *NETFLIX NAB,57.89,0,181576.22,DR,REF506671,NAB,Business
18-08-2025 02:03,NABD177BAC0BCA24D169510,082-900-001,44444444,HARVEY NORMAN NAB,95.09,0,181481.13,DR,REF703517,NAB,Business
18-08-2025 02:13,NABE8FB745A0F71438F87F9,082-900-001,44444444,BANK FEE NAB,153.26,0,181327.87,DR,REF306199,NAB,Business
18-08-2025 02:18,NAB0878B4847DA840BE930E,082-900-001,44444444,CITYLINK NAB,783.38,0,180544.49,DR,REF255069,NAB,Business
18-08-2025 02:24,NABEFAB97C8C9984042AF65,082-900-001,44444444,KFC NAB,772.81,0,179771.68,DR,REF271582,NAB,Business
18-08-2025 02:34,NAB32A628DE697B4282B477,082-900-001,44444444,MCDONALDS NAB,363.49,0,179408.19,DR,REF579337,NAB,Business
18-08-2025 02:40,NAB072D2F36E5CB4BAD9A42,082-900-001,44444444,ZOOM NAB,112.17,0,179296.02,DR,REF572861,NAB,Business
18-08-2025 02:56,NAB6456CB6BF3044123A412,082-900-001,44444444,7-ELEVEN NAB,796.52,0,178499.5,DR,REF171868,NAB,Business
18-08-2025 03:04,INT938A7965213E4402893B,082-900-001,44444444,TRANSFER FROM ANZ 11111111,0,329.77,178829.27,CR,INT-19055,NAB,Business
18-08-2025 03:12,NABD219BCA9FCFB4AE2BC8D,082-900-001,44444444,INTERNET TRANSFER NAB,109.77,0,178719.5,DR,REF660518,NAB,Business
18-08-2025 03:14,NABD22BD8886D4F46D290E0,082-900-001,44444444,MCDONALDS NAB,130.33,0,178589.17,DR,REF883141,NAB,Business
18-08-2025 03:32,NABFDE46754E9504BF38C21,082-900-001,44444444,COMPANY PAYROLL NAB,0,4498.05,183087.22,CR,REF863029,NAB,Business
18-08-2025 03:38,NAB91FF11A5A35C49FE86A4,082-900-001,44444444,COLES NAB,475.14,0,182612.08,DR,REF851610,NAB,Business
18-08-2025 03:58,NABEDA53332E5334A65AD8A,082-900-001,44444444,ALDI NAB,191.37,0,182420.71,DR,REF740298,NAB,Business
18-08-2025 03:59,NAB259AEE2D24FC4309810B,082-900-001,44444444,JB HI-FI NAB,101.26,0,182319.45,DR,REF773270,NAB,Business
18-08-2025 04:41,NAB5E9F14E43DE74E238B34,082-900-001,44444444,DOMINO'S PIZZA NAB,308.15,0,182011.3,DR,REF839953,NAB,Business
18-08-2025 05:10,NAB47BE987864504ED582C2,082-900-001,44444444,SHELL NAB,82.96,0,181928.34,DR,REF924707,NAB,Business
18-08-2025 05:26,NAB9F54CCE65ACF4BE28F67,082-900-001,44444444,LIQUORLAND NAB,80.92,0,181847.42,DR,REF767280,NAB,Business
18-08-2025 05:31,NAB477B41A80458468B919D,082-900-001,44444444,FLIXBUS NAB,1022.14,0,180825.28,DR,REF666972,NAB,Business
18-08-2025 05:46,NAB670FADCB7E344DDA87FF,082-900-001,44444444,MCDONALDS NAB,155.77,0,180669.51,DR,REF151904,NAB,Business
18-08-2025 05:54,NAB6238B640C4974A38A398,082-900-001,44444444,BP NAB,534.42,0,180135.09,DR,REF928614,NAB,Business
18-08-2025 05:57,NAB11A795754DFC4A48971B,082-900-001,44444444,APPLE NAB,108.37,0,180026.72,DR,REF133767,NAB,Business
18-08-2025 06:15,NABB5AC4F88DDB141EB8E8C,082-900-001,44444444,STARBUCKS NAB,144.01,0,179882.71,DR,REF480004,NAB,Business
18-08-2025 06:22,NAB2398D9150BD04DB1A1CA,082-900-001,44444444,KFC NAB,793.87,0,179088.84,DR,REF631461,NAB,Business
18-08-2025 06:26,NABA43B79039F2D4CAF991C,082-900-001,44444444,PAYMENT GATEWAY NAB,255.15,0,178833.69,DR,REF731331,NAB,Business
18-08-2025 07:03,NABFD1C9AF85CCD440CBBDE,082-900-001,44444444,ALDI NAB,157.95,0,178675.74,DR,REF408367,NAB,Business
18-08-2025 07:10,NAB5F6FC6B17C7A44E69B91,082-900-001,44444444,COLES NAB,274.47,0,178401.27,DR,REF416369,NAB,Business
18-08-2025 07:42,NAB407178CB39824745A7AA,082-900-001,44444444,PAYPAL *NETFLIX NAB,844.25,0,177557.02,DR,REF753162,NAB,Business
18-08-2025 07:57,NAB1FE425FC3567453498F8,082-900-001,44444444,LIQUORLAND NAB,1434.14,0,176122.88,DR,REF982408,NAB,Business
18-08-2025 08:00,NAB4ED2209FAF9243A59D9C,082-900-001,44444444,WOOLWORTHS NAB,94.04,0,176028.84,DR,REF806409,NAB,Business
18-08-2025 08:37,NABFEF77DC1F3BE4139B6BF,082-900-001,44444444,LIQUORLAND NAB,366.35,0,175662.49,DR,REF683395,NAB,Business
18-08-2025 08:42,NABE5E386D4AE5C4EF39D70,082-900-001,44444444,JB HI-FI NAB,381.35,0,175281.14,DR,REF560740,NAB,Business
18-08-2025 09:01,NABAD5C150C430D42CB9A7A,082-900-001,44444444,MENULOG NAB,327.05,0,174954.09,DR,REF439888,NAB,Business
18-08-2025 09:08,NAB5C13B2FE45D841D691FC,082-900-001,44444444,PAYROLL CREDIT NAB,0,529.28,175483.37,CR,REF519328,NAB,Business
18-08-2025 09:41,NAB5D8AECAB808C48A7918D,082-900-001,44444444,RAILWAY STATION NAB,259.53,0,175223.84,DR,REF762298,NAB,Business
18-08-2025 10:03,NABC952704C1286484BB36D,082-900-001,44444444,SHELL NAB,364.1,0,174859.74,DR,REF965300,NAB,Business
18-08-2025 10:09,NABFD92A784CD624CA2AFA9,082-900-001,44444444,BP NAB,304.44,0,174555.3,DR,REF921882,NAB,Business
18-08-2025 10:10,NABD4C2C23990C74D2484FB,082-900-001,44444444,ZOOM NAB,172.34,0,174382.96,DR,REF448309,NAB,Business
18-08-2025 10:10,NAB2D4D583CDCD741098B45,082-900-001,44444444,PAYMENT GATEWAY NAB,276.64,0,174106.32,DR,REF584355,NAB,Business
18-08-2025 10:13,NAB5EF9B090A84B4E82BEE1,082-900-001,44444444,TAFE BOOKSHOP NAB,43.31,0,174063.01,DR,REF229422,NAB,Business
18-08-2025 10:23,NABE7D8D70E53B54E94A75A,082-900-001,44444444,UBER EATS NAB,40.59,0,174022.42,DR,REF222298,NAB,Business
18-08-2025 11:43,NABA408B4FE9E0F41F48EA3,082-900-001,44444444,COLES NAB,99.26,0,173923.16,DR,REF458372,NAB,Business
18-08-2025 11:57,NABE7D6648D3EBA4A90AA9D,082-900-001,44444444,FLIXBUS NAB,446.89,0,173476.27,DR,REF354500,NAB,Business
18-08-2025 12:02,NABD13D45210A014948A26E,082-900-001,44444444,DOMINO'S PIZZA NAB,900.49,0,172575.78,DR,REF435193,NAB,Business
18-08-2025 12:03,NAB9355EA68FE464EE98311,082-900-001,44444444,PAYPAL *NETFLIX NAB,375.34,0,172200.44,DR,REF978018,NAB,Business
18-08-2025 12:17,NABD1814F7CBF8642B8B7DA,082-900-001,44444444,JB HI-FI NAB,57.34,0,172143.1,DR,REF662519,NAB,Business
18-08-2025 12:24,NAB8DBB7162AD4A408FA209,082-900-001,44444444,LIQUORLAND NAB,193.96,0,171949.14,DR,REF717577,NAB,Business
18-08-2025 12:44,NAB51DA7B8EE29F4F89AFF6,082-900-001,44444444,KFC NAB,574.68,0,171374.46,DR,REF599884,NAB,Business
18-08-2025 13:40,NABE3D85D3B392F457D9E7B,082-900-001,44444444,KFC NAB,143.24,0,171231.22,DR,REF229810,NAB,Business
18-08-2025 13:41,NABBD2564856B4D4616BF83,082-900-001,44444444,BANK FEE NAB,96.93,0,171134.29,DR,REF536162,NAB,Business
18-08-2025 13:55,NAB48437C7CD2D1425D842B,082-900-001,44444444,TAFE BOOKSHOP NAB,121.27,0,171013.02,DR,REF860429,NAB,Business
18-08-2025 13:59,NABF1399D663E7E4A51B9AE,082-900-001,44444444,COLES NAB,591.16,0,170421.86,DR,REF613429,NAB,Business
18-08-2025 14:02,NAB42E1786011EC4E3EAE00,082-900-001,44444444,MENULOG NAB,509.72,0,169912.14,DR,REF297188,NAB,Business
18-08-2025 14:07,NAB2BD87A44A19540009822,082-900-001,44444444,LIQUORLAND NAB,271.21,0,169640.93,DR,REF113817,NAB,Business
18-08-2025 14:12,NABA4E2AB3F590B42E08938,082-900-001,44444444,BP NAB,397.57,0,169243.36,DR,REF943823,NAB,Business
18-08-2025 14:43,NAB52DFD855065D40E59D28,082-900-001,44444444,PAYROLL CREDIT NAB,0,871.23,170114.59,CR,REF692747,NAB,Business
18-08-2025 15:25,NABC14DD04BA0E243E098BB,082-900-001,44444444,PAY - SALARY NAB,0,4285.95,174400.54,CR,REF875830,NAB,Business
18-08-2025 15:26,NABAC3AD4307AFD420A9C0B,082-900-001,44444444,BP NAB,170.76,0,174229.78,DR,REF906531,NAB,Business
18-08-2025 16:07,NAB0BDDC7FBE3C04842A809,082-900-001,44444444,AMAZON AU NAB,261.45,0,173968.33,DR,REF693267,NAB,Business
18-08-2025 16:10,NAB0E995B9450404859BA92,082-900-001,44444444,ZOOM NAB,438.23,0,173530.1,DR,REF647099,NAB,Business
18-08-2025 16:10,NAB64452F5DC8264CD888AF,082-900-001,44444444,BWS NAB,782.58,0,172747.52,DR,REF629504,NAB,Business
18-08-2025 16:27,NAB4675A68B18644B71A003,082-900-001,44444444,LIQUORLAND NAB,490.29,0,172257.23,DR,REF903127,NAB,Business
18-08-2025 16:42,NAB9F35569F13D340C98862,082-900-001,44444444,AMAZON AU NAB,82.28,0,172174.95,DR,REF926060,NAB,Business
18-08-2025 16:55,NAB5ABBCEAAEECB4ABC9320,082-900-001,44444444,SHELL NAB,62.94,0,172112.01,DR,REF880841,NAB,Business
18-08-2025 17:08,NABA08C3CE8EFFC4FF4B3D0,082-900-001,44444444,BANK FEE NAB,372.7,0,171739.31,DR,REF534572,NAB,Business
18-08-2025 17:10,NAB4E06E09A23354F38BA70,082-900-001,44444444,7-ELEVEN NAB,34.5,0,171704.81,DR,REF993073,NAB,Business
18-08-2025 17:57,NAB2658A47D1BE44BB698D6,082-900-001,44444444,BANK FEE NAB,218.47,0,171486.34,DR,REF863221,NAB,Business
18-08-2025 18:46,NABC5232A919D3F404BAB67,082-900-001,44444444,TAFE BOOKSHOP NAB,281.12,0,171205.22,DR,REF898243,NAB,Business
18-08-2025 18:49,NAB3625254B1AF94A34AD30,082-900-001,44444444,SHELL NAB,631.97,0,170573.25,DR,REF621130,NAB,Business
18-08-2025 19:23,NAB3235F53F499C45E3B31C,082-900-001,44444444,PAYPAL *NETFLIX NAB,997.19,0,169576.06,DR,REF561672,NAB,Business
18-08-2025 19:31,NAB9AF970D1A22B4CBD82A6,082-900-001,44444444,PAYROLL CREDIT NAB,0,290.85,169866.91,CR,REF918056,NAB,Business
18-08-2025 19:47,NAB2C03015D737B4A42BB9B,082-900-001,44444444,AMAZON AU NAB,338.26,0,169528.65,DR,REF738575,NAB,Business
18-08-2025 20:36,NAB2FAF46D1CBBD4AA99940,082-900-001,44444444,ALDI NAB,51.77,0,169476.88,DR,REF525207,NAB,Business
18-08-2025 21:06,NAB9D436940D3BA46D7845E,082-900-001,44444444,BP NAB,65.14,0,169411.74,DR,REF314734,NAB,Business
18-08-2025 21:17,NABDFC3178B408545628089,082-900-001,44444444,PAYMENT GATEWAY NAB,318.43,0,169093.31,DR,REF930499,NAB,Business
18-08-2025 21:40,NAB814373EF81B14ECEAD27,082-900-001,44444444,MCDONALDS NAB,126.01,0,168967.3,DR,REF726817,NAB,Business
18-08-2025 21:43,NABC2CCE4DF17E240908214,082-900-001,44444444,ALDI NAB,522.03,0,168445.27,DR,REF750336,NAB,Business
18-08-2025 22:12,NAB9C370DB0E9CA46FD8FC6,082-900-001,44444444,BIGW NAB,132.81,0,168312.46,DR,REF709073,NAB,Business
18-08-2025 22:15,NAB2875F4A73FA84125B480,082-900-001,44444444,AMAZON AU NAB,346.95,0,167965.51,DR,REF924617,NAB,Business
18-08-2025 22:20,NABE2D276134918416EB9CE,082-900-001,44444444,RAILWAY STATION NAB,336.04,0,167629.47,DR,REF990914,NAB,Business
18-08-2025 22:56,NAB1B56EAC5717B43A6A095,082-900-001,44444444,CITYLINK NAB,1018.33,0,166611.14,DR,REF433419,NAB,Business
18-08-2025 23:10,NAB8F3B959188DA4FE39397,082-900-001,44444444,LIQUORLAND NAB,46.05,0,166565.09,DR,REF681164,NAB,Business
18-08-2025 23:14,NAB14673E1E8E7946A29788,082-900-001,44444444,PAYMENT GATEWAY NAB,1306.04,0,165259.05,DR,REF169968,NAB,Business
18-08-2025 23:49,NAB191647C9BE0949C590D3,082-900-001,44444444,KFC NAB,306.99,0,164952.06,DR,REF675401,NAB,Business
19-08-2025 00:18,NAB9DA3ACA7964F4BB6AEA6,082-900-001,44444444,DOMINO'S PIZZA NAB,396.49,0,164555.57,DR,REF961467,NAB,Business
19-08-2025 00:36,NAB61330ED23B4E4695A518,082-900-001,44444444,ZOOM NAB,424.53,0,164131.04,DR,REF771710,NAB,Business
19-08-2025 01:06,NAB767F9A6F414D43AD9D71,082-900-001,44444444,STARBUCKS NAB,43.82,0,164087.22,DR,REF117155,NAB,Business
19-08-2025 01:16,NABFBE06FC3332A42E19C94,082-900-001,44444444,MENULOG NAB,146.91,0,163940.31,DR,REF448150,NAB,Business
19-08-2025 01:30,NAB68A99A4F3A36422BA0BE,082-900-001,44444444,TAFE BOOKSHOP NAB,267.43,0,163672.88,DR,REF406333,NAB,Business
19-08-2025 01:33,NAB9DD432B4C4AE455693BE,082-900-001,44444444,SHELL NAB,20.32,0,163652.56,DR,REF574942,NAB,Business
19-08-2025 01:37,NAB72F1A511F9934ED3B7F5,082-900-001,44444444,SPOTIFY NAB,746.13,0,162906.43,DR,REF774220,NAB,Business
19-08-2025 02:59,NABA04D1858B27E4D5C9815,082-900-001,44444444,FLIXBUS NAB,555.62,0,162350.81,DR,REF362664,NAB,Business
19-08-2025 03:26,NAB578FEEEE0EF94DB9AFF8,082-900-001,44444444,COMPANY PAYROLL NAB,0,120.74,162471.55,CR,REF653578,NAB,Business
19-08-2025 03:27,NAB9F85E48AF43A4983BBDE,082-900-001,44444444,AMAZON AU NAB,593.88,0,161877.67,DR,REF167398,NAB,Business
19-08-2025 03:35,NABB7C24D47C8F44103BD5A,082-900-001,44444444,MENULOG NAB,130.06,0,161747.61,DR,REF570576,NAB,Business
19-08-2025 03:38,NAB0989B542CAA94D85B7D7,082-900-001,44444444,APPLE NAB,451.93,0,161295.68,DR,REF567385,NAB,Business
19-08-2025 04:17,NABAAF39A23EE784AF5A4EF,082-900-001,44444444,WOOLWORTHS NAB,567.54,0,160728.14,DR,REF141144,NAB,Business
19-08-2025 04:20,NABF74239E63F224D31B708,082-900-001,44444444,PAYPAL *NETFLIX NAB,263.45,0,160464.69,DR,REF360872,NAB,Business
19-08-2025 04:42,NAB0C4BF53D37204DEAA48F,082-900-001,44444444,INTERNET TRANSFER NAB,49.95,0,160414.74,DR,REF470497,NAB,Business
19-08-2025 05:21,NABED241BF6F52D42ACBAAA,082-900-001,44444444,RAILWAY STATION NAB,487.64,0,159927.1,DR,REF730423,NAB,Business
19-08-2025 05:24,NABC62030E6B98A4A30BD32,082-900-001,44444444,ALDI NAB,154.9,0,159772.2,DR,REF861601,NAB,Business
19-08-2025 05:35,NAB0ABF0DE4C05F4A3193F9,082-900-001,44444444,MENULOG NAB,63.43,0,159708.77,DR,REF242998,NAB,Business
19-08-2025 05:40,NAB8ADC65F6FC604478A884,082-900-001,44444444,ZOOM NAB,476.07,0,159232.7,DR,REF945302,NAB,Business
19-08-2025 05:48,NAB4810E1CAA9714C4A8394,082-900-001,44444444,PAYMENT GATEWAY NAB,242.81,0,158989.89,DR,REF481063,NAB,Business
19-08-2025 05:51,NABE743675FFB87413DBB55,082-900-001,44444444,COMPANY PAYROLL NAB,0,2129.46,161119.35,CR,REF265574,NAB,Business
19-08-2025 06:54,NAB784C644AF0BF4978808F,082-900-001,44444444,MCDONALDS NAB,128.77,0,160990.58,DR,REF192490,NAB,Business
19-08-2025 07:09,NAB449773C66F4A4F12BAFC,082-900-001,44444444,ALDI NAB,664.42,0,160326.16,DR,REF460590,NAB,Business
19-08-2025 07:28,NAB40E9ABC4E2414761AFB7,082-900-001,44444444,COLES NAB,158.89,0,160167.27,DR,REF329932,NAB,Business
19-08-2025 07:41,NAB18100E92551F4E0CA4CE,082-900-001,44444444,ZOOM NAB,202.07,0,159965.2,DR,REF345324,NAB,Business
19-08-2025 07:53,NAB4D3DBA6B6B534995B583,082-900-001,44444444,SHELL NAB,412.11,0,159553.09,DR,REF793767,NAB,Business
19-08-2025 07:54,NABF899E2E064674100ADBA,082-900-001,44444444,STARBUCKS NAB,33.78,0,159519.31,DR,REF732409,NAB,Business
19-08-2025 08:07,NAB90DD42F9B6114A6C977E,082-900-001,44444444,AMAZON AU NAB,297,0,159222.31,DR,REF674423,NAB,Business
19-08-2025 08:29,NAB1D9953099B674F138BA4,082-900-001,44444444,SHELL NAB,128.2,0,159094.11,DR,REF199923,NAB,Business
19-08-2025 08:39,NAB85D529725AFD436BAA3E,082-900-001,44444444,HARVEY NORMAN NAB,378.46,0,158715.65,DR,REF989030,NAB,Business
19-08-2025 09:02,NAB67E5476657D347488E09,082-900-001,44444444,COMPANY PAYROLL NAB,0,3848.93,162564.58,CR,REF677552,NAB,Business
19-08-2025 09:05,NABEA7DB440B1CF4F70A53A,082-900-001,44444444,SALARY PAYMENT NAB,0,416.7,162981.28,CR,REF617228,NAB,Business
19-08-2025 09:16,NAB813FFD7D71D44335B958,082-900-001,44444444,PAY - SALARY NAB,0,4182.3,167163.58,CR,REF995788,NAB,Business
19-08-2025 09:34,NAB8454B01E8DDC4448B316,082-900-001,44444444,PAY - SALARY NAB,0,3837.06,171000.64,CR,REF312526,NAB,Business
19-08-2025 09:38,NAB9635DC5CEF2144F98963,082-900-001,44444444,JB HI-FI NAB,43.86,0,170956.78,DR,REF688016,NAB,Business
19-08-2025 10:03,NAB67E213098D594F34AAD9,082-900-001,44444444,WAGES CREDIT NAB,0,1648.13,172604.91,CR,REF754401,NAB,Business
19-08-2025 10:20,INTE15100D9DA5E4A85A1D3,082-900-001,44444444,TRANSFER FROM CBA 22222222,0,1312.85,173917.76,CR,INT-33871,NAB,Business
19-08-2025 11:14,NAB9DA057D646B04152B6FA,082-900-001,44444444,UBER EATS NAB,369.22,0,173548.54,DR,REF615636,NAB,Business
19-08-2025 11:44,NABC3768954D9B947D9B2FB,082-900-001,44444444,APPLE NAB,240.9,0,173307.64,DR,REF184683,NAB,Business
19-08-2025 11:46,NABABF104EF6F8E4F6B98DB,082-900-001,44444444,MENULOG NAB,195.59,0,173112.05,DR,REF511229,NAB,Business
19-08-2025 14:19,NAB1FF1899837B7468792C7,082-900-001,44444444,PAY - SALARY NAB,0,796.79,173908.84,CR,REF510677,NAB,Business
19-08-2025 14:35,NAB20AD7124FAE74546A598,082-900-001,44444444,DOMINO'S PIZZA NAB,64.68,0,173844.16,DR,REF565726,NAB,Business
19-08-2025 14:39,NAB190C37F12D3441828B8C,082-900-001,44444444,7-ELEVEN NAB,41.27,0,173802.89,DR,REF918780,NAB,Business
19-08-2025 15:58,NABD61F7279D616458F8696,082-900-001,44444444,BANK FEE NAB,282.6,0,173520.29,DR,REF254605,NAB,Business
19-08-2025 16:35,NABB65B7AB8FBA84EFFA7A0,082-900-001,44444444,WOOLWORTHS NAB,357.95,0,173162.34,DR,REF786569,NAB,Business
19-08-2025 16:37,NAB8EDEF4A616944E7ABFAF,082-900-001,44444444,INTERNET TRANSFER NAB,553.27,0,172609.07,DR,REF302808,NAB,Business
19-08-2025 16:43,NAB6E05EC58E9534B1D94EB,082-900-001,44444444,UBER EATS NAB,772.62,0,171836.45,DR,REF190166,NAB,Business
19-08-2025 16:48,NABFB9262925D4E42028BB4,082-900-001,44444444,JB HI-FI NAB,46.23,0,171790.22,DR,REF789070,NAB,Business
19-08-2025 17:20,NAB3AD6BB0C727144DD8DC8,082-900-001,44444444,PAY - SALARY NAB,0,7907.37,179697.59,CR,REF264706,NAB,Business
19-08-2025 18:45,INTFEDB8891D7634BDFB7E3,082-900-001,44444444,TRANSFER TO CBA 33333333,1094.67,0,178602.92,DR,INT-28782,NAB,Business
19-08-2025 19:08,NABF84228D991E5448BB119,082-900-001,44444444,INTERNET TRANSFER NAB,720.38,0,177882.54,DR,REF286002,NAB,Business
19-08-2025 19:12,NAB4606B2A5771C454AA51E,082-900-001,44444444,ZOOM NAB,472.79,0,177409.75,DR,REF999479,NAB,Business
19-08-2025 19:42,NAB32579FCD260B45C8A0F5,082-900-001,44444444,ALDI NAB,950.85,0,176458.9,DR,REF463706,NAB,Business
19-08-2025 19:52,NABA1659488731546AAAA0E,082-900-001,44444444,MENULOG NAB,488.94,0,175969.96,DR,REF184023,NAB,Business
19-08-2025 20:06,INT52F07D6BF2614A20A97C,082-900-001,44444444,TRANSFER FROM ANZ 11111111,0,1722.43,177692.39,CR,INT-63805,NAB,Business
19-08-2025 20:43,NABBEF35862CDA54EF389CA,082-900-001,44444444,WOOLWORTHS NAB,185.39,0,177507,DR,REF617662,NAB,Business
19-08-2025 20:46,NAB19F9FAA217834CCB9970,082-900-001,44444444,FLIXBUS NAB,289.59,0,177217.41,DR,REF231395,NAB,Business
19-08-2025 20:49,NAB2A80F10F9B4D4A8DAB16,082-900-001,44444444,STARBUCKS NAB,158.08,0,177059.33,DR,REF383090,NAB,Business
19-08-2025 20:50,NABFAD2494E972E451F8193,082-900-001,44444444,STARBUCKS NAB,2399.53,0,174659.8,DR,REF792169,NAB,Business
19-08-2025 20:53,NABDF108A69CBB847D2BBEB,082-900-001,44444444,DOMINO'S PIZZA NAB,375.05,0,174284.75,DR,REF327000,NAB,Business
19-08-2025 21:16,NABF586B36CD6FE4A2BB849,082-900-001,44444444,HARVEY NORMAN NAB,659.97,0,173624.78,DR,REF475767,NAB,Business
19-08-2025 21:23,NAB66EE786D5FBB4EFD8125,082-900-001,44444444,MENULOG NAB,255.79,0,173368.99,DR,REF375849,NAB,Business
19-08-2025 22:07,NABAFA84A24987B4BE68916,082-900-001,44444444,BANK FEE NAB,38.7,0,173330.29,DR,REF685551,NAB,Business
19-08-2025 22:21,NABD961E9FB3F3342C3B564,082-900-001,44444444,DOMINO'S PIZZA NAB,383.53,0,172946.76,DR,REF923350,NAB,Business
19-08-2025 22:58,NABA858072584354376B69F,082-900-001,44444444,COLES NAB,419.09,0,172527.67,DR,REF633143,NAB,Business
19-08-2025 23:25,NABD350162BAA6342188959,082-900-001,44444444,ZOOM NAB,96.29,0,172431.38,DR,REF829597,NAB,Business
19-08-2025 23:58,NAB97610349C83F41D6ACB0,082-900-001,44444444,7-ELEVEN NAB,522,0,171909.38,DR,REF610750,NAB,Business
20-08-2025 00:05,NAB09CE371F72814CD5B792,082-900-001,44444444,TAFE BOOKSHOP NAB,409.73,0,171499.65,DR,REF249508,NAB,Business
20-08-2025 00:05,NABA8769C10EC464FDE81CD,082-900-001,44444444,MCDONALDS NAB,134.03,0,171365.62,DR,REF360869,NAB,Business
20-08-2025 00:13,NAB8B249CBC8F6F4F0A90AB,082-900-001,44444444,ZOOM NAB,271.93,0,171093.69,DR,REF535552,NAB,Business
20-08-2025 00:40,NABBB41EECB4904402F86F4,082-900-001,44444444,ALDI NAB,886.83,0,170206.86,DR,REF195161,NAB,Business
20-08-2025 00:40,NAB33559BBB3CE14E5B9520,082-900-001,44444444,SHELL NAB,178.54,0,170028.32,DR,REF539150,NAB,Business
20-08-2025 00:42,NABD4A4ED215DE742038E1F,082-900-001,44444444,PAYPAL *NETFLIX NAB,231.51,0,169796.81,DR,REF463891,NAB,Business
20-08-2025 00:43,NAB2D04CFFCF4694180B128,082-900-001,44444444,PAYMENT GATEWAY NAB,288.66,0,169508.15,DR,REF143664,NAB,Business
20-08-2025 02:08,NAB43F7E0DD2A4D46A58EE1,082-900-001,44444444,UBER EATS NAB,181.45,0,169326.7,DR,REF648105,NAB,Business
20-08-2025 02:10,NABE926C4718B83457BB3FF,082-900-001,44444444,7-ELEVEN NAB,208.85,0,169117.85,DR,REF768681,NAB,Business
20-08-2025 02:20,NABACF12ADB9DE84D9086B9,082-900-001,44444444,BANK FEE NAB,904.4,0,168213.45,DR,REF700073,NAB,Business
20-08-2025 02:25,NAB39EE52FF11DC4880BABB,082-900-001,44444444,COMPANY PAYROLL NAB,0,541.74,168755.19,CR,REF304820,NAB,Business
20-08-2025 02:33,NAB07190F46EA584E58B294,082-900-001,44444444,UBER EATS NAB,334.49,0,168420.7,DR,REF569252,NAB,Business
20-08-2025 03:18,NAB6A31D62593B645739670,082-900-001,44444444,UBER EATS NAB,614.02,0,167806.68,DR,REF176733,NAB,Business
20-08-2025 03:24,NAB8E10135F7D304D60B1EC,082-900-001,44444444,PAY - SALARY NAB,0,4267.5,172074.18,CR,REF871678,NAB,Business
20-08-2025 03:33,NAB5ED107210C92486F8835,082-900-001,44444444,UBER EATS NAB,295.32,0,171778.86,DR,REF577092,NAB,Business
20-08-2025 04:19,NAB22E13CC05D2E4912ADE8,082-900-001,44444444,TAFE BOOKSHOP NAB,155.12,0,171623.74,DR,REF877832,NAB,Business
20-08-2025 04:45,NAB589AF75DB7A64124872F,082-900-001,44444444,CITYLINK NAB,183.46,0,171440.28,DR,REF415599,NAB,Business
20-08-2025 04:48,NABFF138E28544C4E109758,082-900-001,44444444,SALARY PAYMENT NAB,0,81.19,171521.47,CR,REF722118,NAB,Business
20-08-2025 05:08,NAB489F441CAE6F4023B6EC,082-900-001,44444444,TAFE BOOKSHOP NAB,209.74,0,171311.73,DR,REF600362,NAB,Business
20-08-2025 05:20,NAB24623ED2E47D49E380E5,082-900-001,44444444,PAYMENT GATEWAY NAB,66.07,0,171245.66,DR,REF940817,NAB,Business
20-08-2025 05:30,INT3570419F64EA4B2EAFE2,082-900-001,44444444,TRANSFER TO ANZ 11111111,739.53,0,170506.13,DR,INT-39381,NAB,Business
20-08-2025 05:41,NABBCE1555EC0544EACB0CE,082-900-001,44444444,WOOLWORTHS NAB,85.37,0,170420.76,DR,REF709839,NAB,Business
20-08-2025 06:00,NAB417234C51EFA4AC7B9CB,082-900-001,44444444,TAFE BOOKSHOP NAB,84.13,0,170336.63,DR,REF708359,NAB,Business
20-08-2025 06:15,NAB361D5E59FE6A4BC19960,082-900-001,44444444,STARBUCKS NAB,179.61,0,170157.02,DR,REF998717,NAB,Business
20-08-2025 06:17,NABF680BD7894C543639A68,082-900-001,44444444,CITYLINK NAB,116.56,0,170040.46,DR,REF526099,NAB,Business
20-08-2025 06:32,NAB2252DF2D93974E3A976D,082-900-001,44444444,BIGW NAB,54.8,0,169985.66,DR,REF669994,NAB,Business
20-08-2025 06:40,NABA2649CEAE54F48B0BDDF,082-900-001,44444444,PAYMENT GATEWAY NAB,393.88,0,169591.78,DR,REF984936,NAB,Business
20-08-2025 07:19,NAB154FD63A4EA744AD98EC,082-900-001,44444444,CITYLINK NAB,85.95,0,169505.83,DR,REF970484,NAB,Business
20-08-2025 07:28,NABD22FBFA659924F39B862,082-900-001,44444444,BIGW NAB,56.72,0,169449.11,DR,REF667946,NAB,Business
20-08-2025 07:34,NABC3CAB4BC4B10435884C5,082-900-001,44444444,RAILWAY STATION NAB,256.03,0,169193.08,DR,REF184947,NAB,Business
20-08-2025 07:45,NAB6C391FB429B442F3BAC2,082-900-001,44444444,CITYLINK NAB,78.85,0,169114.23,DR,REF191393,NAB,Business
20-08-2025 07:51,NAB3C52ADB8E9E54840B162,082-900-001,44444444,ZOOM NAB,169.07,0,168945.16,DR,REF872593,NAB,Business
20-08-2025 08:26,NABA3233463370F4D978013,082-900-001,44444444,BANK FEE NAB,115.87,0,168829.29,DR,REF433848,NAB,Business
20-08-2025 08:33,NAB0705D9BB830C4DF8981C,082-900-001,44444444,ZOOM NAB,475.24,0,168354.05,DR,REF261570,NAB,Business
20-08-2025 08:34,NAB2705321A46F148E4BDA3,082-900-001,44444444,COLES NAB,142.01,0,168212.04,DR,REF995313,NAB,Business
20-08-2025 08:38,NAB1E0F6E04CD8E4A448D24,082-900-001,44444444,JB HI-FI NAB,519.45,0,167692.59,DR,REF833960,NAB,Business
20-08-2025 08:42,NAB6C4F964E84DF4232A598,082-900-001,44444444,INTERNET TRANSFER NAB,79.94,0,167612.65,DR,REF469859,NAB,Business
20-08-2025 08:46,NABCF6B1374F7A64584AF0D,082-900-001,44444444,ZOOM NAB,721.73,0,166890.92,DR,REF813373,NAB,Business
20-08-2025 09:01,NABB63E28D89ABF411FAB22,082-900-001,44444444,COMPANY PAYROLL NAB,0,5227.93,172118.85,CR,REF846812,NAB,Business
20-08-2025 09:02,NABD41D488D390D4D67A66C,082-900-001,44444444,COMPANY PAYROLL NAB,0,2486.91,174605.76,CR,REF177723,NAB,Business
20-08-2025 09:03,NABFDD162ABFD1E41B797CC,082-900-001,44444444,CITYLINK NAB,71.25,0,174534.51,DR,REF939613,NAB,Business
20-08-2025 09:45,NABE9EDC3F4233346EF98D5,082-900-001,44444444,MENULOG NAB,118.22,0,174416.29,DR,REF258833,NAB,Business
20-08-2025 09:49,NAB47CF392AB10C423897BD,082-900-001,44444444,UBER EATS NAB,102.44,0,174313.85,DR,REF949304,NAB,Business
20-08-2025 09:55,NAB50A28E2BB8274946A3C1,082-900-001,44444444,PAY - SALARY NAB,0,164.4,174478.25,CR,REF248132,NAB,Business
20-08-2025 10:37,NABA112D68231F6411F83C7,082-900-001,44444444,AMAZON AU NAB,16.8,0,174461.45,DR,REF749951,NAB,Business
20-08-2025 10:45,NAB21D17005961149B0B55D,082-900-001,44444444,KFC NAB,140.57,0,174320.88,DR,REF492921,NAB,Business
20-08-2025 10:55,NABFB6CE19F3DB4427DB566,082-900-001,44444444,SALARY PAYMENT NAB,0,2256.15,176577.03,CR,REF582483,NAB,Business
20-08-2025 11:09,NAB7C53DF8AB4344C95A30B,082-900-001,44444444,LIQUORLAND NAB,463.27,0,176113.76,DR,REF569148,NAB,Business
20-08-2025 11:22,NABB2DFD7BCB70044649FE7,082-900-001,44444444,BP NAB,967.79,0,175145.97,DR,REF445726,NAB,Business
20-08-2025 11:34,NABA695CA39017C45BEBC08,082-900-001,44444444,BP NAB,526.89,0,174619.08,DR,REF715653,NAB,Business
20-08-2025 11:35,NABA1BE3C6C6E014AC8ACE0,082-900-001,44444444,HARVEY NORMAN NAB,101.65,0,174517.43,DR,REF655636,NAB,Business
20-08-2025 11:41,NAB01E860F13BE648F4960E,082-900-001,44444444,TAFE BOOKSHOP NAB,68.41,0,174449.02,DR,REF848231,NAB,Business
20-08-2025 11:48,NAB11CEDAC023564EDABA71,082-900-001,44444444,DOMINO'S PIZZA NAB,124.8,0,174324.22,DR,REF859246,NAB,Business
20-08-2025 11:48,NABF4022B45C7764394A4FE,082-900-001,44444444,ZOOM NAB,106.9,0,174217.32,DR,REF124590,NAB,Business
20-08-2025 12:13,NAB90DD7A8DD1A148A1AB1F,082-900-001,44444444,AMAZON AU NAB,67.41,0,174149.91,DR,REF727039,NAB,Business
20-08-2025 12:22,NAB8B0BD66DD14F42A2B1F8,082-900-001,44444444,BIGW NAB,331.31,0,173818.6,DR,REF849189,NAB,Business
20-08-2025 12:28,NAB2CA85CA8E8B74E13A4A6,082-900-001,44444444,COMPANY PAYROLL NAB,0,6967.45,180786.05,CR,REF286090,NAB,Business
20-08-2025 12:33,NAB15A4A64D45884F86A88D,082-900-001,44444444,KFC NAB,662.38,0,180123.67,DR,REF607288,NAB,Business
20-08-2025 12:59,NABF3122093A32F499AB0A3,082-900-001,44444444,JB HI-FI NAB,424.42,0,179699.25,DR,REF811594,NAB,Business
20-08-2025 13:07,NAB6FB0AC16ED1541098EEB,082-900-001,44444444,HARVEY NORMAN NAB,74.21,0,179625.04,DR,REF235356,NAB,Business
20-08-2025 14:11,NAB27C01E6E8BF14E1384A4,082-900-001,44444444,WAGES CREDIT NAB,0,2040.11,181665.15,CR,REF756791,NAB,Business
20-08-2025 14:11,NAB331EB350257C4D9BA32D,082-900-001,44444444,MENULOG NAB,73.73,0,181591.42,DR,REF710528,NAB,Business
20-08-2025 15:14,NABB9F694276A984D29A7E9,082-900-001,44444444,SPOTIFY NAB,148.63,0,181442.79,DR,REF400805,NAB,Business
20-08-2025 15:39,NABADE5AA90EB734BE38048,082-900-001,44444444,COMPANY PAYROLL NAB,0,5196.01,186638.8,CR,REF894406,NAB,Business
20-08-2025 15:39,NABF7C8CF03D01A42B8BD67,082-900-001,44444444,SPOTIFY NAB,403.51,0,186235.29,DR,REF178728,NAB,Business
20-08-2025 15:52,NABF3812422BD234449A8E4,082-900-001,44444444,BANK FEE NAB,57.44,0,186177.85,DR,REF226836,NAB,Business
20-08-2025 15:52,NAB97B1053CC71C4B99AB90,082-900-001,44444444,SPOTIFY NAB,77.41,0,186100.44,DR,REF620572,NAB,Business
20-08-2025 15:57,NABBA8EDE5813FC486BA89A,082-900-001,44444444,RAILWAY STATION NAB,119.32,0,185981.12,DR,REF540464,NAB,Business
20-08-2025 16:06,NAB39D5ADA00D4A44CFB74D,082-900-001,44444444,BP NAB,493.74,0,185487.38,DR,REF421005,NAB,Business
20-08-2025 16:14,NAB8F93FB815087477FACB6,082-900-001,44444444,INTERNET TRANSFER NAB,283.26,0,185204.12,DR,REF621869,NAB,Business
20-08-2025 16:33,NAB19961C1F1D684E748534,082-900-001,44444444,BIGW NAB,481.3,0,184722.82,DR,REF240057,NAB,Business
20-08-2025 16:41,NABEFCBC579070A4F54AA33,082-900-001,44444444,TAFE BOOKSHOP NAB,445.92,0,184276.9,DR,REF860383,NAB,Business
20-08-2025 16:43,NAB874E0E52247846109B55,082-900-001,44444444,7-ELEVEN NAB,62.82,0,184214.08,DR,REF903644,NAB,Business
20-08-2025 16:58,INT37BF2757AA1D4F09BBF9,082-900-001,44444444,TRANSFER FROM CBA 22222222,0,890.56,185104.64,CR,INT-93756,NAB,Business
20-08-2025 17:05,INTC23192EBBEEA4F978F00,082-900-001,44444444,TRANSFER TO CBA 22222222,1264.5,0,183840.14,DR,INT-64548,NAB,Business
20-08-2025 17:12,NABDB46B63C5EF74B9DAB77,082-900-001,44444444,MCDONALDS NAB,928.23,0,182911.91,DR,REF360374,NAB,Business
20-08-2025 17:19,NAB52F57B4D2F654D0FB23F,082-900-001,44444444,COMPANY PAYROLL NAB,0,4489.62,187401.53,CR,REF585977,NAB,Business
20-08-2025 17:22,NABBFF9978998304D85A2F1,082-900-001,44444444,HARVEY NORMAN NAB,396.33,0,187005.2,DR,REF839481,NAB,Business
20-08-2025 17:28,NAB0D8D88D3971C4748B0CB,082-900-001,44444444,STARBUCKS NAB,210.64,0,186794.56,DR,REF184599,NAB,Business
20-08-2025 17:43,NABDC9011A5D5BC43C2B2CD,082-900-001,44444444,STARBUCKS NAB,161.6,0,186632.96,DR,REF181890,NAB,Business
20-08-2025 18:11,NABFC1FD378863545959A1F,082-900-001,44444444,APPLE NAB,121.77,0,186511.19,DR,REF722769,NAB,Business
20-08-2025 18:32,INT8165888A8DA946D1BA15,082-900-001,44444444,TRANSFER TO ANZ 11111111,1018.81,0,185492.38,DR,INT-61417,NAB,Business
20-08-2025 18:46,NABFF4F5A02958D444F8711,082-900-001,44444444,AMAZON AU NAB,338.66,0,185153.72,DR,REF933670,NAB,Business
20-08-2025 19:10,NAB214F1D6B75C240B3B642,082-900-001,44444444,HARVEY NORMAN NAB,1096.49,0,184057.23,DR,REF679194,NAB,Business
20-08-2025 19:17,NAB435C4A05E55F472AA947,082-900-001,44444444,PAYROLL CREDIT NAB,0,7843.9,191901.13,CR,REF119191,NAB,Business
20-08-2025 20:15,NAB9F596795AB00482CBA69,082-900-001,44444444,BIGW NAB,213.63,0,191687.5,DR,REF891682,NAB,Business
20-08-2025 20:15,INTC77C5120336A422793E3,082-900-001,44444444,TRANSFER TO ANZ 11111111,150.82,0,191536.68,DR,INT-58306,NAB,Business
20-08-2025 20:20,NAB9B579197391C43DBBBDF,082-900-001,44444444,UBER EATS NAB,54.38,0,191482.3,DR,REF490027,NAB,Business
20-08-2025 21:19,NAB01F262E328A4452A8834,082-900-001,44444444,WOOLWORTHS NAB,157.71,0,191324.59,DR,REF786987,NAB,Business
20-08-2025 21:24,NAB9ECCA5F1A80240F38A3C,082-900-001,44444444,BANK FEE NAB,321.46,0,191003.13,DR,REF838049,NAB,Business
20-08-2025 21:46,NABB0B652A53861483289DE,082-900-001,44444444,PAYPAL *NETFLIX NAB,283.43,0,190719.7,DR,REF720921,NAB,Business
20-08-2025 22:11,NABEF86301EA217462BA082,082-900-001,44444444,PAYMENT GATEWAY NAB,292.42,0,190427.28,DR,REF125033,NAB,Business
20-08-2025 22:21,NAB5FEC8F6B4A814C24B230,082-900-001,44444444,BANK FEE NAB,275.79,0,190151.49,DR,REF244634,NAB,Business
20-08-2025 22:37,NAB6DB25D75DF724F968B42,082-900-001,44444444,PAYROLL CREDIT NAB,0,5655.2,195806.69,CR,REF759599,NAB,Business
20-08-2025 22:49,NAB284667992D594031BFD7,082-900-001,44444444,COLES NAB,1020.47,0,194786.22,DR,REF989646,NAB,Business
20-08-2025 22:49,NABA4381CEDF8D5495697DB,082-900-001,44444444,UBER EATS NAB,68.99,0,194717.23,DR,REF719121,NAB,Business
20-08-2025 23:05,NAB3E9B9608A29949AD99DC,082-900-001,44444444,KFC NAB,57.04,0,194660.19,DR,REF285418,NAB,Business
20-08-2025 23:15,NAB616DCBCAF14143D3824D,082-900-001,44444444,RAILWAY STATION NAB,482.14,0,194178.05,DR,REF641737,NAB,Business
21-08-2025 00:05,NAB9D657C1A2B6A4B2AB018,082-900-001,44444444,KFC NAB,183.89,0,193994.16,DR,REF580926,NAB,Business
21-08-2025 00:11,NAB457E697978C342928D36,082-900-001,44444444,COLES NAB,147.98,0,193846.18,DR,REF820675,NAB,Business
21-08-2025 00:14,NAB85CEDAC5FF454875A1A5,082-900-001,44444444,SHELL NAB,85.55,0,193760.63,DR,REF865921,NAB,Business
21-08-2025 00:17,NAB5954DB3A2F2946B79E8B,082-900-001,44444444,RAILWAY STATION NAB,744.46,0,193016.17,DR,REF342968,NAB,Business
21-08-2025 00:28,NABE3911B90EA9B470FABE4,082-900-001,44444444,RAILWAY STATION NAB,222.63,0,192793.54,DR,REF244422,NAB,Business
21-08-2025 00:47,NABDC396DC010E54A129058,082-900-001,44444444,FLIXBUS NAB,291.19,0,192502.35,DR,REF916537,NAB,Business
21-08-2025 00:51,INTE69EB252B5E9434BA450,082-900-001,44444444,TRANSFER TO CBA 22222222,602.5,0,191899.85,DR,INT-47013,NAB,Business
21-08-2025 00:57,INTBA21DA91452245FCB843,082-900-001,44444444,TRANSFER TO CBA 22222222,1901.33,0,189998.52,DR,INT-87177,NAB,Business
21-08-2025 01:11,NABF1F1FF221A8B4E7998E4,082-900-001,44444444,MCDONALDS NAB,90.7,0,189907.82,DR,REF729726,NAB,Business
21-08-2025 01:12,NABBDEA4A6D4D214FF69C45,082-900-001,44444444,COLES NAB,233.65,0,189674.17,DR,REF434914,NAB,Business
21-08-2025 01:18,NAB31BA1E788F4E4E6095F0,082-900-001,44444444,ALDI NAB,1288.94,0,188385.23,DR,REF866338,NAB,Business
21-08-2025 02:28,NAB64F59362488A486C9500,082-900-001,44444444,RAILWAY STATION NAB,443.48,0,187941.75,DR,REF599042,NAB,Business
21-08-2025 03:14,NAB5B27A9E24D9149FBAAE5,082-900-001,44444444,MCDONALDS NAB,469.35,0,187472.4,DR,REF605798,NAB,Business
21-08-2025 03:14,NAB3F1E151A77D24650B299,082-900-001,44444444,PAYPAL *NETFLIX NAB,542.04,0,186930.36,DR,REF637611,NAB,Business
21-08-2025 04:25,NABFE3E4F79F16B4DABA33B,082-900-001,44444444,PAY - SALARY NAB,0,2576.92,189507.28,CR,REF833979,NAB,Business
21-08-2025 05:09,NABE72125383FF0419EBE1C,082-900-001,44444444,SPOTIFY NAB,56.43,0,189450.85,DR,REF436061,NAB,Business
21-08-2025 05:23,NAB39452F575EFF417C9AD9,082-900-001,44444444,BIGW NAB,379.44,0,189071.41,DR,REF969559,NAB,Business
21-08-2025 05:55,NAB8AA90536D8E74A11A907,082-900-001,44444444,PAYPAL *NETFLIX NAB,129.63,0,188941.78,DR,REF886840,NAB,Business
21-08-2025 06:01,NAB3CED489C732C4AE78643,082-900-001,44444444,ALDI NAB,903.62,0,188038.16,DR,REF620220,NAB,Business
21-08-2025 06:36,NAB19202E0CF33B44DDB74E,082-900-001,44444444,FLIXBUS NAB,206.26,0,187831.9,DR,REF553444,NAB,Business
21-08-2025 06:48,NAB3CD98741A5954846ACD2,082-900-001,44444444,CITYLINK NAB,165.35,0,187666.55,DR,REF394095,NAB,Business
21-08-2025 06:48,NABFFB0BE97D96E4972874A,082-900-001,44444444,BIGW NAB,603.92,0,187062.63,DR,REF764149,NAB,Business
21-08-2025 06:55,NABFDFADF58274D4F6BB4B2,082-900-001,44444444,LIQUORLAND NAB,797.04,0,186265.59,DR,REF960105,NAB,Business
21-08-2025 07:02,NAB6A62F179146546CCA0E4,082-900-001,44444444,7-ELEVEN NAB,274.08,0,185991.51,DR,REF510637,NAB,Business
21-08-2025 07:18,NABB45898B80C3740B2B702,082-900-001,44444444,BIGW NAB,323.17,0,185668.34,DR,REF983930,NAB,Business
21-08-2025 07:19,NAB22A2D72D3E3E45A8B6D4,082-900-001,44444444,KFC NAB,110.61,0,185557.73,DR,REF306036,NAB,Business
21-08-2025 07:29,NABF4EA2242238743E9B314,082-900-001,44444444,WOOLWORTHS NAB,280.3,0,185277.43,DR,REF192926,NAB,Business
21-08-2025 07:48,NAB8F2F6E63A8534291A291,082-900-001,44444444,COLES NAB,475.97,0,184801.46,DR,REF251532,NAB,Business
21-08-2025 08:01,NAB5C0C4D683A414F78A7B3,082-900-001,44444444,ALDI NAB,335.8,0,184465.66,DR,REF887800,NAB,Business
21-08-2025 08:17,NABC50C97A0ADD54D01B545,082-900-001,44444444,WOOLWORTHS NAB,525.66,0,183940,DR,REF365616,NAB,Business
21-08-2025 08:31,NAB288D4619B4904AD4A941,082-900-001,44444444,PAYROLL CREDIT NAB,0,4719.77,188659.77,CR,REF374646,NAB,Business
21-08-2025 08:35,NABD8755E363C6547C2B93C,082-900-001,44444444,MENULOG NAB,1712.26,0,186947.51,DR,REF284810,NAB,Business
21-08-2025 08:44,INT3DA5A0874A2C42089A36,082-900-001,44444444,TRANSFER TO CBA 33333333,1903.99,0,185043.52,DR,INT-66389,NAB,Business
21-08-2025 08:50,NAB9F7731694DB448E591EE,082-900-001,44444444,RAILWAY STATION NAB,876.21,0,184167.31,DR,REF601292,NAB,Business
21-08-2025 09:27,NABE4815DEF9F5D4A1FB081,082-900-001,44444444,7-ELEVEN NAB,108.47,0,184058.84,DR,REF141886,NAB,Business
21-08-2025 09:33,NAB5383D2A65B3349558D88,082-900-001,44444444,INTERNET TRANSFER NAB,468.22,0,183590.62,DR,REF402534,NAB,Business
21-08-2025 09:37,NABA15A11F1BED54864BC4C,082-900-001,44444444,TAFE BOOKSHOP NAB,84.77,0,183505.85,DR,REF144725,NAB,Business
21-08-2025 09:42,NAB3073FF439AB041998233,082-900-001,44444444,PAYPAL *NETFLIX NAB,206.61,0,183299.24,DR,REF350183,NAB,Business
21-08-2025 10:50,NABD87D6F29B62743A381F8,082-900-001,44444444,KFC NAB,671.11,0,182628.13,DR,REF570743,NAB,Business
21-08-2025 10:55,NAB852BC2C52E3A489B866C,082-900-001,44444444,FLIXBUS NAB,48.3,0,182579.83,DR,REF577333,NAB,Business
21-08-2025 10:56,NABA50908F0681F46ECAFC2,082-900-001,44444444,TAFE BOOKSHOP NAB,312.85,0,182266.98,DR,REF667289,NAB,Business
21-08-2025 11:43,NAB727BD4261BAB4832A4AE,082-900-001,44444444,BWS NAB,146.46,0,182120.52,DR,REF201986,NAB,Business
21-08-2025 11:45,NABFB36A4C4763143A695D2,082-900-001,44444444,AMAZON AU NAB,338.13,0,181782.39,DR,REF995122,NAB,Business
21-08-2025 12:14,NABCC08A664759748DC8E8F,082-900-001,44444444,STARBUCKS NAB,482.95,0,181299.44,DR,REF310178,NAB,Business
21-08-2025 12:24,NABEC0D405076BC46BC9C18,082-900-001,44444444,BANK FEE NAB,235.16,0,181064.28,DR,REF391815,NAB,Business
21-08-2025 12:30,NAB05EDED75D8A04BD6B04C,082-900-001,44444444,WAGES CREDIT NAB,0,198.53,181262.81,CR,REF900579,NAB,Business
21-08-2025 12:34,NABE6DA74ED95CE4D7A8791,082-900-001,44444444,ALDI NAB,485.82,0,180776.99,DR,REF564510,NAB,Business
21-08-2025 12:54,NAB7FAE32DD95084C8EB5CA,082-900-001,44444444,STARBUCKS NAB,508,0,180268.99,DR,REF615109,NAB,Business
21-08-2025 13:01,NAB9F2B37B04DC244FEA05A,082-900-001,44444444,SHELL NAB,319.56,0,179949.43,DR,REF589388,NAB,Business
21-08-2025 13:07,NAB9AD9D799B8254BB3B5A6,082-900-001,44444444,WOOLWORTHS NAB,1076.46,0,178872.97,DR,REF641563,NAB,Business
21-08-2025 13:29,NAB7905F4820EEA4B658288,082-900-001,44444444,CITYLINK NAB,330.04,0,178542.93,DR,REF696073,NAB,Business
21-08-2025 13:39,NABEF096F8892EA42A0BE7C,082-900-001,44444444,WOOLWORTHS NAB,46.79,0,178496.14,DR,REF835968,NAB,Business
21-08-2025 13:44,NABD6FE7986524A4AF08299,082-900-001,44444444,BWS NAB,330.08,0,178166.06,DR,REF445393,NAB,Business
21-08-2025 14:39,NAB4964B8EF834049939A9E,082-900-001,44444444,MCDONALDS NAB,15.47,0,178150.59,DR,REF587332,NAB,Business
21-08-2025 14:47,NAB43528CE572DD4B06B37C,082-900-001,44444444,SALARY PAYMENT NAB,0,2372.78,180523.37,CR,REF501525,NAB,Business
21-08-2025 14:59,NABC4025A10929B4E079A9C,082-900-001,44444444,WOOLWORTHS NAB,367.23,0,180156.14,DR,REF352461,NAB,Business
21-08-2025 15:01,NAB38E3BC1EE00448DDBA5E,082-900-001,44444444,AMAZON AU NAB,144.51,0,180011.63,DR,REF512615,NAB,Business
21-08-2025 15:07,NAB71124FBA8A284AF6B261,082-900-001,44444444,INTERNET TRANSFER NAB,309.6,0,179702.03,DR,REF369574,NAB,Business
21-08-2025 15:39,NAB6CBE68F067D14C1B811C,082-900-001,44444444,7-ELEVEN NAB,124.67,0,179577.36,DR,REF401513,NAB,Business
21-08-2025 15:45,NAB62C4A28220564237BC75,082-900-001,44444444,COMPANY PAYROLL NAB,0,5539.7,185117.06,CR,REF424062,NAB,Business
21-08-2025 16:10,NAB584A7A38939D4C329F1B,082-900-001,44444444,PAYROLL CREDIT NAB,0,6787.5,191904.56,CR,REF286388,NAB,Business
21-08-2025 16:28,NABE7C90FC99E084D13BA8C,082-900-001,44444444,JB HI-FI NAB,331.55,0,191573.01,DR,REF966053,NAB,Business
21-08-2025 16:38,NABD5EFC0A49AAD425BBD3A,082-900-001,44444444,CITYLINK NAB,256.47,0,191316.54,DR,REF753578,NAB,Business
21-08-2025 17:33,NAB8A364D8190804E519303,082-900-001,44444444,TAFE BOOKSHOP NAB,137.82,0,191178.72,DR,REF133558,NAB,Business
21-08-2025 17:40,NAB44EB18BBCAEA4736A7BF,082-900-001,44444444,DOMINO'S PIZZA NAB,25.53,0,191153.19,DR,REF711499,NAB,Business
21-08-2025 17:49,NABF81E9B7442DE45D4BAFB,082-900-001,44444444,TAFE BOOKSHOP NAB,76.13,0,191077.06,DR,REF237934,NAB,Business
21-08-2025 17:58,NABFF55504E972544A2A2A4,082-900-001,44444444,WOOLWORTHS NAB,823.04,0,190254.02,DR,REF491086,NAB,Business
21-08-2025 18:39,NAB8A6DD89DBC1846719462,082-900-001,44444444,MCDONALDS NAB,186.11,0,190067.91,DR,REF673079,NAB,Business
21-08-2025 18:53,NABA4D013D74535410693A4,082-900-001,44444444,ALDI NAB,485.14,0,189582.77,DR,REF497017,NAB,Business
21-08-2025 19:30,NAB56A018C5E4CB44BAB6BB,082-900-001,44444444,WAGES CREDIT NAB,0,4991.06,194573.83,CR,REF424839,NAB,Business
21-08-2025 19:38,NABD89F88C8B8534C74BD06,082-900-001,44444444,MENULOG NAB,443.52,0,194130.31,DR,REF292360,NAB,Business
21-08-2025 20:45,NAB72127D8784FB43A0A504,082-900-001,44444444,FLIXBUS NAB,508.6,0,193621.71,DR,REF910777,NAB,Business
21-08-2025 20:48,NAB0D91FBF3DB314DF88E6C,082-900-001,44444444,PAY - SALARY NAB,0,4468.82,198090.53,CR,REF480718,NAB,Business
21-08-2025 21:20,NAB536A398F5A664F9E941C,082-900-001,44444444,PAY - SALARY NAB,0,499.28,198589.81,CR,REF348473,NAB,Business
21-08-2025 21:24,INT5BAE5115D85144D5B624,082-900-001,44444444,TRANSFER FROM CBA 33333333,0,753.39,199343.2,CR,INT-50573,NAB,Business
21-08-2025 21:37,NABE12EAA2E16EE47EA8B25,082-900-001,44444444,HARVEY NORMAN NAB,161.72,0,199181.48,DR,REF748572,NAB,Business
21-08-2025 21:44,NAB2566FF8C8AA24C4CBE1A,082-900-001,44444444,SHELL NAB,504.58,0,198676.9,DR,REF909488,NAB,Business
21-08-2025 22:09,NAB4C6C2A569E1B40D4BC1F,082-900-001,44444444,PAYPAL *NETFLIX NAB,234.7,0,198442.2,DR,REF347419,NAB,Business
21-08-2025 22:21,INT726C6F8767294363936E,082-900-001,44444444,TRANSFER TO CBA 22222222,1336.83,0,197105.37,DR,INT-45920,NAB,Business
21-08-2025 23:11,NABD059AFE25E314CEEA79D,082-900-001,44444444,WOOLWORTHS NAB,99.74,0,197005.63,DR,REF978096,NAB,Business
21-08-2025 23:30,NABD4169D0B9CCC4C6F89FC,082-900-001,44444444,BP NAB,133.26,0,196872.37,DR,REF244275,NAB,Business
21-08-2025 23:56,NAB0E7854494DC14907B623,082-900-001,44444444,BWS NAB,323.86,0,196548.51,DR,REF874032,NAB,Business
22-08-2025 00:01,NAB5140C3FBC1264B45AC97,082-900-001,44444444,WOOLWORTHS NAB,239.7,0,196308.81,DR,REF488083,NAB,Business
22-08-2025 00:31,NAB27A809B6084D407CBAF3,082-900-001,44444444,KFC NAB,208.96,0,196099.85,DR,REF502904,NAB,Business
22-08-2025 00:55,NAB84EEC6A0E5E44DC9936B,082-900-001,44444444,LIQUORLAND NAB,1651.11,0,194448.74,DR,REF911277,NAB,Business
22-08-2025 01:26,NABB5E1255FADA24C558302,082-900-001,44444444,TAFE BOOKSHOP NAB,635.12,0,193813.62,DR,REF380147,NAB,Business
22-08-2025 03:10,NABE87E9363FB514352B38E,082-900-001,44444444,ZOOM NAB,107.05,0,193706.57,DR,REF327576,NAB,Business
22-08-2025 04:00,NABB56E15FDE52B47739869,082-900-001,44444444,RAILWAY STATION NAB,292.89,0,193413.68,DR,REF181393,NAB,Business
22-08-2025 04:38,NAB207238AD572049709E49,082-900-001,44444444,RAILWAY STATION NAB,956.05,0,192457.63,DR,REF219886,NAB,Business
22-08-2025 04:48,NAB7772959C51B44E96A8CF,082-900-001,44444444,MCDONALDS NAB,243.13,0,192214.5,DR,REF560923,NAB,Business
22-08-2025 05:20,NAB66119F43E6F5498797A4,082-900-001,44444444,ZOOM NAB,104.59,0,192109.91,DR,REF948967,NAB,Business
22-08-2025 05:45,NAB97BBDFAFBC5045E1B7CE,082-900-001,44444444,TAFE BOOKSHOP NAB,1157.26,0,190952.65,DR,REF983015,NAB,Business
22-08-2025 06:14,NAB65B1DAEA3AA6452B8604,082-900-001,44444444,ZOOM NAB,361.59,0,190591.06,DR,REF444426,NAB,Business
22-08-2025 06:41,NABA4342E1E4B604AA8897F,082-900-001,44444444,BANK FEE NAB,357.91,0,190233.15,DR,REF566776,NAB,Business
22-08-2025 06:53,NABAB654F96DA454D9EBF15,082-900-001,44444444,JB HI-FI NAB,410.35,0,189822.8,DR,REF338544,NAB,Business
22-08-2025 07:05,NABCB72E19BF4134D1FA6E9,082-900-001,44444444,MENULOG NAB,273.13,0,189549.67,DR,REF503927,NAB,Business
22-08-2025 07:10,NABD59601A951D64E909DA9,082-900-001,44444444,WOOLWORTHS NAB,68.44,0,189481.23,DR,REF682835,NAB,Business
22-08-2025 07:19,NAB3E2511FF99FB4568A7ED,082-900-001,44444444,DOMINO'S PIZZA NAB,129.71,0,189351.52,DR,REF941053,NAB,Business
22-08-2025 07:26,NABF2D32A57FB4E46C683BF,082-900-001,44444444,COMPANY PAYROLL NAB,0,2973.53,192325.05,CR,REF383075,NAB,Business
22-08-2025 08:19,NABDBFBC4B3326F4B699D65,082-900-001,44444444,PAY - SALARY NAB,0,884.95,193210,CR,REF491159,NAB,Business
22-08-2025 08:31,NAB3C0510C6CCE44394A4CB,082-900-001,44444444,CITYLINK NAB,167.26,0,193042.74,DR,REF928363,NAB,Business
22-08-2025 08:39,NABAB37292B69D74DB58E74,082-900-001,44444444,JB HI-FI NAB,273.27,0,192769.47,DR,REF304024,NAB,Business
22-08-2025 08:53,NAB9696C530C6704002A7E6,082-900-001,44444444,TAFE BOOKSHOP NAB,254.92,0,192514.55,DR,REF334091,NAB,Business
22-08-2025 09:38,NAB83E0604800B4422C904C,082-900-001,44444444,APPLE NAB,740.22,0,191774.33,DR,REF247389,NAB,Business
22-08-2025 09:39,NAB8F1846A87BD74129AF9B,082-900-001,44444444,LIQUORLAND NAB,85.29,0,191689.04,DR,REF985154,NAB,Business
22-08-2025 09:43,NAB33CEEDA66263455A84C7,082-900-001,44444444,INTERNET TRANSFER NAB,439.66,0,191249.38,DR,REF852560,NAB,Business
22-08-2025 10:38,NABD2281542D99748989715,082-900-001,44444444,AMAZON AU NAB,61.97,0,191187.41,DR,REF238027,NAB,Business
22-08-2025 10:55,NABD84493DF492546F6BCFC,082-900-001,44444444,WOOLWORTHS NAB,350.01,0,190837.4,DR,REF327044,NAB,Business
22-08-2025 11:06,NAB2DA3D12F9A134E17B700,082-900-001,44444444,KFC NAB,636.72,0,190200.68,DR,REF365877,NAB,Business
22-08-2025 11:07,NAB99A7E4AF610648D580DA,082-900-001,44444444,PAYROLL CREDIT NAB,0,7678.32,197879,CR,REF636299,NAB,Business
22-08-2025 11:34,NAB6101A58AF1A249D2B121,082-900-001,44444444,BIGW NAB,156.56,0,197722.44,DR,REF621970,NAB,Business
22-08-2025 12:21,NAB6074708F29124CFA8950,082-900-001,44444444,HARVEY NORMAN NAB,380.78,0,197341.66,DR,REF847264,NAB,Business
22-08-2025 12:23,NABCFAE80F9E369417586F7,082-900-001,44444444,AMAZON AU NAB,540.4,0,196801.26,DR,REF386082,NAB,Business
22-08-2025 12:37,INTE51A537372274FF0B8AD,082-900-001,44444444,TRANSFER TO CBA 33333333,1536.38,0,195264.88,DR,INT-13257,NAB,Business
22-08-2025 13:00,NAB99A4D1848D4A45A79A56,082-900-001,44444444,SHELL NAB,51.86,0,195213.02,DR,REF868260,NAB,Business
22-08-2025 13:20,NABF9C25D9676294332BCD8,082-900-001,44444444,HARVEY NORMAN NAB,314.55,0,194898.47,DR,REF789410,NAB,Business
22-08-2025 13:28,NABF089CA6B0A3D40D49CE4,082-900-001,44444444,7-ELEVEN NAB,389.27,0,194509.2,DR,REF875534,NAB,Business
22-08-2025 13:29,NABF130F0E5FA5F4988BD8A,082-900-001,44444444,MCDONALDS NAB,230.77,0,194278.43,DR,REF756310,NAB,Business
22-08-2025 13:58,NABE47A7E8AFA5B444EA095,082-900-001,44444444,HARVEY NORMAN NAB,102.33,0,194176.1,DR,REF647538,NAB,Business
22-08-2025 14:54,NAB3F823285FC014A6AB87C,082-900-001,44444444,COMPANY PAYROLL NAB,0,7709.3,201885.4,CR,REF466258,NAB,Business
22-08-2025 15:09,NAB86AF794CF7C84877919C,082-900-001,44444444,MCDONALDS NAB,328.62,0,201556.78,DR,REF194089,NAB,Business
22-08-2025 15:22,NAB663369B7270A439EBB7A,082-900-001,44444444,RAILWAY STATION NAB,213.26,0,201343.52,DR,REF149859,NAB,Business
22-08-2025 15:23,NAB624577C987044EF3B178,082-900-001,44444444,MENULOG NAB,155.96,0,201187.56,DR,REF258532,NAB,Business
22-08-2025 15:35,NABD00F845F20164643A7FB,082-900-001,44444444,BANK FEE NAB,206.89,0,200980.67,DR,REF818477,NAB,Business
22-08-2025 16:45,INT84E522CC1C3B49318E51,082-900-001,44444444,TRANSFER TO CBA 33333333,1771.39,0,199209.28,DR,INT-72371,NAB,Business
22-08-2025 17:17,NAB089A2599CA9945998497,082-900-001,44444444,COLES NAB,41.05,0,199168.23,DR,REF955405,NAB,Business
22-08-2025 17:56,NAB7F5E4859971D40798356,082-900-001,44444444,7-ELEVEN NAB,711.08,0,198457.15,DR,REF876715,NAB,Business
22-08-2025 18:08,INTA352654BE22549628AD9,082-900-001,44444444,TRANSFER TO ANZ 11111111,1465.46,0,196991.69,DR,INT-29020,NAB,Business
22-08-2025 18:23,NABD94459C0031D405180AE,082-900-001,44444444,KFC NAB,206.95,0,196784.74,DR,REF578594,NAB,Business
22-08-2025 18:28,NAB9C1EFC7BC37C422AB957,082-900-001,44444444,STARBUCKS NAB,613.71,0,196171.03,DR,REF367713,NAB,Business
22-08-2025 18:30,NABC2DEA13C7FEA491B9181,082-900-001,44444444,INTERNET TRANSFER NAB,302.71,0,195868.32,DR,REF713836,NAB,Business
22-08-2025 19:13,NAB9944C0BFA063490990EF,082-900-001,44444444,PAYPAL *NETFLIX NAB,155.64,0,195712.68,DR,REF324916,NAB,Business
22-08-2025 20:03,NAB4126E2103291467484EF,082-900-001,44444444,JB HI-FI NAB,53.97,0,195658.71,DR,REF429786,NAB,Business
22-08-2025 20:06,NABA8537EEF6DF149FE92F4,082-900-001,44444444,UBER EATS NAB,319.09,0,195339.62,DR,REF159332,NAB,Business
22-08-2025 20:07,NAB5AA536A1AE0B4C9197C0,082-900-001,44444444,FLIXBUS NAB,186.92,0,195152.7,DR,REF232730,NAB,Business
22-08-2025 20:19,NAB3EB9166D25F347C89DA4,082-900-001,44444444,STARBUCKS NAB,303.71,0,194848.99,DR,REF627541,NAB,Business
22-08-2025 20:41,NABB4BBC1E04DED4EFB9272,082-900-001,44444444,SALARY PAYMENT NAB,0,2271.35,197120.34,CR,REF509385,NAB,Business
22-08-2025 20:56,NABEA5A82EFA8504BCA9ABC,082-900-001,44444444,LIQUORLAND NAB,688.78,0,196431.56,DR,REF599851,NAB,Business
22-08-2025 21:25,NABD12630BD3FB943359494,082-900-001,44444444,SPOTIFY NAB,195.36,0,196236.2,DR,REF535090,NAB,Business
22-08-2025 21:29,NABEDC92E17652C486195F7,082-900-001,44444444,LIQUORLAND NAB,175.17,0,196061.03,DR,REF387529,NAB,Business
22-08-2025 21:31,NAB5397761BAC2649F1B130,082-900-001,44444444,COMPANY PAYROLL NAB,0,3525.37,199586.4,CR,REF123360,NAB,Business
22-08-2025 22:24,NABE84A57151ED64178876D,082-900-001,44444444,COLES NAB,189.52,0,199396.88,DR,REF914374,NAB,Business
22-08-2025 22:27,NAB7CAFB0440CBF44908697,082-900-001,44444444,LIQUORLAND NAB,194.26,0,199202.62,DR,REF162519,NAB,Business
22-08-2025 22:44,NAB7D5B714ED98E4B159FFF,082-900-001,44444444,BWS NAB,40.81,0,199161.81,DR,REF420503,NAB,Business
22-08-2025 22:49,NABE8F8E40E59354389AC38,082-900-001,44444444,SPOTIFY NAB,199.72,0,198962.09,DR,REF103284,NAB,Business
22-08-2025 23:02,INTB83FC0E72B8B466985DF,082-900-001,44444444,TRANSFER TO CBA 22222222,958.81,0,198003.28,DR,INT-68056,NAB,Business
22-08-2025 23:34,NABFFE43031D44448B49A6C,082-900-001,44444444,AMAZON AU NAB,25.91,0,197977.37,DR,REF647728,NAB,Business
22-08-2025 23:36,NAB418A665713D54B78BFB1,082-900-001,44444444,KFC NAB,186.98,0,197790.39,DR,REF978591,NAB,Business
23-08-2025 00:15,NAB3F2A5238FE844B0BB7E5,082-900-001,44444444,COLES NAB,44.3,0,197746.09,DR,REF960229,NAB,Business
23-08-2025 00:23,NAB640C03F726BC442CB49C,082-900-001,44444444,LIQUORLAND NAB,336.16,0,197409.93,DR,REF925494,NAB,Business
23-08-2025 00:27,NAB8B5FE75F60E04594B595,082-900-001,44444444,ALDI NAB,150.01,0,197259.92,DR,REF511174,NAB,Business
23-08-2025 00:55,NAB9F110F9373C04B789636,082-900-001,44444444,WAGES CREDIT NAB,0,4994.14,202254.06,CR,REF253387,NAB,Business
23-08-2025 01:35,NAB56C18165BC9B4ABA8CBB,082-900-001,44444444,SHELL NAB,341.77,0,201912.29,DR,REF608334,NAB,Business
23-08-2025 01:43,NAB5DDE7F0838DB4937988A,082-900-001,44444444,STARBUCKS NAB,758.39,0,201153.9,DR,REF637740,NAB,Business
23-08-2025 01:44,NABC66E22BE7E1E4573A5D1,082-900-001,44444444,JB HI-FI NAB,57.78,0,201096.12,DR,REF896743,NAB,Business
23-08-2025 01:59,NAB1BA92C718A61497EA156,082-900-001,44444444,LIQUORLAND NAB,73.37,0,201022.75,DR,REF730636,NAB,Business
23-08-2025 02:16,NABA21E46D102CA49799301,082-900-001,44444444,BWS NAB,64.03,0,200958.72,DR,REF392951,NAB,Business
23-08-2025 02:22,NAB227BC1416E9B4115B93C,082-900-001,44444444,PAYROLL CREDIT NAB,0,2543.84,203502.56,CR,REF701660,NAB,Business
23-08-2025 02:27,NAB95104A8C61C1422E846D,082-900-001,44444444,WOOLWORTHS NAB,160.07,0,203342.49,DR,REF606476,NAB,Business
23-08-2025 03:25,NAB589C60EAA6C04543972F,082-900-001,44444444,ZOOM NAB,242.19,0,203100.3,DR,REF261005,NAB,Business
23-08-2025 03:51,NABEF095137859F4E81814D,082-900-001,44444444,PAYPAL *NETFLIX NAB,242.72,0,202857.58,DR,REF849253,NAB,Business
23-08-2025 04:02,NAB1DC239AC048941F0A654,082-900-001,44444444,COLES NAB,52.74,0,202804.84,DR,REF697739,NAB,Business
23-08-2025 04:29,NAB08B5344A2A1D40F0B0BB,082-900-001,44444444,COMPANY PAYROLL NAB,0,1842.82,204647.66,CR,REF649369,NAB,Business
23-08-2025 04:31,NAB2AFE9938A82A47078234,082-900-001,44444444,BWS NAB,254.2,0,204393.46,DR,REF796275,NAB,Business
23-08-2025 04:36,NABF24FF273A9334678A999,082-900-001,44444444,AMAZON AU NAB,194.76,0,204198.7,DR,REF883230,NAB,Business
23-08-2025 04:58,NAB41D743C2764F4F45A716,082-900-001,44444444,SALARY PAYMENT NAB,0,5395.52,209594.22,CR,REF403588,NAB,Business
23-08-2025 06:00,INT222DA79A036C4CDFAE09,082-900-001,44444444,TRANSFER TO CBA 33333333,212.91,0,209381.31,DR,INT-34739,NAB,Business
23-08-2025 06:14,NABBE829741169C4F88B505,082-900-001,44444444,INTERNET TRANSFER NAB,734.72,0,208646.59,DR,REF906090,NAB,Business
23-08-2025 06:37,NAB286656AD7B80406BAB8A,082-900-001,44444444,INTERNET TRANSFER NAB,37.16,0,208609.43,DR,REF933029,NAB,Business
23-08-2025 06:40,NABDA769F2DBA52411E8E21,082-900-001,44444444,BANK FEE NAB,130.83,0,208478.6,DR,REF364241,NAB,Business
23-08-2025 07:14,NABF8EEA18F29394FD69D5C,082-900-001,44444444,SALARY PAYMENT NAB,0,1173.84,209652.44,CR,REF780517,NAB,Business
23-08-2025 08:39,NAB81E99C2792B64BFEBC07,082-900-001,44444444,7-ELEVEN NAB,383.36,0,209269.08,DR,REF202760,NAB,Business
23-08-2025 09:34,NAB89D140EE0C9F42D1A8D9,082-900-001,44444444,MENULOG NAB,693.75,0,208575.33,DR,REF824391,NAB,Business
23-08-2025 09:40,NAB5612ABE971A44F6BB14C,082-900-001,44444444,JB HI-FI NAB,228.54,0,208346.79,DR,REF544365,NAB,Business
23-08-2025 10:36,NABD903F4CE7FF048A782A0,082-900-001,44444444,TAFE BOOKSHOP NAB,377.36,0,207969.43,DR,REF393692,NAB,Business
23-08-2025 10:46,NAB3ADF49C5F7BA40DABAF2,082-900-001,44444444,PAY - SALARY NAB,0,5711.93,213681.36,CR,REF910478,NAB,Business
23-08-2025 11:46,NAB592C3C10FADA4893AFBA,082-900-001,44444444,ZOOM NAB,356.65,0,213324.71,DR,REF717157,NAB,Business
23-08-2025 11:49,NABE6A6E7D18383476B8951,082-900-001,44444444,MCDONALDS NAB,87.17,0,213237.54,DR,REF169352,NAB,Business
23-08-2025 12:15,NABACD17E97AF6544E58185,082-900-001,44444444,KFC NAB,484.03,0,212753.51,DR,REF664706,NAB,Business
23-08-2025 12:52,INT9B62E74A73F545399158,082-900-001,44444444,TRANSFER TO CBA 22222222,1135.09,0,211618.42,DR,INT-92259,NAB,Business
23-08-2025 13:10,NABA9F249A5E47448A89638,082-900-001,44444444,JB HI-FI NAB,379.53,0,211238.89,DR,REF432050,NAB,Business
23-08-2025 13:10,NAB65A1C3B451EC41BB923A,082-900-001,44444444,LIQUORLAND NAB,82.53,0,211156.36,DR,REF255656,NAB,Business
23-08-2025 13:14,NABA1FD77F4723B4B4C8D0A,082-900-001,44444444,HARVEY NORMAN NAB,367.54,0,210788.82,DR,REF958693,NAB,Business
23-08-2025 13:30,NAB56CAA739723A4997AB29,082-900-001,44444444,SPOTIFY NAB,923.72,0,209865.1,DR,REF437094,NAB,Business
23-08-2025 13:32,NAB4D0EDF16116941098236,082-900-001,44444444,WOOLWORTHS NAB,43.86,0,209821.24,DR,REF410970,NAB,Business
23-08-2025 13:54,NAB8436F5A84B404E73AA75,082-900-001,44444444,SPOTIFY NAB,382.42,0,209438.82,DR,REF910594,NAB,Business
23-08-2025 14:01,NAB7CD25ACB3FE147AE9D24,082-900-001,44444444,KFC NAB,461.99,0,208976.83,DR,REF917910,NAB,Business
23-08-2025 14:30,NAB91F59447477047639E56,082-900-001,44444444,STARBUCKS NAB,448.07,0,208528.76,DR,REF604736,NAB,Business
23-08-2025 14:42,NABB4BC5E2A33CF4F138D60,082-900-001,44444444,AMAZON AU NAB,453.17,0,208075.59,DR,REF363518,NAB,Business
23-08-2025 14:43,NABFCE5B71A011744858535,082-900-001,44444444,RAILWAY STATION NAB,94,0,207981.59,DR,REF313697,NAB,Business
23-08-2025 14:50,NABA25DA0340AA64E91A4D2,082-900-001,44444444,BWS NAB,436.62,0,207544.97,DR,REF225732,NAB,Business
23-08-2025 15:55,NABD79E18B9B9D94380B520,082-900-001,44444444,ZOOM NAB,471.63,0,207073.34,DR,REF927004,NAB,Business
23-08-2025 15:59,NABE08759BA4F0E4CA0935C,082-900-001,44444444,AMAZON AU NAB,255.25,0,206818.09,DR,REF552709,NAB,Business
23-08-2025 16:23,NAB3D972E6508A64F44A83E,082-900-001,44444444,BANK FEE NAB,308.71,0,206509.38,DR,REF138845,NAB,Business
23-08-2025 16:38,NAB5FAF5844F34042E38EDB,082-900-001,44444444,BIGW NAB,154.09,0,206355.29,DR,REF684994,NAB,Business
23-08-2025 17:23,NABDED8EA30965040EE9611,082-900-001,44444444,CITYLINK NAB,87.56,0,206267.73,DR,REF503814,NAB,Business
23-08-2025 17:31,NABD480D2BACADE4709BDB4,082-900-001,44444444,PAYROLL CREDIT NAB,0,7494.59,213762.32,CR,REF223373,NAB,Business
23-08-2025 18:02,NAB1D7D53FBE48B4328B0A1,082-900-001,44444444,MCDONALDS NAB,217.94,0,213544.38,DR,REF649554,NAB,Business
23-08-2025 18:04,NAB0BCCD655CC174E44B1C2,082-900-001,44444444,PAYPAL *NETFLIX NAB,372.32,0,213172.06,DR,REF537485,NAB,Business
23-08-2025 18:06,NABEB3FBC9D665C457F923A,082-900-001,44444444,7-ELEVEN NAB,50.46,0,213121.6,DR,REF986766,NAB,Business
23-08-2025 18:19,NABEB9A01EBD4DE4F49BEE5,082-900-001,44444444,MENULOG NAB,527.82,0,212593.78,DR,REF532132,NAB,Business
23-08-2025 18:21,NABDB9B208D4C9E433185FE,082-900-001,44444444,WAGES CREDIT NAB,0,4085.72,216679.5,CR,REF798388,NAB,Business
23-08-2025 18:21,INT98D2013E11394AC6ABA0,082-900-001,44444444,TRANSFER FROM CBA 22222222,0,1399.92,218079.42,CR,INT-74013,NAB,Business
23-08-2025 18:45,NAB8BD355149D134117BF6C,082-900-001,44444444,PAYPAL *NETFLIX NAB,242.59,0,217836.83,DR,REF589650,NAB,Business
23-08-2025 18:50,NAB7EA89384F25A42508DCF,082-900-001,44444444,COMPANY PAYROLL NAB,0,4699.53,222536.36,CR,REF432696,NAB,Business
23-08-2025 18:57,NAB73D84EEEF074432FBD08,082-900-001,44444444,UBER EATS NAB,125.36,0,222411,DR,REF715521,NAB,Business
23-08-2025 19:00,NAB89811C5655D34AFD823E,082-900-001,44444444,APPLE NAB,83.41,0,222327.59,DR,REF223476,NAB,Business
23-08-2025 19:22,NABE8C6029FEF6042A0BEEB,082-900-001,44444444,LIQUORLAND NAB,675.83,0,221651.76,DR,REF960086,NAB,Business
23-08-2025 20:21,NAB7D52D7CCBFDF4B02A3B7,082-900-001,44444444,JB HI-FI NAB,136.05,0,221515.71,DR,REF409908,NAB,Business
23-08-2025 20:57,NAB776F1E9669744CDCB455,082-900-001,44444444,PAYPAL *NETFLIX NAB,51.03,0,221464.68,DR,REF921329,NAB,Business
23-08-2025 21:11,NAB00E50925A50E46CFBC0B,082-900-001,44444444,RAILWAY STATION NAB,505.99,0,220958.69,DR,REF792222,NAB,Business
23-08-2025 22:10,NAB4A3FBFD0B8E442D1A63F,082-900-001,44444444,SHELL NAB,142.89,0,220815.8,DR,REF462553,NAB,Business
23-08-2025 22:35,NAB138EA11D343F4AD08834,082-900-001,44444444,COLES NAB,358.26,0,220457.54,DR,REF595145,NAB,Business
23-08-2025 22:42,NABFEB08D2E306B478B9E6A,082-900-001,44444444,JB HI-FI NAB,317.55,0,220139.99,DR,REF761562,NAB,Business
23-08-2025 22:56,NAB940C2F5114CD42BFB1A8,082-900-001,44444444,ALDI NAB,240.69,0,219899.3,DR,REF572176,NAB,Business
23-08-2025 23:07,NAB414D6F3A967B477DBC56,082-900-001,44444444,BWS NAB,262.85,0,219636.45,DR,REF340665,NAB,Business
23-08-2025 23:10,NABD82CE9124EB74B9487F3,082-900-001,44444444,UBER EATS NAB,105.92,0,219530.53,DR,REF268823,NAB,Business
23-08-2025 23:16,NAB68FEBB35EADE4262BB3A,082-900-001,44444444,STARBUCKS NAB,202.77,0,219327.76,DR,REF914714,NAB,Business
23-08-2025 23:42,NAB26471D4B843141B0A53D,082-900-001,44444444,MCDONALDS NAB,869.83,0,218457.93,DR,REF299052,NAB,Business
23-08-2025 23:54,NAB5E5DD6A0C79D46EA9EE3,082-900-001,44444444,MCDONALDS NAB,95.8,0,218362.13,DR,REF925516,NAB,Business
24-08-2025 00:06,NABE7AD270435A3402594BE,082-900-001,44444444,BP NAB,582.69,0,217779.44,DR,REF777560,NAB,Business
24-08-2025 00:26,NAB7E97710AE120462FAEAE,082-900-001,44444444,BANK FEE NAB,67.14,0,217712.3,DR,REF961780,NAB,Business
24-08-2025 00:33,NAB4E94494949C2422D8FCF,082-900-001,44444444,KFC NAB,44.37,0,217667.93,DR,REF595016,NAB,Business
24-08-2025 02:09,NAB4638E63E0DFD49769FE0,082-900-001,44444444,MENULOG NAB,364.59,0,217303.34,DR,REF460975,NAB,Business
24-08-2025 02:13,NABA49E13A0E1404608B46F,082-900-001,44444444,ALDI NAB,395.22,0,216908.12,DR,REF898996,NAB,Business
24-08-2025 02:40,NAB649606D9628841D99774,082-900-001,44444444,JB HI-FI NAB,763.97,0,216144.15,DR,REF362545,NAB,Business
24-08-2025 03:16,NABDC8D26485E394147A529,082-900-001,44444444,COMPANY PAYROLL NAB,0,7728.94,223873.09,CR,REF726183,NAB,Business
24-08-2025 03:35,NABCCC9FBBF43244DCD8461,082-900-001,44444444,SHELL NAB,303.81,0,223569.28,DR,REF212060,NAB,Business
24-08-2025 03:46,NAB1F4BCFA545714C328B01,082-900-001,44444444,WAGES CREDIT NAB,0,930.26,224499.54,CR,REF199560,NAB,Business
24-08-2025 03:57,NABBB10692B191D4E76BD8F,082-900-001,44444444,DOMINO'S PIZZA NAB,678.23,0,223821.31,DR,REF480492,NAB,Business
24-08-2025 04:01,NAB2E11CD37F68041199A1D,082-900-001,44444444,BANK FEE NAB,287.65,0,223533.66,DR,REF120868,NAB,Business
24-08-2025 04:14,NABF5B96395DF5B4328B381,082-900-001,44444444,INTERNET TRANSFER NAB,62.35,0,223471.31,DR,REF391910,NAB,Business
24-08-2025 04:28,NABB5F635A61D7B4CF3828D,082-900-001,44444444,SPOTIFY NAB,215.11,0,223256.2,DR,REF378681,NAB,Business
24-08-2025 05:16,NABEA78F841630941F9891F,082-900-001,44444444,COLES NAB,224.9,0,223031.3,DR,REF955568,NAB,Business
24-08-2025 05:20,NAB4232D9B1B17C400EAD28,082-900-001,44444444,COMPANY PAYROLL NAB,0,2759.82,225791.12,CR,REF661399,NAB,Business
24-08-2025 05:35,NAB851AB26A134B4896A724,082-900-001,44444444,BP NAB,431.24,0,225359.88,DR,REF214785,NAB,Business
24-08-2025 05:55,NAB802B764622C0445EAF30,082-900-001,44444444,BIGW NAB,46.88,0,225313,DR,REF485598,NAB,Business
24-08-2025 06:19,NAB4BC242BDB99D4488917B,082-900-001,44444444,KFC NAB,83.68,0,225229.32,DR,REF730420,NAB,Business
24-08-2025 06:21,NAB7377EFF4FA5145B284B5,082-900-001,44444444,UBER EATS NAB,160.85,0,225068.47,DR,REF529855,NAB,Business
24-08-2025 06:47,NAB2D0A9D855D6E418890D2,082-900-001,44444444,WOOLWORTHS NAB,228.68,0,224839.79,DR,REF342214,NAB,Business
24-08-2025 07:12,NAB679DC335025F4658A42A,082-900-001,44444444,PAYROLL CREDIT NAB,0,7341.56,232181.35,CR,REF197399,NAB,Business
24-08-2025 07:15,NABB7307C8BFA8A4B99970D,082-900-001,44444444,ALDI NAB,927.56,0,231253.79,DR,REF686402,NAB,Business
24-08-2025 07:38,INT4AB51448DA744CA8B6FE,082-900-001,44444444,TRANSFER TO ANZ 11111111,410.65,0,230843.14,DR,INT-91827,NAB,Business
24-08-2025 07:48,NABC037205E882947968879,082-900-001,44444444,ZOOM NAB,1174.26,0,229668.88,DR,REF669633,NAB,Business
24-08-2025 08:04,NAB1E6F23A4D4504419B456,082-900-001,44444444,SPOTIFY NAB,90.52,0,229578.36,DR,REF486628,NAB,Business
24-08-2025 08:13,NABA9A7CC56D1F849358A74,082-900-001,44444444,FLIXBUS NAB,276.2,0,229302.16,DR,REF941215,NAB,Business
24-08-2025 08:52,NAB532F620BDC484238B401,082-900-001,44444444,AMAZON AU NAB,208.86,0,229093.3,DR,REF948242,NAB,Business
24-08-2025 09:12,NABF71FF42726A742B39B98,082-900-001,44444444,MCDONALDS NAB,221.3,0,228872,DR,REF769071,NAB,Business
24-08-2025 09:13,NABADB51B470D0348D0A20D,082-900-001,44444444,SPOTIFY NAB,514.22,0,228357.78,DR,REF744691,NAB,Business
24-08-2025 09:50,NABDD0FD2149BF34CD8B303,082-900-001,44444444,WOOLWORTHS NAB,108.92,0,228248.86,DR,REF941244,NAB,Business
24-08-2025 09:51,NAB95660E56C4B149E9B752,082-900-001,44444444,ZOOM NAB,192.24,0,228056.62,DR,REF119912,NAB,Business
24-08-2025 10:41,NABA9A22BDAC763471096EA,082-900-001,44444444,JB HI-FI NAB,145.95,0,227910.67,DR,REF619362,NAB,Business
24-08-2025 10:41,NAB7271E747A30A49D4A2B1,082-900-001,44444444,RAILWAY STATION NAB,207.99,0,227702.68,DR,REF767903,NAB,Business
24-08-2025 10:53,NAB7E85CB3056694E43907E,082-900-001,44444444,PAY - SALARY NAB,0,755.4,228458.08,CR,REF539821,NAB,Business
24-08-2025 11:02,NABD6FB981010484D7F895A,082-900-001,44444444,PAYMENT GATEWAY NAB,330.69,0,228127.39,DR,REF522960,NAB,Business
24-08-2025 11:21,NAB7116D1A4B0164123A112,082-900-001,44444444,ZOOM NAB,657.36,0,227470.03,DR,REF628788,NAB,Business
24-08-2025 11:48,NABDA40C9714EEB481E992F,082-900-001,44444444,MENULOG NAB,200.17,0,227269.86,DR,REF479886,NAB,Business
24-08-2025 11:56,NAB48D162E21F37426E9462,082-900-001,44444444,BP NAB,55.51,0,227214.35,DR,REF579694,NAB,Business
24-08-2025 12:08,NAB4D6E0503A9844EC38552,082-900-001,44444444,INTERNET TRANSFER NAB,241.47,0,226972.88,DR,REF558164,NAB,Business
24-08-2025 13:12,NAB101E104FBA2643558BD6,082-900-001,44444444,ZOOM NAB,661.39,0,226311.49,DR,REF903353,NAB,Business
24-08-2025 13:13,NAB4BB20F88BB864C6791D6,082-900-001,44444444,STARBUCKS NAB,1103.95,0,225207.54,DR,REF146615,NAB,Business
24-08-2025 13:46,NABFCD011D636CE44E59D22,082-900-001,44444444,CITYLINK NAB,251.57,0,224955.97,DR,REF834287,NAB,Business
24-08-2025 14:12,NABE212381B0B044F2AB6A1,082-900-001,44444444,PAYMENT GATEWAY NAB,382.17,0,224573.8,DR,REF434688,NAB,Business
24-08-2025 15:10,NABD604C58B643C4E6EAC9F,082-900-001,44444444,RAILWAY STATION NAB,131.51,0,224442.29,DR,REF888232,NAB,Business
24-08-2025 15:29,NABA28D38B4A9214146889C,082-900-001,44444444,UBER EATS NAB,86.97,0,224355.32,DR,REF353324,NAB,Business
24-08-2025 15:37,NABE86AA69C1C3C43BF9216,082-900-001,44444444,HARVEY NORMAN NAB,718.87,0,223636.45,DR,REF699096,NAB,Business
24-08-2025 15:46,NABDABC631B29AA405AB0D8,082-900-001,44444444,DOMINO'S PIZZA NAB,475.49,0,223160.96,DR,REF641730,NAB,Business
24-08-2025 15:50,NABC3E74BABDDAB4CF09B95,082-900-001,44444444,INTERNET TRANSFER NAB,114.23,0,223046.73,DR,REF445727,NAB,Business
24-08-2025 16:18,NAB9D4E1F44C19148D58311,082-900-001,44444444,PAYROLL CREDIT NAB,0,890.53,223937.26,CR,REF990263,NAB,Business
24-08-2025 16:45,NAB7EE4814D464C4DACB08D,082-900-001,44444444,CITYLINK NAB,53.69,0,223883.57,DR,REF574781,NAB,Business
24-08-2025 16:54,NAB8E725FCA0A5F4244BF40,082-900-001,44444444,BIGW NAB,488.68,0,223394.89,DR,REF809844,NAB,Business
24-08-2025 17:38,NAB70D47547894044BAB9BA,082-900-001,44444444,APPLE NAB,204.4,0,223190.49,DR,REF594759,NAB,Business
24-08-2025 17:48,NAB5DBB098543E743B0B711,082-900-001,44444444,ALDI NAB,998.79,0,222191.7,DR,REF786524,NAB,Business
24-08-2025 18:14,NAB553E9E38E2174074A498,082-900-001,44444444,HARVEY NORMAN NAB,350.96,0,221840.74,DR,REF776499,NAB,Business
24-08-2025 18:16,NABE95D097196534274995E,082-900-001,44444444,COLES NAB,277.53,0,221563.21,DR,REF789629,NAB,Business
24-08-2025 18:42,NAB34CCFA9B28BF401DB9A2,082-900-001,44444444,SHELL NAB,34.05,0,221529.16,DR,REF252933,NAB,Business
24-08-2025 19:30,NAB535C623756D34A3A8A7A,082-900-001,44444444,RAILWAY STATION NAB,89.71,0,221439.45,DR,REF209933,NAB,Business
24-08-2025 19:32,NAB72FDA01E3D3F47FC97D8,082-900-001,44444444,RAILWAY STATION NAB,305.38,0,221134.07,DR,REF718034,NAB,Business
24-08-2025 19:41,NAB97EAB4577B804FD4A24A,082-900-001,44444444,ZOOM NAB,564.47,0,220569.6,DR,REF948124,NAB,Business
24-08-2025 19:54,NAB232FA1E7F3194341AF4E,082-900-001,44444444,RAILWAY STATION NAB,290.17,0,220279.43,DR,REF502161,NAB,Business
24-08-2025 20:20,NAB6E8E32A0D4CA469FB0FE,082-900-001,44444444,LIQUORLAND NAB,957.63,0,219321.8,DR,REF211766,NAB,Business
24-08-2025 20:41,NAB82036A304F5C4B3AB23B,082-900-001,44444444,SPOTIFY NAB,470.85,0,218850.95,DR,REF560674,NAB,Business
24-08-2025 20:54,NAB28125DBA044642699F41,082-900-001,44444444,JB HI-FI NAB,194.32,0,218656.63,DR,REF624481,NAB,Business
24-08-2025 21:01,NAB5EF6DD00F15040B6A624,082-900-001,44444444,HARVEY NORMAN NAB,223.35,0,218433.28,DR,REF133514,NAB,Business
24-08-2025 22:22,NABE9889B433D3142619EA2,082-900-001,44444444,SHELL NAB,215.94,0,218217.34,DR,REF586317,NAB,Business
24-08-2025 22:22,NABCBF0B355CB2348D7AE96,082-900-001,44444444,MCDONALDS NAB,177.13,0,218040.21,DR,REF399718,NAB,Business
24-08-2025 22:28,NAB5F2851EA7B4F454BB3B8,082-900-001,44444444,SALARY PAYMENT NAB,0,1581.47,219621.68,CR,REF528715,NAB,Business
24-08-2025 22:41,NABFF629A2C9CEB454C8F40,082-900-001,44444444,MENULOG NAB,147.62,0,219474.06,DR,REF704583,NAB,Business
24-08-2025 23:34,NAB4E21FFCCCA73481CACA9,082-900-001,44444444,COMPANY PAYROLL NAB,0,107.41,219581.47,CR,REF971248,NAB,Business
24-08-2025 23:46,NAB6AF6B17BB733430D9F9D,082-900-001,44444444,PAYPAL *NETFLIX NAB,56.37,0,219525.1,DR,REF388656,NAB,Business
25-08-2025 00:30,NABC8666CFAC17C4AAF9C65,082-900-001,44444444,COLES NAB,590.96,0,218934.14,DR,REF802982,NAB,Business
25-08-2025 01:12,NABBDF9BE606CBB41BDB7E8,082-900-001,44444444,WOOLWORTHS NAB,179.46,0,218754.68,DR,REF174012,NAB,Business
25-08-2025 01:16,NABA396794C018842F1B336,082-900-001,44444444,LIQUORLAND NAB,505.62,0,218249.06,DR,REF237954,NAB,Business
25-08-2025 01:18,NAB5124BB9D508E47DDB201,082-900-001,44444444,PAYPAL *NETFLIX NAB,496.07,0,217752.99,DR,REF574467,NAB,Business
25-08-2025 01:52,NAB8CB4544418164D90BD95,082-900-001,44444444,BANK FEE NAB,294.67,0,217458.32,DR,REF863011,NAB,Business
25-08-2025 03:02,NABF452E5929A6A4BA1B84A,082-900-001,44444444,RAILWAY STATION NAB,81.83,0,217376.49,DR,REF301965,NAB,Business
25-08-2025 03:12,NAB0A8946D4149A4A2095E7,082-900-001,44444444,ALDI NAB,81.63,0,217294.86,DR,REF296182,NAB,Business
25-08-2025 03:17,NABD7AB78DA010F4BA68030,082-900-001,44444444,MENULOG NAB,457.84,0,216837.02,DR,REF919226,NAB,Business
25-08-2025 03:31,NAB23614991EEEB4C98B303,082-900-001,44444444,BANK FEE NAB,364.03,0,216472.99,DR,REF212214,NAB,Business
25-08-2025 03:52,NABD4DEEAF3EAC04059A20B,082-900-001,44444444,BWS NAB,686.54,0,215786.45,DR,REF858577,NAB,Business
25-08-2025 03:52,NAB2010D3AC7B6F4830837E,082-900-001,44444444,AMAZON AU NAB,115.8,0,215670.65,DR,REF132774,NAB,Business
25-08-2025 03:57,NABE5F38068EE2246D7B2C9,082-900-001,44444444,BANK FEE NAB,289.34,0,215381.31,DR,REF256094,NAB,Business
25-08-2025 04:05,NABD632A48EFA334EF48A15,082-900-001,44444444,LIQUORLAND NAB,182.43,0,215198.88,DR,REF773149,NAB,Business
25-08-2025 04:25,NAB7DEE2D6B02014E1CB37A,082-900-001,44444444,LIQUORLAND NAB,176.71,0,215022.17,DR,REF697529,NAB,Business
25-08-2025 04:27,NAB1D8C710BBA714BF796FC,082-900-001,44444444,COMPANY PAYROLL NAB,0,5069.89,220092.06,CR,REF358139,NAB,Business
25-08-2025 04:42,NABC2B8EACFFE124848A598,082-900-001,44444444,COLES NAB,250.62,0,219841.44,DR,REF147067,NAB,Business
25-08-2025 04:49,NABB5CA501FC9314167A3F6,082-900-001,44444444,COLES NAB,322.8,0,219518.64,DR,REF400761,NAB,Business
25-08-2025 04:54,NABD477F9AA423E4D5E8536,082-900-001,44444444,INTERNET TRANSFER NAB,577.99,0,218940.65,DR,REF734132,NAB,Business
25-08-2025 05:48,NAB8FA94AF0F19C47A4B363,082-900-001,44444444,COMPANY PAYROLL NAB,0,2517.28,221457.93,CR,REF112025,NAB,Business
25-08-2025 05:48,NAB910FC6B67F1D46309048,082-900-001,44444444,ZOOM NAB,202.85,0,221255.08,DR,REF589065,NAB,Business
25-08-2025 06:16,NAB80D983286A7748E28A30,082-900-001,44444444,PAYROLL CREDIT NAB,0,5121.92,226377,CR,REF919093,NAB,Business
25-08-2025 06:21,NABF4D68933A56344F3B22F,082-900-001,44444444,BIGW NAB,829.87,0,225547.13,DR,REF819651,NAB,Business
25-08-2025 07:35,NAB3817737CBB5D4888B6F6,082-900-001,44444444,LIQUORLAND NAB,678.69,0,224868.44,DR,REF182359,NAB,Business
25-08-2025 07:46,NAB04F9B5EEEBFA407187FF,082-900-001,44444444,WAGES CREDIT NAB,0,63.08,224931.52,CR,REF216737,NAB,Business
25-08-2025 08:46,NABC0DFA6120A89465296AA,082-900-001,44444444,BWS NAB,487.32,0,224444.2,DR,REF733187,NAB,Business
25-08-2025 09:05,NAB45D4C4CDE20243B5AD13,082-900-001,44444444,PAYMENT GATEWAY NAB,54.64,0,224389.56,DR,REF441166,NAB,Business
25-08-2025 09:26,NAB1C7E1F7AC4DC48CBABEE,082-900-001,44444444,MCDONALDS NAB,659.07,0,223730.49,DR,REF438173,NAB,Business
25-08-2025 09:37,NABE3962A956C0B4EC39DDC,082-900-001,44444444,JB HI-FI NAB,104.89,0,223625.6,DR,REF381577,NAB,Business
25-08-2025 09:51,NABEB45793337EA42129097,082-900-001,44444444,STARBUCKS NAB,419.22,0,223206.38,DR,REF710841,NAB,Business
25-08-2025 09:55,INT301016AB1F2A4D0FB141,082-900-001,44444444,TRANSFER FROM CBA 33333333,0,585.68,223792.06,CR,INT-88934,NAB,Business
25-08-2025 10:39,NAB8EBCDDAD910446418042,082-900-001,44444444,SHELL NAB,356.86,0,223435.2,DR,REF501514,NAB,Business
25-08-2025 10:42,NABEEC70AE11F864012992D,082-900-001,44444444,APPLE NAB,86.91,0,223348.29,DR,REF385416,NAB,Business
25-08-2025 11:57,NABCF536BEB7646497E9AE6,082-900-001,44444444,ALDI NAB,492.56,0,222855.73,DR,REF973106,NAB,Business
25-08-2025 12:05,NABC85BB7ACD5C242DEB57E,082-900-001,44444444,AMAZON AU NAB,217.17,0,222638.56,DR,REF826767,NAB,Business
25-08-2025 12:06,NABE5663918743B4D839024,082-900-001,44444444,BWS NAB,716.26,0,221922.3,DR,REF815350,NAB,Business
25-08-2025 12:08,NABD7787E369BB44CBF870D,082-900-001,44444444,MENULOG NAB,134.24,0,221788.06,DR,REF524455,NAB,Business
25-08-2025 12:25,NABCBA30AD8080C4ABE9534,082-900-001,44444444,COLES NAB,136.49,0,221651.57,DR,REF815670,NAB,Business
25-08-2025 12:32,NABEEDF2209880A442398F3,082-900-001,44444444,FLIXBUS NAB,255.81,0,221395.76,DR,REF848275,NAB,Business
25-08-2025 12:36,NABC4E9B0529C4343C28ECF,082-900-001,44444444,UBER EATS NAB,361.46,0,221034.3,DR,REF502848,NAB,Business
25-08-2025 12:38,INT77AFA00986A14A1DB8E1,082-900-001,44444444,TRANSFER FROM CBA 33333333,0,703.39,221737.69,CR,INT-17125,NAB,Business
25-08-2025 12:46,NABAD281B0522DF45A7A5D4,082-900-001,44444444,BANK FEE NAB,340.29,0,221397.4,DR,REF170701,NAB,Business
25-08-2025 12:53,NAB29E49A3403774ECFB4CC,082-900-001,44444444,FLIXBUS NAB,320.73,0,221076.67,DR,REF705332,NAB,Business
25-08-2025 13:10,NAB7344D98A91CB49768296,082-900-001,44444444,RAILWAY STATION NAB,176.66,0,220900.01,DR,REF856221,NAB,Business
25-08-2025 13:27,NABDCA39DEB3AF34F048C7E,082-900-001,44444444,ALDI NAB,356.27,0,220543.74,DR,REF127114,NAB,Business
25-08-2025 13:36,NABD6A2870BF8DA4518A083,082-900-001,44444444,INTERNET TRANSFER NAB,332.03,0,220211.71,DR,REF521975,NAB,Business
25-08-2025 13:45,NAB0489BC54AB7740059441,082-900-001,44444444,COMPANY PAYROLL NAB,0,2532.63,222744.34,CR,REF375469,NAB,Business
25-08-2025 14:00,NAB3B49E1D205AF4A88861C,082-900-001,44444444,WAGES CREDIT NAB,0,3832.69,226577.03,CR,REF514078,NAB,Business
25-08-2025 14:42,NAB22B194A2E80748498CF6,082-900-001,44444444,PAYMENT GATEWAY NAB,537.34,0,226039.69,DR,REF456445,NAB,Business
25-08-2025 14:44,NAB12624963142E400D9FFA,082-900-001,44444444,COLES NAB,243.55,0,225796.14,DR,REF685661,NAB,Business
25-08-2025 15:07,NAB707D18F637EF4D19B943,082-900-001,44444444,HARVEY NORMAN NAB,479.02,0,225317.12,DR,REF836294,NAB,Business
25-08-2025 16:15,NAB0A8C2ACE4FCD41C7A89D,082-900-001,44444444,BANK FEE NAB,265.69,0,225051.43,DR,REF477461,NAB,Business
25-08-2025 16:51,NAB2001AB0A38E14A8F98D3,082-900-001,44444444,MENULOG NAB,170.27,0,224881.16,DR,REF866125,NAB,Business
25-08-2025 17:09,NABD0F3860836D5444DA246,082-900-001,44444444,DOMINO'S PIZZA NAB,62.87,0,224818.29,DR,REF823698,NAB,Business
25-08-2025 17:12,NABDCC1636086B54B7DB49D,082-900-001,44444444,SPOTIFY NAB,337.27,0,224481.02,DR,REF360497,NAB,Business
25-08-2025 17:12,NAB7C9FA2553E9C4B2E8197,082-900-001,44444444,MCDONALDS NAB,38.61,0,224442.41,DR,REF728233,NAB,Business
25-08-2025 17:19,NAB090B9480F9194C768F85,082-900-001,44444444,7-ELEVEN NAB,66.39,0,224376.02,DR,REF123533,NAB,Business
25-08-2025 17:22,NAB866C40C2327044CD9A6B,082-900-001,44444444,BP NAB,27.82,0,224348.2,DR,REF354677,NAB,Business
25-08-2025 18:00,NAB8235864204A2496ABF2A,082-900-001,44444444,LIQUORLAND NAB,176.34,0,224171.86,DR,REF894225,NAB,Business
25-08-2025 18:09,NAB6ED6E3549C814EA4A311,082-900-001,44444444,WAGES CREDIT NAB,0,1617.76,225789.62,CR,REF840990,NAB,Business
25-08-2025 18:32,NABF8640703C5FD4E6A9C34,082-900-001,44444444,PAY - SALARY NAB,0,7124.65,232914.27,CR,REF868584,NAB,Business
25-08-2025 18:34,NAB4AA84C9B1864442EBAFC,082-900-001,44444444,DOMINO'S PIZZA NAB,434.95,0,232479.32,DR,REF626414,NAB,Business
25-08-2025 18:50,NABC47423527879478E9C41,082-900-001,44444444,SALARY PAYMENT NAB,0,971.73,233451.05,CR,REF913640,NAB,Business
25-08-2025 19:24,NAB59E531D133A6444E8E65,082-900-001,44444444,MCDONALDS NAB,174.14,0,233276.91,DR,REF666995,NAB,Business
25-08-2025 19:27,NAB15B3B9B15F1E4172971F,082-900-001,44444444,APPLE NAB,179.97,0,233096.94,DR,REF733900,NAB,Business
25-08-2025 19:31,NAB413635BC7FB24AE09862,082-900-001,44444444,RAILWAY STATION NAB,66.88,0,233030.06,DR,REF340389,NAB,Business
25-08-2025 20:08,NABEF3209D69AFF428B9247,082-900-001,44444444,PAY - SALARY NAB,0,1942.53,234972.59,CR,REF434265,NAB,Business
25-08-2025 20:32,NAB746F966D568E41319957,082-900-001,44444444,SALARY PAYMENT NAB,0,4457.97,239430.56,CR,REF291319,NAB,Business
25-08-2025 20:39,NAB2C2794F91BD440D5B055,082-900-001,44444444,MCDONALDS NAB,194.55,0,239236.01,DR,REF628067,NAB,Business
25-08-2025 20:59,INT64CC060B7C7B451BA68D,082-900-001,44444444,TRANSFER FROM ANZ 11111111,0,1913.75,241149.76,CR,INT-80147,NAB,Business
25-08-2025 21:02,NABB387A6B0DA754F5C91ED,082-900-001,44444444,ALDI NAB,212.84,0,240936.92,DR,REF689015,NAB,Business
25-08-2025 21:13,NABABD8F6B48C7747248FFF,082-900-001,44444444,TAFE BOOKSHOP NAB,610.9,0,240326.02,DR,REF911892,NAB,Business
25-08-2025 21:16,NAB5C1727844BA24A3C9B5B,082-900-001,44444444,RAILWAY STATION NAB,40.48,0,240285.54,DR,REF498907,NAB,Business
25-08-2025 21:25,NAB0890C8EA2CB346D6AEFC,082-900-001,44444444,LIQUORLAND NAB,466.29,0,239819.25,DR,REF813858,NAB,Business
25-08-2025 21:58,NAB2C3AEFC5EB6D4F2FB41C,082-900-001,44444444,COLES NAB,280.19,0,239539.06,DR,REF376640,NAB,Business
25-08-2025 22:08,NAB4D5E7B87389249E581C7,082-900-001,44444444,BIGW NAB,85.53,0,239453.53,DR,REF676898,NAB,Business
25-08-2025 22:19,NAB9AF8195CA51C42BDAAB1,082-900-001,44444444,STARBUCKS NAB,111.02,0,239342.51,DR,REF695894,NAB,Business
25-08-2025 23:05,NABEAA9F35357C54CDCB3C1,082-900-001,44444444,FLIXBUS NAB,512.23,0,238830.28,DR,REF578216,NAB,Business
25-08-2025 23:32,NABB1EA1AF07DBC4588BA88,082-900-001,44444444,LIQUORLAND NAB,639.07,0,238191.21,DR,REF861692,NAB,Business
25-08-2025 23:38,NAB1FD15FDB8FCF482FAA30,082-900-001,44444444,BP NAB,422.66,0,237768.55,DR,REF289393,NAB,Business
26-08-2025 00:14,NAB8F09B1906B6C458AB43F,082-900-001,44444444,APPLE NAB,354.04,0,237414.51,DR,REF849234,NAB,Business
26-08-2025 00:25,NABDC7A69EFD47E45E48142,082-900-001,44444444,SHELL NAB,230.08,0,237184.43,DR,REF328371,NAB,Business
26-08-2025 00:25,NAB8EE69D591C994E7EB446,082-900-001,44444444,BANK FEE NAB,65.09,0,237119.34,DR,REF595742,NAB,Business
26-08-2025 00:29,NABC4676029BEC3418193E8,082-900-001,44444444,BANK FEE NAB,225.69,0,236893.65,DR,REF750847,NAB,Business
26-08-2025 01:09,NAB1539968EE5A94E38B252,082-900-001,44444444,SPOTIFY NAB,504.4,0,236389.25,DR,REF677673,NAB,Business
26-08-2025 01:34,NAB9EC4EA21F2FC4F34B0C4,082-900-001,44444444,INTERNET TRANSFER NAB,427.18,0,235962.07,DR,REF122678,NAB,Business
26-08-2025 01:45,NAB9311D3E37A7D494B84D3,082-900-001,44444444,JB HI-FI NAB,600.77,0,235361.3,DR,REF564501,NAB,Business
26-08-2025 03:10,NABBA1103AD1A2348BB9F23,082-900-001,44444444,DOMINO'S PIZZA NAB,254.33,0,235106.97,DR,REF782439,NAB,Business
26-08-2025 03:41,NAB894C1832089B44DD8A11,082-900-001,44444444,SALARY PAYMENT NAB,0,3078.31,238185.28,CR,REF744510,NAB,Business
26-08-2025 04:08,NABACF8A1F153D64E34A47F,082-900-001,44444444,BIGW NAB,28.51,0,238156.77,DR,REF214979,NAB,Business
26-08-2025 04:22,NAB4EEA777AFF84446AB543,082-900-001,44444444,CITYLINK NAB,51.97,0,238104.8,DR,REF240976,NAB,Business
26-08-2025 04:47,NAB89E74A3EC5CB4DD3B5D4,082-900-001,44444444,PAY - SALARY NAB,0,587.44,238692.24,CR,REF379968,NAB,Business
26-08-2025 05:18,NAB74C91A640C3E4BD38AD3,082-900-001,44444444,CITYLINK NAB,639.04,0,238053.2,DR,REF789694,NAB,Business
26-08-2025 05:32,NABA7A9B54EFB0449CD966D,082-900-001,44444444,STARBUCKS NAB,319.04,0,237734.16,DR,REF588035,NAB,Business
26-08-2025 05:47,NAB65C1DC6EB9C44EFB9D7C,082-900-001,44444444,FLIXBUS NAB,296.55,0,237437.61,DR,REF561712,NAB,Business
26-08-2025 06:10,NABECFE164B8FA04D878ABD,082-900-001,44444444,COMPANY PAYROLL NAB,0,3297.57,240735.18,CR,REF103566,NAB,Business
26-08-2025 06:13,NAB84C6F631E2984E59AF42,082-900-001,44444444,WAGES CREDIT NAB,0,900.25,241635.43,CR,REF184919,NAB,Business
26-08-2025 06:23,INTA5B6F298B06B446F96C0,082-900-001,44444444,TRANSFER FROM CBA 33333333,0,940.37,242575.8,CR,INT-27691,NAB,Business
26-08-2025 07:26,NABDFFA72811DFD430E8C69,082-900-001,44444444,PAY - SALARY NAB,0,298.82,242874.62,CR,REF196152,NAB,Business
26-08-2025 07:36,NABB71F0DC335654E05B7B1,082-900-001,44444444,7-ELEVEN NAB,860.44,0,242014.18,DR,REF329060,NAB,Business
26-08-2025 07:43,NABA6A86872345F47D58C06,082-900-001,44444444,LIQUORLAND NAB,278.38,0,241735.8,DR,REF540750,NAB,Business
26-08-2025 08:19,NAB8396A8FBD304483AB6D6,082-900-001,44444444,ZOOM NAB,532.27,0,241203.53,DR,REF620585,NAB,Business
26-08-2025 09:09,NAB9E66B02E16114FC1B4AE,082-900-001,44444444,APPLE NAB,390.34,0,240813.19,DR,REF223311,NAB,Business
26-08-2025 09:10,INT80B7079C07FF46DA84D5,082-900-001,44444444,TRANSFER FROM CBA 22222222,0,1355.46,242168.65,CR,INT-75204,NAB,Business
26-08-2025 09:37,NABB7D71094E46F4138BBC2,082-900-001,44444444,SHELL NAB,965.05,0,241203.6,DR,REF613529,NAB,Business
26-08-2025 10:24,NAB9613A990050C41C89891,082-900-001,44444444,UBER EATS NAB,1507.23,0,239696.37,DR,REF268127,NAB,Business
26-08-2025 10:43,NABC7657013799C4208A5B8,082-900-001,44444444,AMAZON AU NAB,135.42,0,239560.95,DR,REF500791,NAB,Business
26-08-2025 10:47,NABE96DAF6D8E624754A0F4,082-900-001,44444444,BANK FEE NAB,423.92,0,239137.03,DR,REF764458,NAB,Business
26-08-2025 11:14,NABFC6E2B5EE8C94BF9B4EB,082-900-001,44444444,DOMINO'S PIZZA NAB,518.87,0,238618.16,DR,REF174723,NAB,Business
26-08-2025 11:14,NABFE165ED053934730BE79,082-900-001,44444444,DOMINO'S PIZZA NAB,268.69,0,238349.47,DR,REF466281,NAB,Business
26-08-2025 11:32,NAB8396951A60C942A283A9,082-900-001,44444444,PAYPAL *NETFLIX NAB,172.96,0,238176.51,DR,REF200957,NAB,Business
26-08-2025 11:53,NAB79AFE1AD8B714B87B3A2,082-900-001,44444444,PAYMENT GATEWAY NAB,251.23,0,237925.28,DR,REF748568,NAB,Business
26-08-2025 11:56,NAB6A121B6C28784F088A66,082-900-001,44444444,PAYMENT GATEWAY NAB,261.71,0,237663.57,DR,REF808868,NAB,Business
26-08-2025 12:02,NAB69420683FF004E028CC2,082-900-001,44444444,TAFE BOOKSHOP NAB,139.35,0,237524.22,DR,REF604623,NAB,Business
26-08-2025 12:04,NABA524DA49157844939B4A,082-900-001,44444444,BIGW NAB,213.01,0,237311.21,DR,REF764241,NAB,Business
26-08-2025 12:19,NABD0FE0F492C9A41029C1F,082-900-001,44444444,SPOTIFY NAB,144,0,237167.21,DR,REF389100,NAB,Business
26-08-2025 12:22,NAB6299DEC82F4449CC9928,082-900-001,44444444,BWS NAB,1225.29,0,235941.92,DR,REF884180,NAB,Business
26-08-2025 12:25,NABE5346B8A8DFB424D8685,082-900-001,44444444,STARBUCKS NAB,75.66,0,235866.26,DR,REF582312,NAB,Business
26-08-2025 13:01,NABF9D68A5713174B1CBB49,082-900-001,44444444,SALARY PAYMENT NAB,0,390.59,236256.85,CR,REF966004,NAB,Business
26-08-2025 13:29,NAB20DC5C096A0D4D3B829E,082-900-001,44444444,KFC NAB,31.2,0,236225.65,DR,REF651293,NAB,Business
26-08-2025 13:58,NAB7C1C91C097ED4AB5A921,082-900-001,44444444,HARVEY NORMAN NAB,435.65,0,235790,DR,REF737575,NAB,Business
26-08-2025 13:58,NABB2464379E6AD43CB9CFB,082-900-001,44444444,SPOTIFY NAB,287.24,0,235502.76,DR,REF809210,NAB,Business
26-08-2025 14:12,NAB5DEE1E00CA2D47FFBFE3,082-900-001,44444444,COLES NAB,92.57,0,235410.19,DR,REF920212,NAB,Business
26-08-2025 15:24,NAB8F9349A291494BA890C9,082-900-001,44444444,LIQUORLAND NAB,406.63,0,235003.56,DR,REF219947,NAB,Business
26-08-2025 16:43,INTEC486EEFBEFD48758713,082-900-001,44444444,TRANSFER TO CBA 33333333,270.34,0,234733.22,DR,INT-65503,NAB,Business
26-08-2025 16:52,NAB1720E0D1A6144F68BD76,082-900-001,44444444,MENULOG NAB,301.24,0,234431.98,DR,REF475423,NAB,Business
26-08-2025 17:12,NABA8BEA5D16E084A858A80,082-900-001,44444444,HARVEY NORMAN NAB,945.71,0,233486.27,DR,REF938204,NAB,Business
26-08-2025 17:25,NAB989403BA229940A483A2,082-900-001,44444444,ALDI NAB,896.86,0,232589.41,DR,REF454881,NAB,Business
26-08-2025 17:37,NABDFCD2E87111B46A2B7B5,082-900-001,44444444,PAYROLL CREDIT NAB,0,5587.72,238177.13,CR,REF976091,NAB,Business
26-08-2025 17:38,NAB8380555AFAA5467A86F6,082-900-001,44444444,SALARY PAYMENT NAB,0,789.75,238966.88,CR,REF531681,NAB,Business
26-08-2025 17:49,NABC0BD4FA2B4EC4EE7B24C,082-900-001,44444444,CITYLINK NAB,82.35,0,238884.53,DR,REF848559,NAB,Business
26-08-2025 17:59,NAB0E84126BA7D549E4BD9C,082-900-001,44444444,LIQUORLAND NAB,206.28,0,238678.25,DR,REF454275,NAB,Business
26-08-2025 18:12,NABB5A2DF7AC3C54F4E8261,082-900-001,44444444,RAILWAY STATION NAB,171.34,0,238506.91,DR,REF476318,NAB,Business
26-08-2025 19:38,NAB9776B49B9F944E2F84B1,082-900-001,44444444,SALARY PAYMENT NAB,0,6488.76,244995.67,CR,REF152986,NAB,Business
26-08-2025 20:12,NABD5B637D999CC45AEAAE4,082-900-001,44444444,MCDONALDS NAB,161.14,0,244834.53,DR,REF830709,NAB,Business
26-08-2025 20:47,NABB286AA63018545599B42,082-900-001,44444444,CITYLINK NAB,114.54,0,244719.99,DR,REF955549,NAB,Business
26-08-2025 20:59,INTF71C8F3864924E73A790,082-900-001,44444444,TRANSFER TO CBA 22222222,1488.84,0,243231.15,DR,INT-71702,NAB,Business
26-08-2025 21:36,NAB0A445CAFEC364C4BB438,082-900-001,44444444,SPOTIFY NAB,281.61,0,242949.54,DR,REF889229,NAB,Business
26-08-2025 22:39,INTF859F64D4C844493ACB1,082-900-001,44444444,TRANSFER TO CBA 33333333,810.42,0,242139.12,DR,INT-87838,NAB,Business
26-08-2025 22:45,NAB3339745AA3024B7394D9,082-900-001,44444444,BIGW NAB,937.75,0,241201.37,DR,REF973102,NAB,Business
26-08-2025 23:04,NAB12BA89B93ABC4DE0A69F,082-900-001,44444444,SPOTIFY NAB,48.7,0,241152.67,DR,REF913922,NAB,Business
26-08-2025 23:12,NABDA408A2FA9D74CBCB536,082-900-001,44444444,BWS NAB,289.57,0,240863.1,DR,REF370255,NAB,Business
26-08-2025 23:12,NABF6E1AFCF8F1D42C5AEC7,082-900-001,44444444,BIGW NAB,252.58,0,240610.52,DR,REF248960,NAB,Business
26-08-2025 23:12,NABB8D6F8FE693644D58CA3,082-900-001,44444444,STARBUCKS NAB,164.67,0,240445.85,DR,REF819028,NAB,Business
27-08-2025 00:00,NAB5774A0F69EFD4161A625,082-900-001,44444444,ALDI NAB,260.94,0,240184.91,DR,REF503710,NAB,Business
27-08-2025 00:09,NAB612A0799165A43AFB6A2,082-900-001,44444444,MENULOG NAB,113.37,0,240071.54,DR,REF212043,NAB,Business
27-08-2025 00:19,NAB1246DFDB84D44F37835E,082-900-001,44444444,HARVEY NORMAN NAB,1046.35,0,239025.19,DR,REF125088,NAB,Business
27-08-2025 00:28,NABE9453EC655B24C65BA32,082-900-001,44444444,MENULOG NAB,139.03,0,238886.16,DR,REF913979,NAB,Business
27-08-2025 01:08,NAB459765BF2D8142ACB5D0,082-900-001,44444444,TAFE BOOKSHOP NAB,283.53,0,238602.63,DR,REF933681,NAB,Business
27-08-2025 01:09,NAB05E90496E3FA410A91DB,082-900-001,44444444,PAY - SALARY NAB,0,5979.21,244581.84,CR,REF228871,NAB,Business
27-08-2025 01:26,NAB1DA966454C914590859F,082-900-001,44444444,SPOTIFY NAB,44.4,0,244537.44,DR,REF898465,NAB,Business
27-08-2025 01:29,NABA067135510C544A0BE68,082-900-001,44444444,PAY - SALARY NAB,0,4277.34,248814.78,CR,REF281628,NAB,Business
27-08-2025 01:39,NAB3433D9C2928F4BAABD0A,082-900-001,44444444,LIQUORLAND NAB,542.65,0,248272.13,DR,REF654567,NAB,Business
27-08-2025 01:56,NABDB31C2A6AFE94CBA823D,082-900-001,44444444,STARBUCKS NAB,59.61,0,248212.52,DR,REF329108,NAB,Business
27-08-2025 01:58,NABA3BCCF68648F4797B4D5,082-900-001,44444444,COMPANY PAYROLL NAB,0,150.96,248363.48,CR,REF354497,NAB,Business
27-08-2025 02:32,NAB54D3900924B640EE8FF9,082-900-001,44444444,BP NAB,344.62,0,248018.86,DR,REF592039,NAB,Business
27-08-2025 03:10,NAB6F735FC05E2D45C384A1,082-900-001,44444444,ZOOM NAB,1069.1,0,246949.76,DR,REF887277,NAB,Business
27-08-2025 03:31,NAB89F59B25D1AB4448A514,082-900-001,44444444,HARVEY NORMAN NAB,289.01,0,246660.75,DR,REF867795,NAB,Business
27-08-2025 03:39,NAB0034C261DDAA4CF98EA8,082-900-001,44444444,COLES NAB,252.04,0,246408.71,DR,REF702016,NAB,Business
27-08-2025 04:12,NABF86090A4A36540869561,082-900-001,44444444,AMAZON AU NAB,373.31,0,246035.4,DR,REF860163,NAB,Business
27-08-2025 04:17,NAB31A184B972764039B48E,082-900-001,44444444,MCDONALDS NAB,72.42,0,245962.98,DR,REF438653,NAB,Business
27-08-2025 04:19,NAB3AE8AEB4531F4E1992FF,082-900-001,44444444,COLES NAB,87.93,0,245875.05,DR,REF368185,NAB,Business
27-08-2025 04:53,NABD8E6369E895D4538ADC3,082-900-001,44444444,LIQUORLAND NAB,139.49,0,245735.56,DR,REF508719,NAB,Business
27-08-2025 05:01,NAB6D6C791C3045483B892E,082-900-001,44444444,WOOLWORTHS NAB,600.75,0,245134.81,DR,REF266775,NAB,Business
27-08-2025 05:03,NAB3E4FAE0E2BBB42FE8B9A,082-900-001,44444444,HARVEY NORMAN NAB,56.68,0,245078.13,DR,REF142797,NAB,Business
27-08-2025 06:08,NAB858EE9FCF8B549D0A81D,082-900-001,44444444,PAYPAL *NETFLIX NAB,154.48,0,244923.65,DR,REF440941,NAB,Business
27-08-2025 06:14,NABAFBFAA3B63AA4D419681,082-900-001,44444444,7-ELEVEN NAB,265.59,0,244658.06,DR,REF165566,NAB,Business
27-08-2025 06:19,NAB0AE25F425FE34CC584B1,082-900-001,44444444,WOOLWORTHS NAB,429.33,0,244228.73,DR,REF866570,NAB,Business
27-08-2025 06:25,NAB3BA1CA70049849228828,082-900-001,44444444,STARBUCKS NAB,106.62,0,244122.11,DR,REF724691,NAB,Business
27-08-2025 06:37,NABCD14E93DC4E54C00BDFB,082-900-001,44444444,COLES NAB,678.5,0,243443.61,DR,REF920879,NAB,Business
27-08-2025 06:43,NAB3B4C4A3C3B664DF8B0C7,082-900-001,44444444,SHELL NAB,639.78,0,242803.83,DR,REF205665,NAB,Business
27-08-2025 06:50,NABC16600FD3103409A9CE7,082-900-001,44444444,PAYMENT GATEWAY NAB,208.78,0,242595.05,DR,REF364428,NAB,Business
27-08-2025 06:57,NABA161B885E05147EFBFE4,082-900-001,44444444,WOOLWORTHS NAB,56.09,0,242538.96,DR,REF102480,NAB,Business
27-08-2025 08:15,NAB64CE1460E28245E4B32E,082-900-001,44444444,FLIXBUS NAB,394.69,0,242144.27,DR,REF486847,NAB,Business
27-08-2025 08:22,NABAC112417CD464BD489BE,082-900-001,44444444,BIGW NAB,824.48,0,241319.79,DR,REF779165,NAB,Business
27-08-2025 09:05,NAB2689E1DE7B734B77BC18,082-900-001,44444444,FLIXBUS NAB,378.52,0,240941.27,DR,REF785379,NAB,Business
27-08-2025 09:16,NABC6DB0A10F23445C9A8BD,082-900-001,44444444,PAYPAL *NETFLIX NAB,734.95,0,240206.32,DR,REF804078,NAB,Business
27-08-2025 09:22,NABF030D2E9868E4072B568,082-900-001,44444444,WAGES CREDIT NAB,0,5578.82,245785.14,CR,REF543260,NAB,Business
27-08-2025 09:37,INT0C9C97B3BD0D43BC9153,082-900-001,44444444,TRANSFER TO CBA 22222222,604.8,0,245180.34,DR,INT-53948,NAB,Business
27-08-2025 10:03,NAB7638992E99124774A792,082-900-001,44444444,SPOTIFY NAB,383.1,0,244797.24,DR,REF196469,NAB,Business
27-08-2025 10:12,NABA22C04A77AE34FB3B3C4,082-900-001,44444444,BANK FEE NAB,110.98,0,244686.26,DR,REF319505,NAB,Business
27-08-2025 10:21,NABC04CA4E53B7740CFAFB7,082-900-001,44444444,BWS NAB,1459.06,0,243227.2,DR,REF262693,NAB,Business
27-08-2025 10:46,NAB7968D88DB3CD4F4CA918,082-900-001,44444444,COMPANY PAYROLL NAB,0,639.5,243866.7,CR,REF615585,NAB,Business
27-08-2025 11:00,NAB2D2CADE6568A4D56B294,082-900-001,44444444,BP NAB,606.16,0,243260.54,DR,REF664344,NAB,Business
27-08-2025 11:00,NABCCCF0B2C48A1469B9662,082-900-001,44444444,HARVEY NORMAN NAB,248.58,0,243011.96,DR,REF305985,NAB,Business
27-08-2025 11:36,NAB67284103DAFC4CD18C41,082-900-001,44444444,RAILWAY STATION NAB,73.39,0,242938.57,DR,REF686080,NAB,Business
27-08-2025 11:39,NAB4097E7ACF8154EF8943A,082-900-001,44444444,BANK FEE NAB,368.53,0,242570.04,DR,REF688736,NAB,Business
27-08-2025 11:39,NAB312E0B90D3F2461C88D6,082-900-001,44444444,AMAZON AU NAB,208.7,0,242361.34,DR,REF602578,NAB,Business
27-08-2025 12:10,NAB7B722EF0E1114E70B1C0,082-900-001,44444444,INTERNET TRANSFER NAB,50.8,0,242310.54,DR,REF803039,NAB,Business
27-08-2025 12:15,NAB2BE0AC7F19934DCE8BAE,082-900-001,44444444,APPLE NAB,612.18,0,241698.36,DR,REF942832,NAB,Business
27-08-2025 12:57,NAB6DE5D884FE714EC28D6C,082-900-001,44444444,WAGES CREDIT NAB,0,2442.04,244140.4,CR,REF744473,NAB,Business
27-08-2025 13:00,NAB6F1C605376F14D499843,082-900-001,44444444,SHELL NAB,894.7,0,243245.7,DR,REF608697,NAB,Business
27-08-2025 13:07,NAB70CB8C77BF0E417E8CE9,082-900-001,44444444,JB HI-FI NAB,305.78,0,242939.92,DR,REF904179,NAB,Business
27-08-2025 14:04,NAB303EFC21D9CD4FF4879E,082-900-001,44444444,MCDONALDS NAB,717.77,0,242222.15,DR,REF491114,NAB,Business
27-08-2025 14:29,NAB515DD767E4DE45F5A3E7,082-900-001,44444444,MCDONALDS NAB,379.61,0,241842.54,DR,REF129024,NAB,Business
27-08-2025 14:30,NAB4B76CA898F9F494D93C0,082-900-001,44444444,ALDI NAB,54.98,0,241787.56,DR,REF476671,NAB,Business
27-08-2025 15:24,NABF611E01E228E4DE1AC12,082-900-001,44444444,AMAZON AU NAB,262.85,0,241524.71,DR,REF254308,NAB,Business
27-08-2025 15:33,NAB6C39E8D295204997AC88,082-900-001,44444444,ALDI NAB,270.28,0,241254.43,DR,REF225042,NAB,Business
27-08-2025 16:02,NAB1C7CEC865BC345A09032,082-900-001,44444444,CITYLINK NAB,179.85,0,241074.58,DR,REF398096,NAB,Business
27-08-2025 16:50,NAB4B25E724E2C8493CAEB4,082-900-001,44444444,UBER EATS NAB,212.95,0,240861.63,DR,REF257700,NAB,Business
27-08-2025 17:23,NAB77BA0DBE2072407AA74A,082-900-001,44444444,FLIXBUS NAB,161.48,0,240700.15,DR,REF692222,NAB,Business
27-08-2025 17:30,NABB82E57B32905446CB25B,082-900-001,44444444,TAFE BOOKSHOP NAB,54.58,0,240645.57,DR,REF967501,NAB,Business
27-08-2025 17:40,NAB2B2548B7BAE14ADB8A29,082-900-001,44444444,FLIXBUS NAB,169.85,0,240475.72,DR,REF840186,NAB,Business
27-08-2025 17:46,NAB4588B4C16CF94E36BC29,082-900-001,44444444,DOMINO'S PIZZA NAB,13.25,0,240462.47,DR,REF736028,NAB,Business
27-08-2025 18:29,NAB4BEFE3D7C0A949219A9E,082-900-001,44444444,WOOLWORTHS NAB,182,0,240280.47,DR,REF507653,NAB,Business
27-08-2025 18:38,NABF1A023D9216A4EA5B24B,082-900-001,44444444,JB HI-FI NAB,90.81,0,240189.66,DR,REF886531,NAB,Business
27-08-2025 19:07,NABD5837D254D2D4F2A992B,082-900-001,44444444,MCDONALDS NAB,631.65,0,239558.01,DR,REF392199,NAB,Business
27-08-2025 19:22,NABC4B1E8C9F51549E5A48D,082-900-001,44444444,PAYPAL *NETFLIX NAB,188.91,0,239369.1,DR,REF171784,NAB,Business
27-08-2025 19:36,NAB09A648A4E7C64C23B157,082-900-001,44444444,BWS NAB,53.39,0,239315.71,DR,REF101649,NAB,Business
27-08-2025 19:42,NAB02D23B3C9DEE4AC7B0E0,082-900-001,44444444,RAILWAY STATION NAB,300.01,0,239015.7,DR,REF534340,NAB,Business
27-08-2025 19:46,NABFB812D00D87245A0B49E,082-900-001,44444444,JB HI-FI NAB,326.22,0,238689.48,DR,REF665753,NAB,Business
27-08-2025 19:58,NAB24ED7FDF050041A4AF7D,082-900-001,44444444,BIGW NAB,109.78,0,238579.7,DR,REF249991,NAB,Business
27-08-2025 20:11,NAB30A44198EA8240FCB1D5,082-900-001,44444444,INTERNET TRANSFER NAB,575.91,0,238003.79,DR,REF631243,NAB,Business
27-08-2025 20:15,NAB6AB296B1B73B4D47A122,082-900-001,44444444,TAFE BOOKSHOP NAB,1437.75,0,236566.04,DR,REF521186,NAB,Business
27-08-2025 20:23,NAB106626CEBF224C3698D1,082-900-001,44444444,RAILWAY STATION NAB,238.34,0,236327.7,DR,REF681081,NAB,Business
27-08-2025 20:46,NABEFBE238F32AE45668B71,082-900-001,44444444,LIQUORLAND NAB,355.56,0,235972.14,DR,REF108093,NAB,Business
27-08-2025 20:47,NABCCA1BF9F8DB942C58E0B,082-900-001,44444444,COLES NAB,297.66,0,235674.48,DR,REF507274,NAB,Business
27-08-2025 21:09,NAB106892098D9C45C68F24,082-900-001,44444444,DOMINO'S PIZZA NAB,269.01,0,235405.47,DR,REF397183,NAB,Business
27-08-2025 21:18,NAB40098B8D86054BFBB90C,082-900-001,44444444,CITYLINK NAB,251.68,0,235153.79,DR,REF630415,NAB,Business
27-08-2025 21:22,NAB290A333E417D49B0BE1F,082-900-001,44444444,LIQUORLAND NAB,1264.87,0,233888.92,DR,REF436524,NAB,Business
27-08-2025 21:23,NAB90CAC39C5B1C4F66818D,082-900-001,44444444,INTERNET TRANSFER NAB,1461.8,0,232427.12,DR,REF721315,NAB,Business
27-08-2025 21:30,NAB9042DFDFD1724C66B883,082-900-001,44444444,FLIXBUS NAB,203.32,0,232223.8,DR,REF390479,NAB,Business
27-08-2025 21:42,NABDB4A5C5B82E8437889BD,082-900-001,44444444,HARVEY NORMAN NAB,226.49,0,231997.31,DR,REF351178,NAB,Business
27-08-2025 21:53,NAB63C183C4BF5C496FBCE8,082-900-001,44444444,WOOLWORTHS NAB,349.03,0,231648.28,DR,REF197569,NAB,Business
27-08-2025 22:07,NABC80A2FD4BBBB44CCB525,082-900-001,44444444,AMAZON AU NAB,20.55,0,231627.73,DR,REF148187,NAB,Business
27-08-2025 22:25,NABF6F1569271064415A3C5,082-900-001,44444444,BWS NAB,318.57,0,231309.16,DR,REF786633,NAB,Business
27-08-2025 22:44,NAB59B05DCE982944CD891C,082-900-001,44444444,BP NAB,171.59,0,231137.57,DR,REF575004,NAB,Business
27-08-2025 22:56,NAB56276477B42A4479A01C,082-900-001,44444444,COMPANY PAYROLL NAB,0,1187.06,232324.63,CR,REF290409,NAB,Business
27-08-2025 23:21,NABE2D0E3056B97464187B0,082-900-001,44444444,KFC NAB,50.48,0,232274.15,DR,REF845504,NAB,Business
27-08-2025 23:27,NABEB0D1CF5E5B4463EA7EF,082-900-001,44444444,KFC NAB,125.17,0,232148.98,DR,REF823746,NAB,Business
28-08-2025 00:01,NABB110758187BD4378AC3C,082-900-001,44444444,CITYLINK NAB,725.5,0,231423.48,DR,REF848400,NAB,Business
28-08-2025 00:02,NAB1C10A5D06BBD40139E11,082-900-001,44444444,7-ELEVEN NAB,161.56,0,231261.92,DR,REF330916,NAB,Business
28-08-2025 00:07,NAB94BD7B25E72E48B3833B,082-900-001,44444444,PAYROLL CREDIT NAB,0,4059.21,235321.13,CR,REF655986,NAB,Business
28-08-2025 00:38,NAB0BCB024C34264FC4B1D1,082-900-001,44444444,TAFE BOOKSHOP NAB,1547.12,0,233774.01,DR,REF754685,NAB,Business
28-08-2025 00:54,NABA82785AED0A44E0AA07C,082-900-001,44444444,UBER EATS NAB,172.33,0,233601.68,DR,REF750931,NAB,Business
28-08-2025 01:33,NABF94FA2D802AD4E4681BD,082-900-001,44444444,FLIXBUS NAB,407.44,0,233194.24,DR,REF951061,NAB,Business
28-08-2025 02:08,NAB42F2F5FCD76F43C79733,082-900-001,44444444,PAYMENT GATEWAY NAB,507.3,0,232686.94,DR,REF551897,NAB,Business
28-08-2025 02:23,NAB36C9D8506FBA4DC0AAE6,082-900-001,44444444,WAGES CREDIT NAB,0,1733.44,234420.38,CR,REF856369,NAB,Business
28-08-2025 03:05,NABB5BAE2C7A4B549FEB8CE,082-900-001,44444444,WAGES CREDIT NAB,0,5404.7,239825.08,CR,REF910327,NAB,Business
28-08-2025 03:07,NAB7524D81E04BE4021879E,082-900-001,44444444,LIQUORLAND NAB,758.13,0,239066.95,DR,REF474884,NAB,Business
28-08-2025 03:24,NAB5A08130EB5334648B0E5,082-900-001,44444444,SALARY PAYMENT NAB,0,2707.73,241774.68,CR,REF880415,NAB,Business
28-08-2025 03:37,NAB2B0D108105394FB7B784,082-900-001,44444444,UBER EATS NAB,393.46,0,241381.22,DR,REF980717,NAB,Business
28-08-2025 03:49,NAB49BC74C879C84534B40E,082-900-001,44444444,KFC NAB,1295.61,0,240085.61,DR,REF390820,NAB,Business
28-08-2025 04:05,NABF374C748C9FF4B8A8F80,082-900-001,44444444,SPOTIFY NAB,495.25,0,239590.36,DR,REF278660,NAB,Business
28-08-2025 05:51,NAB50C8AAC7721D4C1AB71A,082-900-001,44444444,FLIXBUS NAB,247.17,0,239343.19,DR,REF978083,NAB,Business
28-08-2025 06:02,NAB92EF4F84384E44F7BB93,082-900-001,44444444,SALARY PAYMENT NAB,0,4300.25,243643.44,CR,REF367800,NAB,Business
28-08-2025 06:09,NABA2181CAC47414679A9EC,082-900-001,44444444,DOMINO'S PIZZA NAB,29.89,0,243613.55,DR,REF754604,NAB,Business
28-08-2025 06:17,NABD31B394DAC564D92B448,082-900-001,44444444,LIQUORLAND NAB,561.29,0,243052.26,DR,REF262738,NAB,Business
28-08-2025 06:22,NAB78917E6463894E6CB9EA,082-900-001,44444444,DOMINO'S PIZZA NAB,1110.26,0,241942,DR,REF846884,NAB,Business
28-08-2025 07:16,NABAF2A911855CD48D986CF,082-900-001,44444444,WOOLWORTHS NAB,86.44,0,241855.56,DR,REF617250,NAB,Business
28-08-2025 07:17,NAB7DE48E0A1899463BAE29,082-900-001,44444444,BANK FEE NAB,103.89,0,241751.67,DR,REF347855,NAB,Business
28-08-2025 07:26,NAB5DABEA620AE444A88DD8,082-900-001,44444444,ALDI NAB,563.75,0,241187.92,DR,REF498596,NAB,Business
28-08-2025 07:27,NAB19C9481D22F047A9BF40,082-900-001,44444444,PAYPAL *NETFLIX NAB,379.7,0,240808.22,DR,REF819211,NAB,Business
28-08-2025 07:29,NAB45FBEB1A51D343E78CE0,082-900-001,44444444,MENULOG NAB,355.17,0,240453.05,DR,REF125008,NAB,Business
28-08-2025 07:34,NAB697ACA04A2C9471DAA5E,082-900-001,44444444,WOOLWORTHS NAB,59.21,0,240393.84,DR,REF328195,NAB,Business
28-08-2025 07:37,NAB6BF9ADBF77424DF08425,082-900-001,44444444,ZOOM NAB,619.57,0,239774.27,DR,REF921358,NAB,Business
28-08-2025 07:40,NABDB5006CFE56B45E2BD29,082-900-001,44444444,PAYPAL *NETFLIX NAB,75.58,0,239698.69,DR,REF451762,NAB,Business
28-08-2025 07:43,NAB8086A801F635442D8B38,082-900-001,44444444,WAGES CREDIT NAB,0,6857.28,246555.97,CR,REF775219,NAB,Business
28-08-2025 07:43,NAB4BB4473E94A4491FBE6A,082-900-001,44444444,COMPANY PAYROLL NAB,0,796.96,247352.93,CR,REF157527,NAB,Business
28-08-2025 07:56,NAB5944B552EF254273AA5D,082-900-001,44444444,RAILWAY STATION NAB,424.24,0,246928.69,DR,REF882328,NAB,Business
28-08-2025 08:16,NABE58DDC9A909149C7951B,082-900-001,44444444,INTERNET TRANSFER NAB,31.61,0,246897.08,DR,REF879473,NAB,Business
28-08-2025 08:20,NAB7744B1F777B645D7A534,082-900-001,44444444,JB HI-FI NAB,144.98,0,246752.1,DR,REF891378,NAB,Business
28-08-2025 08:28,NAB11BCA21959444F87B0C5,082-900-001,44444444,KFC NAB,171.62,0,246580.48,DR,REF200465,NAB,Business
28-08-2025 08:43,NAB655DF6EC78AA43DBBAC4,082-900-001,44444444,HARVEY NORMAN NAB,366.55,0,246213.93,DR,REF255251,NAB,Business
28-08-2025 08:53,NAB32443AAD4B644D669BEC,082-900-001,44444444,BIGW NAB,40.67,0,246173.26,DR,REF350053,NAB,Business
28-08-2025 09:09,NAB2B69CD6904E94431BE84,082-900-001,44444444,KFC NAB,476.97,0,245696.29,DR,REF590516,NAB,Business
28-08-2025 09:16,NAB132068BA53EE455F9DDE,082-900-001,44444444,CITYLINK NAB,163.52,0,245532.77,DR,REF500460,NAB,Business
28-08-2025 09:17,NABD373347E818D48A68246,082-900-001,44444444,MENULOG NAB,47.64,0,245485.13,DR,REF882218,NAB,Business
28-08-2025 09:38,NAB347D193A366D47FB9342,082-900-001,44444444,LIQUORLAND NAB,178.7,0,245306.43,DR,REF962196,NAB,Business
28-08-2025 09:42,NABC6C65B9D38974B20AA1A,082-900-001,44444444,SHELL NAB,147.62,0,245158.81,DR,REF571007,NAB,Business
28-08-2025 09:43,NAB8D5F685FB4C347DA8124,082-900-001,44444444,INTERNET TRANSFER NAB,345.73,0,244813.08,DR,REF672937,NAB,Business
28-08-2025 09:53,NAB540CBADB517A464BB6FD,082-900-001,44444444,BANK FEE NAB,281,0,244532.08,DR,REF160894,NAB,Business
28-08-2025 10:25,NAB534BD349120E4327BF1A,082-900-001,44444444,MENULOG NAB,194.34,0,244337.74,DR,REF481810,NAB,Business
28-08-2025 10:32,NABE815A9C14D524F658DBD,082-900-001,44444444,BANK FEE NAB,361.42,0,243976.32,DR,REF614155,NAB,Business
28-08-2025 10:32,NABA59829119AC04ADE9C2D,082-900-001,44444444,BP NAB,172.5,0,243803.82,DR,REF724339,NAB,Business
28-08-2025 10:54,NAB33FB91B2AFBA4202B470,082-900-001,44444444,JB HI-FI NAB,15.18,0,243788.64,DR,REF574179,NAB,Business
28-08-2025 11:09,NABF728396593BF4B83B204,082-900-001,44444444,HARVEY NORMAN NAB,66.92,0,243721.72,DR,REF933252,NAB,Business
28-08-2025 11:13,NAB9E057A68EB8B412989CD,082-900-001,44444444,STARBUCKS NAB,201.37,0,243520.35,DR,REF760163,NAB,Business
28-08-2025 11:15,NAB2585A4E62FED4E6D88BD,082-900-001,44444444,BIGW NAB,674.41,0,242845.94,DR,REF730639,NAB,Business
28-08-2025 11:17,NAB0A9E8C569E2C4B90865A,082-900-001,44444444,AMAZON AU NAB,564.96,0,242280.98,DR,REF589041,NAB,Business
28-08-2025 11:25,NABACADE198F93D4EFFAB5D,082-900-001,44444444,SHELL NAB,354.26,0,241926.72,DR,REF991355,NAB,Business
28-08-2025 12:19,NAB094A15E4C110446AA3F0,082-900-001,44444444,COLES NAB,1157.53,0,240769.19,DR,REF669367,NAB,Business
28-08-2025 12:25,NAB0C86B0D0954F45B3933A,082-900-001,44444444,BANK FEE NAB,778.84,0,239990.35,DR,REF732614,NAB,Business
28-08-2025 12:41,NABAFCC1FBE03904ACF9B33,082-900-001,44444444,ZOOM NAB,491.49,0,239498.86,DR,REF448200,NAB,Business
28-08-2025 12:42,NABC03FC251BF6A417E872E,082-900-001,44444444,TAFE BOOKSHOP NAB,201.57,0,239297.29,DR,REF619949,NAB,Business
28-08-2025 12:47,INTF21D412A2D434A069FF4,082-900-001,44444444,TRANSFER TO CBA 22222222,581.54,0,238715.75,DR,INT-95914,NAB,Business
28-08-2025 12:56,NAB365236E1914E4A89956E,082-900-001,44444444,UBER EATS NAB,180.54,0,238535.21,DR,REF504453,NAB,Business
28-08-2025 13:46,NAB59B36DC036074814A5BA,082-900-001,44444444,FLIXBUS NAB,114.6,0,238420.61,DR,REF625162,NAB,Business
28-08-2025 13:51,NABF444A6956C4F491C9138,082-900-001,44444444,ZOOM NAB,58.01,0,238362.6,DR,REF673842,NAB,Business
28-08-2025 14:16,NAB34E184CFC1FB4367A19A,082-900-001,44444444,ALDI NAB,105.78,0,238256.82,DR,REF171634,NAB,Business
28-08-2025 14:59,NAB6DD2F2D9573844DDB3F5,082-900-001,44444444,BIGW NAB,171.06,0,238085.76,DR,REF534455,NAB,Business
28-08-2025 15:43,NAB9EED277E68904153837D,082-900-001,44444444,COMPANY PAYROLL NAB,0,6869.76,244955.52,CR,REF430006,NAB,Business
28-08-2025 15:46,NAB5413C6081B5445A8B537,082-900-001,44444444,WOOLWORTHS NAB,1122.99,0,243832.53,DR,REF699154,NAB,Business
28-08-2025 16:07,NAB9F4B81441BFC488594C1,082-900-001,44444444,HARVEY NORMAN NAB,321.03,0,243511.5,DR,REF517815,NAB,Business
28-08-2025 16:12,NAB58A814F3481E4B609C8F,082-900-001,44444444,ZOOM NAB,194.54,0,243316.96,DR,REF615339,NAB,Business
28-08-2025 16:18,NABEF64782B16E84A2296EB,082-900-001,44444444,PAY - SALARY NAB,0,6812.45,250129.41,CR,REF297191,NAB,Business
28-08-2025 16:21,NAB24F05D3170614138ADA5,082-900-001,44444444,UBER EATS NAB,133.2,0,249996.21,DR,REF421014,NAB,Business
28-08-2025 16:26,NAB6BEA7B7FE9F043FB828C,082-900-001,44444444,DOMINO'S PIZZA NAB,521.13,0,249475.08,DR,REF391897,NAB,Business
28-08-2025 17:20,NAB7E0836B33A2747CD9313,082-900-001,44444444,DOMINO'S PIZZA NAB,400.53,0,249074.55,DR,REF488170,NAB,Business
28-08-2025 17:47,NABDEA42024860546F092E6,082-900-001,44444444,DOMINO'S PIZZA NAB,683.3,0,248391.25,DR,REF299296,NAB,Business
28-08-2025 19:25,NAB87115CA9680244BDA4AC,082-900-001,44444444,BP NAB,246.47,0,248144.78,DR,REF781837,NAB,Business
28-08-2025 19:55,NAB30EDB90B3E1346749634,082-900-001,44444444,PAYROLL CREDIT NAB,0,792.5,248937.28,CR,REF201476,NAB,Business
28-08-2025 20:05,INT89FA496855A0426485EA,082-900-001,44444444,TRANSFER FROM CBA 22222222,0,282.34,249219.62,CR,INT-56821,NAB,Business
28-08-2025 20:13,NABF410687EAE104C20AD9E,082-900-001,44444444,ZOOM NAB,322.79,0,248896.83,DR,REF967140,NAB,Business
28-08-2025 20:14,NAB2850A327FB294215927E,082-900-001,44444444,FLIXBUS NAB,158.75,0,248738.08,DR,REF411916,NAB,Business
28-08-2025 20:20,NABFAA70705157246C1AE34,082-900-001,44444444,COLES NAB,533.75,0,248204.33,DR,REF684054,NAB,Business
28-08-2025 20:33,NAB728EDF5670ED47C5BFBF,082-900-001,44444444,INTERNET TRANSFER NAB,158.8,0,248045.53,DR,REF997229,NAB,Business
28-08-2025 20:55,NABEED7D43BEFC240B9B673,082-900-001,44444444,INTERNET TRANSFER NAB,166.41,0,247879.12,DR,REF803032,NAB,Business
28-08-2025 21:16,NAB7FFEB35CAEA74806B9FB,082-900-001,44444444,CITYLINK NAB,443.48,0,247435.64,DR,REF226018,NAB,Business
28-08-2025 21:19,NABFF54252ED9E349FDA86D,082-900-001,44444444,PAY - SALARY NAB,0,5743.63,253179.27,CR,REF800149,NAB,Business
28-08-2025 21:52,NAB2637ED63B3E14EFBBA8A,082-900-001,44444444,BIGW NAB,178.17,0,253001.1,DR,REF630797,NAB,Business
28-08-2025 21:54,NABE59FC49C427C47B098C4,082-900-001,44444444,BWS NAB,310.45,0,252690.65,DR,REF967604,NAB,Business
28-08-2025 22:19,NAB5FF95EB71AAB4C75ADCC,082-900-001,44444444,BANK FEE NAB,60.9,0,252629.75,DR,REF577506,NAB,Business
28-08-2025 22:40,NABCDD616BEB60B4F31B5C3,082-900-001,44444444,PAY - SALARY NAB,0,4280.42,256910.17,CR,REF261869,NAB,Business
28-08-2025 22:46,NABA4331F3E77C04075BC26,082-900-001,44444444,PAYMENT GATEWAY NAB,443.85,0,256466.32,DR,REF663058,NAB,Business
28-08-2025 22:51,NABF78059AF8A364BD7B04F,082-900-001,44444444,PAYPAL *NETFLIX NAB,382.12,0,256084.2,DR,REF877411,NAB,Business
28-08-2025 22:54,NAB01D7CF504AAA4DF4AEB1,082-900-001,44444444,CITYLINK NAB,109.25,0,255974.95,DR,REF240295,NAB,Business
28-08-2025 23:14,NABA4FFCE68F999401F94D3,082-900-001,44444444,INTERNET TRANSFER NAB,936.74,0,255038.21,DR,REF905055,NAB,Business
28-08-2025 23:22,NAB6D7CDA81461E4246A763,082-900-001,44444444,DOMINO'S PIZZA NAB,493.06,0,254545.15,DR,REF823234,NAB,Business
28-08-2025 23:37,NAB3A0E4FBA558D4D3781CA,082-900-001,44444444,DOMINO'S PIZZA NAB,321.81,0,254223.34,DR,REF790115,NAB,Business
28-08-2025 23:43,NABC39B1F11051846839D65,082-900-001,44444444,LIQUORLAND NAB,539.48,0,253683.86,DR,REF979801,NAB,Business
28-08-2025 23:48,INT8BD9EDEB14E149A9AECB,082-900-001,44444444,TRANSFER TO CBA 33333333,594.15,0,253089.71,DR,INT-50772,NAB,Business
28-08-2025 23:56,NABFC447DADD3A6412C88C2,082-900-001,44444444,WAGES CREDIT NAB,0,5865.54,258955.25,CR,REF171352,NAB,Business
29-08-2025 00:33,NAB332B28D6897C45C7B368,082-900-001,44444444,BIGW NAB,107.82,0,258847.43,DR,REF509206,NAB,Business
29-08-2025 00:36,NABC08A6389A6F54AC6A27A,082-900-001,44444444,UBER EATS NAB,1113.47,0,257733.96,DR,REF909329,NAB,Business
29-08-2025 00:49,NABDB180CC837CC4948B656,082-900-001,44444444,BP NAB,411.54,0,257322.42,DR,REF455601,NAB,Business
29-08-2025 01:11,NABDC339F98057B494E8654,082-900-001,44444444,SHELL NAB,487.52,0,256834.9,DR,REF260332,NAB,Business
29-08-2025 01:25,NAB40314240BBED47C4BCE6,082-900-001,44444444,RAILWAY STATION NAB,1381.33,0,255453.57,DR,REF715802,NAB,Business
29-08-2025 01:27,INT71D052D14CF4492196A7,082-900-001,44444444,TRANSFER TO CBA 33333333,1990.98,0,253462.59,DR,INT-99676,NAB,Business
29-08-2025 01:29,NABE36F3081951640EE93A3,082-900-001,44444444,TAFE BOOKSHOP NAB,57.69,0,253404.9,DR,REF819086,NAB,Business
29-08-2025 01:31,NABD32B5993057B4DA794F0,082-900-001,44444444,PAYPAL *NETFLIX NAB,85.91,0,253318.99,DR,REF428228,NAB,Business
29-08-2025 02:53,NAB56AC15F591DC49758D44,082-900-001,44444444,LIQUORLAND NAB,176.5,0,253142.49,DR,REF788879,NAB,Business
29-08-2025 03:16,NAB45E34C1B0A8E4C1A8969,082-900-001,44444444,COLES NAB,81.47,0,253061.02,DR,REF543778,NAB,Business
29-08-2025 04:18,NAB5F86BA9C466D40DC8781,082-900-001,44444444,AMAZON AU NAB,273.4,0,252787.62,DR,REF845305,NAB,Business
29-08-2025 04:21,NAB1D369E387F7E45F49FB1,082-900-001,44444444,BANK FEE NAB,94.91,0,252692.71,DR,REF658700,NAB,Business
29-08-2025 04:29,NABE604155580044ABFB500,082-900-001,44444444,SALARY PAYMENT NAB,0,2198.67,254891.38,CR,REF378679,NAB,Business
29-08-2025 04:37,NABDCF7698F974942DB8901,082-900-001,44444444,TAFE BOOKSHOP NAB,204.8,0,254686.58,DR,REF376309,NAB,Business
29-08-2025 05:06,NAB581281E239DB40018FE9,082-900-001,44444444,RAILWAY STATION NAB,452.28,0,254234.3,DR,REF624294,NAB,Business
29-08-2025 05:17,NAB3A86ECF287DE4943BF02,082-900-001,44444444,CITYLINK NAB,130.46,0,254103.84,DR,REF115723,NAB,Business
29-08-2025 05:31,NAB82DC8612C12B4599ABFC,082-900-001,44444444,PAYMENT GATEWAY NAB,180.42,0,253923.42,DR,REF901926,NAB,Business
29-08-2025 05:34,NABB72CC3A8294B47F98124,082-900-001,44444444,APPLE NAB,35.38,0,253888.04,DR,REF610123,NAB,Business
29-08-2025 05:49,NAB2EB9DEE9244C40A881E9,082-900-001,44444444,ALDI NAB,97.17,0,253790.87,DR,REF141734,NAB,Business
29-08-2025 05:51,NAB04777CEB2F2C4969A358,082-900-001,44444444,BANK FEE NAB,492.08,0,253298.79,DR,REF855211,NAB,Business
29-08-2025 06:00,NAB8B4C624252034B288184,082-900-001,44444444,TAFE BOOKSHOP NAB,45.73,0,253253.06,DR,REF753561,NAB,Business
29-08-2025 06:11,NABF7DCFF61D1994EE69213,082-900-001,44444444,COLES NAB,174.31,0,253078.75,DR,REF309430,NAB,Business
29-08-2025 06:16,NABCD13CFCDDDCF4F58BFEB,082-900-001,44444444,TAFE BOOKSHOP NAB,811.82,0,252266.93,DR,REF728374,NAB,Business
29-08-2025 06:29,NAB43D4C656D0874CCF9882,082-900-001,44444444,AMAZON AU NAB,32.95,0,252233.98,DR,REF591713,NAB,Business
29-08-2025 06:38,NAB5C8DF4A3A810434B9E76,082-900-001,44444444,COLES NAB,135.58,0,252098.4,DR,REF891905,NAB,Business
29-08-2025 06:44,NAB4B62EF1B2D9D44AD9882,082-900-001,44444444,SHELL NAB,265.78,0,251832.62,DR,REF629967,NAB,Business
29-08-2025 08:40,NAB07E4DE0FAE7049C185AD,082-900-001,44444444,COMPANY PAYROLL NAB,0,3227.91,255060.53,CR,REF555926,NAB,Business
29-08-2025 09:21,NAB833B39D0731449DBA161,082-900-001,44444444,DOMINO'S PIZZA NAB,42.99,0,255017.54,DR,REF889896,NAB,Business
29-08-2025 09:40,NAB10B63CADF3AF40FCAEE1,082-900-001,44444444,SPOTIFY NAB,447.21,0,254570.33,DR,REF377900,NAB,Business
29-08-2025 09:44,NAB775A37D51F0746939996,082-900-001,44444444,AMAZON AU NAB,347.75,0,254222.58,DR,REF960167,NAB,Business
29-08-2025 10:15,NABCD76EF26489A48B08229,082-900-001,44444444,KFC NAB,281.77,0,253940.81,DR,REF324259,NAB,Business
29-08-2025 10:16,NAB4D708AC5EA1140F992D6,082-900-001,44444444,JB HI-FI NAB,99.59,0,253841.22,DR,REF323209,NAB,Business
29-08-2025 10:32,NAB88699BAF5D8540D1B8EE,082-900-001,44444444,BWS NAB,76.68,0,253764.54,DR,REF564714,NAB,Business
29-08-2025 10:53,NABB07397155AB3490AAEC2,082-900-001,44444444,BP NAB,104.03,0,253660.51,DR,REF117436,NAB,Business
29-08-2025 11:07,NAB9F58A32560CF4B9BBE08,082-900-001,44444444,FLIXBUS NAB,1197.25,0,252463.26,DR,REF910524,NAB,Business
29-08-2025 11:21,NABF028B06624B2414B8204,082-900-001,44444444,DOMINO'S PIZZA NAB,392.88,0,252070.38,DR,REF173146,NAB,Business
29-08-2025 12:04,NABCAC7A1C80D4A43ABB63A,082-900-001,44444444,SHELL NAB,627.44,0,251442.94,DR,REF363949,NAB,Business
29-08-2025 12:14,NAB6329142D7C8048ACAD83,082-900-001,44444444,MCDONALDS NAB,173.89,0,251269.05,DR,REF688080,NAB,Business
29-08-2025 12:19,NAB96FCAF2C75FF4DAFB256,082-900-001,44444444,ALDI NAB,24.46,0,251244.59,DR,REF965510,NAB,Business
29-08-2025 12:20,NAB868DA0C960EA4D8F8EAC,082-900-001,44444444,FLIXBUS NAB,146.77,0,251097.82,DR,REF469796,NAB,Business
29-08-2025 12:49,NAB7E6B3A4D9F7E4349A1D6,082-900-001,44444444,FLIXBUS NAB,237.02,0,250860.8,DR,REF136826,NAB,Business
29-08-2025 13:55,INT64FEB3533E1F4FC3BCC1,082-900-001,44444444,TRANSFER FROM CBA 33333333,0,1329.94,252190.74,CR,INT-88955,NAB,Business
29-08-2025 14:19,NAB39347ED7A97B48D989D2,082-900-001,44444444,AMAZON AU NAB,291.11,0,251899.63,DR,REF779962,NAB,Business
29-08-2025 14:30,NABAD9693C372194437AB10,082-900-001,44444444,ZOOM NAB,34.04,0,251865.59,DR,REF555031,NAB,Business
29-08-2025 14:32,NABA3AF5A0D1BF045D48AF9,082-900-001,44444444,WAGES CREDIT NAB,0,884,252749.59,CR,REF964928,NAB,Business
29-08-2025 14:54,NAB13650F8F92F44491B59F,082-900-001,44444444,BWS NAB,1113.4,0,251636.19,DR,REF833036,NAB,Business
29-08-2025 14:54,NABBEEED740C16C4E81A8C5,082-900-001,44444444,ALDI NAB,33.32,0,251602.87,DR,REF188030,NAB,Business
29-08-2025 15:24,NABD0D5A2993AE347A1AD54,082-900-001,44444444,UBER EATS NAB,576.49,0,251026.38,DR,REF543722,NAB,Business
29-08-2025 15:42,NABC76434AA653A4BB2AA30,082-900-001,44444444,LIQUORLAND NAB,173.22,0,250853.16,DR,REF843827,NAB,Business
29-08-2025 15:55,NABA30E065114EA4BCAB3D4,082-900-001,44444444,ALDI NAB,162.94,0,250690.22,DR,REF299552,NAB,Business
29-08-2025 17:27,NABEA9619393E3147339FFC,082-900-001,44444444,PAYMENT GATEWAY NAB,765.66,0,249924.56,DR,REF295723,NAB,Business
29-08-2025 17:31,NAB9EC563028A0D4216B3C5,082-900-001,44444444,FLIXBUS NAB,167.49,0,249757.07,DR,REF852214,NAB,Business
29-08-2025 17:38,NAB13BF54267467421EB046,082-900-001,44444444,KFC NAB,305.65,0,249451.42,DR,REF176045,NAB,Business
29-08-2025 17:56,NAB218AC27185084F83B11C,082-900-001,44444444,BWS NAB,469.91,0,248981.51,DR,REF126750,NAB,Business
29-08-2025 18:51,NABFF4A7E13503046618D05,082-900-001,44444444,SPOTIFY NAB,544.11,0,248437.4,DR,REF433588,NAB,Business
29-08-2025 18:56,NAB5BC0678B22FC4C6B904D,082-900-001,44444444,RAILWAY STATION NAB,547.9,0,247889.5,DR,REF870242,NAB,Business
29-08-2025 19:13,NAB83A2FB38A59E46B2A830,082-900-001,44444444,JB HI-FI NAB,389.22,0,247500.28,DR,REF830389,NAB,Business
29-08-2025 19:30,NAB59ED4E27A038497B9FC8,082-900-001,44444444,PAYPAL *NETFLIX NAB,76.77,0,247423.51,DR,REF475357,NAB,Business
29-08-2025 19:38,INT08C24EA5B9D34D2685CD,082-900-001,44444444,TRANSFER TO CBA 22222222,1349.89,0,246073.62,DR,INT-56459,NAB,Business
29-08-2025 19:55,INT238BCD24EC0640649507,082-900-001,44444444,TRANSFER TO CBA 33333333,445.91,0,245627.71,DR,INT-92306,NAB,Business
29-08-2025 20:53,NABF76A0D3A0F4345B78B68,082-900-001,44444444,BANK FEE NAB,695.17,0,244932.54,DR,REF307901,NAB,Business
29-08-2025 21:13,NAB4315F94BB48B4027B581,082-900-001,44444444,BP NAB,341.03,0,244591.51,DR,REF622023,NAB,Business
29-08-2025 21:16,NABD0E8A49EA46747AD813B,082-900-001,44444444,7-ELEVEN NAB,400.49,0,244191.02,DR,REF121130,NAB,Business
29-08-2025 21:22,NAB0B4CD3078FA349DBA252,082-900-001,44444444,PAY - SALARY NAB,0,3551.51,247742.53,CR,REF454344,NAB,Business
29-08-2025 21:44,NABE9E451DEFD714A5D87C9,082-900-001,44444444,BWS NAB,1708.92,0,246033.61,DR,REF340760,NAB,Business
29-08-2025 22:17,NAB215478919F9F4878BA5B,082-900-001,44444444,LIQUORLAND NAB,272.33,0,245761.28,DR,REF882969,NAB,Business
29-08-2025 22:37,NAB3031D721825742A197C2,082-900-001,44444444,HARVEY NORMAN NAB,53.17,0,245708.11,DR,REF485807,NAB,Business
29-08-2025 23:01,NAB6804781B1D104DFD9420,082-900-001,44444444,KFC NAB,264.98,0,245443.13,DR,REF654000,NAB,Business
29-08-2025 23:06,NAB55B9D85DE4B74638AB16,082-900-001,44444444,RAILWAY STATION NAB,224.55,0,245218.58,DR,REF805169,NAB,Business
29-08-2025 23:20,NABD0B4D2E647F44F66B1DE,082-900-001,44444444,BP NAB,156.15,0,245062.43,DR,REF536684,NAB,Business
29-08-2025 23:31,NAB1BBDB55CDED14BADBA27,082-900-001,44444444,FLIXBUS NAB,153.36,0,244909.07,DR,REF480181,NAB,Business
29-08-2025 23:44,NAB4BAC16A08A7240F4B5FE,082-900-001,44444444,BIGW NAB,445.55,0,244463.52,DR,REF674783,NAB,Business
29-08-2025 23:52,NABA91CC6607CA94935A014,082-900-001,44444444,PAY - SALARY NAB,0,5206.68,249670.2,CR,REF301816,NAB,Business
30-08-2025 00:33,NAB9A7C8993AC9449438F07,082-900-001,44444444,SPOTIFY NAB,874.39,0,248795.81,DR,REF266957,NAB,Business
30-08-2025 00:53,NABDB87CF90696D436F9095,082-900-001,44444444,PAYMENT GATEWAY NAB,318.2,0,248477.61,DR,REF280738,NAB,Business
30-08-2025 01:01,NAB065191F3B3BA4AAE86DE,082-900-001,44444444,JB HI-FI NAB,337.97,0,248139.64,DR,REF766961,NAB,Business
30-08-2025 01:39,NAB0FBBCC957A8749C2A604,082-900-001,44444444,COMPANY PAYROLL NAB,0,5415.44,253555.08,CR,REF444654,NAB,Business
30-08-2025 02:36,NABF41390844E1D4022AE81,082-900-001,44444444,SHELL NAB,65.31,0,253489.77,DR,REF307296,NAB,Business
30-08-2025 02:49,NAB2155B5F6ED5A40D7A44F,082-900-001,44444444,BWS NAB,705.4,0,252784.37,DR,REF186674,NAB,Business
30-08-2025 03:10,NAB4688A58C783A41A1928C,082-900-001,44444444,AMAZON AU NAB,383.96,0,252400.41,DR,REF421878,NAB,Business
30-08-2025 04:18,NABB8EAD38207944028B2E8,082-900-001,44444444,BP NAB,661.45,0,251738.96,DR,REF287220,NAB,Business
30-08-2025 04:22,NABBF394A12A98E41FAB227,082-900-001,44444444,JB HI-FI NAB,50.7,0,251688.26,DR,REF836394,NAB,Business
30-08-2025 04:23,NABEFBCAD2B12714BC19BBA,082-900-001,44444444,DOMINO'S PIZZA NAB,342.13,0,251346.13,DR,REF529780,NAB,Business
30-08-2025 04:53,NAB22EFA385196C4728B024,082-900-001,44444444,LIQUORLAND NAB,50.04,0,251296.09,DR,REF393597,NAB,Business
30-08-2025 05:19,NAB85F27C660EF84B11B7BE,082-900-001,44444444,APPLE NAB,329.13,0,250966.96,DR,REF465689,NAB,Business
30-08-2025 05:40,NAB9890D127AB184A1BBD12,082-900-001,44444444,COMPANY PAYROLL NAB,0,1140.64,252107.6,CR,REF427527,NAB,Business
30-08-2025 05:43,NAB4C7F46A1F29C45709058,082-900-001,44444444,PAYROLL CREDIT NAB,0,7933.31,260040.91,CR,REF970192,NAB,Business
30-08-2025 05:55,NAB11E77D9D520945E9BEAC,082-900-001,44444444,UBER EATS NAB,100.7,0,259940.21,DR,REF551986,NAB,Business
30-08-2025 06:13,NAB4E6EB637D6F84731A9EA,082-900-001,44444444,STARBUCKS NAB,94.45,0,259845.76,DR,REF187823,NAB,Business
30-08-2025 06:14,NAB01544BDB817C436A9A1D,082-900-001,44444444,BP NAB,640.68,0,259205.08,DR,REF356946,NAB,Business
30-08-2025 06:29,NAB651B8F14662A4606B902,082-900-001,44444444,BP NAB,275.37,0,258929.71,DR,REF708421,NAB,Business
30-08-2025 06:40,NAB9CD85A27B7804451B26B,082-900-001,44444444,ZOOM NAB,1258.03,0,257671.68,DR,REF491640,NAB,Business
30-08-2025 06:59,NAB04332A2367FF48C5BBA1,082-900-001,44444444,SALARY PAYMENT NAB,0,854.37,258526.05,CR,REF536804,NAB,Business
30-08-2025 07:03,NABE3DA0DD6872F455E9D8D,082-900-001,44444444,DOMINO'S PIZZA NAB,251.59,0,258274.46,DR,REF520421,NAB,Business
30-08-2025 07:39,NABFD9CD6196CFA466CBDB0,082-900-001,44444444,BP NAB,71.86,0,258202.6,DR,REF357831,NAB,Business
30-08-2025 07:39,NABC8F2DAB3FF6B4E23B153,082-900-001,44444444,MENULOG NAB,1242.45,0,256960.15,DR,REF191949,NAB,Business
30-08-2025 08:06,NABA6603D78B7B94A2B8ED7,082-900-001,44444444,COLES NAB,1070.59,0,255889.56,DR,REF376010,NAB,Business
30-08-2025 08:13,NAB16BE30C8C2584887953B,082-900-001,44444444,ZOOM NAB,373.53,0,255516.03,DR,REF533775,NAB,Business
30-08-2025 08:18,NAB3D848E87CB7A42B0BF04,082-900-001,44444444,COMPANY PAYROLL NAB,0,3668.5,259184.53,CR,REF599910,NAB,Business
30-08-2025 09:37,NAB48634066AE31470FB795,082-900-001,44444444,TAFE BOOKSHOP NAB,537.02,0,258647.51,DR,REF349701,NAB,Business
30-08-2025 09:44,NABEE1B5AFCFD6847B2B2FD,082-900-001,44444444,JB HI-FI NAB,624.57,0,258022.94,DR,REF674578,NAB,Business
30-08-2025 10:11,NAB204B86CE650E4B3D8627,082-900-001,44444444,ZOOM NAB,129.39,0,257893.55,DR,REF282696,NAB,Business
30-08-2025 10:17,NAB80C74138C23649C086A8,082-900-001,44444444,KFC NAB,709.21,0,257184.34,DR,REF717738,NAB,Business
30-08-2025 10:19,NAB49718BB9E5804446A521,082-900-001,44444444,SPOTIFY NAB,135.03,0,257049.31,DR,REF288817,NAB,Business
30-08-2025 11:07,NABF1188E50C7C24BBD8669,082-900-001,44444444,PAY - SALARY NAB,0,7314.36,264363.67,CR,REF260978,NAB,Business
30-08-2025 11:12,NABC0336FC776B54F3D8032,082-900-001,44444444,SHELL NAB,689.77,0,263673.9,DR,REF171774,NAB,Business
30-08-2025 11:18,NAB95AA9B150D0E47FF893C,082-900-001,44444444,ZOOM NAB,245.12,0,263428.78,DR,REF219249,NAB,Business
30-08-2025 11:39,NABB3F3808DF67446498FB8,082-900-001,44444444,FLIXBUS NAB,204.87,0,263223.91,DR,REF297224,NAB,Business
30-08-2025 11:50,NABE3411B6E5AA64E7C9386,082-900-001,44444444,PAYMENT GATEWAY NAB,199.55,0,263024.36,DR,REF134687,NAB,Business
30-08-2025 12:14,NAB0C56BE2F1AEE423FBC21,082-900-001,44444444,SHELL NAB,757.84,0,262266.52,DR,REF414838,NAB,Business
30-08-2025 13:28,INT68F3AF8BF90C43B6B618,082-900-001,44444444,TRANSFER FROM ANZ 11111111,0,1711.65,263978.17,CR,INT-31430,NAB,Business
30-08-2025 13:56,NAB16EE5569FC4448EA8142,082-900-001,44444444,KFC NAB,48.87,0,263929.3,DR,REF481741,NAB,Business
30-08-2025 13:57,NAB9F6F8ADEA665480DA7B8,082-900-001,44444444,7-ELEVEN NAB,63.99,0,263865.31,DR,REF941801,NAB,Business
30-08-2025 14:16,NAB1C8E15639ED54F2F8EA4,082-900-001,44444444,MCDONALDS NAB,59.69,0,263805.62,DR,REF475080,NAB,Business
30-08-2025 14:31,NABFCF028D318C047D4A656,082-900-001,44444444,WAGES CREDIT NAB,0,5833.05,269638.67,CR,REF582495,NAB,Business
30-08-2025 14:32,NAB920BD69A798846009A45,082-900-001,44444444,MENULOG NAB,55.03,0,269583.64,DR,REF854555,NAB,Business
30-08-2025 14:46,NAB47B16FADAF7945F4B9EF,082-900-001,44444444,FLIXBUS NAB,208.75,0,269374.89,DR,REF952398,NAB,Business
30-08-2025 14:58,NABF78640CEE83244FEA4CB,082-900-001,44444444,DOMINO'S PIZZA NAB,666.73,0,268708.16,DR,REF873750,NAB,Business
30-08-2025 15:04,NAB60896BC958834D93AF0E,082-900-001,44444444,KFC NAB,546.24,0,268161.92,DR,REF249942,NAB,Business
30-08-2025 15:11,NABFCC55739357748CA82A9,082-900-001,44444444,INTERNET TRANSFER NAB,119.92,0,268042,DR,REF571195,NAB,Business
30-08-2025 15:13,NAB0C0A6708026E4FDFB838,082-900-001,44444444,COMPANY PAYROLL NAB,0,538.43,268580.43,CR,REF491969,NAB,Business
30-08-2025 15:26,NAB4B97634C940442FEA4E3,082-900-001,44444444,BANK FEE NAB,709.43,0,267871,DR,REF544963,NAB,Business
30-08-2025 15:47,NAB30BF4CD09BDC442D958B,082-900-001,44444444,COMPANY PAYROLL NAB,0,795.47,268666.47,CR,REF698265,NAB,Business
30-08-2025 15:53,INT4FBF339227CA42D9977D,082-900-001,44444444,TRANSFER TO CBA 33333333,205.81,0,268460.66,DR,INT-99903,NAB,Business
30-08-2025 17:19,NAB4E7E411601924DB58731,082-900-001,44444444,UBER EATS NAB,210.5,0,268250.16,DR,REF815115,NAB,Business
30-08-2025 17:49,NAB159B4BE5E1054D60B5CB,082-900-001,44444444,PAYMENT GATEWAY NAB,386.48,0,267863.68,DR,REF381357,NAB,Business
30-08-2025 17:57,NAB2AE26A940C9944A5854E,082-900-001,44444444,BWS NAB,911.72,0,266951.96,DR,REF208368,NAB,Business
30-08-2025 18:15,NAB92959756CF7445858C2D,082-900-001,44444444,TAFE BOOKSHOP NAB,293.6,0,266658.36,DR,REF474915,NAB,Business
30-08-2025 18:36,NAB46EDB1A3F2604677A34A,082-900-001,44444444,WAGES CREDIT NAB,0,834.1,267492.46,CR,REF913428,NAB,Business
30-08-2025 19:20,NAB50225F95186E4686B688,082-900-001,44444444,PAY - SALARY NAB,0,1125.59,268618.05,CR,REF376548,NAB,Business
30-08-2025 19:22,NABD9BB8D7BE0754572AF9F,082-900-001,44444444,TAFE BOOKSHOP NAB,152.12,0,268465.93,DR,REF337852,NAB,Business
30-08-2025 19:43,NABAFD01C4A74E94ED98DBC,082-900-001,44444444,PAYPAL *NETFLIX NAB,134.49,0,268331.44,DR,REF843354,NAB,Business
30-08-2025 20:00,NAB78F94A6120F8431A9386,082-900-001,44444444,BWS NAB,52.26,0,268279.18,DR,REF305432,NAB,Business
30-08-2025 20:09,NAB533BB2648598475780E1,082-900-001,44444444,LIQUORLAND NAB,46.38,0,268232.8,DR,REF139159,NAB,Business
30-08-2025 20:22,NAB8C4B6E19C2AC4BE19584,082-900-001,44444444,BIGW NAB,222.66,0,268010.14,DR,REF143598,NAB,Business
30-08-2025 20:54,NABF333844858F54124A885,082-900-001,44444444,PAYMENT GATEWAY NAB,40.26,0,267969.88,DR,REF543703,NAB,Business
30-08-2025 20:55,NAB2CE55741EF3E46329080,082-900-001,44444444,WOOLWORTHS NAB,389.02,0,267580.86,DR,REF903732,NAB,Business
30-08-2025 20:57,INT1C9A856027B24F1389EA,082-900-001,44444444,TRANSFER FROM CBA 33333333,0,482.6,268063.46,CR,INT-36355,NAB,Business
30-08-2025 21:11,NAB65D8A7D4BE47494DA39A,082-900-001,44444444,DOMINO'S PIZZA NAB,13.99,0,268049.47,DR,REF486751,NAB,Business
30-08-2025 21:29,NAB0342C08740E64826B791,082-900-001,44444444,INTERNET TRANSFER NAB,125.82,0,267923.65,DR,REF325866,NAB,Business
30-08-2025 21:44,NAB0FE6C4062F7C4DC09448,082-900-001,44444444,INTERNET TRANSFER NAB,69.14,0,267854.51,DR,REF369900,NAB,Business
30-08-2025 22:01,NAB889CA8A548AC413F9DF0,082-900-001,44444444,PAYMENT GATEWAY NAB,810.41,0,267044.1,DR,REF681194,NAB,Business
30-08-2025 22:05,NAB7CF8529B1DAC466DACE0,082-900-001,44444444,TAFE BOOKSHOP NAB,89.63,0,266954.47,DR,REF777988,NAB,Business
30-08-2025 22:08,NABBD48408EA7864C528B86,082-900-001,44444444,FLIXBUS NAB,67.76,0,266886.71,DR,REF779222,NAB,Business
30-08-2025 22:24,NABDE1072C71E6343FA9E77,082-900-001,44444444,AMAZON AU NAB,433.74,0,266452.97,DR,REF990330,NAB,Business
30-08-2025 23:37,INTC38DE2B240D34AF6AEA8,082-900-001,44444444,TRANSFER TO CBA 22222222,1863.57,0,264589.4,DR,INT-17947,NAB,Business
30-08-2025 23:44,NAB4D912C40E1F848679E32,082-900-001,44444444,ALDI NAB,989.76,0,263599.64,DR,REF144246,NAB,Business
30-08-2025 23:53,NABE56C366E83F349D18A4B,082-900-001,44444444,WOOLWORTHS NAB,73.08,0,263526.56,DR,REF239916,NAB,Business
31-08-2025 00:52,NABAAF974F58803410DACF6,082-900-001,44444444,BWS NAB,677.37,0,262849.19,DR,REF362876,NAB,Business
31-08-2025 01:31,NAB86164D151B19421091F4,082-900-001,44444444,HARVEY NORMAN NAB,306.54,0,262542.65,DR,REF652633,NAB,Business
31-08-2025 01:33,NABAD026038B17E4B23BD4A,082-900-001,44444444,JB HI-FI NAB,204.91,0,262337.74,DR,REF255479,NAB,Business
31-08-2025 01:49,NAB06DBA070D65543A697FA,082-900-001,44444444,INTERNET TRANSFER NAB,343.07,0,261994.67,DR,REF139461,NAB,Business
31-08-2025 02:04,NAB45F878711D6148478366,082-900-001,44444444,INTERNET TRANSFER NAB,200.93,0,261793.74,DR,REF737016,NAB,Business
31-08-2025 02:24,NABF837D7C22296468AA55F,082-900-001,44444444,BWS NAB,237.31,0,261556.43,DR,REF160099,NAB,Business
31-08-2025 02:34,NAB3E3BFD39C99A442497F6,082-900-001,44444444,AMAZON AU NAB,44.88,0,261511.55,DR,REF200221,NAB,Business
31-08-2025 03:08,NAB43B5B8D580144D478002,082-900-001,44444444,COMPANY PAYROLL NAB,0,2451.13,263962.68,CR,REF170018,NAB,Business
31-08-2025 03:55,NABCFB76C7E12DE4D27AEE8,082-900-001,44444444,WOOLWORTHS NAB,475.65,0,263487.03,DR,REF809379,NAB,Business
31-08-2025 04:02,NABCCAB23F62B4B4CB18FEB,082-900-001,44444444,WAGES CREDIT NAB,0,378.03,263865.06,CR,REF843589,NAB,Business
31-08-2025 04:06,INT76C47EA7EA2C48FD8EA4,082-900-001,44444444,TRANSFER TO CBA 22222222,127.33,0,263737.73,DR,INT-44900,NAB,Business
31-08-2025 04:37,NABACC5C2711DC14CC1A59F,082-900-001,44444444,PAY - SALARY NAB,0,1162.66,264900.39,CR,REF294925,NAB,Business
31-08-2025 04:47,NAB426210AB728A4EFC8237,082-900-001,44444444,APPLE NAB,164.02,0,264736.37,DR,REF244273,NAB,Business
31-08-2025 04:52,NAB01B5CA84FC51498F8A92,082-900-001,44444444,BWS NAB,566.2,0,264170.17,DR,REF791014,NAB,Business
31-08-2025 05:19,NABD5974FA5CECB410B8838,082-900-001,44444444,BP NAB,45.77,0,264124.4,DR,REF168716,NAB,Business
31-08-2025 05:25,NAB7FD55F3F14E64E9EA893,082-900-001,44444444,COLES NAB,372.74,0,263751.66,DR,REF786626,NAB,Business
31-08-2025 05:30,NAB8051377351314CF08773,082-900-001,44444444,FLIXBUS NAB,355.87,0,263395.79,DR,REF491290,NAB,Business
31-08-2025 06:03,NABE971743675C7458486FA,082-900-001,44444444,HARVEY NORMAN NAB,372.99,0,263022.8,DR,REF865564,NAB,Business
31-08-2025 06:16,NAB74678FB4B7CD4680954F,082-900-001,44444444,HARVEY NORMAN NAB,185.01,0,262837.79,DR,REF919038,NAB,Business
31-08-2025 06:20,NABF44B3D2B312940A597B3,082-900-001,44444444,SHELL NAB,111.88,0,262725.91,DR,REF541887,NAB,Business
31-08-2025 06:54,NABA9B7151FFAC04D96B2DF,082-900-001,44444444,TAFE BOOKSHOP NAB,142.44,0,262583.47,DR,REF570186,NAB,Business
31-08-2025 07:32,NABD25E9558E19848E6AC10,082-900-001,44444444,LIQUORLAND NAB,227.71,0,262355.76,DR,REF997043,NAB,Business
31-08-2025 07:37,NABDC0656BFD7BC480F8971,082-900-001,44444444,MENULOG NAB,158.76,0,262197,DR,REF145055,NAB,Business
31-08-2025 08:01,NAB65DF8758E3EE4012A3F9,082-900-001,44444444,DOMINO'S PIZZA NAB,342.85,0,261854.15,DR,REF524989,NAB,Business
31-08-2025 08:10,NAB22801BCB364C4AAA8C2E,082-900-001,44444444,SPOTIFY NAB,235.94,0,261618.21,DR,REF286707,NAB,Business
31-08-2025 08:10,NAB0FDA17FD088442B0B641,082-900-001,44444444,SPOTIFY NAB,45.79,0,261572.42,DR,REF157503,NAB,Business
31-08-2025 08:16,NAB086B76F453F94E6E88E8,082-900-001,44444444,UBER EATS NAB,434.55,0,261137.87,DR,REF429792,NAB,Business
31-08-2025 08:22,NAB4032A8D746FA4F8B8736,082-900-001,44444444,SPOTIFY NAB,378.1,0,260759.77,DR,REF771948,NAB,Business
31-08-2025 08:54,NAB9C4097397BA046D2A1AC,082-900-001,44444444,MENULOG NAB,470.62,0,260289.15,DR,REF114776,NAB,Business
31-08-2025 09:04,NABD4BC6C45C28D4773B35E,082-900-001,44444444,LIQUORLAND NAB,428.85,0,259860.3,DR,REF786213,NAB,Business
31-08-2025 09:27,NAB4F0D31316BA4486D850D,082-900-001,44444444,CITYLINK NAB,342.08,0,259518.22,DR,REF195325,NAB,Business
31-08-2025 10:00,NAB3061B088299944CA9F22,082-900-001,44444444,TAFE BOOKSHOP NAB,306.71,0,259211.51,DR,REF891052,NAB,Business
31-08-2025 10:03,NABA92A83D5CBB94CBAA398,082-900-001,44444444,SPOTIFY NAB,240.49,0,258971.02,DR,REF813932,NAB,Business
31-08-2025 10:05,INTD2D084B243024EA981CC,082-900-001,44444444,TRANSFER FROM CBA 33333333,0,1571.53,260542.55,CR,INT-40666,NAB,Business
31-08-2025 10:14,NAB27C3A4B3F30E4565B8D5,082-900-001,44444444,BP NAB,305.84,0,260236.71,DR,REF932627,NAB,Business
31-08-2025 10:17,NAB00C6FADFB6D846ABA363,082-900-001,44444444,INTERNET TRANSFER NAB,41.57,0,260195.14,DR,REF767437,NAB,Business
31-08-2025 10:30,NAB73C877A3CC6F4BF19D2D,082-900-001,44444444,PAYMENT GATEWAY NAB,535.76,0,259659.38,DR,REF248356,NAB,Business
31-08-2025 10:40,NABEFB49C5FD64240C9804A,082-900-001,44444444,ZOOM NAB,224.49,0,259434.89,DR,REF213634,NAB,Business
31-08-2025 11:15,NABE0C35926BA9149CAAC04,082-900-001,44444444,ZOOM NAB,795.6,0,258639.29,DR,REF524617,NAB,Business
31-08-2025 11:44,NAB3611AE4B3CAC4C27876E,082-900-001,44444444,CITYLINK NAB,139.83,0,258499.46,DR,REF189457,NAB,Business
31-08-2025 12:24,NABB9BC1EF7E6E94AE7AEC0,082-900-001,44444444,CITYLINK NAB,61.61,0,258437.85,DR,REF217366,NAB,Business
31-08-2025 12:40,NABCD96E11756F84790B22B,082-900-001,44444444,COLES NAB,577.51,0,257860.34,DR,REF233496,NAB,Business
31-08-2025 13:07,NABB3FD65A6B528485DBD1F,082-900-001,44444444,BWS NAB,581.57,0,257278.77,DR,REF973011,NAB,Business
31-08-2025 13:32,NAB884E4B97F068418FBA2A,082-900-001,44444444,MCDONALDS NAB,64.67,0,257214.1,DR,REF236858,NAB,Business
31-08-2025 13:50,NAB3E5BC86E8EE3446E9A36,082-900-001,44444444,DOMINO'S PIZZA NAB,518.84,0,256695.26,DR,REF663281,NAB,Business
31-08-2025 14:14,NABCF3B74CB872140579D18,082-900-001,44444444,CITYLINK NAB,356.25,0,256339.01,DR,REF284633,NAB,Business
31-08-2025 14:16,NAB39D05A5F816D40C89636,082-900-001,44444444,PAYMENT GATEWAY NAB,449.59,0,255889.42,DR,REF963943,NAB,Business
31-08-2025 14:18,NAB9DDBF5315E6B40B3B35F,082-900-001,44444444,DOMINO'S PIZZA NAB,599.92,0,255289.5,DR,REF526458,NAB,Business
31-08-2025 14:24,NAB06C4A149C03D4A21A99C,082-900-001,44444444,PAY - SALARY NAB,0,5546.92,260836.42,CR,REF828269,NAB,Business
31-08-2025 14:35,NAB8DBE87B6FE7548F99107,082-900-001,44444444,APPLE NAB,353,0,260483.42,DR,REF954685,NAB,Business
31-08-2025 15:03,NAB2C9C73DD493645639936,082-900-001,44444444,FLIXBUS NAB,192.45,0,260290.97,DR,REF206118,NAB,Business
31-08-2025 15:17,NABA24D6F4B8A2E482194DD,082-900-001,44444444,COMPANY PAYROLL NAB,0,70.64,260361.61,CR,REF434245,NAB,Business
31-08-2025 15:33,NABC529ED11F77245B39098,082-900-001,44444444,RAILWAY STATION NAB,298.52,0,260063.09,DR,REF263759,NAB,Business
31-08-2025 16:02,NAB63106508CEDA44B0A62B,082-900-001,44444444,BWS NAB,365.03,0,259698.06,DR,REF616482,NAB,Business
31-08-2025 16:14,NAB696EBDBC07FF4779835C,082-900-001,44444444,SALARY PAYMENT NAB,0,6593.28,266291.34,CR,REF960433,NAB,Business
31-08-2025 16:35,NABFA45E560BFC643A0A9C8,082-900-001,44444444,HARVEY NORMAN NAB,223.59,0,266067.75,DR,REF707692,NAB,Business
31-08-2025 17:00,NAB34527941110D495EB20C,082-900-001,44444444,CITYLINK NAB,380.76,0,265686.99,DR,REF113483,NAB,Business
31-08-2025 17:05,NABBF10F68AABBC410CA67A,082-900-001,44444444,KFC NAB,94.22,0,265592.77,DR,REF425146,NAB,Business
31-08-2025 17:37,NAB7D4366319C3F426C9A7C,082-900-001,44444444,PAY - SALARY NAB,0,4061.72,269654.49,CR,REF278221,NAB,Business
31-08-2025 17:57,NAB17D3B8A9C2B549CDB392,082-900-001,44444444,TAFE BOOKSHOP NAB,263.65,0,269390.84,DR,REF759470,NAB,Business
31-08-2025 18:16,NAB16BA06DA64494A7580EB,082-900-001,44444444,BIGW NAB,420.01,0,268970.83,DR,REF183748,NAB,Business
31-08-2025 18:37,INT835F328243B341AE9FA8,082-900-001,44444444,TRANSFER TO CBA 33333333,749.49,0,268221.34,DR,INT-46303,NAB,Business
31-08-2025 18:41,NAB40523D8621454B608555,082-900-001,44444444,PAYMENT GATEWAY NAB,174.4,0,268046.94,DR,REF196642,NAB,Business
31-08-2025 18:57,NAB404174BF4DA245DBAFED,082-900-001,44444444,LIQUORLAND NAB,1078.61,0,266968.33,DR,REF368958,NAB,Business
31-08-2025 19:09,NABCC1F77D3A1FA4A248C66,082-900-001,44444444,ZOOM NAB,61.12,0,266907.21,DR,REF701667,NAB,Business
31-08-2025 19:11,NABDF64D843DB0B4375B493,082-900-001,44444444,JB HI-FI NAB,518.91,0,266388.3,DR,REF543407,NAB,Business
31-08-2025 19:13,NAB895F4D5D4050448CB918,082-900-001,44444444,PAY - SALARY NAB,0,3253.67,269641.97,CR,REF195223,NAB,Business
31-08-2025 19:31,NABE24310C28C2C4C809180,082-900-001,44444444,WOOLWORTHS NAB,174.88,0,269467.09,DR,REF643959,NAB,Business
31-08-2025 19:38,NAB9183EA1AD29F4EB89581,082-900-001,44444444,7-ELEVEN NAB,178.31,0,269288.78,DR,REF784489,NAB,Business
31-08-2025 19:42,NAB4FD48B9B079E403680E7,082-900-001,44444444,DOMINO'S PIZZA NAB,176.37,0,269112.41,DR,REF439391,NAB,Business
31-08-2025 20:08,NABC6191E18962F4C199441,082-900-001,44444444,SHELL NAB,27.21,0,269085.2,DR,REF475668,NAB,Business
31-08-2025 20:26,NAB6906C45D423342D3A925,082-900-001,44444444,AMAZON AU NAB,218.6,0,268866.6,DR,REF578550,NAB,Business
31-08-2025 20:47,NAB69BE8E15E3344B2E93B9,082-900-001,44444444,COMPANY PAYROLL NAB,0,7788.2,276654.8,CR,REF736860,NAB,Business
31-08-2025 21:02,NABD15FF49130024AC2B5C7,082-900-001,44444444,ZOOM NAB,336.99,0,276317.81,DR,REF604108,NAB,Business
31-08-2025 21:09,NABF0653F1608774367B14F,082-900-001,44444444,COLES NAB,402.16,0,275915.65,DR,REF805279,NAB,Business
31-08-2025 21:33,INT58416E962D14458FBDE7,082-900-001,44444444,TRANSFER TO ANZ 11111111,1384.29,0,274531.36,DR,INT-74290,NAB,Business
31-08-2025 21:38,NAB6D5EE6FF27334965B025,082-900-001,44444444,CITYLINK NAB,28.77,0,274502.59,DR,REF660039,NAB,Business
31-08-2025 22:10,NABDDC7CFACB9DC476AAE01,082-900-001,44444444,PAY - SALARY NAB,0,39.85,274542.44,CR,REF308541,NAB,Business
31-08-2025 22:40,NABC3D31520B4314FDC996F,082-900-001,44444444,KFC NAB,163.31,0,274379.13,DR,REF631543,NAB,Business
31-08-2025 22:51,NAB5119E4D19B4E49BB9788,082-900-001,44444444,BWS NAB,200.83,0,274178.3,DR,REF849233,NAB,Business
31-08-2025 23:13,NABACEC3A25337842C0BAD2,082-900-001,44444444,SPOTIFY NAB,97.07,0,274081.23,DR,REF596654,NAB,Business
31-08-2025 23:23,NAB26C4242B0BFB46458EDA,082-900-001,44444444,WOOLWORTHS NAB,239.38,0,273841.85,DR,REF106968,NAB,Business
01-09-2025 00:04,NAB2D967CC694D5460FA1A0,082-900-001,44444444,INTERNET TRANSFER NAB,124.9,0,273716.95,DR,REF240580,NAB,Business
01-09-2025 00:22,NAB1E97E812DBDE4ED4BA38,082-900-001,44444444,INTERNET TRANSFER NAB,71.97,0,273644.98,DR,REF572908,NAB,Business
01-09-2025 00:29,NAB9B178C4F47E24DCDB595,082-900-001,44444444,UBER EATS NAB,112.86,0,273532.12,DR,REF975507,NAB,Business
01-09-2025 00:54,NABCD41CA085CB041AC8C1A,082-900-001,44444444,WOOLWORTHS NAB,76.86,0,273455.26,DR,REF814458,NAB,Business
01-09-2025 00:57,NAB6B554B6234DD49508174,082-900-001,44444444,BP NAB,65,0,273390.26,DR,REF529397,NAB,Business
01-09-2025 01:19,NABD188C47F9C8449489732,082-900-001,44444444,BWS NAB,96.2,0,273294.06,DR,REF582787,NAB,Business
01-09-2025 01:25,NABF9E803CF44B74DDDA149,082-900-001,44444444,AMAZON AU NAB,530.29,0,272763.77,DR,REF464642,NAB,Business
01-09-2025 01:30,NABA16974B6B9334F20AED3,082-900-001,44444444,BP NAB,37.12,0,272726.65,DR,REF789895,NAB,Business
01-09-2025 01:34,NAB0773D159A53F4BB39262,082-900-001,44444444,HARVEY NORMAN NAB,678.28,0,272048.37,DR,REF213553,NAB,Business
01-09-2025 01:40,NAB009853004AEB47EAAF30,082-900-001,44444444,UBER EATS NAB,313.67,0,271734.7,DR,REF803294,NAB,Business
01-09-2025 01:44,NAB5A55EFF98796456AA690,082-900-001,44444444,AMAZON AU NAB,73.14,0,271661.56,DR,REF402507,NAB,Business
01-09-2025 01:51,NABAF9A197A51F84094B978,082-900-001,44444444,MCDONALDS NAB,888.67,0,270772.89,DR,REF549824,NAB,Business
01-09-2025 01:58,NAB7BCB2D711C374273851D,082-900-001,44444444,KFC NAB,126.15,0,270646.74,DR,REF560045,NAB,Business
01-09-2025 02:31,NAB63EB4C0A8ECC409D8B77,082-900-001,44444444,WAGES CREDIT NAB,0,4733.27,275380.01,CR,REF809850,NAB,Business
01-09-2025 03:01,NABBF5E5D789A344ACFAD33,082-900-001,44444444,WAGES CREDIT NAB,0,3735.62,279115.63,CR,REF176427,NAB,Business
01-09-2025 03:11,NAB988F70668B444CD1A3C0,082-900-001,44444444,HARVEY NORMAN NAB,42.37,0,279073.26,DR,REF512826,NAB,Business
01-09-2025 03:13,NAB1FAFA4360A994191AD6B,082-900-001,44444444,KFC NAB,207.49,0,278865.77,DR,REF383570,NAB,Business
01-09-2025 03:16,NAB7A78CDD5A2CD4A5890BB,082-900-001,44444444,PAYMENT GATEWAY NAB,566.31,0,278299.46,DR,REF646402,NAB,Business
01-09-2025 03:19,NAB22B46AEE67A44F64A334,082-900-001,44444444,SPOTIFY NAB,323.41,0,277976.05,DR,REF988399,NAB,Business
01-09-2025 03:22,NAB070C20FC9A4644889BB8,082-900-001,44444444,WAGES CREDIT NAB,0,4573.58,282549.63,CR,REF468858,NAB,Business
01-09-2025 03:44,NAB3021889E51864DCD858A,082-900-001,44444444,ALDI NAB,312.22,0,282237.41,DR,REF747654,NAB,Business
01-09-2025 03:45,NAB9749144F62DF41E4B26D,082-900-001,44444444,AMAZON AU NAB,445.54,0,281791.87,DR,REF216795,NAB,Business
01-09-2025 03:58,NAB3C55045EC51147A0BF9E,082-900-001,44444444,MENULOG NAB,54.65,0,281737.22,DR,REF640890,NAB,Business
01-09-2025 04:17,NAB5AB801C7101E4EF3A522,082-900-001,44444444,BIGW NAB,343.99,0,281393.23,DR,REF322766,NAB,Business
01-09-2025 04:48,NAB5E647AD3B22145D0A18E,082-900-001,44444444,BWS NAB,53.66,0,281339.57,DR,REF422416,NAB,Business
01-09-2025 04:49,NAB4184594429154291B66E,082-900-001,44444444,UBER EATS NAB,1382.2,0,279957.37,DR,REF568808,NAB,Business
01-09-2025 05:02,NAB392222FEA50B4431B82F,082-900-001,44444444,COLES NAB,462.08,0,279495.29,DR,REF556388,NAB,Business
01-09-2025 05:05,NAB7D15CB48FE0A4A8EBDD3,082-900-001,44444444,AMAZON AU NAB,250.73,0,279244.56,DR,REF150469,NAB,Business
01-09-2025 05:13,NABE5B86BBCE15E4AA5A51B,082-900-001,44444444,BP NAB,1099.85,0,278144.71,DR,REF605481,NAB,Business
01-09-2025 05:17,NAB79E7D1F96D9B465AB6D9,082-900-001,44444444,PAYPAL *NETFLIX NAB,119.06,0,278025.65,DR,REF163861,NAB,Business
01-09-2025 05:18,NABAB89307DC66744319C14,082-900-001,44444444,HARVEY NORMAN NAB,77.52,0,277948.13,DR,REF724497,NAB,Business
01-09-2025 06:00,NAB57D817BA0BC143589692,082-900-001,44444444,BP NAB,348.71,0,277599.42,DR,REF392312,NAB,Business
01-09-2025 06:00,INTB295929D2006458C8526,082-900-001,44444444,TRANSFER TO ANZ 11111111,1713.75,0,275885.67,DR,INT-82873,NAB,Business
01-09-2025 06:07,NAB898340CF9E0744EDB973,082-900-001,44444444,SALARY PAYMENT NAB,0,4092.41,279978.08,CR,REF637068,NAB,Business
01-09-2025 06:07,NAB32B7507236314303BE08,082-900-001,44444444,FLIXBUS NAB,39.86,0,279938.22,DR,REF975390,NAB,Business
01-09-2025 06:16,NAB43584A31B71B428A9EDD,082-900-001,44444444,CITYLINK NAB,688.52,0,279249.7,DR,REF647957,NAB,Business
01-09-2025 06:22,NAB9E95AD74DCBD46D4A055,082-900-001,44444444,STARBUCKS NAB,555.3,0,278694.4,DR,REF376275,NAB,Business
01-09-2025 06:42,NABC5C252CDA4FD4FE4B613,082-900-001,44444444,ZOOM NAB,286.36,0,278408.04,DR,REF554671,NAB,Business
01-09-2025 06:55,NABA015C6EADB46469C8AF2,082-900-001,44444444,ZOOM NAB,132.61,0,278275.43,DR,REF836967,NAB,Business
01-09-2025 07:11,NABF502920BDB4C4A698A86,082-900-001,44444444,KFC NAB,95.15,0,278180.28,DR,REF389622,NAB,Business
01-09-2025 07:20,NABE114A6E360FF431A9F40,082-900-001,44444444,BANK FEE NAB,338.5,0,277841.78,DR,REF130159,NAB,Business
01-09-2025 07:38,NAB1F2BDAD839CB4257B88A,082-900-001,44444444,HARVEY NORMAN NAB,138.37,0,277703.41,DR,REF962984,NAB,Business
01-09-2025 08:00,NAB03B0175477FD4F6B9C67,082-900-001,44444444,WOOLWORTHS NAB,664.14,0,277039.27,DR,REF486977,NAB,Business
01-09-2025 08:33,NAB0344B9031B1449B2BCDC,082-900-001,44444444,ZOOM NAB,187.61,0,276851.66,DR,REF140614,NAB,Business
01-09-2025 08:45,NABAECF303A43C749DAA57D,082-900-001,44444444,MENULOG NAB,210.33,0,276641.33,DR,REF210732,NAB,Business
01-09-2025 08:59,INT886ECC1C45114346B88B,082-900-001,44444444,TRANSFER TO CBA 22222222,1541.05,0,275100.28,DR,INT-99521,NAB,Business
01-09-2025 09:19,NABA9C9764C002248298AC5,082-900-001,44444444,BWS NAB,240.18,0,274860.1,DR,REF447565,NAB,Business
01-09-2025 09:24,NABF509EA4369BC476897A8,082-900-001,44444444,MCDONALDS NAB,440.94,0,274419.16,DR,REF186671,NAB,Business
01-09-2025 09:34,NABC3C84291F6A9461BBBAF,082-900-001,44444444,COLES NAB,150.57,0,274268.59,DR,REF391695,NAB,Business
01-09-2025 09:42,NAB16D3D0C1F0374005B3AB,082-900-001,44444444,SHELL NAB,813.74,0,273454.85,DR,REF145311,NAB,Business
01-09-2025 09:49,NAB5BC3514F2CCA4CD68B56,082-900-001,44444444,PAYROLL CREDIT NAB,0,7553.33,281008.18,CR,REF262368,NAB,Business
01-09-2025 09:50,NAB9DAE092208164793BA6B,082-900-001,44444444,LIQUORLAND NAB,95.55,0,280912.63,DR,REF259203,NAB,Business
01-09-2025 09:56,NABF9479A738DE44A748C5B,082-900-001,44444444,PAY - SALARY NAB,0,6158.83,287071.46,CR,REF210601,NAB,Business
01-09-2025 10:09,NABD9145E9881524B699FF5,082-900-001,44444444,FLIXBUS NAB,561.34,0,286510.12,DR,REF577233,NAB,Business
01-09-2025 10:36,NABCC30A808C9A2441C94C8,082-900-001,44444444,SHELL NAB,342.17,0,286167.95,DR,REF316913,NAB,Business
01-09-2025 10:46,NABE915727A53C04229A85B,082-900-001,44444444,KFC NAB,311.46,0,285856.49,DR,REF381392,NAB,Business
01-09-2025 12:02,NAB839AFCE3FAC84C579010,082-900-001,44444444,AMAZON AU NAB,384.33,0,285472.16,DR,REF422207,NAB,Business
01-09-2025 12:06,INT222301CE3CE34612A2CF,082-900-001,44444444,TRANSFER TO ANZ 11111111,460.46,0,285011.7,DR,INT-40135,NAB,Business
01-09-2025 12:09,NAB5996C0DCF1C84D019B69,082-900-001,44444444,STARBUCKS NAB,54.44,0,284957.26,DR,REF818786,NAB,Business
01-09-2025 12:13,NABCE6EF07BA29C4072A05F,082-900-001,44444444,PAYMENT GATEWAY NAB,1945.58,0,283011.68,DR,REF218695,NAB,Business
01-09-2025 12:29,NAB5D19A8AF53D741DA95AF,082-900-001,44444444,LIQUORLAND NAB,36.99,0,282974.69,DR,REF967264,NAB,Business
01-09-2025 13:11,NAB68E933E1FD8A48079987,082-900-001,44444444,CITYLINK NAB,304.81,0,282669.88,DR,REF145819,NAB,Business
01-09-2025 13:41,NAB9211CEF2DE3F440797FC,082-900-001,44444444,TAFE BOOKSHOP NAB,685.41,0,281984.47,DR,REF160022,NAB,Business
01-09-2025 13:48,NABCFE343C998C4415F9886,082-900-001,44444444,FLIXBUS NAB,839.96,0,281144.51,DR,REF575379,NAB,Business
01-09-2025 14:15,NABE49605AF59A74628AA5E,082-900-001,44444444,BANK FEE NAB,254.98,0,280889.53,DR,REF172718,NAB,Business
01-09-2025 14:17,NAB1F09B82171C64BD8BA91,082-900-001,44444444,APPLE NAB,483.5,0,280406.03,DR,REF800543,NAB,Business
01-09-2025 14:21,NAB8A337FC76E244F61A6B8,082-900-001,44444444,INTERNET TRANSFER NAB,1133.85,0,279272.18,DR,REF510171,NAB,Business
01-09-2025 14:25,NABAB9D29BEEE7E4251B917,082-900-001,44444444,PAYMENT GATEWAY NAB,803.64,0,278468.54,DR,REF498223,NAB,Business
01-09-2025 14:31,NAB3C6CB0022BE14289993D,082-900-001,44444444,BWS NAB,653.35,0,277815.19,DR,REF264726,NAB,Business
01-09-2025 14:49,NAB31AC0057929C403FB3D6,082-900-001,44444444,PAY - SALARY NAB,0,2285.84,280101.03,CR,REF465332,NAB,Business
01-09-2025 14:49,NAB245166A90E3C4CA9BBC0,082-900-001,44444444,ZOOM NAB,742.72,0,279358.31,DR,REF246709,NAB,Business
01-09-2025 14:55,NAB6F11F70A0E044E2F9599,082-900-001,44444444,APPLE NAB,140.53,0,279217.78,DR,REF725487,NAB,Business
01-09-2025 15:05,NAB1FC72E26A1A4479B804F,082-900-001,44444444,ZOOM NAB,345.07,0,278872.71,DR,REF636270,NAB,Business
01-09-2025 15:19,NAB0B7AB00C4236468DB464,082-900-001,44444444,LIQUORLAND NAB,327.14,0,278545.57,DR,REF480006,NAB,Business
01-09-2025 15:31,NABF53E266B7C5248569D39,082-900-001,44444444,APPLE NAB,97.02,0,278448.55,DR,REF257476,NAB,Business
01-09-2025 15:40,NAB99CDC8DBCA814BBE957E,082-900-001,44444444,MCDONALDS NAB,732.98,0,277715.57,DR,REF392646,NAB,Business
01-09-2025 16:02,NABDF6C8CA4BDCC454A9562,082-900-001,44444444,ZOOM NAB,402.49,0,277313.08,DR,REF956274,NAB,Business
01-09-2025 16:39,NAB3E5EF681F7044D2CACB7,082-900-001,44444444,PAYROLL CREDIT NAB,0,60.16,277373.24,CR,REF616614,NAB,Business
01-09-2025 17:00,NABB6C22AEE321D4BB6B3BA,082-900-001,44444444,DOMINO'S PIZZA NAB,28.02,0,277345.22,DR,REF398905,NAB,Business
01-09-2025 17:01,NAB5253DB8049C94E0688A9,082-900-001,44444444,CITYLINK NAB,663.24,0,276681.98,DR,REF325390,NAB,Business
01-09-2025 17:25,NAB30273367B7A84C8BAABD,082-900-001,44444444,MENULOG NAB,35.03,0,276646.95,DR,REF765892,NAB,Business
01-09-2025 17:45,NAB10EBFF030C904DA4BC42,082-900-001,44444444,RAILWAY STATION NAB,352.96,0,276293.99,DR,REF250521,NAB,Business
01-09-2025 17:50,NAB580D8332A6BD419A8713,082-900-001,44444444,PAYPAL *NETFLIX NAB,529.02,0,275764.97,DR,REF922246,NAB,Business
01-09-2025 17:59,NAB8318BBDE162D4EE7BAE4,082-900-001,44444444,SALARY PAYMENT NAB,0,2448.43,278213.4,CR,REF272756,NAB,Business
01-09-2025 18:39,NABDB8274053B054761BE22,082-900-001,44444444,JB HI-FI NAB,587.29,0,277626.11,DR,REF450529,NAB,Business
01-09-2025 18:51,NAB58A824A07CA9465A95B6,082-900-001,44444444,RAILWAY STATION NAB,290.29,0,277335.82,DR,REF744991,NAB,Business
01-09-2025 19:31,NAB56EEA7223F3D402385A8,082-900-001,44444444,INTERNET TRANSFER NAB,84.13,0,277251.69,DR,REF843054,NAB,Business
01-09-2025 19:48,NABE6329683A892431C8D1A,082-900-001,44444444,PAYMENT GATEWAY NAB,554.61,0,276697.08,DR,REF929743,NAB,Business
01-09-2025 20:06,NABCB10D8ADE6DF4705A113,082-900-001,44444444,APPLE NAB,293.97,0,276403.11,DR,REF868412,NAB,Business
01-09-2025 20:32,NAB4DEC3E09F61646839CDF,082-900-001,44444444,UBER EATS NAB,170.68,0,276232.43,DR,REF377361,NAB,Business
01-09-2025 20:37,NABEFD853FC971B45B4809E,082-900-001,44444444,AMAZON AU NAB,635.37,0,275597.06,DR,REF378287,NAB,Business
01-09-2025 20:37,NAB00A68FAE2AD446E484B8,082-900-001,44444444,7-ELEVEN NAB,356.47,0,275240.59,DR,REF868256,NAB,Business
01-09-2025 21:29,NAB99AE7294F2804259828F,082-900-001,44444444,PAYMENT GATEWAY NAB,225.61,0,275014.98,DR,REF581901,NAB,Business
01-09-2025 21:29,NAB2E3DF7B3144C492D8549,082-900-001,44444444,SHELL NAB,85.82,0,274929.16,DR,REF335697,NAB,Business
01-09-2025 22:12,NAB677DAD1522AD427FA8E7,082-900-001,44444444,PAYROLL CREDIT NAB,0,6608.05,281537.21,CR,REF485839,NAB,Business
01-09-2025 22:17,NAB2D662693226146AE921E,082-900-001,44444444,STARBUCKS NAB,103.24,0,281433.97,DR,REF779054,NAB,Business
01-09-2025 22:40,NAB5358AB5ED4BE41A4B301,082-900-001,44444444,HARVEY NORMAN NAB,365.51,0,281068.46,DR,REF658445,NAB,Business
01-09-2025 22:59,NABA94DC9D9B88F4DC68F71,082-900-001,44444444,FLIXBUS NAB,380.97,0,280687.49,DR,REF224971,NAB,Business
01-09-2025 23:27,INT8E033243D37540AB9A1C,082-900-001,44444444,TRANSFER TO CBA 22222222,1600.97,0,279086.52,DR,INT-45913,NAB,Business
01-09-2025 23:28,NABD3A72BA1E7874467AEDD,082-900-001,44444444,KFC NAB,87.48,0,278999.04,DR,REF910620,NAB,Business
01-09-2025 23:28,NAB0ED17F1143C4478BA2B8,082-900-001,44444444,STARBUCKS NAB,200.78,0,278798.26,DR,REF384812,NAB,Business
01-09-2025 23:30,NAB543A2623D23748C893BC,082-900-001,44444444,ZOOM NAB,71.61,0,278726.65,DR,REF666150,NAB,Business
01-09-2025 23:39,NAB416C218F7E3E4B82953B,082-900-001,44444444,KFC NAB,199.7,0,278526.95,DR,REF839792,NAB,Business
02-09-2025 00:01,NAB4EF5B3853D964320920C,082-900-001,44444444,FLIXBUS NAB,239.76,0,278287.19,DR,REF531424,NAB,Business
02-09-2025 00:02,NAB5353EC638D8349E48A2D,082-900-001,44444444,AMAZON AU NAB,159.86,0,278127.33,DR,REF492342,NAB,Business
02-09-2025 00:08,NAB495E3634430B45019D19,082-900-001,44444444,PAYMENT GATEWAY NAB,96.69,0,278030.64,DR,REF591323,NAB,Business
02-09-2025 01:18,NAB485EE86639BE4944A813,082-900-001,44444444,RAILWAY STATION NAB,648.12,0,277382.52,DR,REF253754,NAB,Business
02-09-2025 01:48,NABC439E2B6B8014796A4E8,082-900-001,44444444,BIGW NAB,645.41,0,276737.11,DR,REF814735,NAB,Business
02-09-2025 02:11,NABE4723D41427C4E9586C3,082-900-001,44444444,MENULOG NAB,296.65,0,276440.46,DR,REF978205,NAB,Business
02-09-2025 02:32,NABF2B63FB5459E44139C17,082-900-001,44444444,COMPANY PAYROLL NAB,0,260.21,276700.67,CR,REF109784,NAB,Business
02-09-2025 02:33,NAB766598D179A0418DB5F8,082-900-001,44444444,PAYPAL *NETFLIX NAB,150.31,0,276550.36,DR,REF726007,NAB,Business
02-09-2025 02:55,NAB0D265ED1E9C641ED9921,082-900-001,44444444,MENULOG NAB,780.42,0,275769.94,DR,REF484117,NAB,Business
02-09-2025 03:10,NABC8638B7D80784B74ACD1,082-900-001,44444444,PAYPAL *NETFLIX NAB,464.34,0,275305.6,DR,REF904427,NAB,Business
02-09-2025 03:21,NABBC5E2840E6E54FFBA07B,082-900-001,44444444,BIGW NAB,73.9,0,275231.7,DR,REF432582,NAB,Business
02-09-2025 03:29,NABD348373B8FE84581B67D,082-900-001,44444444,STARBUCKS NAB,815.53,0,274416.17,DR,REF851737,NAB,Business
02-09-2025 03:52,NABE1953AD9D0A8468DABA0,082-900-001,44444444,PAYROLL CREDIT NAB,0,5191.86,279608.03,CR,REF433144,NAB,Business
02-09-2025 04:07,NAB3612D717BEF24A93ACF4,082-900-001,44444444,TAFE BOOKSHOP NAB,536.28,0,279071.75,DR,REF283523,NAB,Business
02-09-2025 04:10,INT008AB479DD784BAA9F62,082-900-001,44444444,TRANSFER TO ANZ 11111111,115.09,0,278956.66,DR,INT-77984,NAB,Business
02-09-2025 04:12,NABDD9EB0044F2D4384A9FA,082-900-001,44444444,ZOOM NAB,113.33,0,278843.33,DR,REF299717,NAB,Business
02-09-2025 04:22,NABB1E6CE705FC7478998C3,082-900-001,44444444,WOOLWORTHS NAB,737.29,0,278106.04,DR,REF563981,NAB,Business
02-09-2025 04:37,NAB6E1AB9FF42554A2F8117,082-900-001,44444444,JB HI-FI NAB,19.24,0,278086.8,DR,REF557310,NAB,Business
02-09-2025 04:46,NAB0D26887860E9431FACFC,082-900-001,44444444,BP NAB,542.35,0,277544.45,DR,REF726611,NAB,Business
02-09-2025 04:52,NAB0000852B771A4EF49709,082-900-001,44444444,WOOLWORTHS NAB,330.77,0,277213.68,DR,REF220256,NAB,Business
02-09-2025 04:56,NAB4CA3979BA8EF4348AFF3,082-900-001,44444444,INTERNET TRANSFER NAB,1050.19,0,276163.49,DR,REF910094,NAB,Business
02-09-2025 05:26,NABE3A69E9029924FC9AB32,082-900-001,44444444,RAILWAY STATION NAB,544.27,0,275619.22,DR,REF676942,NAB,Business
02-09-2025 05:42,NABF48147D57A3B4FB6853C,082-900-001,44444444,TAFE BOOKSHOP NAB,138.37,0,275480.85,DR,REF957955,NAB,Business
02-09-2025 05:55,NAB54A46CA3CCA04477BC00,082-900-001,44444444,CITYLINK NAB,807.2,0,274673.65,DR,REF151022,NAB,Business
02-09-2025 06:01,NAB07AD57E0CDE64D839A11,082-900-001,44444444,BWS NAB,84.2,0,274589.45,DR,REF139306,NAB,Business
02-09-2025 06:13,NAB6FE2E57FADA34DA0B54B,082-900-001,44444444,UBER EATS NAB,194.57,0,274394.88,DR,REF118878,NAB,Business
02-09-2025 06:15,NAB269B8174210E413B8720,082-900-001,44444444,UBER EATS NAB,376.41,0,274018.47,DR,REF192981,NAB,Business
02-09-2025 06:30,NABC119FCAD059246929F6E,082-900-001,44444444,RAILWAY STATION NAB,112.51,0,273905.96,DR,REF608249,NAB,Business
02-09-2025 07:08,NAB69E110555875435593E1,082-900-001,44444444,ALDI NAB,327.43,0,273578.53,DR,REF203688,NAB,Business
02-09-2025 07:18,NAB54B994332F624F5A9634,082-900-001,44444444,BANK FEE NAB,434.34,0,273144.19,DR,REF907573,NAB,Business
02-09-2025 07:20,NAB118E71250B944469AEB0,082-900-001,44444444,PAYPAL *NETFLIX NAB,82.16,0,273062.03,DR,REF119653,NAB,Business
02-09-2025 07:28,NABB01C4567E2B642389F89,082-900-001,44444444,7-ELEVEN NAB,49.7,0,273012.33,DR,REF878702,NAB,Business
02-09-2025 07:33,NAB81CA66C45BCF4E8B956E,082-900-001,44444444,HARVEY NORMAN NAB,205.97,0,272806.36,DR,REF818413,NAB,Business
02-09-2025 07:52,NAB19A125724D6649D9B2F5,082-900-001,44444444,SHELL NAB,39.01,0,272767.35,DR,REF763392,NAB,Business
02-09-2025 08:07,NABBF01754286C4448FBDDE,082-900-001,44444444,HARVEY NORMAN NAB,55.28,0,272712.07,DR,REF304545,NAB,Business
02-09-2025 08:19,NAB49A969F373BD44B2ACC2,082-900-001,44444444,KFC NAB,453.69,0,272258.38,DR,REF195849,NAB,Business
02-09-2025 08:29,NABCC43887E4B6347EA96D1,082-900-001,44444444,MCDONALDS NAB,459.4,0,271798.98,DR,REF380669,NAB,Business
02-09-2025 09:16,NAB55EA11879D8E495E83C8,082-900-001,44444444,SALARY PAYMENT NAB,0,276.75,272075.73,CR,REF837987,NAB,Business
02-09-2025 09:33,INT7EED108F7448462E8099,082-900-001,44444444,TRANSFER FROM CBA 22222222,0,1367.47,273443.2,CR,INT-90332,NAB,Business
02-09-2025 09:42,NAB79E2CACC1340456F88C1,082-900-001,44444444,AMAZON AU NAB,643.89,0,272799.31,DR,REF816041,NAB,Business
02-09-2025 09:42,NAB871ECB2AABB44C258BC9,082-900-001,44444444,PAYPAL *NETFLIX NAB,183.06,0,272616.25,DR,REF350215,NAB,Business
02-09-2025 09:55,NAB8FCB3BAEB5524EA2B7AC,082-900-001,44444444,BIGW NAB,372.95,0,272243.3,DR,REF527339,NAB,Business
02-09-2025 09:57,INTA7F8FB2266984801B9D4,082-900-001,44444444,TRANSFER TO CBA 33333333,428.72,0,271814.58,DR,INT-58078,NAB,Business
02-09-2025 10:03,NAB69BFA17CC8F54B4194F2,082-900-001,44444444,PAYPAL *NETFLIX NAB,106.31,0,271708.27,DR,REF681959,NAB,Business
02-09-2025 11:15,NAB75454A7366B5449AA4E1,082-900-001,44444444,STARBUCKS NAB,405.35,0,271302.92,DR,REF910293,NAB,Business
02-09-2025 11:18,INT71D6D6C0A4CA4589A089,082-900-001,44444444,TRANSFER TO CBA 22222222,1456.47,0,269846.45,DR,INT-27349,NAB,Business
02-09-2025 11:23,NABDDCEA32AF0234AEE980F,082-900-001,44444444,ALDI NAB,219.23,0,269627.22,DR,REF673427,NAB,Business
02-09-2025 11:36,NAB00096C11FFBA4E63825A,082-900-001,44444444,BIGW NAB,270.98,0,269356.24,DR,REF186859,NAB,Business
02-09-2025 11:40,NAB2AAFA7266D1143C786A1,082-900-001,44444444,DOMINO'S PIZZA NAB,81.95,0,269274.29,DR,REF236575,NAB,Business
02-09-2025 11:58,NAB3BA45A32E3E146118D7E,082-900-001,44444444,MENULOG NAB,207.45,0,269066.84,DR,REF178974,NAB,Business
02-09-2025 12:18,NABE9F331D85D874DB5B9FF,082-900-001,44444444,FLIXBUS NAB,47.38,0,269019.46,DR,REF759862,NAB,Business
02-09-2025 12:23,INT31CB0A383EBE44ADBF38,082-900-001,44444444,TRANSFER FROM CBA 33333333,0,1922.72,270942.18,CR,INT-23080,NAB,Business
02-09-2025 12:55,NAB5A36F419DE5D44B4A53C,082-900-001,44444444,JB HI-FI NAB,656.26,0,270285.92,DR,REF496200,NAB,Business
02-09-2025 13:47,NAB0C275F7A84704FA38BCB,082-900-001,44444444,INTERNET TRANSFER NAB,31.96,0,270253.96,DR,REF441936,NAB,Business
02-09-2025 15:24,NAB7BF1D308523D41858842,082-900-001,44444444,BWS NAB,345.37,0,269908.59,DR,REF731114,NAB,Business
02-09-2025 15:33,INT75067CC579584F93BE31,082-900-001,44444444,TRANSFER TO CBA 22222222,1703.75,0,268204.84,DR,INT-38883,NAB,Business
02-09-2025 15:39,NABA3B757D191754783A5C4,082-900-001,44444444,HARVEY NORMAN NAB,296.28,0,267908.56,DR,REF389537,NAB,Business
02-09-2025 15:51,NABA3225B06BE024590B58F,082-900-001,44444444,COLES NAB,526.7,0,267381.86,DR,REF202214,NAB,Business
02-09-2025 16:01,NABDB2E6633EC494C9EB97D,082-900-001,44444444,BWS NAB,771.63,0,266610.23,DR,REF239201,NAB,Business
02-09-2025 16:05,NABD0AA0D04DA3F4535B90D,082-900-001,44444444,JB HI-FI NAB,511.81,0,266098.42,DR,REF479971,NAB,Business
02-09-2025 16:40,NABC25C5C00686E4DE4BC8D,082-900-001,44444444,ZOOM NAB,400.58,0,265697.84,DR,REF295422,NAB,Business
02-09-2025 16:43,NAB7967A1B3F6B540BB8E69,082-900-001,44444444,FLIXBUS NAB,87.95,0,265609.89,DR,REF270246,NAB,Business
02-09-2025 17:13,NABF5B0C6DCDDE64233B396,082-900-001,44444444,KFC NAB,129.37,0,265480.52,DR,REF573763,NAB,Business
02-09-2025 17:24,INT5F8735B604534FDC9FD8,082-900-001,44444444,TRANSFER FROM CBA 33333333,0,864.38,266344.9,CR,INT-43115,NAB,Business
02-09-2025 17:25,NAB498E45D97426481C851F,082-900-001,44444444,DOMINO'S PIZZA NAB,114.36,0,266230.54,DR,REF624801,NAB,Business
02-09-2025 17:26,NAB4C90DC0810C14C6B9024,082-900-001,44444444,COLES NAB,551.78,0,265678.76,DR,REF304838,NAB,Business
02-09-2025 17:48,NAB87B1338E0F6248CFB5EF,082-900-001,44444444,ALDI NAB,360.27,0,265318.49,DR,REF444630,NAB,Business
02-09-2025 18:00,NABDFBC4BE35A9E4421A28D,082-900-001,44444444,STARBUCKS NAB,256.51,0,265061.98,DR,REF656273,NAB,Business
02-09-2025 18:27,NABE5DEB199D79E4C5DA920,082-900-001,44444444,ALDI NAB,239.11,0,264822.87,DR,REF508406,NAB,Business
02-09-2025 19:02,NABE14AA9EBC01047C6851D,082-900-001,44444444,PAYROLL CREDIT NAB,0,5895.89,270718.76,CR,REF730209,NAB,Business
02-09-2025 19:27,NABA0DAC5788FA849ED888E,082-900-001,44444444,WOOLWORTHS NAB,524.01,0,270194.75,DR,REF516948,NAB,Business
02-09-2025 19:37,NABD54342B26E6B46688E86,082-900-001,44444444,JB HI-FI NAB,1115.22,0,269079.53,DR,REF796276,NAB,Business
02-09-2025 19:39,NAB73A72F10759549BDBA47,082-900-001,44444444,BANK FEE NAB,1053.43,0,268026.1,DR,REF861120,NAB,Business
02-09-2025 20:28,NAB1DAE94BADBFF40B2BD5C,082-900-001,44444444,COMPANY PAYROLL NAB,0,592.83,268618.93,CR,REF672216,NAB,Business
02-09-2025 21:16,NABA7613AE9A62F472EB392,082-900-001,44444444,COLES NAB,708.65,0,267910.28,DR,REF580945,NAB,Business
02-09-2025 21:16,INT96FBBC7834A94644B0AA,082-900-001,44444444,TRANSFER FROM CBA 22222222,0,283.48,268193.76,CR,INT-33938,NAB,Business
02-09-2025 22:01,NABE15A11E4A1214C71B2AC,082-900-001,44444444,MCDONALDS NAB,176.22,0,268017.54,DR,REF610387,NAB,Business
02-09-2025 22:12,NAB39C126AB347740D9AE63,082-900-001,44444444,SPOTIFY NAB,206.78,0,267810.76,DR,REF689705,NAB,Business
02-09-2025 22:15,NABD052A7EE0F1F4646B78D,082-900-001,44444444,SPOTIFY NAB,435.37,0,267375.39,DR,REF421328,NAB,Business
02-09-2025 22:36,NAB7B20B754EC994F538E67,082-900-001,44444444,JB HI-FI NAB,884.19,0,266491.2,DR,REF380326,NAB,Business
02-09-2025 22:40,INTA92446E2D448429F9C8C,082-900-001,44444444,TRANSFER TO CBA 22222222,1820.88,0,264670.32,DR,INT-95281,NAB,Business
02-09-2025 23:15,NABF660D58F53B84CAE95A5,082-900-001,44444444,AMAZON AU NAB,184.46,0,264485.86,DR,REF662167,NAB,Business
02-09-2025 23:19,NABEE467C482F6D44B59E34,082-900-001,44444444,ZOOM NAB,57.66,0,264428.2,DR,REF499611,NAB,Business
02-09-2025 23:39,NAB063E461CCBCF4906BC35,082-900-001,44444444,ZOOM NAB,503.55,0,263924.65,DR,REF342584,NAB,Business
02-09-2025 23:42,NABD732BCA9BD274FC39265,082-900-001,44444444,APPLE NAB,558.94,0,263365.71,DR,REF226821,NAB,Business
02-09-2025 23:48,NAB1AAAE0610AAA4B85AFB5,082-900-001,44444444,PAYROLL CREDIT NAB,0,5209.34,268575.05,CR,REF704392,NAB,Business
02-09-2025 23:53,NAB983B87D658B74CA48836,082-900-001,44444444,BWS NAB,478.66,0,268096.39,DR,REF477277,NAB,Business
03-09-2025 00:04,NAB58FE71F776654451A9AB,082-900-001,44444444,CITYLINK NAB,102.8,0,267993.59,DR,REF192731,NAB,Business
03-09-2025 00:20,NAB36D88CCE7CD34ACFAF95,082-900-001,44444444,BWS NAB,206.25,0,267787.34,DR,REF172163,NAB,Business
03-09-2025 01:07,NAB0D96F3EC03D447FC847D,082-900-001,44444444,COMPANY PAYROLL NAB,0,6214.94,274002.28,CR,REF102367,NAB,Business
03-09-2025 01:12,NAB2CE0BF4F116F4E6698BA,082-900-001,44444444,FLIXBUS NAB,476.78,0,273525.5,DR,REF513123,NAB,Business
03-09-2025 01:20,NAB12509A8CBB4F4703A11B,082-900-001,44444444,SALARY PAYMENT NAB,0,1546.5,275072,CR,REF418252,NAB,Business
03-09-2025 01:50,NABE1C1B815A2B34953BEA4,082-900-001,44444444,APPLE NAB,375.25,0,274696.75,DR,REF120415,NAB,Business
03-09-2025 02:20,NABE04884764D7B45468D2F,082-900-001,44444444,COLES NAB,48.95,0,274647.8,DR,REF287065,NAB,Business
03-09-2025 02:45,NAB08F5ACE1338B4B5AA3A1,082-900-001,44444444,HARVEY NORMAN NAB,245.51,0,274402.29,DR,REF597321,NAB,Business
03-09-2025 02:51,NABE020CFBDD23A41D9B402,082-900-001,44444444,ALDI NAB,573.22,0,273829.07,DR,REF198526,NAB,Business
03-09-2025 03:33,NAB23C956EF20E141239D4A,082-900-001,44444444,CITYLINK NAB,87.88,0,273741.19,DR,REF636692,NAB,Business
03-09-2025 05:00,NAB8DA1BE50C51F4EB88A8E,082-900-001,44444444,MCDONALDS NAB,211.55,0,273529.64,DR,REF871077,NAB,Business
03-09-2025 05:03,NABD1868AED201D44759591,082-900-001,44444444,FLIXBUS NAB,30.44,0,273499.2,DR,REF938293,NAB,Business
03-09-2025 05:05,NAB3638FA60476444959AB8,082-900-001,44444444,ZOOM NAB,91.69,0,273407.51,DR,REF852386,NAB,Business
03-09-2025 05:19,NABC5FCC28C9D094092AD72,082-900-001,44444444,DOMINO'S PIZZA NAB,420.3,0,272987.21,DR,REF968248,NAB,Business
03-09-2025 05:20,NAB6B52F6798DAA43A9B15D,082-900-001,44444444,TAFE BOOKSHOP NAB,151.89,0,272835.32,DR,REF720594,NAB,Business
03-09-2025 05:35,NABF95CD13E958F4B159566,082-900-001,44444444,PAY - SALARY NAB,0,2877.5,275712.82,CR,REF199859,NAB,Business
03-09-2025 05:43,NABB3A27AEDF7594C47B21A,082-900-001,44444444,BWS NAB,708.45,0,275004.37,DR,REF746940,NAB,Business
03-09-2025 05:56,NAB4FA35318B89746309539,082-900-001,44444444,JB HI-FI NAB,219.91,0,274784.46,DR,REF959672,NAB,Business
03-09-2025 06:19,NAB50B465524353437F9B8B,082-900-001,44444444,PAYPAL *NETFLIX NAB,68.45,0,274716.01,DR,REF513066,NAB,Business
03-09-2025 06:22,NABDAD6A98E97B04025A6A5,082-900-001,44444444,ALDI NAB,315.46,0,274400.55,DR,REF708111,NAB,Business
03-09-2025 06:26,NAB819F5AA6219E432BB869,082-900-001,44444444,WOOLWORTHS NAB,386.63,0,274013.92,DR,REF462310,NAB,Business
03-09-2025 06:26,NABFCEA57B29B4A42FAB042,082-900-001,44444444,COMPANY PAYROLL NAB,0,816.99,274830.91,CR,REF871375,NAB,Business
03-09-2025 06:32,NAB49F4592B1C4044C9AB23,082-900-001,44444444,TAFE BOOKSHOP NAB,31.02,0,274799.89,DR,REF111969,NAB,Business
03-09-2025 06:44,NAB2E8F67801CA347009E1A,082-900-001,44444444,STARBUCKS NAB,457.61,0,274342.28,DR,REF622759,NAB,Business
03-09-2025 06:53,NAB4C51C263713B4008915C,082-900-001,44444444,KFC NAB,53.68,0,274288.6,DR,REF617834,NAB,Business
03-09-2025 07:27,NABA7D8ED7C3A0540EC82FC,082-900-001,44444444,HARVEY NORMAN NAB,75.33,0,274213.27,DR,REF833272,NAB,Business
03-09-2025 07:54,NABE62CAC7049D54ADCA0AC,082-900-001,44444444,STARBUCKS NAB,177.49,0,274035.78,DR,REF945803,NAB,Business
03-09-2025 08:20,NABBE754A49AE4044828F10,082-900-001,44444444,ZOOM NAB,524,0,273511.78,DR,REF490219,NAB,Business
03-09-2025 08:23,NABC5D8981554CF4E659127,082-900-001,44444444,BIGW NAB,1025.07,0,272486.71,DR,REF131251,NAB,Business
03-09-2025 08:25,NABFAC26905E68243958F79,082-900-001,44444444,7-ELEVEN NAB,781.65,0,271705.06,DR,REF230733,NAB,Business
03-09-2025 09:13,NABFB98344EA84B456B86D8,082-900-001,44444444,BP NAB,274.08,0,271430.98,DR,REF314500,NAB,Business
03-09-2025 09:16,NAB97CC3E5DD43145D39DFE,082-900-001,44444444,INTERNET TRANSFER NAB,504.61,0,270926.37,DR,REF410905,NAB,Business
03-09-2025 09:17,NAB0A37063D32024D9295DD,082-900-001,44444444,BP NAB,57.42,0,270868.95,DR,REF142741,NAB,Business
03-09-2025 09:25,INT7E9C5E8616C24BDE8635,082-900-001,44444444,TRANSFER FROM CBA 33333333,0,1810.24,272679.19,CR,INT-72435,NAB,Business
03-09-2025 10:27,NABABB7329F324F4736A564,082-900-001,44444444,TAFE BOOKSHOP NAB,372.83,0,272306.36,DR,REF237773,NAB,Business
03-09-2025 10:31,NABFDD6E150CFBE43BDB9F9,082-900-001,44444444,ZOOM NAB,410.82,0,271895.54,DR,REF253674,NAB,Business
03-09-2025 10:41,NAB121D461CB55E4FF8AA4B,082-900-001,44444444,COMPANY PAYROLL NAB,0,717.48,272613.02,CR,REF594874,NAB,Business
03-09-2025 11:19,NAB42C3A1E9A9C7477A8EB2,082-900-001,44444444,PAY - SALARY NAB,0,851.61,273464.63,CR,REF270659,NAB,Business
03-09-2025 11:31,NABC5FE9D377C8D4814BCCC,082-900-001,44444444,SHELL NAB,632.19,0,272832.44,DR,REF667865,NAB,Business
03-09-2025 11:43,NABE4FC65DFE6EA46B5AB77,082-900-001,44444444,KFC NAB,451.36,0,272381.08,DR,REF402553,NAB,Business
03-09-2025 11:58,NABA42D0004DE4E4982AC87,082-900-001,44444444,BIGW NAB,490.75,0,271890.33,DR,REF395400,NAB,Business
03-09-2025 12:03,NABF8AEDB09E99B4F69837B,082-900-001,44444444,RAILWAY STATION NAB,244.19,0,271646.14,DR,REF715051,NAB,Business
03-09-2025 12:18,NABCFB3C6E95CCA4CEBBE5F,082-900-001,44444444,STARBUCKS NAB,184.53,0,271461.61,DR,REF689743,NAB,Business
03-09-2025 12:44,NABFA87AE009674486290CF,082-900-001,44444444,BANK FEE NAB,196.65,0,271264.96,DR,REF523650,NAB,Business
03-09-2025 12:55,NABF215A21C9A444D17BFCE,082-900-001,44444444,BWS NAB,367.64,0,270897.32,DR,REF407152,NAB,Business
03-09-2025 13:06,INT063A2FFD1F124104A2D9,082-900-001,44444444,TRANSFER TO CBA 33333333,208.55,0,270688.77,DR,INT-49742,NAB,Business
03-09-2025 13:10,NABD60C621E6B744CB0A772,082-900-001,44444444,PAYROLL CREDIT NAB,0,6120.62,276809.39,CR,REF547197,NAB,Business
03-09-2025 14:21,NAB6D39DF5FBAA44B53B3A3,082-900-001,44444444,CITYLINK NAB,599.62,0,276209.77,DR,REF485793,NAB,Business
03-09-2025 15:14,NABD9EE0D7CAA034F6BBD60,082-900-001,44444444,BP NAB,83.01,0,276126.76,DR,REF246234,NAB,Business
03-09-2025 15:26,NAB2A9649CB86914987A19B,082-900-001,44444444,ALDI NAB,183.57,0,275943.19,DR,REF133277,NAB,Business
03-09-2025 15:34,NABC8AE93DC0DDE4BC7981B,082-900-001,44444444,MCDONALDS NAB,294.81,0,275648.38,DR,REF497391,NAB,Business
03-09-2025 15:36,NAB8FA669BA526940909DF0,082-900-001,44444444,TAFE BOOKSHOP NAB,70.23,0,275578.15,DR,REF935551,NAB,Business
03-09-2025 15:51,NAB0CB3E1418D854FF9AC8A,082-900-001,44444444,MENULOG NAB,308.94,0,275269.21,DR,REF189038,NAB,Business
03-09-2025 16:00,INTDEBF4E3964B94F7BBA2A,082-900-001,44444444,TRANSFER FROM ANZ 11111111,0,596.96,275866.17,CR,INT-55613,NAB,Business
03-09-2025 16:02,NABEA0976AE110643E19B4F,082-900-001,44444444,KFC NAB,144.07,0,275722.1,DR,REF560892,NAB,Business
03-09-2025 16:25,NAB39477B34AE5742ABB67F,082-900-001,44444444,7-ELEVEN NAB,195.94,0,275526.16,DR,REF989148,NAB,Business
03-09-2025 16:34,NAB2D8394B4624840778075,082-900-001,44444444,FLIXBUS NAB,448.64,0,275077.52,DR,REF386861,NAB,Business
03-09-2025 16:46,NAB0915A9D2C52042189275,082-900-001,44444444,INTERNET TRANSFER NAB,226.88,0,274850.64,DR,REF325041,NAB,Business
03-09-2025 16:48,NABAC2C26C6A3B94E6E93AD,082-900-001,44444444,ZOOM NAB,205.94,0,274644.7,DR,REF242329,NAB,Business
03-09-2025 16:53,NAB3ADECAF1FB7A49ACAD35,082-900-001,44444444,BIGW NAB,269.57,0,274375.13,DR,REF216390,NAB,Business
03-09-2025 16:55,NABF2CD9917044D4C869622,082-900-001,44444444,COMPANY PAYROLL NAB,0,4183.26,278558.39,CR,REF508836,NAB,Business
03-09-2025 17:51,NAB0C2C5F6863164350BDA0,082-900-001,44444444,SALARY PAYMENT NAB,0,878.33,279436.72,CR,REF439402,NAB,Business
03-09-2025 18:01,NABC1D569E83FE249F1905D,082-900-001,44444444,WAGES CREDIT NAB,0,6902.18,286338.9,CR,REF925047,NAB,Business
03-09-2025 18:16,NABE9BF58E3D0AB4D2F8028,082-900-001,44444444,PAYROLL CREDIT NAB,0,6886.69,293225.59,CR,REF467725,NAB,Business
03-09-2025 18:26,NAB24517FB31590422988B6,082-900-001,44444444,COMPANY PAYROLL NAB,0,5470.01,298695.6,CR,REF165689,NAB,Business
03-09-2025 18:47,NABB6ADFAB7F35A4BD6BAAD,082-900-001,44444444,WOOLWORTHS NAB,112.31,0,298583.29,DR,REF356218,NAB,Business
03-09-2025 18:47,NAB452E69237979403F90B3,082-900-001,44444444,7-ELEVEN NAB,134.62,0,298448.67,DR,REF159821,NAB,Business
03-09-2025 19:38,NAB98B0CA68A63F48A88370,082-900-001,44444444,PAY - SALARY NAB,0,392.2,298840.87,CR,REF988785,NAB,Business
03-09-2025 20:10,NAB00BDEED86491456092FC,082-900-001,44444444,7-ELEVEN NAB,587.06,0,298253.81,DR,REF760374,NAB,Business
03-09-2025 20:17,NAB1F3FAA82A3554D3EB151,082-900-001,44444444,BP NAB,81.13,0,298172.68,DR,REF458296,NAB,Business
03-09-2025 21:01,NAB52E53866BCCF4315A913,082-900-001,44444444,WOOLWORTHS NAB,533.79,0,297638.89,DR,REF479139,NAB,Business
03-09-2025 21:04,NABA0770E2C753340D8AD05,082-900-001,44444444,CITYLINK NAB,195.8,0,297443.09,DR,REF794216,NAB,Business
03-09-2025 21:12,NAB049D01F31C77488CA53B,082-900-001,44444444,SALARY PAYMENT NAB,0,1140.85,298583.94,CR,REF260077,NAB,Business
03-09-2025 21:41,NABC39FE404A2534ED39447,082-900-001,44444444,ZOOM NAB,140.98,0,298442.96,DR,REF512376,NAB,Business
03-09-2025 21:46,NAB6F93EE3974CE4C6894FB,082-900-001,44444444,RAILWAY STATION NAB,265.18,0,298177.78,DR,REF790507,NAB,Business
03-09-2025 22:22,NABE2D5C1185D7B40DB9332,082-900-001,44444444,PAYMENT GATEWAY NAB,106.57,0,298071.21,DR,REF838293,NAB,Business
03-09-2025 22:23,NABE624F821798E4268AB86,082-900-001,44444444,WOOLWORTHS NAB,86.85,0,297984.36,DR,REF720653,NAB,Business
03-09-2025 22:54,NAB5966B6D7FC6B496293C5,082-900-001,44444444,ALDI NAB,266.49,0,297717.87,DR,REF145648,NAB,Business
03-09-2025 23:02,NABA36005AC5076404EA517,082-900-001,44444444,INTERNET TRANSFER NAB,399.86,0,297318.01,DR,REF237393,NAB,Business
03-09-2025 23:45,NAB6B6EC307FD874B729FC0,082-900-001,44444444,SHELL NAB,215.52,0,297102.49,DR,REF689033,NAB,Business
03-09-2025 23:46,NABEE56D1F20B594A399B3B,082-900-001,44444444,KFC NAB,93.89,0,297008.6,DR,REF327307,NAB,Business
03-09-2025 23:57,NAB0EED8584E46B450FB594,082-900-001,44444444,JB HI-FI NAB,228.46,0,296780.14,DR,REF478370,NAB,Business
03-09-2025 23:58,NAB13CAC18EA52E46F49661,082-900-001,44444444,LIQUORLAND NAB,558.33,0,296221.81,DR,REF941615,NAB,Business
04-09-2025 00:21,NAB0261534E42BB4FCDAE54,082-900-001,44444444,BANK FEE NAB,500.36,0,295721.45,DR,REF187285,NAB,Business
04-09-2025 00:22,NABD16CE1061AC04F198567,082-900-001,44444444,COMPANY PAYROLL NAB,0,6935.38,302656.83,CR,REF764951,NAB,Business
04-09-2025 01:09,NAB9F58362AFD6B44318775,082-900-001,44444444,PAYMENT GATEWAY NAB,402.89,0,302253.94,DR,REF615577,NAB,Business
04-09-2025 01:12,NAB7539AB948AF640F1A10D,082-900-001,44444444,ALDI NAB,236.64,0,302017.3,DR,REF835044,NAB,Business
04-09-2025 01:20,INT136DEF9C134E40FC95BE,082-900-001,44444444,TRANSFER TO ANZ 11111111,1522.79,0,300494.51,DR,INT-68390,NAB,Business
04-09-2025 01:32,NAB9EA4251F20484D62994C,082-900-001,44444444,FLIXBUS NAB,907.13,0,299587.38,DR,REF107929,NAB,Business
04-09-2025 01:35,NAB7945EF2F05FB45A59C9D,082-900-001,44444444,BP NAB,665.46,0,298921.92,DR,REF873934,NAB,Business
04-09-2025 01:43,NAB01E7D0AFD0FC41798085,082-900-001,44444444,MENULOG NAB,1285.18,0,297636.74,DR,REF871557,NAB,Business
04-09-2025 01:47,NAB50E37882FD6C4BB9BE77,082-900-001,44444444,BP NAB,196.67,0,297440.07,DR,REF534188,NAB,Business
04-09-2025 02:13,INT1A090AAC555E41ACA8C0,082-900-001,44444444,TRANSFER FROM CBA 33333333,0,1774.24,299214.31,CR,INT-51039,NAB,Business
04-09-2025 02:40,NABF8ADBC28C550487BAD8D,082-900-001,44444444,STARBUCKS NAB,369.21,0,298845.1,DR,REF681354,NAB,Business
04-09-2025 03:13,NAB2B889337069B4D34B937,082-900-001,44444444,SALARY PAYMENT NAB,0,1809.05,300654.15,CR,REF568058,NAB,Business
04-09-2025 03:44,NABA0D78CA5A5684A2B81D4,082-900-001,44444444,RAILWAY STATION NAB,470.92,0,300183.23,DR,REF291876,NAB,Business
04-09-2025 04:15,NAB4C78FB0C72B5483DA466,082-900-001,44444444,KFC NAB,488.46,0,299694.77,DR,REF743523,NAB,Business
04-09-2025 05:30,NAB8FDA13E6BA904240B7AA,082-900-001,44444444,APPLE NAB,172.66,0,299522.11,DR,REF841025,NAB,Business
04-09-2025 06:29,NABD807208749CD47C8A47D,082-900-001,44444444,FLIXBUS NAB,611.24,0,298910.87,DR,REF933218,NAB,Business
04-09-2025 06:39,NAB9B57FEDBC17F4E0899E9,082-900-001,44444444,COMPANY PAYROLL NAB,0,654.68,299565.55,CR,REF702088,NAB,Business
04-09-2025 06:45,NAB675E30006E6A4ABB853C,082-900-001,44444444,7-ELEVEN NAB,161.94,0,299403.61,DR,REF852831,NAB,Business
04-09-2025 06:51,NAB0ABAB147D1BD4B508680,082-900-001,44444444,LIQUORLAND NAB,112.28,0,299291.33,DR,REF896787,NAB,Business
04-09-2025 06:59,NABF61E02B4C24C466D8F72,082-900-001,44444444,WAGES CREDIT NAB,0,7955.31,307246.64,CR,REF343073,NAB,Business
04-09-2025 07:46,NAB210B790029B344CF8A51,082-900-001,44444444,BWS NAB,449.71,0,306796.93,DR,REF172519,NAB,Business
04-09-2025 08:15,NABA421B3D8A20B4059A2E5,082-900-001,44444444,CITYLINK NAB,1558.78,0,305238.15,DR,REF265632,NAB,Business
04-09-2025 08:25,NABC276DEB7FA194392AD28,082-900-001,44444444,SALARY PAYMENT NAB,0,548.2,305786.35,CR,REF978500,NAB,Business
04-09-2025 08:27,NABB9C512DED3E84D5EA255,082-900-001,44444444,KFC NAB,34.79,0,305751.56,DR,REF356700,NAB,Business
04-09-2025 09:05,NABB2A57855A76F4CBCA2FB,082-900-001,44444444,HARVEY NORMAN NAB,96.77,0,305654.79,DR,REF361503,NAB,Business
04-09-2025 09:26,NAB9CACDF98AD204546941C,082-900-001,44444444,COMPANY PAYROLL NAB,0,2442.07,308096.86,CR,REF268675,NAB,Business
04-09-2025 09:31,NAB81F08A4EF8A44E788881,082-900-001,44444444,JB HI-FI NAB,952.69,0,307144.17,DR,REF360877,NAB,Business
04-09-2025 09:50,NABB1B5F7EDCA5D457FB44E,082-900-001,44444444,PAYMENT GATEWAY NAB,390.98,0,306753.19,DR,REF294531,NAB,Business
04-09-2025 10:06,NAB53B9458F15794AA28B9A,082-900-001,44444444,BP NAB,192.81,0,306560.38,DR,REF142489,NAB,Business
04-09-2025 10:08,NABFA57C8EB4D3743598FB3,082-900-001,44444444,PAYMENT GATEWAY NAB,536.23,0,306024.15,DR,REF724995,NAB,Business
04-09-2025 10:20,NAB4E93030423C34B1CA1FA,082-900-001,44444444,COMPANY PAYROLL NAB,0,2588.65,308612.8,CR,REF193459,NAB,Business
04-09-2025 10:32,NABD3577E4BFE4346A38594,082-900-001,44444444,RAILWAY STATION NAB,1391.17,0,307221.63,DR,REF524525,NAB,Business
04-09-2025 11:29,NABD8B54C701A294F14AD0C,082-900-001,44444444,BANK FEE NAB,319.96,0,306901.67,DR,REF691660,NAB,Business
04-09-2025 11:30,NAB3C51A461A3754F7CA157,082-900-001,44444444,APPLE NAB,265.07,0,306636.6,DR,REF114440,NAB,Business
04-09-2025 12:00,NAB867CDA263BDC46C394D6,082-900-001,44444444,MENULOG NAB,494.86,0,306141.74,DR,REF172814,NAB,Business
04-09-2025 12:08,NAB482B24EDEA804A6DA4AC,082-900-001,44444444,BWS NAB,242.95,0,305898.79,DR,REF124614,NAB,Business
04-09-2025 12:13,NAB74AFC3F4092A49DA80BE,082-900-001,44444444,STARBUCKS NAB,42.86,0,305855.93,DR,REF650317,NAB,Business
04-09-2025 12:35,NAB84E500057EBB48558319,082-900-001,44444444,FLIXBUS NAB,56,0,305799.93,DR,REF319104,NAB,Business
04-09-2025 12:38,NAB3552D005617F4AEBA77B,082-900-001,44444444,BWS NAB,1051.45,0,304748.48,DR,REF266465,NAB,Business
04-09-2025 12:44,NABE2D51445A7CF49279FAE,082-900-001,44444444,DOMINO'S PIZZA NAB,428.86,0,304319.62,DR,REF134590,NAB,Business
04-09-2025 12:52,NABD3C37A8EC8EC4E158871,082-900-001,44444444,JB HI-FI NAB,371.97,0,303947.65,DR,REF427592,NAB,Business
04-09-2025 13:56,NAB17205274FC974F8A98FC,082-900-001,44444444,ALDI NAB,417.63,0,303530.02,DR,REF817843,NAB,Business
04-09-2025 13:57,NAB9C5197F5885B4F119B2A,082-900-001,44444444,MCDONALDS NAB,1514.06,0,302015.96,DR,REF892107,NAB,Business
04-09-2025 14:02,NAB428790CAFF4A4E2AA995,082-900-001,44444444,AMAZON AU NAB,249.37,0,301766.59,DR,REF258797,NAB,Business
04-09-2025 14:15,NAB3B7B2A925E2442B4B7D0,082-900-001,44444444,PAYMENT GATEWAY NAB,99.25,0,301667.34,DR,REF348020,NAB,Business
04-09-2025 14:33,INTFF0B54ED70CB48EE9631,082-900-001,44444444,TRANSFER TO CBA 33333333,464.88,0,301202.46,DR,INT-19691,NAB,Business
04-09-2025 14:50,NAB89A4FD6DAAC547909639,082-900-001,44444444,JB HI-FI NAB,1059.74,0,300142.72,DR,REF340161,NAB,Business
04-09-2025 15:44,NAB2BEE9EB4051E47C5B3C1,082-900-001,44444444,PAYMENT GATEWAY NAB,368.67,0,299774.05,DR,REF531917,NAB,Business
04-09-2025 16:26,NAB361E975395A740B59FB5,082-900-001,44444444,KFC NAB,88.62,0,299685.43,DR,REF227189,NAB,Business
04-09-2025 16:45,NAB7F992E82A3484E68ACEF,082-900-001,44444444,COLES NAB,166.42,0,299519.01,DR,REF764510,NAB,Business
04-09-2025 17:33,NAB2B1C5967DCD34A8FA4D5,082-900-001,44444444,PAYPAL *NETFLIX NAB,974.7,0,298544.31,DR,REF406625,NAB,Business
04-09-2025 19:08,NABF872FBDE80424E44B6EE,082-900-001,44444444,AMAZON AU NAB,81.85,0,298462.46,DR,REF881729,NAB,Business
04-09-2025 19:11,INT3383E31806444B2CA667,082-900-001,44444444,TRANSFER FROM CBA 33333333,0,1549.2,300011.66,CR,INT-77505,NAB,Business
04-09-2025 19:21,NABE8D455815F2E46059463,082-900-001,44444444,COLES NAB,152.32,0,299859.34,DR,REF385722,NAB,Business
04-09-2025 19:42,NAB8C8E61B4BE5D4A99B8D6,082-900-001,44444444,7-ELEVEN NAB,221.93,0,299637.41,DR,REF411064,NAB,Business
04-09-2025 20:22,NAB7E5F38BF54444A68BFB6,082-900-001,44444444,BANK FEE NAB,91.59,0,299545.82,DR,REF302575,NAB,Business
04-09-2025 20:41,NAB88020474239D4DA6A17D,082-900-001,44444444,SHELL NAB,53.93,0,299491.89,DR,REF505632,NAB,Business
04-09-2025 21:14,NABE5AF193BE1C745ECA7DF,082-900-001,44444444,CITYLINK NAB,210.44,0,299281.45,DR,REF414541,NAB,Business
04-09-2025 21:31,NABB60E3078BC8C4322B1B7,082-900-001,44444444,INTERNET TRANSFER NAB,95.69,0,299185.76,DR,REF408545,NAB,Business
04-09-2025 21:47,NAB809D975618224BABBB6E,082-900-001,44444444,TAFE BOOKSHOP NAB,165.79,0,299019.97,DR,REF953192,NAB,Business
04-09-2025 22:13,NABC1F80DC75851471A9AF6,082-900-001,44444444,TAFE BOOKSHOP NAB,542.35,0,298477.62,DR,REF475736,NAB,Business
04-09-2025 22:52,NAB046111A412BE4D118E55,082-900-001,44444444,KFC NAB,97.83,0,298379.79,DR,REF221841,NAB,Business
04-09-2025 22:56,NABE458D62AC30346A49DB2,082-900-001,44444444,COLES NAB,221.96,0,298157.83,DR,REF876790,NAB,Business
04-09-2025 23:19,NABD2132A7D9A1B48D9AFA5,082-900-001,44444444,APPLE NAB,156.25,0,298001.58,DR,REF838236,NAB,Business
05-09-2025 00:18,NABB24F977912A34AE0A819,082-900-001,44444444,7-ELEVEN NAB,278.79,0,297722.79,DR,REF783606,NAB,Business
05-09-2025 00:26,NAB9E2A3540BF2A46088BB4,082-900-001,44444444,PAYROLL CREDIT NAB,0,265.03,297987.82,CR,REF915948,NAB,Business
05-09-2025 00:33,NAB57E345CE795C4732BA56,082-900-001,44444444,FLIXBUS NAB,52.68,0,297935.14,DR,REF620035,NAB,Business
05-09-2025 00:40,NAB2BDAB070A73B4F19AF73,082-900-001,44444444,APPLE NAB,218.85,0,297716.29,DR,REF573843,NAB,Business
05-09-2025 01:21,NAB9A035726630D44A5801B,082-900-001,44444444,WAGES CREDIT NAB,0,3385.94,301102.23,CR,REF349904,NAB,Business
05-09-2025 02:28,NABF7A76BA6130A43FB89F0,082-900-001,44444444,BWS NAB,91.65,0,301010.58,DR,REF623858,NAB,Business
05-09-2025 02:30,NAB5E64BF85E44948748485,082-900-001,44444444,PAYPAL *NETFLIX NAB,177.78,0,300832.8,DR,REF888613,NAB,Business
05-09-2025 02:38,NABB992F0937B0F473FBD17,082-900-001,44444444,PAYPAL *NETFLIX NAB,403.1,0,300429.7,DR,REF362032,NAB,Business
05-09-2025 03:07,NABFE8021CAF951465295F8,082-900-001,44444444,WAGES CREDIT NAB,0,1979.4,302409.1,CR,REF288956,NAB,Business
05-09-2025 03:08,NAB76C8B1043D5F4207832D,082-900-001,44444444,JB HI-FI NAB,258.19,0,302150.91,DR,REF523323,NAB,Business
05-09-2025 03:08,NAB9B1AFD5DEC734CEB8DF7,082-900-001,44444444,AMAZON AU NAB,473.25,0,301677.66,DR,REF229994,NAB,Business
05-09-2025 03:09,NABCD2200549A6F47949A46,082-900-001,44444444,WOOLWORTHS NAB,69.99,0,301607.67,DR,REF768580,NAB,Business
05-09-2025 03:16,NAB211CD57971754E548B92,082-900-001,44444444,ZOOM NAB,211.17,0,301396.5,DR,REF975579,NAB,Business
05-09-2025 04:10,NAB2EC2AF4A5C9D42FC827B,082-900-001,44444444,MCDONALDS NAB,252.45,0,301144.05,DR,REF566796,NAB,Business
05-09-2025 04:11,NABC9CDE4DECC894049A5A9,082-900-001,44444444,UBER EATS NAB,66.75,0,301077.3,DR,REF460427,NAB,Business
05-09-2025 04:36,NAB8BC3446229EE4E30A426,082-900-001,44444444,MENULOG NAB,1181.2,0,299896.1,DR,REF521324,NAB,Business
05-09-2025 05:05,NAB8439214C2FEA471686BE,082-900-001,44444444,RAILWAY STATION NAB,1142.3,0,298753.8,DR,REF870511,NAB,Business
05-09-2025 05:14,NAB1E4173538B68492ABB75,082-900-001,44444444,UBER EATS NAB,120.15,0,298633.65,DR,REF944780,NAB,Business
05-09-2025 05:21,NABBC8E38571E8A476D8E73,082-900-001,44444444,APPLE NAB,387.05,0,298246.6,DR,REF700659,NAB,Business
05-09-2025 06:26,NAB62D8ADAE6F6C4ADA8B10,082-900-001,44444444,SHELL NAB,110.82,0,298135.78,DR,REF121374,NAB,Business
05-09-2025 06:30,NAB70D506D7D16C4191AFB1,082-900-001,44444444,FLIXBUS NAB,827.35,0,297308.43,DR,REF916197,NAB,Business
05-09-2025 07:18,NABBE2D17AD833742DB9771,082-900-001,44444444,BWS NAB,74.1,0,297234.33,DR,REF164144,NAB,Business
05-09-2025 07:58,NAB65FBAA7D69B2423596E9,082-900-001,44444444,LIQUORLAND NAB,80.87,0,297153.46,DR,REF881514,NAB,Business
05-09-2025 08:03,NABAE00D8D12CFF4998BC5B,082-900-001,44444444,APPLE NAB,100.13,0,297053.33,DR,REF648263,NAB,Business
05-09-2025 08:38,NABE5BB268AAED24CC6B5FF,082-900-001,44444444,DOMINO'S PIZZA NAB,366.57,0,296686.76,DR,REF562236,NAB,Business
05-09-2025 09:00,NAB28768B07F8A84D759911,082-900-001,44444444,TAFE BOOKSHOP NAB,1230.47,0,295456.29,DR,REF284647,NAB,Business
05-09-2025 10:11,INT1539CD22252E40B19740,082-900-001,44444444,TRANSFER FROM CBA 33333333,0,651.53,296107.82,CR,INT-58648,NAB,Business
05-09-2025 10:52,NABE9E70F31FE3943149AFD,082-900-001,44444444,HARVEY NORMAN NAB,516.05,0,295591.77,DR,REF187030,NAB,Business
05-09-2025 11:22,NAB1AD36C155FD34ACB99E2,082-900-001,44444444,BIGW NAB,1037.57,0,294554.2,DR,REF690851,NAB,Business
05-09-2025 11:48,NABD307C7EE4A5D4AC78F0C,082-900-001,44444444,BANK FEE NAB,80.04,0,294474.16,DR,REF758865,NAB,Business
05-09-2025 12:23,NABC1F48CC836F0417FBAB4,082-900-001,44444444,CITYLINK NAB,820.38,0,293653.78,DR,REF497303,NAB,Business
05-09-2025 13:04,NABEE8F8E2421864A85A06F,082-900-001,44444444,BIGW NAB,641.7,0,293012.08,DR,REF513631,NAB,Business
05-09-2025 13:07,NAB90840A43273147629B22,082-900-001,44444444,SPOTIFY NAB,24.14,0,292987.94,DR,REF132206,NAB,Business
05-09-2025 14:08,NAB4808F5E309504FA489D4,082-900-001,44444444,WAGES CREDIT NAB,0,2548.59,295536.53,CR,REF915195,NAB,Business
05-09-2025 14:36,INT4706D8AC99FD4583950C,082-900-001,44444444,TRANSFER FROM ANZ 11111111,0,1597.43,297133.96,CR,INT-16218,NAB,Business
05-09-2025 14:59,NABD24CE07585924BC5B016,082-900-001,44444444,TAFE BOOKSHOP NAB,332.66,0,296801.3,DR,REF450421,NAB,Business
05-09-2025 15:05,NAB3AB832E7D87643A09402,082-900-001,44444444,MENULOG NAB,102.67,0,296698.63,DR,REF311088,NAB,Business
05-09-2025 15:06,INT5D47D8F8FD3841A4B694,082-900-001,44444444,TRANSFER TO CBA 33333333,1649.7,0,295048.93,DR,INT-64114,NAB,Business
05-09-2025 15:12,NAB58CFC46606994150A36D,082-900-001,44444444,RAILWAY STATION NAB,107.42,0,294941.51,DR,REF778588,NAB,Business
05-09-2025 15:13,NAB4377FA1A40D24D48AA17,082-900-001,44444444,INTERNET TRANSFER NAB,68.83,0,294872.68,DR,REF338820,NAB,Business
05-09-2025 15:22,NABA4B4496D80404FD1AA18,082-900-001,44444444,SHELL NAB,66.81,0,294805.87,DR,REF172711,NAB,Business
05-09-2025 15:56,NAB0C2087CA974046D48B73,082-900-001,44444444,MCDONALDS NAB,71.1,0,294734.77,DR,REF920356,NAB,Business
05-09-2025 16:00,NAB76F9056B91104808A800,082-900-001,44444444,WOOLWORTHS NAB,54.33,0,294680.44,DR,REF270410,NAB,Business
05-09-2025 16:01,NAB496A11C8F7664D539616,082-900-001,44444444,JB HI-FI NAB,905.23,0,293775.21,DR,REF121845,NAB,Business
05-09-2025 16:20,NAB5E01003991D54662AA04,082-900-001,44444444,SHELL NAB,142.58,0,293632.63,DR,REF134300,NAB,Business
05-09-2025 16:44,NABD88FADDD2BAF4678A16E,082-900-001,44444444,BWS NAB,228.31,0,293404.32,DR,REF172856,NAB,Business
05-09-2025 17:07,NAB8C4EAF81D7CA43A98E26,082-900-001,44444444,MCDONALDS NAB,63.89,0,293340.43,DR,REF337157,NAB,Business
05-09-2025 17:10,NAB9DF3CF5A95E94B94A82F,082-900-001,44444444,RAILWAY STATION NAB,12.93,0,293327.5,DR,REF908722,NAB,Business
05-09-2025 17:19,INT1F8AFB97D2534378882B,082-900-001,44444444,TRANSFER FROM CBA 33333333,0,313.89,293641.39,CR,INT-15011,NAB,Business
05-09-2025 17:24,NAB8897FA30C2E846538CAC,082-900-001,44444444,ZOOM NAB,151.96,0,293489.43,DR,REF120395,NAB,Business
05-09-2025 17:36,NAB3E28074266164F6DB412,082-900-001,44444444,BP NAB,504.65,0,292984.78,DR,REF418180,NAB,Business
05-09-2025 17:54,NABB6AA55FFE2B6440D8D47,082-900-001,44444444,7-ELEVEN NAB,66.9,0,292917.88,DR,REF473320,NAB,Business
05-09-2025 18:00,NAB4EC25E8E2C4645808F99,082-900-001,44444444,LIQUORLAND NAB,81.97,0,292835.91,DR,REF306356,NAB,Business
05-09-2025 18:39,NABC137523625AA4F3E85D6,082-900-001,44444444,ZOOM NAB,336.68,0,292499.23,DR,REF995448,NAB,Business
05-09-2025 19:41,NAB19D9959AC02946D394B9,082-900-001,44444444,HARVEY NORMAN NAB,452.74,0,292046.49,DR,REF346301,NAB,Business
05-09-2025 19:54,NAB05D096C916BC4B9A867E,082-900-001,44444444,UBER EATS NAB,346.91,0,291699.58,DR,REF779562,NAB,Business
05-09-2025 20:07,NAB9A92D5FE324C4D1AAAF2,082-900-001,44444444,MCDONALDS NAB,517.93,0,291181.65,DR,REF796104,NAB,Business
05-09-2025 20:16,NAB0C81298F9842443EA69D,082-900-001,44444444,STARBUCKS NAB,126.93,0,291054.72,DR,REF561253,NAB,Business
05-09-2025 20:45,NABC4F189556F2C4E2AB643,082-900-001,44444444,APPLE NAB,80.14,0,290974.58,DR,REF144991,NAB,Business
05-09-2025 21:00,NAB9F1AACE1C16648ECA849,082-900-001,44444444,HARVEY NORMAN NAB,45.2,0,290929.38,DR,REF913112,NAB,Business
05-09-2025 21:41,NABA27B49EC10734565BA55,082-900-001,44444444,HARVEY NORMAN NAB,48.11,0,290881.27,DR,REF283906,NAB,Business
05-09-2025 22:03,NABC2E235377EE34445A9D9,082-900-001,44444444,PAYPAL *NETFLIX NAB,192.57,0,290688.7,DR,REF429888,NAB,Business
05-09-2025 22:11,NAB88A7E01A85794682B96C,082-900-001,44444444,DOMINO'S PIZZA NAB,192.7,0,290496,DR,REF174952,NAB,Business
05-09-2025 22:17,NAB7D95BB2BE7954AA28800,082-900-001,44444444,PAYPAL *NETFLIX NAB,191.93,0,290304.07,DR,REF244477,NAB,Business
05-09-2025 22:39,NAB37085C2EBB2F472D85E9,082-900-001,44444444,SALARY PAYMENT NAB,0,570.37,290874.44,CR,REF287903,NAB,Business
05-09-2025 23:04,INT0A2A8B8824584A2989B8,082-900-001,44444444,TRANSFER FROM CBA 22222222,0,1436.98,292311.42,CR,INT-79977,NAB,Business
05-09-2025 23:07,NABBC3B41A9D2AD4FA99D1F,082-900-001,44444444,JB HI-FI NAB,449.6,0,291861.82,DR,REF464023,NAB,Business
06-09-2025 00:01,NABBDF9C7F657C04B629CB8,082-900-001,44444444,LIQUORLAND NAB,315.3,0,291546.52,DR,REF492250,NAB,Business
06-09-2025 00:03,NAB0BDEE96457E44F0EA98B,082-900-001,44444444,TAFE BOOKSHOP NAB,25.09,0,291521.43,DR,REF193598,NAB,Business
06-09-2025 00:07,NABB7BD7AE162F64B50BF39,082-900-001,44444444,COLES NAB,68.88,0,291452.55,DR,REF914229,NAB,Business
06-09-2025 00:10,NAB64309370104540E7B7E2,082-900-001,44444444,APPLE NAB,170.75,0,291281.8,DR,REF774930,NAB,Business
06-09-2025 00:38,NAB0577241A86D547A39529,082-900-001,44444444,PAY - SALARY NAB,0,1010.02,292291.82,CR,REF751786,NAB,Business
06-09-2025 00:40,NABAC79661011584BEA9E4B,082-900-001,44444444,CITYLINK NAB,50.4,0,292241.42,DR,REF233174,NAB,Business
06-09-2025 01:19,NABBD62E48E90BE42039F26,082-900-001,44444444,HARVEY NORMAN NAB,283.86,0,291957.56,DR,REF403280,NAB,Business
06-09-2025 01:54,NABBE7810EDA2BC4E0A9C07,082-900-001,44444444,BANK FEE NAB,273.83,0,291683.73,DR,REF838033,NAB,Business
06-09-2025 02:11,NABCDE6E37E2DB44C78A516,082-900-001,44444444,SHELL NAB,71.64,0,291612.09,DR,REF330593,NAB,Business
06-09-2025 02:43,NAB1F124116255E473A875D,082-900-001,44444444,SPOTIFY NAB,755.13,0,290856.96,DR,REF552353,NAB,Business
06-09-2025 03:10,NAB1F7D914CE6C6434D9545,082-900-001,44444444,PAYPAL *NETFLIX NAB,195.13,0,290661.83,DR,REF289546,NAB,Business
06-09-2025 03:19,NABB2DDBC4FBED647DDB42F,082-900-001,44444444,INTERNET TRANSFER NAB,362.04,0,290299.79,DR,REF192869,NAB,Business
06-09-2025 03:20,NAB732380F09B3C4D37A63F,082-900-001,44444444,COMPANY PAYROLL NAB,0,699.64,290999.43,CR,REF731792,NAB,Business
06-09-2025 04:39,NAB536B16A0B31B4CCF802F,082-900-001,44444444,SHELL NAB,109.53,0,290889.9,DR,REF298676,NAB,Business
06-09-2025 04:50,NAB05015112CEC44A59AD11,082-900-001,44444444,7-ELEVEN NAB,77.01,0,290812.89,DR,REF525555,NAB,Business
06-09-2025 05:02,NABCEF48BEBB8444207A01C,082-900-001,44444444,SHELL NAB,80.88,0,290732.01,DR,REF951119,NAB,Business
06-09-2025 05:45,NAB6660A746445D490E8D8D,082-900-001,44444444,WAGES CREDIT NAB,0,2552.1,293284.11,CR,REF430375,NAB,Business
06-09-2025 06:01,NAB497D9E124CF249ECA5F8,082-900-001,44444444,PAYPAL *NETFLIX NAB,416.82,0,292867.29,DR,REF950130,NAB,Business
06-09-2025 06:03,NABD4D5E54AB66A4B9B8777,082-900-001,44444444,CITYLINK NAB,427.19,0,292440.1,DR,REF588302,NAB,Business
06-09-2025 06:17,INT9D8E528CB49B49D78177,082-900-001,44444444,TRANSFER FROM ANZ 11111111,0,1256.54,293696.64,CR,INT-17342,NAB,Business
06-09-2025 06:40,NABFB47668ED06B4ACBBD6D,082-900-001,44444444,SPOTIFY NAB,92.73,0,293603.91,DR,REF918888,NAB,Business
06-09-2025 06:41,NAB98B36B6E1CD24EDA8FA3,082-900-001,44444444,HARVEY NORMAN NAB,161.12,0,293442.79,DR,REF862318,NAB,Business
06-09-2025 06:48,NABF518466CFD0A4EB4BF67,082-900-001,44444444,COLES NAB,161.88,0,293280.91,DR,REF374190,NAB,Business
06-09-2025 09:11,NABA6639D51AD5247DB9AEA,082-900-001,44444444,SHELL NAB,203.39,0,293077.52,DR,REF932831,NAB,Business
06-09-2025 09:23,NAB4925087FA1B74A26A7A3,082-900-001,44444444,LIQUORLAND NAB,293.07,0,292784.45,DR,REF985165,NAB,Business
06-09-2025 09:29,NAB42F6D0A4F7744014B02A,082-900-001,44444444,BANK FEE NAB,130.13,0,292654.32,DR,REF869884,NAB,Business
06-09-2025 09:54,NAB47B54DF1343D42EF8D4D,082-900-001,44444444,FLIXBUS NAB,411.2,0,292243.12,DR,REF270235,NAB,Business
06-09-2025 10:14,INT629E79D5A18A4A35A2EA,082-900-001,44444444,TRANSFER TO ANZ 11111111,72.87,0,292170.25,DR,INT-58556,NAB,Business
06-09-2025 10:48,NABE19B959D00CE4C419F93,082-900-001,44444444,STARBUCKS NAB,509.21,0,291661.04,DR,REF249173,NAB,Business
06-09-2025 10:58,NABAA7F8FF6B06C4B71A36A,082-900-001,44444444,BWS NAB,254.6,0,291406.44,DR,REF174233,NAB,Business
06-09-2025 11:01,NAB5D1E8AE12BF54AF1956A,082-900-001,44444444,7-ELEVEN NAB,643.44,0,290763,DR,REF709204,NAB,Business
06-09-2025 11:17,NABEEB3CC0EA17A467A9CEF,082-900-001,44444444,WOOLWORTHS NAB,470.6,0,290292.4,DR,REF890151,NAB,Business
06-09-2025 11:19,NABDEDDE007FC82421DB0F9,082-900-001,44444444,7-ELEVEN NAB,706.2,0,289586.2,DR,REF609487,NAB,Business
06-09-2025 11:25,NAB7292763DB94646D9B4DA,082-900-001,44444444,UBER EATS NAB,115.12,0,289471.08,DR,REF547000,NAB,Business
06-09-2025 11:54,NAB625448458FD4412D88A7,082-900-001,44444444,INTERNET TRANSFER NAB,520.65,0,288950.43,DR,REF897456,NAB,Business
06-09-2025 13:13,NAB03AE83CBAD994AB48F27,082-900-001,44444444,RAILWAY STATION NAB,427.47,0,288522.96,DR,REF304634,NAB,Business
06-09-2025 13:24,INT0631FE49DC95455287EA,082-900-001,44444444,TRANSFER TO ANZ 11111111,986.88,0,287536.08,DR,INT-38689,NAB,Business
06-09-2025 13:31,NAB1ECDFCD299784BD18516,082-900-001,44444444,LIQUORLAND NAB,27.76,0,287508.32,DR,REF564507,NAB,Business
06-09-2025 13:36,NAB63F9B75083C9437784E6,082-900-001,44444444,RAILWAY STATION NAB,334.05,0,287174.27,DR,REF340455,NAB,Business
06-09-2025 14:41,INTCE6FB4F5F32D4C3B80DB,082-900-001,44444444,TRANSFER FROM CBA 33333333,0,964.37,288138.64,CR,INT-21712,NAB,Business
06-09-2025 15:03,NAB71C36A5EA0F84236B940,082-900-001,44444444,WOOLWORTHS NAB,91.68,0,288046.96,DR,REF461573,NAB,Business
06-09-2025 15:09,NABA0A5EBDECB7C45249B7D,082-900-001,44444444,PAYPAL *NETFLIX NAB,184.79,0,287862.17,DR,REF775952,NAB,Business
06-09-2025 15:18,NAB7384F10352E04F0B952F,082-900-001,44444444,AMAZON AU NAB,27.82,0,287834.35,DR,REF175409,NAB,Business
06-09-2025 15:24,NAB798EFD5566E5445B80D9,082-900-001,44444444,BP NAB,142.38,0,287691.97,DR,REF286234,NAB,Business
06-09-2025 16:02,NAB0A5DA59DEE0846449E34,082-900-001,44444444,HARVEY NORMAN NAB,751.02,0,286940.95,DR,REF179968,NAB,Business
06-09-2025 16:28,NABB23F8214EFF94A449C07,082-900-001,44444444,TAFE BOOKSHOP NAB,54.45,0,286886.5,DR,REF278662,NAB,Business
06-09-2025 16:54,NAB88888DBA017E43FA8240,082-900-001,44444444,COLES NAB,270.46,0,286616.04,DR,REF696487,NAB,Business
06-09-2025 16:59,NAB7904CFDEF4234B1DA667,082-900-001,44444444,BIGW NAB,184.28,0,286431.76,DR,REF938667,NAB,Business
06-09-2025 17:00,NAB918B77CF92C24E749137,082-900-001,44444444,JB HI-FI NAB,533.84,0,285897.92,DR,REF641108,NAB,Business
06-09-2025 17:08,NAB80FA3399D18143CA9618,082-900-001,44444444,BANK FEE NAB,510.28,0,285387.64,DR,REF827371,NAB,Business
06-09-2025 17:11,NAB2A504C1B3E784758A8D9,082-900-001,44444444,7-ELEVEN NAB,630.01,0,284757.63,DR,REF422576,NAB,Business
06-09-2025 17:12,NAB5A94DBF6A9974B87B587,082-900-001,44444444,BP NAB,1616.32,0,283141.31,DR,REF346295,NAB,Business
06-09-2025 17:21,NAB511042ED7FDC4E58B0F6,082-900-001,44444444,KFC NAB,303.63,0,282837.68,DR,REF955003,NAB,Business
06-09-2025 17:25,NABCEF0271F956A492BB0CA,082-900-001,44444444,SALARY PAYMENT NAB,0,3058.88,285896.56,CR,REF671948,NAB,Business
06-09-2025 17:47,NAB1F561B74995D41A4B52A,082-900-001,44444444,SHELL NAB,406.68,0,285489.88,DR,REF801816,NAB,Business
06-09-2025 17:48,NABE05A65B473FB44CBAC81,082-900-001,44444444,SALARY PAYMENT NAB,0,3730.63,289220.51,CR,REF288146,NAB,Business
06-09-2025 18:28,NAB20E9FFE364E7452F9096,082-900-001,44444444,RAILWAY STATION NAB,179.13,0,289041.38,DR,REF689594,NAB,Business
06-09-2025 18:37,NAB35244768BEF84BCEA821,082-900-001,44444444,BANK FEE NAB,140.68,0,288900.7,DR,REF873797,NAB,Business
06-09-2025 18:46,NAB0BE567CEF2124FAD8747,082-900-001,44444444,UBER EATS NAB,678.68,0,288222.02,DR,REF429245,NAB,Business
06-09-2025 19:00,NAB5786CAAD11D340C68E8F,082-900-001,44444444,COLES NAB,146.14,0,288075.88,DR,REF536567,NAB,Business
06-09-2025 19:05,NABE07484561518412D8130,082-900-001,44444444,CITYLINK NAB,296.72,0,287779.16,DR,REF903244,NAB,Business
06-09-2025 19:36,NAB24055A158A5E44348B5D,082-900-001,44444444,MENULOG NAB,434.24,0,287344.92,DR,REF802824,NAB,Business
06-09-2025 19:59,NABF60577BA1BC44CC7894A,082-900-001,44444444,ZOOM NAB,288.19,0,287056.73,DR,REF836279,NAB,Business
06-09-2025 20:07,NABFA81A082C64F443A8D09,082-900-001,44444444,JB HI-FI NAB,95.52,0,286961.21,DR,REF349054,NAB,Business
06-09-2025 20:48,NAB07128FEB9BD34F9BACB1,082-900-001,44444444,7-ELEVEN NAB,558.73,0,286402.48,DR,REF574133,NAB,Business
06-09-2025 20:59,NAB0CA13C257B9A4251BCEF,082-900-001,44444444,BIGW NAB,152.53,0,286249.95,DR,REF926188,NAB,Business
06-09-2025 21:03,NAB4679E4FE362840109657,082-900-001,44444444,COMPANY PAYROLL NAB,0,252.67,286502.62,CR,REF377866,NAB,Business
06-09-2025 21:47,NABF4FDD47247584EFDB905,082-900-001,44444444,STARBUCKS NAB,150.94,0,286351.68,DR,REF758773,NAB,Business
06-09-2025 21:49,NAB295038523EDD4D40A3C7,082-900-001,44444444,BIGW NAB,131.59,0,286220.09,DR,REF148100,NAB,Business
06-09-2025 21:49,NABEE859D9BF9DF4D048DD3,082-900-001,44444444,DOMINO'S PIZZA NAB,213.65,0,286006.44,DR,REF153366,NAB,Business
06-09-2025 22:16,NAB3E0F9C82695E4DD19C28,082-900-001,44444444,ZOOM NAB,736.6,0,285269.84,DR,REF712082,NAB,Business
06-09-2025 22:23,NAB0A25EE9AC37C4ADD9710,082-900-001,44444444,STARBUCKS NAB,215.97,0,285053.87,DR,REF829496,NAB,Business
06-09-2025 22:48,INT0DBFBC4C1F3D41259ED2,082-900-001,44444444,TRANSFER TO ANZ 11111111,1441.17,0,283612.7,DR,INT-82764,NAB,Business
06-09-2025 23:27,NABB4E810E734A2401EAA62,082-900-001,44444444,CITYLINK NAB,689.16,0,282923.54,DR,REF326350,NAB,Business
06-09-2025 23:48,NAB250CBA8EFD2A45A0916F,082-900-001,44444444,WAGES CREDIT NAB,0,5254.49,288178.03,CR,REF942594,NAB,Business
07-09-2025 00:07,NAB2BA39A75884E43F6B088,082-900-001,44444444,WOOLWORTHS NAB,345.06,0,287832.97,DR,REF219309,NAB,Business
07-09-2025 01:13,NAB8B5AFE26AA47413CB050,082-900-001,44444444,ALDI NAB,117.03,0,287715.94,DR,REF854242,NAB,Business
07-09-2025 02:01,NAB47A7259B6FDF4936BD7E,082-900-001,44444444,APPLE NAB,166.54,0,287549.4,DR,REF766702,NAB,Business
07-09-2025 02:24,NAB6ED6397AE4574D7D8FEA,082-900-001,44444444,SPOTIFY NAB,469.64,0,287079.76,DR,REF179201,NAB,Business
07-09-2025 02:37,NAB29E9D6BCA5D34F43B104,082-900-001,44444444,KFC NAB,268.56,0,286811.2,DR,REF957972,NAB,Business
07-09-2025 02:50,NAB223D31E6E61B4F7DB04E,082-900-001,44444444,ZOOM NAB,610.68,0,286200.52,DR,REF258755,NAB,Business
07-09-2025 02:56,NABAA833A19DCA24A3BB2C2,082-900-001,44444444,AMAZON AU NAB,349.38,0,285851.14,DR,REF164190,NAB,Business
07-09-2025 02:57,NAB2521413D02124D2F9CFA,082-900-001,44444444,ALDI NAB,377.1,0,285474.04,DR,REF461440,NAB,Business
07-09-2025 03:08,NABA552B1B7467A49FF901A,082-900-001,44444444,KFC NAB,401.84,0,285072.2,DR,REF937292,NAB,Business
07-09-2025 03:35,INT1B9111D8834348DE8543,082-900-001,44444444,TRANSFER FROM ANZ 11111111,0,1131.69,286203.89,CR,INT-62747,NAB,Business
07-09-2025 04:20,NABF563C1F594114F06A793,082-900-001,44444444,ZOOM NAB,1325.09,0,284878.8,DR,REF105791,NAB,Business
07-09-2025 04:44,NAB99858FFE50B3491DA209,082-900-001,44444444,PAYMENT GATEWAY NAB,467.35,0,284411.45,DR,REF386552,NAB,Business
07-09-2025 04:56,NAB95B08E1B849347B08B77,082-900-001,44444444,BIGW NAB,233.96,0,284177.49,DR,REF789743,NAB,Business
07-09-2025 05:23,NAB7A1B217ABA5540FE9E83,082-900-001,44444444,COMPANY PAYROLL NAB,0,488.3,284665.79,CR,REF231890,NAB,Business
07-09-2025 05:40,NAB45CF01EB73634EE3A79C,082-900-001,44444444,TAFE BOOKSHOP NAB,128.49,0,284537.3,DR,REF874632,NAB,Business
07-09-2025 05:43,NAB5855F182D26943528827,082-900-001,44444444,PAYMENT GATEWAY NAB,214.78,0,284322.52,DR,REF334505,NAB,Business
07-09-2025 07:06,NAB2D474BD0C59348C3B6F0,082-900-001,44444444,PAYMENT GATEWAY NAB,584.09,0,283738.43,DR,REF602485,NAB,Business
07-09-2025 07:16,NABE36FC0482FE64088AE3C,082-900-001,44444444,ALDI NAB,365.9,0,283372.53,DR,REF657596,NAB,Business
07-09-2025 07:33,NABE30199D798D24898BC72,082-900-001,44444444,AMAZON AU NAB,742.24,0,282630.29,DR,REF604108,NAB,Business
07-09-2025 07:39,NAB99ADDC8F21914FC1A645,082-900-001,44444444,CITYLINK NAB,782.92,0,281847.37,DR,REF846403,NAB,Business
07-09-2025 08:25,NABFFA29CE03DF9452A8CC8,082-900-001,44444444,SHELL NAB,819.95,0,281027.42,DR,REF238360,NAB,Business
07-09-2025 08:30,NABB6F96D4EA9EA4F8E9219,082-900-001,44444444,APPLE NAB,27.73,0,280999.69,DR,REF237136,NAB,Business
07-09-2025 08:52,NAB5D19338F6B5C4BB3B5D2,082-900-001,44444444,BP NAB,88.34,0,280911.35,DR,REF857777,NAB,Business
07-09-2025 08:55,NAB940B8916AD7541CE8000,082-900-001,44444444,BP NAB,279.91,0,280631.44,DR,REF543307,NAB,Business
07-09-2025 08:55,NAB54C7C4E6A7C246D7ABB1,082-900-001,44444444,MENULOG NAB,426.8,0,280204.64,DR,REF760700,NAB,Business
07-09-2025 09:52,INT03472185DD024249A950,082-900-001,44444444,TRANSFER FROM CBA 33333333,0,1712.57,281917.21,CR,INT-69236,NAB,Business
07-09-2025 10:02,NABCD4FAAB24FA94E45BC7B,082-900-001,44444444,PAYROLL CREDIT NAB,0,5797.42,287714.63,CR,REF681560,NAB,Business
07-09-2025 10:44,NABA9994A71EE57469BBACA,082-900-001,44444444,COLES NAB,539.01,0,287175.62,DR,REF446261,NAB,Business
07-09-2025 10:59,NABAE312E19180549A4848C,082-900-001,44444444,DOMINO'S PIZZA NAB,437.01,0,286738.61,DR,REF502385,NAB,Business
07-09-2025 11:11,NAB8CB557E0133F4483B6F7,082-900-001,44444444,PAYMENT GATEWAY NAB,262.13,0,286476.48,DR,REF855593,NAB,Business
07-09-2025 11:11,NAB3A43A25DDCD144C6B3CA,082-900-001,44444444,PAY - SALARY NAB,0,2047.21,288523.69,CR,REF343452,NAB,Business
07-09-2025 11:16,NABAD591416BB8F4E4EAD58,082-900-001,44444444,STARBUCKS NAB,387.32,0,288136.37,DR,REF762247,NAB,Business
07-09-2025 11:21,NAB43AC732732A2475185B4,082-900-001,44444444,BP NAB,90.83,0,288045.54,DR,REF238114,NAB,Business
07-09-2025 11:28,NAB0358CCEAF96C4526A6CE,082-900-001,44444444,ZOOM NAB,56.43,0,287989.11,DR,REF756863,NAB,Business
07-09-2025 11:46,NAB97543357B9CD4059B5B9,082-900-001,44444444,LIQUORLAND NAB,387.28,0,287601.83,DR,REF953835,NAB,Business
07-09-2025 11:48,NABF1E756E7B6714BC399B7,082-900-001,44444444,HARVEY NORMAN NAB,97.68,0,287504.15,DR,REF104948,NAB,Business
07-09-2025 12:06,NAB6F86FF4ACAD4436A9020,082-900-001,44444444,KFC NAB,78.47,0,287425.68,DR,REF842035,NAB,Business
07-09-2025 12:15,NAB1E76681693834FB2AE88,082-900-001,44444444,LIQUORLAND NAB,86.77,0,287338.91,DR,REF535064,NAB,Business
07-09-2025 12:18,NAB4A848674BD6F4EC8AEE7,082-900-001,44444444,AMAZON AU NAB,535.22,0,286803.69,DR,REF143462,NAB,Business
07-09-2025 12:32,NAB6A629BED67014C16AA3A,082-900-001,44444444,AMAZON AU NAB,555.71,0,286247.98,DR,REF367652,NAB,Business
07-09-2025 12:37,NABC4DEF423644F402E99D9,082-900-001,44444444,PAYPAL *NETFLIX NAB,193.02,0,286054.96,DR,REF662157,NAB,Business
07-09-2025 12:39,NAB93617CF8644446D0A9DC,082-900-001,44444444,ZOOM NAB,161.46,0,285893.5,DR,REF548209,NAB,Business
07-09-2025 12:41,INT556AE11102734CE29D50,082-900-001,44444444,TRANSFER TO ANZ 11111111,60.23,0,285833.27,DR,INT-89846,NAB,Business
07-09-2025 12:57,NAB23566770F92443EA8A3B,082-900-001,44444444,BIGW NAB,691.57,0,285141.7,DR,REF343384,NAB,Business
07-09-2025 14:19,NAB5FFF764F13E942A08135,082-900-001,44444444,SPOTIFY NAB,643.65,0,284498.05,DR,REF387079,NAB,Business
07-09-2025 14:25,NAB37105D5C84BF4E7DAC36,082-900-001,44444444,ZOOM NAB,410.84,0,284087.21,DR,REF178919,NAB,Business
07-09-2025 14:47,INT9208FE68F2EE4D65A5DE,082-900-001,44444444,TRANSFER FROM ANZ 11111111,0,1347.99,285435.2,CR,INT-49976,NAB,Business
07-09-2025 14:50,NABFA4085EEC9EC4F9D9756,082-900-001,44444444,ALDI NAB,306.43,0,285128.77,DR,REF799335,NAB,Business
07-09-2025 14:53,NAB3A3755AD36F34CCFA34B,082-900-001,44444444,CITYLINK NAB,170.61,0,284958.16,DR,REF382498,NAB,Business
07-09-2025 15:23,INTCF39AB4B571D4B56977A,082-900-001,44444444,TRANSFER TO ANZ 11111111,1366.97,0,283591.19,DR,INT-14324,NAB,Business
07-09-2025 15:43,NAB2A4FCC32073B46A19AD8,082-900-001,44444444,BANK FEE NAB,346.63,0,283244.56,DR,REF248619,NAB,Business
07-09-2025 15:52,NAB4C577969C5404AE98FFF,082-900-001,44444444,DOMINO'S PIZZA NAB,638.79,0,282605.77,DR,REF162603,NAB,Business
07-09-2025 16:20,NAB9A6B52595975462FABF0,082-900-001,44444444,UBER EATS NAB,442.53,0,282163.24,DR,REF123805,NAB,Business
07-09-2025 16:25,NAB75985FDCCA9E4766A095,082-900-001,44444444,ZOOM NAB,46.87,0,282116.37,DR,REF411133,NAB,Business
07-09-2025 17:18,NABFD7EA217D81E49F98FE3,082-900-001,44444444,BIGW NAB,304.16,0,281812.21,DR,REF280365,NAB,Business
07-09-2025 17:29,NAB3D888C9C012B43C78D6F,082-900-001,44444444,DOMINO'S PIZZA NAB,168.67,0,281643.54,DR,REF698112,NAB,Business
07-09-2025 17:35,NABD5B631D10AEA48F08AE3,082-900-001,44444444,PAYMENT GATEWAY NAB,106.32,0,281537.22,DR,REF971869,NAB,Business
07-09-2025 17:46,NABC42E06A4373C424B89A0,082-900-001,44444444,BIGW NAB,174.59,0,281362.63,DR,REF500384,NAB,Business
07-09-2025 17:46,NAB5DE7B980F46B48F08C38,082-900-001,44444444,SALARY PAYMENT NAB,0,957.03,282319.66,CR,REF909931,NAB,Business
07-09-2025 17:49,NAB359A24EF47AC48EA8297,082-900-001,44444444,PAYMENT GATEWAY NAB,260.71,0,282058.95,DR,REF163520,NAB,Business
07-09-2025 17:56,NABEA1E167521B940D3A114,082-900-001,44444444,PAY - SALARY NAB,0,2194.18,284253.13,CR,REF481066,NAB,Business
07-09-2025 17:59,NABC16AEFD8C035415ABC27,082-900-001,44444444,SPOTIFY NAB,435.81,0,283817.32,DR,REF610894,NAB,Business
07-09-2025 18:08,NAB12B1A34441BD4F91B2EF,082-900-001,44444444,KFC NAB,56.06,0,283761.26,DR,REF108921,NAB,Business
07-09-2025 18:28,NABA832979DC0AB4729BFA9,082-900-001,44444444,ZOOM NAB,749.5,0,283011.76,DR,REF376223,NAB,Business
07-09-2025 18:29,NABD8194B6FB7AB41D49B46,082-900-001,44444444,UBER EATS NAB,286.22,0,282725.54,DR,REF742518,NAB,Business
07-09-2025 18:39,NAB1741528CB3D44B72B19E,082-900-001,44444444,7-ELEVEN NAB,177.2,0,282548.34,DR,REF760443,NAB,Business
07-09-2025 18:49,INTA44E48B00BE44C219311,082-900-001,44444444,TRANSFER TO CBA 33333333,1616.65,0,280931.69,DR,INT-68347,NAB,Business
07-09-2025 18:50,NABBACA4F141810437980A4,082-900-001,44444444,BWS NAB,343.9,0,280587.79,DR,REF236777,NAB,Business
07-09-2025 18:56,NAB766F88CB0D3E4B758507,082-900-001,44444444,ZOOM NAB,273.72,0,280314.07,DR,REF205143,NAB,Business
07-09-2025 19:28,NAB00366E8001DE47E6B645,082-900-001,44444444,PAYMENT GATEWAY NAB,1048.55,0,279265.52,DR,REF690141,NAB,Business
07-09-2025 20:11,NABD6FA26FB34634F74ACE4,082-900-001,44444444,7-ELEVEN NAB,236.01,0,279029.51,DR,REF706337,NAB,Business
07-09-2025 21:05,NAB1F2B3CE34EED423EB3E1,082-900-001,44444444,UBER EATS NAB,64.16,0,278965.35,DR,REF613435,NAB,Business
07-09-2025 21:08,NABACE5E026095C4738B18F,082-900-001,44444444,COMPANY PAYROLL NAB,0,1037.74,280003.09,CR,REF306415,NAB,Business
07-09-2025 21:33,NAB551322C567BF4FEDB634,082-900-001,44444444,INTERNET TRANSFER NAB,93.68,0,279909.41,DR,REF106715,NAB,Business
07-09-2025 21:49,NABFF4AD6FD7FE447549AC6,082-900-001,44444444,7-ELEVEN NAB,229.08,0,279680.33,DR,REF655253,NAB,Business
07-09-2025 22:06,NABC5E834CD02A446C2B232,082-900-001,44444444,BWS NAB,172.99,0,279507.34,DR,REF508464,NAB,Business
07-09-2025 22:16,NABD20E71B00E4F4E45962A,082-900-001,44444444,UBER EATS NAB,421,0,279086.34,DR,REF531241,NAB,Business
07-09-2025 22:17,NABAAD59C8E515D465DBFEB,082-900-001,44444444,INTERNET TRANSFER NAB,54.93,0,279031.41,DR,REF481409,NAB,Business
07-09-2025 22:40,NAB689F1891455846D2B0D2,082-900-001,44444444,CITYLINK NAB,95.33,0,278936.08,DR,REF934117,NAB,Business
07-09-2025 23:09,NAB22B25B2A312E4AA5941F,082-900-001,44444444,DOMINO'S PIZZA NAB,108.05,0,278828.03,DR,REF346113,NAB,Business
07-09-2025 23:51,NABC219DC6EB97442C7B89F,082-900-001,44444444,AMAZON AU NAB,57.31,0,278770.72,DR,REF711924,NAB,Business
08-09-2025 00:12,NABFFF6B656DAF14BF6AC4D,082-900-001,44444444,BANK FEE NAB,551.97,0,278218.75,DR,REF680584,NAB,Business
08-09-2025 01:12,NABF97BE2E15A494BA5B188,082-900-001,44444444,PAYMENT GATEWAY NAB,211.06,0,278007.69,DR,REF135770,NAB,Business
08-09-2025 01:33,NAB6CDB34CA028F4124BE98,082-900-001,44444444,WOOLWORTHS NAB,489.94,0,277517.75,DR,REF103172,NAB,Business
08-09-2025 02:18,NAB1735615AC51744DAAA88,082-900-001,44444444,FLIXBUS NAB,107.89,0,277409.86,DR,REF874592,NAB,Business
08-09-2025 02:28,NAB0BE49072E6314CCF92CF,082-900-001,44444444,PAY - SALARY NAB,0,4564,281973.86,CR,REF966454,NAB,Business
08-09-2025 02:40,NAB0040635543FD423EAE28,082-900-001,44444444,DOMINO'S PIZZA NAB,252,0,281721.86,DR,REF406977,NAB,Business
08-09-2025 02:42,NAB53CAE2F77B2C46A48CFC,082-900-001,44444444,DOMINO'S PIZZA NAB,750.18,0,280971.68,DR,REF718491,NAB,Business
08-09-2025 02:47,NAB432F3E5C3E7E4526963C,082-900-001,44444444,LIQUORLAND NAB,216.1,0,280755.58,DR,REF809122,NAB,Business
08-09-2025 03:46,NAB3D5E602E1BD340ABB30E,082-900-001,44444444,AMAZON AU NAB,655.48,0,280100.1,DR,REF870233,NAB,Business
08-09-2025 04:30,NAB571C7EB3B45A4B5C8C04,082-900-001,44444444,ZOOM NAB,37.05,0,280063.05,DR,REF134816,NAB,Business
08-09-2025 04:35,NAB7632477ECA4E4C5BABCA,082-900-001,44444444,INTERNET TRANSFER NAB,119.93,0,279943.12,DR,REF676926,NAB,Business
08-09-2025 05:00,NAB55591D88A0AB4EBCA57B,082-900-001,44444444,BANK FEE NAB,1027.94,0,278915.18,DR,REF554813,NAB,Business
08-09-2025 05:05,NAB85F8BCE8B0E34B8B81EE,082-900-001,44444444,STARBUCKS NAB,2067.54,0,276847.64,DR,REF446604,NAB,Business
08-09-2025 05:09,NAB8DFED6EA2431464AA309,082-900-001,44444444,WOOLWORTHS NAB,185.81,0,276661.83,DR,REF981804,NAB,Business
08-09-2025 05:48,NABAB9ACB90018B435AB8CE,082-900-001,44444444,KFC NAB,448.51,0,276213.32,DR,REF991644,NAB,Business
08-09-2025 06:11,NABC6B6CFDA18864496851E,082-900-001,44444444,ZOOM NAB,57.25,0,276156.07,DR,REF385143,NAB,Business
08-09-2025 06:19,NAB96FB023D3F654D43ACC3,082-900-001,44444444,LIQUORLAND NAB,587.15,0,275568.92,DR,REF406521,NAB,Business
08-09-2025 06:51,NAB4E92661FEE4B4265BA69,082-900-001,44444444,SPOTIFY NAB,167.85,0,275401.07,DR,REF470103,NAB,Business
08-09-2025 06:53,NAB13AF3AE18A45458298EC,082-900-001,44444444,MCDONALDS NAB,500.67,0,274900.4,DR,REF344392,NAB,Business
08-09-2025 07:41,NAB2FA088A5A6954F0B97A7,082-900-001,44444444,UBER EATS NAB,211.8,0,274688.6,DR,REF441044,NAB,Business
08-09-2025 09:00,NAB34666A48C1FC4881BA86,082-900-001,44444444,STARBUCKS NAB,327.94,0,274360.66,DR,REF677864,NAB,Business
08-09-2025 09:56,NABEE8C88601BC64D928657,082-900-001,44444444,LIQUORLAND NAB,287.41,0,274073.25,DR,REF908468,NAB,Business
08-09-2025 10:31,NAB391432EE1A2F485DBF7D,082-900-001,44444444,PAYROLL CREDIT NAB,0,994.48,275067.73,CR,REF133910,NAB,Business
08-09-2025 11:12,NAB244B5E7DECFE4D78976E,082-900-001,44444444,WAGES CREDIT NAB,0,2665.44,277733.17,CR,REF770433,NAB,Business
08-09-2025 11:22,NAB71766DA7A18C49F9BE5E,082-900-001,44444444,COLES NAB,217.9,0,277515.27,DR,REF852006,NAB,Business
08-09-2025 11:30,NAB50096B3E971B46DD9BFF,082-900-001,44444444,PAY - SALARY NAB,0,467.89,277983.16,CR,REF867623,NAB,Business
08-09-2025 11:32,NAB470CF28FCDC740CBA2C1,082-900-001,44444444,DOMINO'S PIZZA NAB,695.33,0,277287.83,DR,REF438009,NAB,Business
08-09-2025 11:33,NABC9AFC567863F42C4B96D,082-900-001,44444444,DOMINO'S PIZZA NAB,24.78,0,277263.05,DR,REF506036,NAB,Business
08-09-2025 11:47,NAB30F99EE8938845D9906F,082-900-001,44444444,SPOTIFY NAB,51.66,0,277211.39,DR,REF722568,NAB,Business
08-09-2025 12:06,NAB127F454189564167965E,082-900-001,44444444,APPLE NAB,437.65,0,276773.74,DR,REF904667,NAB,Business
08-09-2025 12:12,NAB4041E067250B43089303,082-900-001,44444444,RAILWAY STATION NAB,152.44,0,276621.3,DR,REF936228,NAB,Business
08-09-2025 12:49,NAB209718B21F8E406CB615,082-900-001,44444444,WAGES CREDIT NAB,0,2261.41,278882.71,CR,REF925914,NAB,Business
08-09-2025 12:55,NABF93692B7C8AC4C90A6B7,082-900-001,44444444,PAYPAL *NETFLIX NAB,187.01,0,278695.7,DR,REF898185,NAB,Business
08-09-2025 13:13,NAB7FB82228A81C43B18F6D,082-900-001,44444444,BANK FEE NAB,592.13,0,278103.57,DR,REF511267,NAB,Business
08-09-2025 13:15,NAB128EEA3D116E4908A48D,082-900-001,44444444,7-ELEVEN NAB,160.29,0,277943.28,DR,REF133011,NAB,Business
08-09-2025 13:52,NAB3EBA921972394283809F,082-900-001,44444444,7-ELEVEN NAB,249.17,0,277694.11,DR,REF577269,NAB,Business
08-09-2025 14:11,NABBEF1B7429AE44273AF8E,082-900-001,44444444,JB HI-FI NAB,82.24,0,277611.87,DR,REF166385,NAB,Business
08-09-2025 14:47,NABB14E45B66204419FAB5A,082-900-001,44444444,STARBUCKS NAB,356.42,0,277255.45,DR,REF377491,NAB,Business
08-09-2025 15:04,NABDE15FC7562744D4E8727,082-900-001,44444444,BP NAB,370.9,0,276884.55,DR,REF322172,NAB,Business
08-09-2025 15:09,NAB266E5248ECCE477EAC7D,082-900-001,44444444,APPLE NAB,187.08,0,276697.47,DR,REF256021,NAB,Business
08-09-2025 15:10,NAB6A4D8B6672584D2A873C,082-900-001,44444444,FLIXBUS NAB,523.08,0,276174.39,DR,REF275061,NAB,Business
08-09-2025 15:16,NABD865F18FB11346EBBAE7,082-900-001,44444444,SHELL NAB,189.65,0,275984.74,DR,REF315945,NAB,Business
08-09-2025 15:40,NAB79D04AB4E3524D71A5F5,082-900-001,44444444,COLES NAB,124.8,0,275859.94,DR,REF221966,NAB,Business
08-09-2025 15:47,NAB0DC81565CFBA40D28BEF,082-900-001,44444444,ALDI NAB,447.31,0,275412.63,DR,REF415805,NAB,Business
08-09-2025 16:16,NAB0638919EE85F40069EA2,082-900-001,44444444,PAYROLL CREDIT NAB,0,3692.3,279104.93,CR,REF593557,NAB,Business
08-09-2025 16:48,NABD0A40A25EE37445E93E4,082-900-001,44444444,JB HI-FI NAB,42.76,0,279062.17,DR,REF592682,NAB,Business
08-09-2025 17:02,NAB02E41E24D06647F98F67,082-900-001,44444444,RAILWAY STATION NAB,27.59,0,279034.58,DR,REF813616,NAB,Business
08-09-2025 17:44,NABE1F88D9036954554912E,082-900-001,44444444,COMPANY PAYROLL NAB,0,6950.56,285985.14,CR,REF832446,NAB,Business
08-09-2025 18:36,NAB7ABDB0A6DD6145039DC8,082-900-001,44444444,DOMINO'S PIZZA NAB,120.06,0,285865.08,DR,REF699974,NAB,Business
08-09-2025 18:43,NABBDBC938D1A8A44FC8F1B,082-900-001,44444444,PAYMENT GATEWAY NAB,758.12,0,285106.96,DR,REF255448,NAB,Business
08-09-2025 19:02,NAB618592F699564A9A949F,082-900-001,44444444,MENULOG NAB,65.83,0,285041.13,DR,REF473597,NAB,Business
08-09-2025 19:09,NAB8E342324F9014BBFA741,082-900-001,44444444,PAYPAL *NETFLIX NAB,1294.55,0,283746.58,DR,REF667681,NAB,Business
08-09-2025 19:27,NAB7A02194DE5284654B1E1,082-900-001,44444444,PAYMENT GATEWAY NAB,224.66,0,283521.92,DR,REF559453,NAB,Business
08-09-2025 19:41,NABF367A746865743D6828B,082-900-001,44444444,SALARY PAYMENT NAB,0,4252.91,287774.83,CR,REF491340,NAB,Business
08-09-2025 19:49,NABDD29DB5DD50C41F59DF3,082-900-001,44444444,INTERNET TRANSFER NAB,693,0,287081.83,DR,REF954086,NAB,Business
08-09-2025 19:59,NAB982535B5E8DE405CA88D,082-900-001,44444444,COLES NAB,72.83,0,287009,DR,REF790668,NAB,Business
08-09-2025 20:37,NABCFD0A5FBF8C447458271,082-900-001,44444444,ALDI NAB,143.67,0,286865.33,DR,REF210871,NAB,Business
08-09-2025 21:04,NABFD2CCE7F6AB844D3AFA5,082-900-001,44444444,DOMINO'S PIZZA NAB,316.62,0,286548.71,DR,REF284854,NAB,Business
08-09-2025 21:08,NABE980A3B17E0A4F418026,082-900-001,44444444,BP NAB,1123.59,0,285425.12,DR,REF936844,NAB,Business
08-09-2025 21:11,NAB79DF9FC7F510443C9184,082-900-001,44444444,SHELL NAB,85.82,0,285339.3,DR,REF367431,NAB,Business
08-09-2025 21:23,NAB9B9E8EBD5B4A436E95A9,082-900-001,44444444,SPOTIFY NAB,297.73,0,285041.57,DR,REF245318,NAB,Business
08-09-2025 21:44,NABDB8A1E5723864323A8EF,082-900-001,44444444,STARBUCKS NAB,101.35,0,284940.22,DR,REF552666,NAB,Business
08-09-2025 22:12,NABF397A2C1F49449868C19,082-900-001,44444444,ALDI NAB,70.41,0,284869.81,DR,REF862536,NAB,Business
08-09-2025 22:20,NAB15E616F91FD048E1912A,082-900-001,44444444,PAY - SALARY NAB,0,898.43,285768.24,CR,REF791432,NAB,Business
08-09-2025 22:41,NABB66ABF350FDA44C38639,082-900-001,44444444,SPOTIFY NAB,298.15,0,285470.09,DR,REF123533,NAB,Business
08-09-2025 22:44,NABAC205FC7195D45FB82DB,082-900-001,44444444,PAYPAL *NETFLIX NAB,419.24,0,285050.85,DR,REF916014,NAB,Business
08-09-2025 23:39,INTAE7B0A0C15B4426A9D82,082-900-001,44444444,TRANSFER TO CBA 33333333,884.51,0,284166.34,DR,INT-96665,NAB,Business
08-09-2025 23:39,NAB7AEE2A8E91214ACDAA4A,082-900-001,44444444,PAYPAL *NETFLIX NAB,89.04,0,284077.3,DR,REF138115,NAB,Business
09-09-2025 00:06,NAB4373EF16AB114B46B623,082-900-001,44444444,INTERNET TRANSFER NAB,609.26,0,283468.04,DR,REF264867,NAB,Business
09-09-2025 00:15,NABABF044677CB040129293,082-900-001,44444444,SHELL NAB,400.93,0,283067.11,DR,REF794809,NAB,Business
09-09-2025 00:22,NABAE77BFACA0D742C98BD4,082-900-001,44444444,ALDI NAB,117.08,0,282950.03,DR,REF411434,NAB,Business
09-09-2025 00:27,NABF671AC186B8F4E9BA10D,082-900-001,44444444,COLES NAB,175.48,0,282774.55,DR,REF988467,NAB,Business
09-09-2025 00:35,NABF395DD4877564067AD65,082-900-001,44444444,MCDONALDS NAB,949.44,0,281825.11,DR,REF935700,NAB,Business
09-09-2025 00:43,NAB28028975975C44178F53,082-900-001,44444444,STARBUCKS NAB,681.94,0,281143.17,DR,REF952200,NAB,Business
09-09-2025 00:47,NAB33C3656F77BF4BB59B66,082-900-001,44444444,PAYPAL *NETFLIX NAB,55.39,0,281087.78,DR,REF713348,NAB,Business
09-09-2025 00:56,NAB96A5E0C39A184011996C,082-900-001,44444444,ALDI NAB,716.34,0,280371.44,DR,REF482165,NAB,Business
09-09-2025 01:08,NABE95BAFB0F346458CB318,082-900-001,44444444,RAILWAY STATION NAB,135.69,0,280235.75,DR,REF520302,NAB,Business
09-09-2025 01:10,NAB8E4A34664BCF4BFA91DA,082-900-001,44444444,BIGW NAB,130.42,0,280105.33,DR,REF783065,NAB,Business
09-09-2025 01:54,INT474BA91C91B947BDAE2A,082-900-001,44444444,TRANSFER TO CBA 22222222,1423.61,0,278681.72,DR,INT-75741,NAB,Business
09-09-2025 02:01,NABF184632C912E4113953C,082-900-001,44444444,TAFE BOOKSHOP NAB,709.38,0,277972.34,DR,REF521165,NAB,Business
09-09-2025 02:02,NAB1B960D0B5A814AF5B1C2,082-900-001,44444444,WOOLWORTHS NAB,139.53,0,277832.81,DR,REF618220,NAB,Business
09-09-2025 02:11,NABA03CE9F90ADA4D429137,082-900-001,44444444,COMPANY PAYROLL NAB,0,44.86,277877.67,CR,REF559386,NAB,Business
09-09-2025 03:24,NAB8154BD4BF3D04EE08975,082-900-001,44444444,TAFE BOOKSHOP NAB,209.49,0,277668.18,DR,REF562962,NAB,Business
09-09-2025 03:33,NAB3F5814E5E53345E196AD,082-900-001,44444444,ZOOM NAB,240.33,0,277427.85,DR,REF698985,NAB,Business
09-09-2025 03:37,NABFBFB5E824DD9416ABD8F,082-900-001,44444444,LIQUORLAND NAB,154.14,0,277273.71,DR,REF924376,NAB,Business
09-09-2025 04:09,NAB15D5BD7975EB4BE3ABE7,082-900-001,44444444,PAYMENT GATEWAY NAB,193.42,0,277080.29,DR,REF371295,NAB,Business
09-09-2025 04:12,NAB8A63F4784B7F4F80BDB2,082-900-001,44444444,BIGW NAB,426.98,0,276653.31,DR,REF850558,NAB,Business
09-09-2025 04:28,NAB0883DB9E4BB34B859567,082-900-001,44444444,BP NAB,69.95,0,276583.36,DR,REF908271,NAB,Business
09-09-2025 06:32,INT412F2BB50DE048619898,082-900-001,44444444,TRANSFER TO CBA 22222222,361.79,0,276221.57,DR,INT-87918,NAB,Business
09-09-2025 06:38,NAB9721E5C1B1114C4FBCCB,082-900-001,44444444,JB HI-FI NAB,195.61,0,276025.96,DR,REF562823,NAB,Business
09-09-2025 06:38,NAB13BAA3475FE44935AEC0,082-900-001,44444444,PAY - SALARY NAB,0,5943.02,281968.98,CR,REF974792,NAB,Business
09-09-2025 06:43,NAB765FD65D745F4D688D80,082-900-001,44444444,FLIXBUS NAB,954.79,0,281014.19,DR,REF641439,NAB,Business
09-09-2025 07:03,NABC61DACB19E1E42C8962D,082-900-001,44444444,PAYMENT GATEWAY NAB,221.42,0,280792.77,DR,REF133001,NAB,Business
09-09-2025 07:10,NAB5F731B6916E04AEA9508,082-900-001,44444444,TAFE BOOKSHOP NAB,336.74,0,280456.03,DR,REF383983,NAB,Business
09-09-2025 08:38,NABC138B4C23A0642A8B5F7,082-900-001,44444444,STARBUCKS NAB,20.59,0,280435.44,DR,REF116229,NAB,Business
09-09-2025 08:43,NAB8AE7D5AFAB1543F19F7A,082-900-001,44444444,KFC NAB,117.54,0,280317.9,DR,REF209115,NAB,Business
09-09-2025 08:48,NAB74BE8859E6854917A287,082-900-001,44444444,INTERNET TRANSFER NAB,381.19,0,279936.71,DR,REF289550,NAB,Business
09-09-2025 09:54,NAB019220D9E0DB41E6AC81,082-900-001,44444444,RAILWAY STATION NAB,95.33,0,279841.38,DR,REF952217,NAB,Business
09-09-2025 10:27,NABDC3EA5A7CA95450D9A2A,082-900-001,44444444,SHELL NAB,268.31,0,279573.07,DR,REF994133,NAB,Business
09-09-2025 10:29,NAB58D01A5EE1F34927A19F,082-900-001,44444444,PAYMENT GATEWAY NAB,250.5,0,279322.57,DR,REF205616,NAB,Business
09-09-2025 10:32,NAB5289E2FE223D4829956E,082-900-001,44444444,SALARY PAYMENT NAB,0,3975.15,283297.72,CR,REF356425,NAB,Business
09-09-2025 10:55,NABC273F278BBF847EDB707,082-900-001,44444444,BIGW NAB,283.19,0,283014.53,DR,REF789505,NAB,Business
09-09-2025 11:10,NAB90B0608FA930488F9484,082-900-001,44444444,BP NAB,53.76,0,282960.77,DR,REF698275,NAB,Business
09-09-2025 11:36,NABA5B9A7D340A047D199D5,082-900-001,44444444,BANK FEE NAB,35.56,0,282925.21,DR,REF679629,NAB,Business
09-09-2025 11:44,NAB9AC14F3BB88040488F38,082-900-001,44444444,TAFE BOOKSHOP NAB,717.63,0,282207.58,DR,REF986345,NAB,Business
09-09-2025 12:08,NAB4014C984E41C49F38533,082-900-001,44444444,LIQUORLAND NAB,16.48,0,282191.1,DR,REF327457,NAB,Business
09-09-2025 12:40,NAB00862A34510A457087DE,082-900-001,44444444,CITYLINK NAB,76.5,0,282114.6,DR,REF911623,NAB,Business
09-09-2025 12:50,NAB55B630A1BC2640BA8887,082-900-001,44444444,SPOTIFY NAB,256.47,0,281858.13,DR,REF852863,NAB,Business
09-09-2025 12:57,NAB201D35FF692F4E07B849,082-900-001,44444444,BP NAB,285.37,0,281572.76,DR,REF684668,NAB,Business
09-09-2025 12:57,NAB57CE2775EF7A4E0A93A3,082-900-001,44444444,PAYROLL CREDIT NAB,0,5426.49,286999.25,CR,REF783143,NAB,Business
09-09-2025 13:04,NAB8B897747FEB240669401,082-900-001,44444444,COLES NAB,547.86,0,286451.39,DR,REF668128,NAB,Business
09-09-2025 13:28,NAB787C5991DCDF4F2293AB,082-900-001,44444444,APPLE NAB,519.89,0,285931.5,DR,REF151134,NAB,Business
09-09-2025 13:56,NABB140C183B6D5476B888C,082-900-001,44444444,SPOTIFY NAB,819.51,0,285111.99,DR,REF284038,NAB,Business
09-09-2025 14:12,NAB45F1F6DAB38043C8BEB7,082-900-001,44444444,CITYLINK NAB,414.72,0,284697.27,DR,REF718440,NAB,Business
09-09-2025 14:28,NAB5BB57432EB754CDDB781,082-900-001,44444444,INTERNET TRANSFER NAB,126.98,0,284570.29,DR,REF823122,NAB,Business
09-09-2025 14:36,NAB5FB58AA834D44722B820,082-900-001,44444444,AMAZON AU NAB,48.06,0,284522.23,DR,REF584927,NAB,Business
09-09-2025 14:49,INT90938A4A666B4B16B2B4,082-900-001,44444444,TRANSFER TO ANZ 11111111,1689.13,0,282833.1,DR,INT-45034,NAB,Business
09-09-2025 14:52,NABF2561A1F2F1C483FBC6A,082-900-001,44444444,APPLE NAB,102.41,0,282730.69,DR,REF389377,NAB,Business
09-09-2025 14:53,NABBF0EDBE5849140F6AF75,082-900-001,44444444,STARBUCKS NAB,39.5,0,282691.19,DR,REF940016,NAB,Business
09-09-2025 15:53,NAB459DD66314014E82838E,082-900-001,44444444,APPLE NAB,96.74,0,282594.45,DR,REF420838,NAB,Business
09-09-2025 16:01,NAB61B6A1023275410B9124,082-900-001,44444444,DOMINO'S PIZZA NAB,137.55,0,282456.9,DR,REF955156,NAB,Business
09-09-2025 16:02,NAB6C7A457014A14ACBB4F5,082-900-001,44444444,INTERNET TRANSFER NAB,57.57,0,282399.33,DR,REF730530,NAB,Business
09-09-2025 16:28,NAB5D60D1062082445495DC,082-900-001,44444444,MCDONALDS NAB,106.38,0,282292.95,DR,REF491198,NAB,Business
09-09-2025 16:39,NAB8706F03C9C7943B18367,082-900-001,44444444,ZOOM NAB,194.69,0,282098.26,DR,REF793530,NAB,Business
09-09-2025 16:48,NAB06BC983C6A044484A1D6,082-900-001,44444444,SALARY PAYMENT NAB,0,255.95,282354.21,CR,REF316751,NAB,Business
09-09-2025 16:55,NAB5F0EAF26070C48E99FE3,082-900-001,44444444,COLES NAB,80.04,0,282274.17,DR,REF395887,NAB,Business
09-09-2025 17:09,NAB7AC71AA6267B41678D76,082-900-001,44444444,BANK FEE NAB,193.8,0,282080.37,DR,REF594796,NAB,Business
09-09-2025 17:29,NAB681BBE3ECC524A29B87C,082-900-001,44444444,DOMINO'S PIZZA NAB,115.95,0,281964.42,DR,REF324919,NAB,Business
09-09-2025 17:59,NABC9F5DC4AB8C740DA8E81,082-900-001,44444444,FLIXBUS NAB,616.86,0,281347.56,DR,REF434230,NAB,Business
09-09-2025 18:03,NABBC249615B8AE4D0A87EB,082-900-001,44444444,CITYLINK NAB,317.19,0,281030.37,DR,REF159000,NAB,Business
09-09-2025 18:45,NAB52BDEA84C5B641EDA7C6,082-900-001,44444444,CITYLINK NAB,95.86,0,280934.51,DR,REF939049,NAB,Business
09-09-2025 19:14,NABDDE4F939F05A40AF90B9,082-900-001,44444444,7-ELEVEN NAB,419.9,0,280514.61,DR,REF579973,NAB,Business
09-09-2025 19:17,NABD94151BBDE9546EC9F3E,082-900-001,44444444,PAYROLL CREDIT NAB,0,4078.21,284592.82,CR,REF873865,NAB,Business
09-09-2025 19:19,NABC61E473E07B445EDB804,082-900-001,44444444,BANK FEE NAB,729.91,0,283862.91,DR,REF867557,NAB,Business
09-09-2025 19:40,NAB7B6ADF7BB3414C068CD5,082-900-001,44444444,COLES NAB,294.78,0,283568.13,DR,REF415946,NAB,Business
09-09-2025 20:15,NABC2FD1667BAC748DCA571,082-900-001,44444444,BP NAB,277.38,0,283290.75,DR,REF207038,NAB,Business
09-09-2025 20:35,NAB6CEA1703715C41B0A783,082-900-001,44444444,KFC NAB,533.77,0,282756.98,DR,REF753715,NAB,Business
09-09-2025 20:47,NAB42986825F9234523BF81,082-900-001,44444444,HARVEY NORMAN NAB,175.84,0,282581.14,DR,REF340990,NAB,Business
09-09-2025 20:55,INT2A02F6C0940C4EC3A5CC,082-900-001,44444444,TRANSFER TO CBA 22222222,786.33,0,281794.81,DR,INT-70654,NAB,Business
09-09-2025 21:38,NABF5D6883F37A3492DA7F8,082-900-001,44444444,UBER EATS NAB,151.8,0,281643.01,DR,REF922620,NAB,Business
09-09-2025 21:59,NAB03D0EFC3FA054BD5B5E8,082-900-001,44444444,MCDONALDS NAB,277.39,0,281365.62,DR,REF811324,NAB,Business
09-09-2025 22:41,NAB6F6B40B094A04CF5BA39,082-900-001,44444444,RAILWAY STATION NAB,146.06,0,281219.56,DR,REF422693,NAB,Business
09-09-2025 23:04,NABC1187F800BC44090AF5F,082-900-001,44444444,APPLE NAB,87.92,0,281131.64,DR,REF602554,NAB,Business
09-09-2025 23:28,NAB187A6CDEC589455DA5C4,082-900-001,44444444,PAYPAL *NETFLIX NAB,230.57,0,280901.07,DR,REF818285,NAB,Business
09-09-2025 23:38,NAB5405F9D2F40A41168C09,082-900-001,44444444,PAYPAL *NETFLIX NAB,65.24,0,280835.83,DR,REF643341,NAB,Business
09-09-2025 23:47,NAB32BA9444778D4C409469,082-900-001,44444444,WAGES CREDIT NAB,0,417.78,281253.61,CR,REF181653,NAB,Business
09-09-2025 23:55,NABB9197C1588B1496B84C9,082-900-001,44444444,SHELL NAB,1338.37,0,279915.24,DR,REF412200,NAB,Business
10-09-2025 00:02,NAB997F59300EF141F4A84D,082-900-001,44444444,JB HI-FI NAB,136.06,0,279779.18,DR,REF645233,NAB,Business
10-09-2025 00:56,NAB207ACE0FA81D4FB1B260,082-900-001,44444444,BANK FEE NAB,285.97,0,279493.21,DR,REF876006,NAB,Business
10-09-2025 01:15,NAB176EB5862D4C4F598D1F,082-900-001,44444444,MENULOG NAB,170.17,0,279323.04,DR,REF247271,NAB,Business
10-09-2025 02:17,INT3E897CD3AE8C43AFA836,082-900-001,44444444,TRANSFER TO CBA 33333333,762.14,0,278560.9,DR,INT-24651,NAB,Business
10-09-2025 02:19,NABAD1A442085DB4313820A,082-900-001,44444444,WAGES CREDIT NAB,0,2041.21,280602.11,CR,REF327960,NAB,Business
10-09-2025 02:21,NABA93ECF2AB3414D5DB860,082-900-001,44444444,FLIXBUS NAB,135.02,0,280467.09,DR,REF618619,NAB,Business
10-09-2025 03:44,NAB453685592FE547189A4E,082-900-001,44444444,BWS NAB,688.3,0,279778.79,DR,REF185069,NAB,Business
10-09-2025 03:52,NAB3FD4B0DDF3734F559F73,082-900-001,44444444,PAYPAL *NETFLIX NAB,505.45,0,279273.34,DR,REF186968,NAB,Business
10-09-2025 03:55,NABEE1EF71D345440EEA0D4,082-900-001,44444444,BIGW NAB,551.12,0,278722.22,DR,REF293542,NAB,Business
10-09-2025 03:56,NAB500C6AB52CA34A988002,082-900-001,44444444,7-ELEVEN NAB,500.98,0,278221.24,DR,REF448747,NAB,Business
10-09-2025 04:27,NABB47AA340DC6548FE8DB0,082-900-001,44444444,BWS NAB,451.69,0,277769.55,DR,REF964027,NAB,Business
10-09-2025 04:54,NAB30ABFB1ED5AA4C7D9E90,082-900-001,44444444,APPLE NAB,37.93,0,277731.62,DR,REF698806,NAB,Business
10-09-2025 04:54,NAB8C0865E125DC46AB8D54,082-900-001,44444444,STARBUCKS NAB,171.66,0,277559.96,DR,REF565395,NAB,Business
10-09-2025 05:21,NABD2F833B8331B47DDB1C8,082-900-001,44444444,7-ELEVEN NAB,205.06,0,277354.9,DR,REF700046,NAB,Business
10-09-2025 05:32,NABD21B46A6F4374E538717,082-900-001,44444444,MCDONALDS NAB,96.19,0,277258.71,DR,REF741730,NAB,Business
10-09-2025 05:55,NAB9EB4C7CEC83F4B77A9E4,082-900-001,44444444,RAILWAY STATION NAB,183.08,0,277075.63,DR,REF684020,NAB,Business
10-09-2025 06:32,NABD71800C497BD43CCA887,082-900-001,44444444,MCDONALDS NAB,353.22,0,276722.41,DR,REF716229,NAB,Business
10-09-2025 06:57,NABD4853C88ACEF46D69521,082-900-001,44444444,FLIXBUS NAB,125.69,0,276596.72,DR,REF719149,NAB,Business
10-09-2025 08:31,INTC6EEE847B2714D9B809F,082-900-001,44444444,TRANSFER FROM ANZ 11111111,0,1409.14,278005.86,CR,INT-55163,NAB,Business
10-09-2025 08:34,NABB891FF8E43544F43BD77,082-900-001,44444444,COLES NAB,257.91,0,277747.95,DR,REF486638,NAB,Business
10-09-2025 09:10,NAB4973A7791A9F4896B905,082-900-001,44444444,TAFE BOOKSHOP NAB,141.21,0,277606.74,DR,REF944284,NAB,Business
10-09-2025 09:18,NAB3617B842F98C46ADB9FE,082-900-001,44444444,APPLE NAB,864.55,0,276742.19,DR,REF450841,NAB,Business
10-09-2025 09:25,NAB1EA904B7D5B9420B8D90,082-900-001,44444444,ZOOM NAB,59.3,0,276682.89,DR,REF307108,NAB,Business
10-09-2025 09:31,NAB92183B2DD3434BDA83C5,082-900-001,44444444,ZOOM NAB,347.5,0,276335.39,DR,REF428946,NAB,Business
10-09-2025 09:42,NAB2AE79BF8F4964FE190D8,082-900-001,44444444,JB HI-FI NAB,29.96,0,276305.43,DR,REF481529,NAB,Business
10-09-2025 09:51,NAB37A2E9FF7D5D4CDB85BC,082-900-001,44444444,UBER EATS NAB,377.98,0,275927.45,DR,REF261831,NAB,Business
10-09-2025 09:52,NAB4A0A00F62FF84A49BA00,082-900-001,44444444,MENULOG NAB,450.99,0,275476.46,DR,REF409167,NAB,Business
10-09-2025 09:55,NAB8A5EE0030B8D45F192C5,082-900-001,44444444,ZOOM NAB,98.85,0,275377.61,DR,REF749861,NAB,Business
10-09-2025 10:38,NABA40D0E773A714DF1A306,082-900-001,44444444,INTERNET TRANSFER NAB,175.2,0,275202.41,DR,REF392909,NAB,Business
10-09-2025 10:58,NABC9C43DFD4801402E9695,082-900-001,44444444,INTERNET TRANSFER NAB,190.59,0,275011.82,DR,REF565321,NAB,Business
10-09-2025 11:41,NAB2D1FF7B406CF44058233,082-900-001,44444444,STARBUCKS NAB,111.53,0,274900.29,DR,REF606619,NAB,Business
10-09-2025 11:42,NAB28068DA4003F459296F8,082-900-001,44444444,CITYLINK NAB,209.7,0,274690.59,DR,REF130598,NAB,Business
10-09-2025 11:43,NABA9920A4F11AF41AEA460,082-900-001,44444444,APPLE NAB,751.77,0,273938.82,DR,REF867238,NAB,Business
10-09-2025 11:53,NAB83A52656049B4EEFA789,082-900-001,44444444,APPLE NAB,214.85,0,273723.97,DR,REF546342,NAB,Business
10-09-2025 11:55,NABF1F8565EE4AF46AEBB24,082-900-001,44444444,LIQUORLAND NAB,478.05,0,273245.92,DR,REF602317,NAB,Business
10-09-2025 12:04,NAB771B2F2390464CB18408,082-900-001,44444444,SPOTIFY NAB,264.27,0,272981.65,DR,REF291747,NAB,Business
10-09-2025 12:10,NAB1EBE7E25911B4F7786E2,082-900-001,44444444,SALARY PAYMENT NAB,0,7653.69,280635.34,CR,REF340904,NAB,Business
10-09-2025 12:24,NABDBD899DDEA3D44CBB22D,082-900-001,44444444,JB HI-FI NAB,218.63,0,280416.71,DR,REF508682,NAB,Business
10-09-2025 12:35,NAB65CDA79F786A49AC8CD6,082-900-001,44444444,RAILWAY STATION NAB,321.66,0,280095.05,DR,REF983187,NAB,Business
10-09-2025 12:40,NABCCF72BCBAA7D465C9038,082-900-001,44444444,PAYPAL *NETFLIX NAB,443.52,0,279651.53,DR,REF956440,NAB,Business
10-09-2025 13:40,NABB9A1C85DB84A4C758923,082-900-001,44444444,JB HI-FI NAB,488.78,0,279162.75,DR,REF963930,NAB,Business
10-09-2025 14:11,NAB7B8FE5329317439B982C,082-900-001,44444444,MENULOG NAB,48.25,0,279114.5,DR,REF312954,NAB,Business
10-09-2025 14:51,NAB5F6FCB2AF87645FA9BA2,082-900-001,44444444,MCDONALDS NAB,140.93,0,278973.57,DR,REF621606,NAB,Business
10-09-2025 14:52,INTFC952CA5722649BDA096,082-900-001,44444444,TRANSFER TO ANZ 11111111,445.45,0,278528.12,DR,INT-97764,NAB,Business
10-09-2025 15:01,NAB32476B8394AE4F40834C,082-900-001,44444444,ALDI NAB,242.44,0,278285.68,DR,REF480705,NAB,Business
10-09-2025 15:36,NAB8346288D31514F79A325,082-900-001,44444444,TAFE BOOKSHOP NAB,556.77,0,277728.91,DR,REF358918,NAB,Business
10-09-2025 15:59,INTEE22D8221FCF40899EF9,082-900-001,44444444,TRANSFER FROM ANZ 11111111,0,1501.7,279230.61,CR,INT-48688,NAB,Business
10-09-2025 16:47,NABDB40B00B57794DF2A2BC,082-900-001,44444444,BANK FEE NAB,148.22,0,279082.39,DR,REF156160,NAB,Business
10-09-2025 16:50,NAB8FBA07E3B30A46759246,082-900-001,44444444,WOOLWORTHS NAB,12.13,0,279070.26,DR,REF382062,NAB,Business
10-09-2025 16:59,NABA18A7D8ECB2D4530AF9D,082-900-001,44444444,BP NAB,34.55,0,279035.71,DR,REF539648,NAB,Business
10-09-2025 17:16,NABDD8C36EC0EE7453984EB,082-900-001,44444444,DOMINO'S PIZZA NAB,90.39,0,278945.32,DR,REF269821,NAB,Business
10-09-2025 17:58,NAB6DAE611D7636484D8D4F,082-900-001,44444444,SALARY PAYMENT NAB,0,4665.01,283610.33,CR,REF516176,NAB,Business
10-09-2025 18:24,NAB23232EF06CA94E2F93D3,082-900-001,44444444,SALARY PAYMENT NAB,0,4902.87,288513.2,CR,REF935467,NAB,Business
10-09-2025 18:48,NAB75B6EC7DB1EF492B8B4D,082-900-001,44444444,AMAZON AU NAB,935.7,0,287577.5,DR,REF834747,NAB,Business
10-09-2025 18:48,NABA05F646C5EC345779B99,082-900-001,44444444,BIGW NAB,108.56,0,287468.94,DR,REF240187,NAB,Business
10-09-2025 18:52,NAB26BBBA4EFDFE454B9C27,082-900-001,44444444,PAYPAL *NETFLIX NAB,747.22,0,286721.72,DR,REF236991,NAB,Business
10-09-2025 18:58,NABD1C28FFD5D3C4BC2BC60,082-900-001,44444444,RAILWAY STATION NAB,438.21,0,286283.51,DR,REF547772,NAB,Business
10-09-2025 19:08,NABBEB0100C0B8C4F6C8113,082-900-001,44444444,MCDONALDS NAB,76.33,0,286207.18,DR,REF588032,NAB,Business
10-09-2025 19:20,NAB7E9F669489DF4D31AE29,082-900-001,44444444,APPLE NAB,430.64,0,285776.54,DR,REF484089,NAB,Business
10-09-2025 20:16,NABDB2D6D2F79B24C81ABAD,082-900-001,44444444,ZOOM NAB,186.25,0,285590.29,DR,REF940300,NAB,Business
10-09-2025 20:22,NABC1CAC0BF436F4710843F,082-900-001,44444444,PAYROLL CREDIT NAB,0,6641.77,292232.06,CR,REF838161,NAB,Business
10-09-2025 20:24,NABB26FF58A24754921A296,082-900-001,44444444,UBER EATS NAB,187.29,0,292044.77,DR,REF591302,NAB,Business
10-09-2025 20:28,NABDC83A2274AE14E07A990,082-900-001,44444444,PAYPAL *NETFLIX NAB,188.91,0,291855.86,DR,REF447104,NAB,Business
10-09-2025 20:28,NABE081EF9298D34273B1D1,082-900-001,44444444,MCDONALDS NAB,269.65,0,291586.21,DR,REF439566,NAB,Business
10-09-2025 21:00,NABA50DA50678AF4891AC72,082-900-001,44444444,STARBUCKS NAB,1119.36,0,290466.85,DR,REF885602,NAB,Business
10-09-2025 21:00,NABA21FF0A088824FA3A2FC,082-900-001,44444444,TAFE BOOKSHOP NAB,77.6,0,290389.25,DR,REF843846,NAB,Business
10-09-2025 22:12,NAB17A25887FE8D4682BC15,082-900-001,44444444,WOOLWORTHS NAB,533.2,0,289856.05,DR,REF490507,NAB,Business
10-09-2025 22:18,NAB362F3F4FDD634101B0AF,082-900-001,44444444,COLES NAB,40.56,0,289815.49,DR,REF723860,NAB,Business
10-09-2025 22:21,NAB8FACB09FBA29436BA033,082-900-001,44444444,PAYPAL *NETFLIX NAB,382,0,289433.49,DR,REF944993,NAB,Business
10-09-2025 22:43,NAB429F0DAB4B5F4E47AFD7,082-900-001,44444444,SPOTIFY NAB,302.92,0,289130.57,DR,REF837172,NAB,Business
10-09-2025 22:57,NAB32A85A3496CB47798678,082-900-001,44444444,7-ELEVEN NAB,151.77,0,288978.8,DR,REF989918,NAB,Business
10-09-2025 23:51,NAB2D1FA81DDE754F61AE91,082-900-001,44444444,COMPANY PAYROLL NAB,0,4122.22,293101.02,CR,REF261599,NAB,Business
11-09-2025 00:36,NABF600306C621248D89A1C,082-900-001,44444444,BIGW NAB,326.35,0,292774.67,DR,REF701057,NAB,Business
11-09-2025 00:42,NABEEB7835466CB496ABD99,082-900-001,44444444,PAYPAL *NETFLIX NAB,327.86,0,292446.81,DR,REF656384,NAB,Business
11-09-2025 00:46,NAB06B902EAC74F413DBD11,082-900-001,44444444,BANK FEE NAB,686,0,291760.81,DR,REF401904,NAB,Business
11-09-2025 01:23,NAB48DB59592A73470CA37B,082-900-001,44444444,INTERNET TRANSFER NAB,401.84,0,291358.97,DR,REF885275,NAB,Business
11-09-2025 01:36,NAB0388619C11B84D809B75,082-900-001,44444444,PAYMENT GATEWAY NAB,1171.44,0,290187.53,DR,REF925417,NAB,Business
11-09-2025 02:03,NAB2C70917EE4D445C29742,082-900-001,44444444,PAYPAL *NETFLIX NAB,194.76,0,289992.77,DR,REF475280,NAB,Business
11-09-2025 02:16,NAB6BD53404B6B64039A125,082-900-001,44444444,APPLE NAB,608.22,0,289384.55,DR,REF654121,NAB,Business
11-09-2025 02:25,NABDEF57AF36C934AACB33D,082-900-001,44444444,BANK FEE NAB,512.2,0,288872.35,DR,REF211988,NAB,Business
11-09-2025 02:34,NAB212F42E36B1B433CBFF9,082-900-001,44444444,SPOTIFY NAB,78.58,0,288793.77,DR,REF308425,NAB,Business
11-09-2025 02:43,NABEBE85868BEF74D4C847A,082-900-001,44444444,KFC NAB,234.86,0,288558.91,DR,REF602537,NAB,Business
11-09-2025 02:45,NABC7742EC22FCF40B6ABF7,082-900-001,44444444,PAY - SALARY NAB,0,4245.25,292804.16,CR,REF466697,NAB,Business
11-09-2025 02:55,NAB2ED989E08E694E90926A,082-900-001,44444444,CITYLINK NAB,64.13,0,292740.03,DR,REF619138,NAB,Business
11-09-2025 03:10,NAB22B3FBBE7C8A4D78A99C,082-900-001,44444444,AMAZON AU NAB,81.15,0,292658.88,DR,REF872821,NAB,Business
11-09-2025 03:40,NABF45D3D5BDE9C4E159E32,082-900-001,44444444,HARVEY NORMAN NAB,330.17,0,292328.71,DR,REF579225,NAB,Business
11-09-2025 04:53,NABA8761782D5284FE4B332,082-900-001,44444444,COLES NAB,295.92,0,292032.79,DR,REF415049,NAB,Business
11-09-2025 05:04,NAB4488D0710ABF4AD59E18,082-900-001,44444444,WAGES CREDIT NAB,0,7620.71,299653.5,CR,REF737729,NAB,Business
11-09-2025 05:10,NAB14BF80BA370B4402AF18,082-900-001,44444444,BANK FEE NAB,188.35,0,299465.15,DR,REF679987,NAB,Business
11-09-2025 05:17,NAB66013B3055FA4F9CA1CF,082-900-001,44444444,PAYPAL *NETFLIX NAB,103.57,0,299361.58,DR,REF231650,NAB,Business
11-09-2025 06:21,NAB024FB6E71C47441FB794,082-900-001,44444444,MCDONALDS NAB,257.17,0,299104.41,DR,REF498550,NAB,Business
11-09-2025 07:06,NAB08C7470ED546407C97DA,082-900-001,44444444,INTERNET TRANSFER NAB,683.63,0,298420.78,DR,REF631001,NAB,Business
11-09-2025 07:40,NAB994D2F1C28D84E7EBD9E,082-900-001,44444444,TAFE BOOKSHOP NAB,1653.54,0,296767.24,DR,REF900668,NAB,Business
11-09-2025 07:41,NABF14BB428AAE948B69B71,082-900-001,44444444,STARBUCKS NAB,852.5,0,295914.74,DR,REF669787,NAB,Business
11-09-2025 07:54,NAB98D7F402FF27490CB9E1,082-900-001,44444444,MCDONALDS NAB,11.84,0,295902.9,DR,REF612244,NAB,Business
11-09-2025 08:01,NAB5322C771F3134A068DE4,082-900-001,44444444,ZOOM NAB,142.35,0,295760.55,DR,REF342351,NAB,Business
11-09-2025 08:05,NAB3A30773E94044B8FA9DA,082-900-001,44444444,RAILWAY STATION NAB,710.8,0,295049.75,DR,REF760795,NAB,Business
11-09-2025 08:12,NAB9308526DCB0B47D68611,082-900-001,44444444,BP NAB,47.65,0,295002.1,DR,REF567725,NAB,Business
11-09-2025 08:37,NAB9E92D5AAC9584AD3BA69,082-900-001,44444444,BWS NAB,259.32,0,294742.78,DR,REF158479,NAB,Business
11-09-2025 08:42,NAB7F76B74246234D91A825,082-900-001,44444444,JB HI-FI NAB,664.62,0,294078.16,DR,REF913003,NAB,Business
11-09-2025 09:06,NAB859B50005F1348639885,082-900-001,44444444,WAGES CREDIT NAB,0,2725.57,296803.73,CR,REF339900,NAB,Business
11-09-2025 09:12,NABEB1C6B2D486940F5AE5C,082-900-001,44444444,BANK FEE NAB,250.03,0,296553.7,DR,REF937071,NAB,Business
11-09-2025 09:31,NAB18A67689E83843B690C9,082-900-001,44444444,PAYMENT GATEWAY NAB,460.66,0,296093.04,DR,REF294982,NAB,Business
11-09-2025 09:57,NABECC78DD041B24473ADF3,082-900-001,44444444,STARBUCKS NAB,265.27,0,295827.77,DR,REF236346,NAB,Business
11-09-2025 10:00,NAB369B3E83ED764D398F72,082-900-001,44444444,STARBUCKS NAB,469.33,0,295358.44,DR,REF796923,NAB,Business
11-09-2025 10:12,NABC580EE62C06A4758A55E,082-900-001,44444444,WAGES CREDIT NAB,0,7591.3,302949.74,CR,REF165340,NAB,Business
11-09-2025 10:32,NABD681422376804562B326,082-900-001,44444444,JB HI-FI NAB,598.33,0,302351.41,DR,REF600949,NAB,Business
11-09-2025 10:34,NAB0F78B02D33234028B668,082-900-001,44444444,COMPANY PAYROLL NAB,0,1810.99,304162.4,CR,REF354092,NAB,Business
11-09-2025 10:52,NABCFEF45DAB5D14CF4A6D0,082-900-001,44444444,BIGW NAB,121.17,0,304041.23,DR,REF940680,NAB,Business
11-09-2025 11:19,INT4DBA8133888048DCB131,082-900-001,44444444,TRANSFER TO CBA 22222222,866.32,0,303174.91,DR,INT-88593,NAB,Business
11-09-2025 11:33,NABA5D53CD46A43415C9226,082-900-001,44444444,BANK FEE NAB,228.7,0,302946.21,DR,REF863623,NAB,Business
11-09-2025 11:53,NABC0AA91FB283046B98B0D,082-900-001,44444444,STARBUCKS NAB,1145.52,0,301800.69,DR,REF367750,NAB,Business
11-09-2025 12:17,NAB15A82962BC214C218E36,082-900-001,44444444,RAILWAY STATION NAB,533.13,0,301267.56,DR,REF216782,NAB,Business
11-09-2025 12:57,NAB9BC47806769047EFBE22,082-900-001,44444444,BIGW NAB,364.88,0,300902.68,DR,REF665294,NAB,Business
11-09-2025 13:00,NABCD65E96CCEDD4202AD6D,082-900-001,44444444,KFC NAB,101.57,0,300801.11,DR,REF470353,NAB,Business
11-09-2025 13:10,NABF82E38A136584431BBC0,082-900-001,44444444,COLES NAB,291.46,0,300509.65,DR,REF393425,NAB,Business
11-09-2025 13:10,NABC477C00B6B5A412CAB03,082-900-001,44444444,PAYMENT GATEWAY NAB,373.21,0,300136.44,DR,REF629800,NAB,Business
11-09-2025 13:11,NAB68DA418228BE4D84BA65,082-900-001,44444444,SALARY PAYMENT NAB,0,5621.08,305757.52,CR,REF617340,NAB,Business
11-09-2025 13:40,INTA771E9214B894DFD8BE8,082-900-001,44444444,TRANSFER TO ANZ 11111111,303.05,0,305454.47,DR,INT-66474,NAB,Business
11-09-2025 13:58,NABF42DC858993E4FDCBBA6,082-900-001,44444444,ALDI NAB,450.28,0,305004.19,DR,REF824240,NAB,Business
11-09-2025 14:08,NABB4953D541F974F6A8823,082-900-001,44444444,UBER EATS NAB,421.26,0,304582.93,DR,REF169360,NAB,Business
11-09-2025 14:34,NABAB8190EE06F648768053,082-900-001,44444444,FLIXBUS NAB,187.59,0,304395.34,DR,REF492666,NAB,Business
11-09-2025 14:53,NAB37FB5F7A035546EF80FA,082-900-001,44444444,BP NAB,288.27,0,304107.07,DR,REF322056,NAB,Business
11-09-2025 15:12,NABFBC3DF5B8DC64E03A52E,082-900-001,44444444,SPOTIFY NAB,266.91,0,303840.16,DR,REF428673,NAB,Business
11-09-2025 15:28,NABE6419C98ECB04949BC34,082-900-001,44444444,STARBUCKS NAB,447.4,0,303392.76,DR,REF787826,NAB,Business
11-09-2025 15:43,NAB49E3F05DDE7B48349A5F,082-900-001,44444444,ALDI NAB,137.33,0,303255.43,DR,REF629637,NAB,Business
11-09-2025 15:43,NABB45C861479664BB6ACC3,082-900-001,44444444,PAY - SALARY NAB,0,6013.16,309268.59,CR,REF523821,NAB,Business
11-09-2025 15:58,NAB4C5AA220B43140119A30,082-900-001,44444444,APPLE NAB,282.78,0,308985.81,DR,REF822616,NAB,Business
11-09-2025 16:16,NAB0C2336BCC35048E78F58,082-900-001,44444444,BWS NAB,178.29,0,308807.52,DR,REF251155,NAB,Business
11-09-2025 16:41,NABD25DA6EB9BCC45B4BB44,082-900-001,44444444,KFC NAB,32.13,0,308775.39,DR,REF104437,NAB,Business
11-09-2025 16:47,NAB22DD1DC78BEF457CB2A9,082-900-001,44444444,PAYROLL CREDIT NAB,0,6965.62,315741.01,CR,REF243118,NAB,Business
11-09-2025 17:08,NABB5360A9DD12E43A788FE,082-900-001,44444444,ALDI NAB,508.03,0,315232.98,DR,REF835859,NAB,Business
11-09-2025 17:08,NABD091A8B6D0524C9A86E6,082-900-001,44444444,BP NAB,530.86,0,314702.12,DR,REF586273,NAB,Business
11-09-2025 17:30,NAB3D99180FB1CB4E08A574,082-900-001,44444444,RAILWAY STATION NAB,100.07,0,314602.05,DR,REF451543,NAB,Business
11-09-2025 17:34,INT98A080CDB10E43A682E5,082-900-001,44444444,TRANSFER TO CBA 22222222,266.11,0,314335.94,DR,INT-71677,NAB,Business
11-09-2025 17:35,NABE7BA0544B46D4ECCA55D,082-900-001,44444444,WOOLWORTHS NAB,177.58,0,314158.36,DR,REF787359,NAB,Business
11-09-2025 18:11,NAB153E999BD33D4D728084,082-900-001,44444444,ALDI NAB,157.31,0,314001.05,DR,REF662882,NAB,Business
11-09-2025 18:21,NABD6BD61169AC949BAB216,082-900-001,44444444,APPLE NAB,167.1,0,313833.95,DR,REF412378,NAB,Business
11-09-2025 18:25,NABE112E8A441654BDF893A,082-900-001,44444444,COMPANY PAYROLL NAB,0,4479.13,318313.08,CR,REF344869,NAB,Business
11-09-2025 19:02,INTABCCC3DB9D3640E7BEBE,082-900-001,44444444,TRANSFER FROM CBA 33333333,0,1916.24,320229.32,CR,INT-91431,NAB,Business
11-09-2025 19:21,NABCE063AA6B6D2465C8211,082-900-001,44444444,PAYROLL CREDIT NAB,0,88.69,320318.01,CR,REF296561,NAB,Business
11-09-2025 19:49,NAB46CF53FF888E444AB220,082-900-001,44444444,BWS NAB,44.17,0,320273.84,DR,REF441844,NAB,Business
11-09-2025 20:02,NAB65A7DFCD2A0F4927BD18,082-900-001,44444444,RAILWAY STATION NAB,459.66,0,319814.18,DR,REF914894,NAB,Business
11-09-2025 20:26,NAB4E2FFE26CC544C7D87FF,082-900-001,44444444,STARBUCKS NAB,943.32,0,318870.86,DR,REF673284,NAB,Business
11-09-2025 20:29,NAB01A330B53FF445749FB9,082-900-001,44444444,MENULOG NAB,106.12,0,318764.74,DR,REF160324,NAB,Business
11-09-2025 20:34,NABC2E0B382C72440CBAD6C,082-900-001,44444444,MCDONALDS NAB,373.1,0,318391.64,DR,REF237727,NAB,Business
11-09-2025 21:12,NAB573A03B11E5D4895A602,082-900-001,44444444,SPOTIFY NAB,398.32,0,317993.32,DR,REF898183,NAB,Business
11-09-2025 21:20,NAB6B61C50FAAA7477E8348,082-900-001,44444444,SHELL NAB,424.21,0,317569.11,DR,REF297581,NAB,Business
11-09-2025 21:33,NAB026198BD773740578672,082-900-001,44444444,SHELL NAB,109.92,0,317459.19,DR,REF491261,NAB,Business
11-09-2025 21:34,NAB69CD822162EF4C998A9C,082-900-001,44444444,DOMINO'S PIZZA NAB,476.89,0,316982.3,DR,REF920807,NAB,Business
11-09-2025 21:47,NAB421EA9EB9D9E49F0B2B3,082-900-001,44444444,BP NAB,444.45,0,316537.85,DR,REF239680,NAB,Business
11-09-2025 21:50,NABD92E3AC4CC20412B8713,082-900-001,44444444,KFC NAB,1276.29,0,315261.56,DR,REF402145,NAB,Business
11-09-2025 21:59,NAB4777DD1B9CA34184A482,082-900-001,44444444,BWS NAB,466.82,0,314794.74,DR,REF200363,NAB,Business
11-09-2025 22:07,NAB585FF92E830843B9BC87,082-900-001,44444444,ALDI NAB,883.76,0,313910.98,DR,REF760243,NAB,Business
11-09-2025 22:15,NABD1F728904CE24FF0BA7C,082-900-001,44444444,SHELL NAB,832.68,0,313078.3,DR,REF122262,NAB,Business
11-09-2025 22:45,NABBD1E0FF8CA57490498F4,082-900-001,44444444,MENULOG NAB,329.34,0,312748.96,DR,REF702831,NAB,Business
11-09-2025 23:09,NABFAB849C3DB9048D5BE4E,082-900-001,44444444,CITYLINK NAB,280.95,0,312468.01,DR,REF737092,NAB,Business
12-09-2025 00:15,NAB418CD86B656142039593,082-900-001,44444444,ALDI NAB,54.37,0,312413.64,DR,REF786884,NAB,Business
12-09-2025 00:22,NAB2FE8AD5F82164F3AB4ED,082-900-001,44444444,UBER EATS NAB,60.07,0,312353.57,DR,REF346753,NAB,Business
12-09-2025 00:43,NABA3F84916303C47AC9FB2,082-900-001,44444444,COLES NAB,133.85,0,312219.72,DR,REF643423,NAB,Business
12-09-2025 01:30,NAB7C74EFD824284F0C9425,082-900-001,44444444,PAYROLL CREDIT NAB,0,5663.79,317883.51,CR,REF672894,NAB,Business
12-09-2025 01:41,NABB2987E9701864C7C8C1F,082-900-001,44444444,MENULOG NAB,339.54,0,317543.97,DR,REF204768,NAB,Business
12-09-2025 01:48,NAB0560876E8D214D6AB106,082-900-001,44444444,DOMINO'S PIZZA NAB,288.27,0,317255.7,DR,REF593394,NAB,Business
12-09-2025 01:54,NABF3A0E2EFEF6E446D8A26,082-900-001,44444444,PAY - SALARY NAB,0,7068.88,324324.58,CR,REF850965,NAB,Business
12-09-2025 02:47,NAB0AD062DF648F42988ADF,082-900-001,44444444,JB HI-FI NAB,226.93,0,324097.65,DR,REF231334,NAB,Business
12-09-2025 03:21,NAB0A2DF6F1849E442BA753,082-900-001,44444444,MENULOG NAB,652.28,0,323445.37,DR,REF936105,NAB,Business
12-09-2025 03:40,NAB91112A1DD29D458C9FE8,082-900-001,44444444,7-ELEVEN NAB,161.97,0,323283.4,DR,REF832836,NAB,Business
12-09-2025 03:48,NABC8FC132018994DA084A4,082-900-001,44444444,INTERNET TRANSFER NAB,146.71,0,323136.69,DR,REF958094,NAB,Business
12-09-2025 03:50,NABAB9073AE3F3942E18E33,082-900-001,44444444,WAGES CREDIT NAB,0,184.32,323321.01,CR,REF147104,NAB,Business
12-09-2025 04:03,NABD5035749BDF448BDAFA9,082-900-001,44444444,BWS NAB,760.01,0,322561,DR,REF146731,NAB,Business
12-09-2025 04:43,NAB9507AD12AC884617A4C5,082-900-001,44444444,BWS NAB,89.14,0,322471.86,DR,REF652519,NAB,Business
12-09-2025 05:06,NAB8504A5A5F6BE4E54B1D5,082-900-001,44444444,WAGES CREDIT NAB,0,4079.19,326551.05,CR,REF310671,NAB,Business
12-09-2025 05:37,NABBC623C9EB59E4F82B6BC,082-900-001,44444444,AMAZON AU NAB,452.33,0,326098.72,DR,REF280739,NAB,Business
12-09-2025 06:11,NABD156087DC42B474DBA57,082-900-001,44444444,STARBUCKS NAB,226.45,0,325872.27,DR,REF493418,NAB,Business
12-09-2025 06:25,INT1B1B7856C42B4CE4A37C,082-900-001,44444444,TRANSFER FROM CBA 33333333,0,103.87,325976.14,CR,INT-10439,NAB,Business
12-09-2025 07:06,NABF8385CE0E9174B7BA8CF,082-900-001,44444444,ZOOM NAB,150.23,0,325825.91,DR,REF285454,NAB,Business
12-09-2025 07:08,NAB358D7FB77333474FBCCE,082-900-001,44444444,SALARY PAYMENT NAB,0,3525.38,329351.29,CR,REF391962,NAB,Business
12-09-2025 07:26,NABA3431EB864D24F9EA72D,082-900-001,44444444,MCDONALDS NAB,203.88,0,329147.41,DR,REF564292,NAB,Business
12-09-2025 08:05,NAB68D13DB309144A0D825D,082-900-001,44444444,HARVEY NORMAN NAB,555.13,0,328592.28,DR,REF320655,NAB,Business
12-09-2025 08:31,NABAC8587FF3D714498817C,082-900-001,44444444,APPLE NAB,85.99,0,328506.29,DR,REF960029,NAB,Business
12-09-2025 08:46,NAB5F319B7BC2FE45778E57,082-900-001,44444444,HARVEY NORMAN NAB,367.8,0,328138.49,DR,REF982908,NAB,Business
12-09-2025 09:17,NABD48913FF8CBB4E0689AE,082-900-001,44444444,BP NAB,170.68,0,327967.81,DR,REF847364,NAB,Business
12-09-2025 09:17,NABEED103D541D449698429,082-900-001,44444444,BP NAB,64.18,0,327903.63,DR,REF416771,NAB,Business
12-09-2025 09:24,NAB5410C74EED86434196E0,082-900-001,44444444,MCDONALDS NAB,108.28,0,327795.35,DR,REF674179,NAB,Business
12-09-2025 09:28,NAB080C40B0E58344359959,082-900-001,44444444,FLIXBUS NAB,275.52,0,327519.83,DR,REF214978,NAB,Business
12-09-2025 09:31,NABA96202C2E7574AA781A8,082-900-001,44444444,COLES NAB,126.16,0,327393.67,DR,REF479894,NAB,Business
12-09-2025 09:39,NAB9CA2B0DDA596446888F4,082-900-001,44444444,STARBUCKS NAB,270.13,0,327123.54,DR,REF834825,NAB,Business
12-09-2025 10:12,NABFD2C5CC3D4F447A6AF3F,082-900-001,44444444,BWS NAB,414.77,0,326708.77,DR,REF622509,NAB,Business
12-09-2025 10:15,NAB0065211C39334137B87D,082-900-001,44444444,BP NAB,187.14,0,326521.63,DR,REF226783,NAB,Business
12-09-2025 10:28,NAB34CDA9D366D243CD808D,082-900-001,44444444,ZOOM NAB,961.71,0,325559.92,DR,REF549341,NAB,Business
12-09-2025 10:46,NAB62A63BC7E2BB48CDA964,082-900-001,44444444,COLES NAB,78.48,0,325481.44,DR,REF607763,NAB,Business
12-09-2025 10:51,NAB9FD33694391643EF99FB,082-900-001,44444444,PAYPAL *NETFLIX NAB,68.23,0,325413.21,DR,REF265645,NAB,Business
12-09-2025 10:57,NAB177D7AF8C30C48F887A3,082-900-001,44444444,7-ELEVEN NAB,721.53,0,324691.68,DR,REF627826,NAB,Business
12-09-2025 11:14,NAB740CA48A03B449C0ADF7,082-900-001,44444444,MCDONALDS NAB,143.65,0,324548.03,DR,REF681910,NAB,Business
12-09-2025 11:47,NABD5F1B68401194DCF9AA1,082-900-001,44444444,BWS NAB,369.94,0,324178.09,DR,REF155650,NAB,Business
12-09-2025 11:48,NAB4F8BB5626D6E4D36BC4E,082-900-001,44444444,PAY - SALARY NAB,0,7834.58,332012.67,CR,REF297860,NAB,Business
12-09-2025 11:48,NABA402E2B07AE544DF9215,082-900-001,44444444,KFC NAB,274.24,0,331738.43,DR,REF887229,NAB,Business
12-09-2025 12:02,NABF5AD4B92D3B84693884E,082-900-001,44444444,SALARY PAYMENT NAB,0,4116.68,335855.11,CR,REF195441,NAB,Business
12-09-2025 12:35,NAB14CFEA3926124B819485,082-900-001,44444444,RAILWAY STATION NAB,950.84,0,334904.27,DR,REF442890,NAB,Business
12-09-2025 12:45,NABA1343E1ABE404155BBCC,082-900-001,44444444,MENULOG NAB,392.73,0,334511.54,DR,REF940166,NAB,Business
12-09-2025 12:53,NAB5177FAAC06A449789DFF,082-900-001,44444444,BIGW NAB,181.36,0,334330.18,DR,REF975804,NAB,Business
12-09-2025 13:19,NABA2871A30BE354D8F8F1D,082-900-001,44444444,BWS NAB,65.62,0,334264.56,DR,REF454902,NAB,Business
12-09-2025 13:34,NABE5B23BB8833744E59D0A,082-900-001,44444444,BANK FEE NAB,304.18,0,333960.38,DR,REF407705,NAB,Business
12-09-2025 13:49,NAB8791AE5580A1495EB6F1,082-900-001,44444444,PAYPAL *NETFLIX NAB,1359.16,0,332601.22,DR,REF667713,NAB,Business
12-09-2025 14:04,NABD1A21C033CB2451FB942,082-900-001,44444444,7-ELEVEN NAB,374.43,0,332226.79,DR,REF684946,NAB,Business
12-09-2025 14:05,INT59387A1E262E4F7BB8E3,082-900-001,44444444,TRANSFER FROM CBA 33333333,0,759.95,332986.74,CR,INT-31897,NAB,Business
12-09-2025 14:21,NAB20FBC8C1E4534DA6BD57,082-900-001,44444444,LIQUORLAND NAB,211.66,0,332775.08,DR,REF323537,NAB,Business
12-09-2025 14:23,NAB769DA971892B404C9AF9,082-900-001,44444444,TAFE BOOKSHOP NAB,367.01,0,332408.07,DR,REF762317,NAB,Business
12-09-2025 14:35,NABFC7C0B9E8F8A4B7B8A99,082-900-001,44444444,SPOTIFY NAB,279.99,0,332128.08,DR,REF347778,NAB,Business
12-09-2025 14:42,NAB3F280747316B47F7B9D2,082-900-001,44444444,APPLE NAB,108.98,0,332019.1,DR,REF508459,NAB,Business
12-09-2025 15:17,NAB427088AC031F40FCBA42,082-900-001,44444444,HARVEY NORMAN NAB,284.05,0,331735.05,DR,REF426802,NAB,Business
12-09-2025 15:39,NAB79AF46B25278478D9779,082-900-001,44444444,JB HI-FI NAB,344.34,0,331390.71,DR,REF261009,NAB,Business
12-09-2025 15:40,NABDFCE44340E03426E834D,082-900-001,44444444,BWS NAB,281.61,0,331109.1,DR,REF904258,NAB,Business
12-09-2025 16:08,NABBCDBACC5561649A585F8,082-900-001,44444444,BANK FEE NAB,84.65,0,331024.45,DR,REF292296,NAB,Business
12-09-2025 16:24,NABEB47D4D1D5C3449FAEBC,082-900-001,44444444,COLES NAB,116.68,0,330907.77,DR,REF787037,NAB,Business
12-09-2025 16:50,NAB9A2BF7A1C01F47D2AF88,082-900-001,44444444,KFC NAB,631.7,0,330276.07,DR,REF216680,NAB,Business
12-09-2025 17:05,NAB7564582A030D4716BFF9,082-900-001,44444444,WOOLWORTHS NAB,54.71,0,330221.36,DR,REF236371,NAB,Business
12-09-2025 17:40,NAB78DCF913FB8346E0A889,082-900-001,44444444,PAYPAL *NETFLIX NAB,646.9,0,329574.46,DR,REF560510,NAB,Business
12-09-2025 17:52,NABCAF6C44EA8864A54B11B,082-900-001,44444444,JB HI-FI NAB,305.78,0,329268.68,DR,REF537623,NAB,Business
12-09-2025 18:25,NAB9DE776DF340D473FB43A,082-900-001,44444444,CITYLINK NAB,237.92,0,329030.76,DR,REF981851,NAB,Business
12-09-2025 18:33,NABF6069C3C12CB428D8922,082-900-001,44444444,BANK FEE NAB,53.89,0,328976.87,DR,REF847627,NAB,Business
12-09-2025 18:50,NAB7B910C8E6192410DB0DA,082-900-001,44444444,WAGES CREDIT NAB,0,2506.71,331483.58,CR,REF965181,NAB,Business
12-09-2025 18:58,NAB9C4747B9FFC94B53A19A,082-900-001,44444444,SHELL NAB,137.72,0,331345.86,DR,REF449373,NAB,Business
12-09-2025 19:23,NABA568CAA235D94433B123,082-900-001,44444444,7-ELEVEN NAB,58.81,0,331287.05,DR,REF681682,NAB,Business
12-09-2025 19:24,NABD0A582D95B7C4D298C33,082-900-001,44444444,7-ELEVEN NAB,482.49,0,330804.56,DR,REF979763,NAB,Business
12-09-2025 19:50,NAB1F0D7D2405A247BCB466,082-900-001,44444444,ZOOM NAB,1973.35,0,328831.21,DR,REF735037,NAB,Business
12-09-2025 20:19,NAB282B99AB4A304DE38EAA,082-900-001,44444444,LIQUORLAND NAB,84.39,0,328746.82,DR,REF508722,NAB,Business
12-09-2025 20:41,NAB44D9C21EF5B04A739B31,082-900-001,44444444,BIGW NAB,725.43,0,328021.39,DR,REF160027,NAB,Business
12-09-2025 20:41,INTD30D121A653E49F2986A,082-900-001,44444444,TRANSFER FROM ANZ 11111111,0,911.67,328933.06,CR,INT-41386,NAB,Business
12-09-2025 21:00,NAB6E7B56EC4BA245DFB768,082-900-001,44444444,HARVEY NORMAN NAB,199.22,0,328733.84,DR,REF197013,NAB,Business
12-09-2025 21:05,NAB676C7A7790574F468FD0,082-900-001,44444444,KFC NAB,42.42,0,328691.42,DR,REF862578,NAB,Business
12-09-2025 21:06,NAB1F268B1B96934E5F822F,082-900-001,44444444,APPLE NAB,490.17,0,328201.25,DR,REF734442,NAB,Business
12-09-2025 22:06,NABC2E9E255423A4C16A48A,082-900-001,44444444,INTERNET TRANSFER NAB,271.14,0,327930.11,DR,REF610344,NAB,Business
12-09-2025 22:16,NAB6628430184DC4FA5801E,082-900-001,44444444,KFC NAB,71.15,0,327858.96,DR,REF603927,NAB,Business
12-09-2025 22:38,INTDE1CBC64A6AB42B18747,082-900-001,44444444,TRANSFER TO CBA 33333333,1665.48,0,326193.48,DR,INT-88005,NAB,Business
12-09-2025 22:49,NABD3F37D9F572C4B53A93E,082-900-001,44444444,WOOLWORTHS NAB,390.89,0,325802.59,DR,REF847704,NAB,Business
12-09-2025 23:38,NAB0A63571260B247089F28,082-900-001,44444444,PAYMENT GATEWAY NAB,1125.35,0,324677.24,DR,REF589582,NAB,Business
12-09-2025 23:48,NABD3738E6D05634813BD37,082-900-001,44444444,JB HI-FI NAB,248.83,0,324428.41,DR,REF864105,NAB,Business
12-09-2025 23:51,NABC6C1C2B4904841C6BFAC,082-900-001,44444444,BP NAB,45.53,0,324382.88,DR,REF767319,NAB,Business
12-09-2025 23:52,NAB2795BEC3706C45C1BD83,082-900-001,44444444,COMPANY PAYROLL NAB,0,3242.53,327625.41,CR,REF767285,NAB,Business
13-09-2025 00:16,NAB3BED50FD1991480696BB,082-900-001,44444444,FLIXBUS NAB,73.07,0,327552.34,DR,REF388028,NAB,Business
13-09-2025 00:38,NAB304395E4945D499FAD4F,082-900-001,44444444,SALARY PAYMENT NAB,0,516.66,328069,CR,REF147675,NAB,Business
13-09-2025 00:45,NAB9B566D6BD799408086C0,082-900-001,44444444,ZOOM NAB,82.14,0,327986.86,DR,REF255000,NAB,Business
13-09-2025 01:01,NAB82D45A55A48742838A38,082-900-001,44444444,BP NAB,161.67,0,327825.19,DR,REF147981,NAB,Business
13-09-2025 01:21,NABE6FFBAFF98D244E684A6,082-900-001,44444444,BIGW NAB,260.31,0,327564.88,DR,REF762322,NAB,Business
13-09-2025 01:30,NAB5296AAE344BC487C833A,082-900-001,44444444,FLIXBUS NAB,40.58,0,327524.3,DR,REF386650,NAB,Business
13-09-2025 02:05,NAB1276AC7837EF44C1B3D1,082-900-001,44444444,BANK FEE NAB,1361.76,0,326162.54,DR,REF244449,NAB,Business
13-09-2025 03:01,NABD5BDE4848406447BB1E9,082-900-001,44444444,COMPANY PAYROLL NAB,0,2651.47,328814.01,CR,REF951232,NAB,Business
13-09-2025 03:34,NAB846A6F20E8B54CF49C87,082-900-001,44444444,ZOOM NAB,413.51,0,328400.5,DR,REF695070,NAB,Business
13-09-2025 03:53,NAB57496F8F75484358B1AE,082-900-001,44444444,STARBUCKS NAB,479.77,0,327920.73,DR,REF124657,NAB,Business
13-09-2025 03:55,INTC773208DBB9D4BA3A0EE,082-900-001,44444444,TRANSFER FROM CBA 22222222,0,1922.18,329842.91,CR,INT-13561,NAB,Business
13-09-2025 03:57,NAB2DDF4B74226C47F699AD,082-900-001,44444444,SALARY PAYMENT NAB,0,488.64,330331.55,CR,REF816679,NAB,Business
13-09-2025 04:11,NAB7A0BB65DF3CD410B9A3D,082-900-001,44444444,MENULOG NAB,250.72,0,330080.83,DR,REF715309,NAB,Business
13-09-2025 04:28,NABB6BCB9E578764F699B42,082-900-001,44444444,ALDI NAB,326.39,0,329754.44,DR,REF896301,NAB,Business
13-09-2025 05:07,NAB8C8B52AF95C142FE988A,082-900-001,44444444,AMAZON AU NAB,323.19,0,329431.25,DR,REF238855,NAB,Business
13-09-2025 05:20,NABC1D352EA2163483F93E5,082-900-001,44444444,SHELL NAB,422.5,0,329008.75,DR,REF857509,NAB,Business
13-09-2025 05:53,NAB3392C50143FB4DABB118,082-900-001,44444444,PAYROLL CREDIT NAB,0,794.46,329803.21,CR,REF860810,NAB,Business
13-09-2025 05:59,NAB9D2C994BDE4748218E86,082-900-001,44444444,ALDI NAB,105.08,0,329698.13,DR,REF494998,NAB,Business
13-09-2025 05:59,NABC58A80C3C0A1421DB6E1,082-900-001,44444444,CITYLINK NAB,52.22,0,329645.91,DR,REF751589,NAB,Business
13-09-2025 06:19,NAB25B77F2BD2474E008126,082-900-001,44444444,INTERNET TRANSFER NAB,781.68,0,328864.23,DR,REF614167,NAB,Business
13-09-2025 06:45,NAB61BD35F6CAF94D509470,082-900-001,44444444,PAYROLL CREDIT NAB,0,607.07,329471.3,CR,REF697384,NAB,Business
13-09-2025 07:07,NAB48CCE77557324B02BA40,082-900-001,44444444,WOOLWORTHS NAB,60.01,0,329411.29,DR,REF841591,NAB,Business
13-09-2025 07:52,NAB151C0EB36F304DC79389,082-900-001,44444444,PAYPAL *NETFLIX NAB,556.95,0,328854.34,DR,REF732647,NAB,Business
13-09-2025 08:03,NAB7F18E1884C8C4404B398,082-900-001,44444444,MENULOG NAB,751.27,0,328103.07,DR,REF116559,NAB,Business
13-09-2025 08:09,NAB5390D96DACB34B3B9E68,082-900-001,44444444,APPLE NAB,219.78,0,327883.29,DR,REF649865,NAB,Business
13-09-2025 08:17,NABFEDBF6869D5C46A0AEBF,082-900-001,44444444,SALARY PAYMENT NAB,0,6839.35,334722.64,CR,REF307277,NAB,Business
13-09-2025 08:27,NABEA0D6FDD0C8747E78ECE,082-900-001,44444444,SALARY PAYMENT NAB,0,5636.66,340359.3,CR,REF548318,NAB,Business
13-09-2025 08:42,NAB44D6373B00354027A18A,082-900-001,44444444,TAFE BOOKSHOP NAB,127.53,0,340231.77,DR,REF659407,NAB,Business
13-09-2025 08:56,NABA3291AAAD011433B8BAF,082-900-001,44444444,STARBUCKS NAB,156.94,0,340074.83,DR,REF506322,NAB,Business
13-09-2025 09:57,NAB6AC7CDE223E147F1965B,082-900-001,44444444,WAGES CREDIT NAB,0,6656.73,346731.56,CR,REF710606,NAB,Business
13-09-2025 10:34,NABDD337BC8F463460093FE,082-900-001,44444444,HARVEY NORMAN NAB,781.26,0,345950.3,DR,REF275156,NAB,Business
13-09-2025 11:17,NABB52CC2D65A2145FE9279,082-900-001,44444444,CITYLINK NAB,61.97,0,345888.33,DR,REF518983,NAB,Business
13-09-2025 11:39,NAB5D21733D1C7B45FCB799,082-900-001,44444444,SHELL NAB,132.99,0,345755.34,DR,REF721101,NAB,Business
13-09-2025 12:03,NAB922760E707A141D38782,082-900-001,44444444,ALDI NAB,26.16,0,345729.18,DR,REF858497,NAB,Business
13-09-2025 12:07,NAB3E128188814841DA935E,082-900-001,44444444,PAY - SALARY NAB,0,5555.24,351284.42,CR,REF792674,NAB,Business
13-09-2025 12:12,NAB7E23DA47DC62446D8ABD,082-900-001,44444444,BP NAB,480.87,0,350803.55,DR,REF251291,NAB,Business
13-09-2025 12:21,INT975DA84A66E54FA2905B,082-900-001,44444444,TRANSFER FROM CBA 33333333,0,1495.17,352298.72,CR,INT-91530,NAB,Business
13-09-2025 12:33,NAB6DD17529DD434FA5A179,082-900-001,44444444,PAY - SALARY NAB,0,7812.96,360111.68,CR,REF430700,NAB,Business
13-09-2025 12:44,NABC869EE20FC3F4F5B9189,082-900-001,44444444,LIQUORLAND NAB,87.55,0,360024.13,DR,REF674462,NAB,Business
13-09-2025 12:53,NABA367DA90579C4CDCACA1,082-900-001,44444444,WAGES CREDIT NAB,0,7418.11,367442.24,CR,REF471512,NAB,Business
13-09-2025 12:55,NAB220902A7854C4BFF8EEF,082-900-001,44444444,RAILWAY STATION NAB,84.12,0,367358.12,DR,REF569094,NAB,Business
13-09-2025 13:19,NAB6F37C7AC35184B1389C7,082-900-001,44444444,MENULOG NAB,967.56,0,366390.56,DR,REF637414,NAB,Business
13-09-2025 13:33,NAB5BFE921C0D7D491D95DD,082-900-001,44444444,FLIXBUS NAB,223.65,0,366166.91,DR,REF623825,NAB,Business
13-09-2025 14:03,NAB24038BE6970640908C9C,082-900-001,44444444,APPLE NAB,117.12,0,366049.79,DR,REF214511,NAB,Business
13-09-2025 14:10,NAB8899966B5BF64CCF9F57,082-900-001,44444444,7-ELEVEN NAB,331.49,0,365718.3,DR,REF537910,NAB,Business
13-09-2025 14:27,NAB18544BDCB2924216A121,082-900-001,44444444,SALARY PAYMENT NAB,0,6622.25,372340.55,CR,REF706702,NAB,Business
13-09-2025 14:27,NABE2D8B67B6B0B404C925B,082-900-001,44444444,SHELL NAB,36.63,0,372303.92,DR,REF771969,NAB,Business
13-09-2025 14:52,NAB864D44F8BFBA441EB7F6,082-900-001,44444444,STARBUCKS NAB,264.56,0,372039.36,DR,REF733883,NAB,Business
13-09-2025 14:59,NABCE959BE7AA0E4FA3B725,082-900-001,44444444,WOOLWORTHS NAB,236.31,0,371803.05,DR,REF297863,NAB,Business
13-09-2025 15:07,NABA9C5A88A007E49F6A122,082-900-001,44444444,7-ELEVEN NAB,167.35,0,371635.7,DR,REF481680,NAB,Business
13-09-2025 15:12,INT90D3F508BC414092A905,082-900-001,44444444,TRANSFER FROM CBA 33333333,0,543.67,372179.37,CR,INT-63551,NAB,Business
13-09-2025 15:36,NAB882E8DDFE7E44AA6AB8D,082-900-001,44444444,LIQUORLAND NAB,65.16,0,372114.21,DR,REF633182,NAB,Business
13-09-2025 15:56,NABF136E9DA56A04824A604,082-900-001,44444444,INTERNET TRANSFER NAB,161.42,0,371952.79,DR,REF563141,NAB,Business
13-09-2025 16:15,NAB966AA95FDBDA4943AADB,082-900-001,44444444,CITYLINK NAB,191.01,0,371761.78,DR,REF953831,NAB,Business
13-09-2025 16:22,NABDF6368AB4D9D4CA386CD,082-900-001,44444444,ZOOM NAB,125.12,0,371636.66,DR,REF511789,NAB,Business
13-09-2025 17:06,NAB7F2F9D4DC36241BCBD9E,082-900-001,44444444,SPOTIFY NAB,64.08,0,371572.58,DR,REF139908,NAB,Business
13-09-2025 17:56,NAB94BD4D4A3CC04F2CB081,082-900-001,44444444,COMPANY PAYROLL NAB,0,246.02,371818.6,CR,REF476974,NAB,Business
13-09-2025 18:15,NAB99CF1BBA563C4D5DA6B5,082-900-001,44444444,SHELL NAB,282.19,0,371536.41,DR,REF877436,NAB,Business
13-09-2025 18:23,NAB48A9DA9E3E3C4606B8DE,082-900-001,44444444,BIGW NAB,183.82,0,371352.59,DR,REF705211,NAB,Business
13-09-2025 18:47,NABFC04769982BE4326BCE9,082-900-001,44444444,UBER EATS NAB,355.48,0,370997.11,DR,REF848700,NAB,Business
13-09-2025 18:59,NAB37CFEBBE2E1043B78AC4,082-900-001,44444444,JB HI-FI NAB,44.43,0,370952.68,DR,REF645193,NAB,Business
13-09-2025 19:01,NABD7543F086A0649C1AD6A,082-900-001,44444444,CITYLINK NAB,246.5,0,370706.18,DR,REF902301,NAB,Business
13-09-2025 19:52,NAB88764164480D4595995F,082-900-001,44444444,BANK FEE NAB,65.79,0,370640.39,DR,REF312093,NAB,Business
13-09-2025 19:53,INT67643B59EB184B54A8D1,082-900-001,44444444,TRANSFER TO ANZ 11111111,972.85,0,369667.54,DR,INT-10969,NAB,Business
13-09-2025 20:13,NAB9F06C8A4BA234960A394,082-900-001,44444444,BWS NAB,177.9,0,369489.64,DR,REF142139,NAB,Business
13-09-2025 20:13,NABDD9C027983B24A48B3DE,082-900-001,44444444,BWS NAB,72.06,0,369417.58,DR,REF141962,NAB,Business
13-09-2025 20:16,NABC1B14D89025F4BD282C3,082-900-001,44444444,WAGES CREDIT NAB,0,5282.63,374700.21,CR,REF238883,NAB,Business
13-09-2025 20:41,NAB33C65F48B5F84562B4BD,082-900-001,44444444,CITYLINK NAB,149.06,0,374551.15,DR,REF925953,NAB,Business
13-09-2025 20:48,NAB7A69F1BE2E264F7991EA,082-900-001,44444444,DOMINO'S PIZZA NAB,557.3,0,373993.85,DR,REF506552,NAB,Business
13-09-2025 20:58,NABE4BDF8A6070142C8A863,082-900-001,44444444,PAYMENT GATEWAY NAB,328.71,0,373665.14,DR,REF246027,NAB,Business
13-09-2025 21:08,NABDCF9B0EB8ABA423594A8,082-900-001,44444444,ALDI NAB,411.51,0,373253.63,DR,REF571774,NAB,Business
13-09-2025 21:14,NABE85D33E4B728471C9CC1,082-900-001,44444444,JB HI-FI NAB,380.89,0,372872.74,DR,REF499355,NAB,Business
13-09-2025 21:35,NABE1201D98054D408DA0B7,082-900-001,44444444,SALARY PAYMENT NAB,0,2667.76,375540.5,CR,REF865718,NAB,Business
13-09-2025 21:42,NAB886124CC5C1A4ACABAAC,082-900-001,44444444,RAILWAY STATION NAB,107.57,0,375432.93,DR,REF976472,NAB,Business
13-09-2025 21:43,NAB592FDF68D6C0422DBBBD,082-900-001,44444444,SALARY PAYMENT NAB,0,567.11,376000.04,CR,REF115865,NAB,Business
13-09-2025 22:14,NAB4B42D863FF7940518863,082-900-001,44444444,UBER EATS NAB,379.02,0,375621.02,DR,REF120021,NAB,Business
13-09-2025 22:39,NAB344871637D60443F8751,082-900-001,44444444,INTERNET TRANSFER NAB,161.15,0,375459.87,DR,REF447055,NAB,Business
13-09-2025 22:54,NABB0FE73F329834E0F97A7,082-900-001,44444444,HARVEY NORMAN NAB,344.16,0,375115.71,DR,REF233197,NAB,Business
13-09-2025 23:09,NABD74A9B663E224877AB11,082-900-001,44444444,FLIXBUS NAB,41.43,0,375074.28,DR,REF106735,NAB,Business
13-09-2025 23:26,NAB2F91AB7A69A14647B025,082-900-001,44444444,MCDONALDS NAB,107.87,0,374966.41,DR,REF627704,NAB,Business
13-09-2025 23:59,NAB768890F704B844889620,082-900-001,44444444,RAILWAY STATION NAB,423.21,0,374543.2,DR,REF650991,NAB,Business
14-09-2025 00:09,NAB8C04288259FD492294F3,082-900-001,44444444,SHELL NAB,108.96,0,374434.24,DR,REF853375,NAB,Business
14-09-2025 00:20,NAB5D2C511392F540FEB333,082-900-001,44444444,PAYROLL CREDIT NAB,0,476.34,374910.58,CR,REF585808,NAB,Business
14-09-2025 00:27,NAB3FFE3E606D4A4FBAA2AD,082-900-001,44444444,PAYPAL *NETFLIX NAB,187.59,0,374722.99,DR,REF206173,NAB,Business
14-09-2025 00:38,NABC447047D63CD4F67AA8C,082-900-001,44444444,HARVEY NORMAN NAB,155.82,0,374567.17,DR,REF774818,NAB,Business
14-09-2025 00:44,INTDB8A421016DD41C8BA82,082-900-001,44444444,TRANSFER TO ANZ 11111111,1806.28,0,372760.89,DR,INT-53404,NAB,Business
14-09-2025 01:08,NAB3127D89A396947E8AD80,082-900-001,44444444,SPOTIFY NAB,129.46,0,372631.43,DR,REF791458,NAB,Business
14-09-2025 01:09,NAB0106CECD18BC49D18BA5,082-900-001,44444444,PAYPAL *NETFLIX NAB,328.94,0,372302.49,DR,REF939737,NAB,Business
14-09-2025 01:24,NAB1C9CF065348C4285A6D6,082-900-001,44444444,COLES NAB,72.32,0,372230.17,DR,REF168853,NAB,Business
14-09-2025 01:36,NABAD4F440116414DD5BE44,082-900-001,44444444,AMAZON AU NAB,454.08,0,371776.09,DR,REF185931,NAB,Business
14-09-2025 02:44,NABF62497B9BD18440AA8E8,082-900-001,44444444,LIQUORLAND NAB,59.59,0,371716.5,DR,REF864698,NAB,Business
14-09-2025 03:05,NABC2A06EDC575D4AC5BC0B,082-900-001,44444444,SPOTIFY NAB,149.04,0,371567.46,DR,REF115327,NAB,Business
14-09-2025 03:22,NABEF8C1CF7848941A8AD77,082-900-001,44444444,FLIXBUS NAB,242.83,0,371324.63,DR,REF825674,NAB,Business
14-09-2025 03:31,NAB6DE170FBEE7D4C1F9ED1,082-900-001,44444444,WOOLWORTHS NAB,247.66,0,371076.97,DR,REF262791,NAB,Business
14-09-2025 03:48,NABF9A7DD00D6824B4088DA,082-900-001,44444444,COLES NAB,114.91,0,370962.06,DR,REF348236,NAB,Business
14-09-2025 03:56,NAB6F2B5867D644488FA9FA,082-900-001,44444444,INTERNET TRANSFER NAB,92.09,0,370869.97,DR,REF470445,NAB,Business
14-09-2025 04:03,NABFBDBE7DA9D6E4A838D26,082-900-001,44444444,CITYLINK NAB,555.82,0,370314.15,DR,REF137811,NAB,Business
14-09-2025 04:11,NAB7487D594C31642D2B98B,082-900-001,44444444,PAY - SALARY NAB,0,5316.61,375630.76,CR,REF753558,NAB,Business
14-09-2025 04:30,NABD2687C31E10F4FA29D43,082-900-001,44444444,ZOOM NAB,1705.93,0,373924.83,DR,REF334040,NAB,Business
14-09-2025 04:48,NABAA1207E3B5BA408BBDD9,082-900-001,44444444,DOMINO'S PIZZA NAB,10.82,0,373914.01,DR,REF117307,NAB,Business
14-09-2025 05:19,NABB653543C78A342C09C73,082-900-001,44444444,KFC NAB,300.67,0,373613.34,DR,REF977720,NAB,Business
14-09-2025 06:11,NAB5F36435FD7E64D48B925,082-900-001,44444444,COLES NAB,59.28,0,373554.06,DR,REF802933,NAB,Business
14-09-2025 07:06,NABAD4857FB2DAF44BDB550,082-900-001,44444444,WOOLWORTHS NAB,232.15,0,373321.91,DR,REF361029,NAB,Business
14-09-2025 07:21,INT4617FC0B545B45A185DF,082-900-001,44444444,TRANSFER TO ANZ 11111111,326.54,0,372995.37,DR,INT-82785,NAB,Business
14-09-2025 07:26,NAB4E79292112EC4FD1886C,082-900-001,44444444,DOMINO'S PIZZA NAB,1027.93,0,371967.44,DR,REF857986,NAB,Business
14-09-2025 07:58,NABC5D603E57DBB49A6A967,082-900-001,44444444,ZOOM NAB,278,0,371689.44,DR,REF345415,NAB,Business
14-09-2025 08:15,NAB9CA339D250594EC6AFB9,082-900-001,44444444,FLIXBUS NAB,17.85,0,371671.59,DR,REF445236,NAB,Business
14-09-2025 09:30,NAB54C6B319D59E46CBA582,082-900-001,44444444,LIQUORLAND NAB,279.64,0,371391.95,DR,REF988137,NAB,Business
14-09-2025 09:45,INT31F936B130B74EF89EC8,082-900-001,44444444,TRANSFER FROM CBA 33333333,0,1173.81,372565.76,CR,INT-94856,NAB,Business
14-09-2025 09:51,NAB0ECC4518567041C3AD12,082-900-001,44444444,BP NAB,29.64,0,372536.12,DR,REF763804,NAB,Business
14-09-2025 10:37,NABD18FA078A3804C44B188,082-900-001,44444444,STARBUCKS NAB,322.23,0,372213.89,DR,REF871941,NAB,Business
14-09-2025 10:55,NAB069A6917E5604C80972B,082-900-001,44444444,WAGES CREDIT NAB,0,5400.17,377614.06,CR,REF983233,NAB,Business
14-09-2025 11:00,NAB6025DEAC4B494E79AF23,082-900-001,44444444,MENULOG NAB,910.33,0,376703.73,DR,REF759119,NAB,Business
14-09-2025 11:08,NAB970201E7A8184ABE90F7,082-900-001,44444444,SALARY PAYMENT NAB,0,7639.41,384343.14,CR,REF100054,NAB,Business
14-09-2025 11:19,NABC442AFE8AC454D428D48,082-900-001,44444444,WOOLWORTHS NAB,125.66,0,384217.48,DR,REF322606,NAB,Business
14-09-2025 11:27,NAB26507F745DEA41DB8ED7,082-900-001,44444444,SPOTIFY NAB,255,0,383962.48,DR,REF851270,NAB,Business
14-09-2025 11:48,NAB944A16DBA5954D318691,082-900-001,44444444,RAILWAY STATION NAB,259.03,0,383703.45,DR,REF488420,NAB,Business
14-09-2025 11:58,NAB0CC5FF560B1945B78252,082-900-001,44444444,RAILWAY STATION NAB,710.8,0,382992.65,DR,REF867368,NAB,Business
14-09-2025 12:12,NABC15BF1F16A7147C5887A,082-900-001,44444444,DOMINO'S PIZZA NAB,472.08,0,382520.57,DR,REF114251,NAB,Business
14-09-2025 12:29,NAB8E71B0344ADA4F1E83C9,082-900-001,44444444,TAFE BOOKSHOP NAB,73.94,0,382446.63,DR,REF461495,NAB,Business
14-09-2025 12:37,INT699FB53F453748669C1B,082-900-001,44444444,TRANSFER TO ANZ 11111111,1677.15,0,380769.48,DR,INT-63331,NAB,Business
14-09-2025 12:41,NAB4D554FF4A6CB4E5C88BF,082-900-001,44444444,MENULOG NAB,282.8,0,380486.68,DR,REF196531,NAB,Business
14-09-2025 12:41,NAB79C43F28B5AE484E83F4,082-900-001,44444444,BIGW NAB,56.2,0,380430.48,DR,REF103144,NAB,Business
14-09-2025 13:13,NAB5E87ED8A3A054F0795B8,082-900-001,44444444,SALARY PAYMENT NAB,0,4354.99,384785.47,CR,REF308099,NAB,Business
14-09-2025 13:19,NAB0A1E7FEBA1F5436897B6,082-900-001,44444444,BANK FEE NAB,48.78,0,384736.69,DR,REF969631,NAB,Business
14-09-2025 14:29,NABFDE7BEC7C4BD446B9C09,082-900-001,44444444,SALARY PAYMENT NAB,0,4254.73,388991.42,CR,REF770663,NAB,Business
14-09-2025 14:35,NABA9B334FFAEF143CA87BD,082-900-001,44444444,BIGW NAB,251.76,0,388739.66,DR,REF352259,NAB,Business
14-09-2025 14:47,NAB7D697F7111134ADFADD1,082-900-001,44444444,SPOTIFY NAB,192.59,0,388547.07,DR,REF289940,NAB,Business
14-09-2025 14:48,NAB402E4C29FC4B4AB98538,082-900-001,44444444,PAYROLL CREDIT NAB,0,128.91,388675.98,CR,REF805293,NAB,Business
14-09-2025 14:49,NAB9178458A6C834B2D9DEB,082-900-001,44444444,BWS NAB,404.79,0,388271.19,DR,REF719030,NAB,Business
14-09-2025 15:02,NABF1E38F257B0946BBB9B5,082-900-001,44444444,INTERNET TRANSFER NAB,773.35,0,387497.84,DR,REF424826,NAB,Business
14-09-2025 15:07,NAB9D19FB845CF640139FA6,082-900-001,44444444,BANK FEE NAB,530.02,0,386967.82,DR,REF749128,NAB,Business
14-09-2025 15:25,NAB6DC76AA40C034D089499,082-900-001,44444444,FLIXBUS NAB,524,0,386443.82,DR,REF721465,NAB,Business
14-09-2025 15:56,NABE8EC40DDFA684E93A313,082-900-001,44444444,PAYMENT GATEWAY NAB,273.28,0,386170.54,DR,REF258267,NAB,Business
14-09-2025 15:59,NAB86C2917C0F2B4665B783,082-900-001,44444444,MCDONALDS NAB,199.28,0,385971.26,DR,REF393192,NAB,Business
14-09-2025 16:00,NAB9437DDD7662A457EB9CB,082-900-001,44444444,JB HI-FI NAB,61.88,0,385909.38,DR,REF953360,NAB,Business
14-09-2025 16:07,INTF91A20460E7443C7A6DD,082-900-001,44444444,TRANSFER FROM ANZ 11111111,0,1995.88,387905.26,CR,INT-76222,NAB,Business
14-09-2025 16:13,NAB9254673AD52442589E42,082-900-001,44444444,UBER EATS NAB,108.21,0,387797.05,DR,REF581208,NAB,Business
14-09-2025 16:38,INTE0E6E0475D514DE9AD02,082-900-001,44444444,TRANSFER FROM CBA 22222222,0,281.82,388078.87,CR,INT-99115,NAB,Business
14-09-2025 16:41,NABC4E76893233549DC8B44,082-900-001,44444444,FLIXBUS NAB,240.32,0,387838.55,DR,REF984269,NAB,Business
14-09-2025 17:09,NABBE3C76F8DC7D4D61920B,082-900-001,44444444,COMPANY PAYROLL NAB,0,801.73,388640.28,CR,REF474727,NAB,Business
14-09-2025 17:10,NAB347D3C8DCC844E4D8707,082-900-001,44444444,STARBUCKS NAB,45.24,0,388595.04,DR,REF357131,NAB,Business
14-09-2025 17:17,NABBEC3C77F26A6445B874A,082-900-001,44444444,SPOTIFY NAB,257.12,0,388337.92,DR,REF850152,NAB,Business
14-09-2025 17:27,NABCE25160AA23F4409A251,082-900-001,44444444,WOOLWORTHS NAB,127.36,0,388210.56,DR,REF911510,NAB,Business
14-09-2025 17:38,NAB1EB64601CCD74C4E97FA,082-900-001,44444444,PAY - SALARY NAB,0,3882.93,392093.49,CR,REF573811,NAB,Business
14-09-2025 18:17,NAB113E4FD7BED340BF89C9,082-900-001,44444444,WAGES CREDIT NAB,0,6433.91,398527.4,CR,REF169086,NAB,Business
14-09-2025 18:20,NABF31E03922A3B4F3D887D,082-900-001,44444444,BWS NAB,168.59,0,398358.81,DR,REF505974,NAB,Business
14-09-2025 18:47,NABCC59423E71CE4F19850F,082-900-001,44444444,SPOTIFY NAB,1157.71,0,397201.1,DR,REF620946,NAB,Business
14-09-2025 18:48,NABDA52883C5FF541128340,082-900-001,44444444,KFC NAB,551.79,0,396649.31,DR,REF186960,NAB,Business
14-09-2025 18:53,NABA30FE8A0378B4E108D72,082-900-001,44444444,HARVEY NORMAN NAB,532.67,0,396116.64,DR,REF623617,NAB,Business
14-09-2025 19:02,NABD0F7B6A25D864F2DA53D,082-900-001,44444444,SPOTIFY NAB,229.35,0,395887.29,DR,REF899686,NAB,Business
14-09-2025 19:29,INT005DE918177D412D8268,082-900-001,44444444,TRANSFER FROM CBA 33333333,0,1853.6,397740.89,CR,INT-96287,NAB,Business
14-09-2025 20:02,NAB1C2A619F3F4944C88361,082-900-001,44444444,COLES NAB,78.31,0,397662.58,DR,REF257795,NAB,Business
14-09-2025 20:07,NAB208BE3C7250C4B439756,082-900-001,44444444,CITYLINK NAB,240.59,0,397421.99,DR,REF301604,NAB,Business
14-09-2025 20:23,NAB5E012F69CFED4EFC8E89,082-900-001,44444444,DOMINO'S PIZZA NAB,297.02,0,397124.97,DR,REF607893,NAB,Business
14-09-2025 20:29,NABBFD45A7AE5B147B2ABF6,082-900-001,44444444,INTERNET TRANSFER NAB,81.51,0,397043.46,DR,REF306168,NAB,Business
14-09-2025 20:55,NABDC1CAFD08D864DCDBAEA,082-900-001,44444444,BWS NAB,82.74,0,396960.72,DR,REF632690,NAB,Business
14-09-2025 21:18,NAB4B9E98AA64FE4E658EBD,082-900-001,44444444,BWS NAB,297.35,0,396663.37,DR,REF661655,NAB,Business
14-09-2025 21:33,NAB46C2700983F74DBDA903,082-900-001,44444444,COMPANY PAYROLL NAB,0,630.88,397294.25,CR,REF448801,NAB,Business
14-09-2025 21:34,NAB8463E0147AC64AF5B270,082-900-001,44444444,PAYPAL *NETFLIX NAB,201.79,0,397092.46,DR,REF863327,NAB,Business
14-09-2025 21:35,NAB26382F66E6774A869041,082-900-001,44444444,PAYMENT GATEWAY NAB,316.09,0,396776.37,DR,REF294429,NAB,Business
14-09-2025 22:09,NAB0D3C05BCD58B4AD98B1E,082-900-001,44444444,LIQUORLAND NAB,95.85,0,396680.52,DR,REF805595,NAB,Business
14-09-2025 22:19,NAB4CB1BBE80276405ABB8B,082-900-001,44444444,COLES NAB,308.56,0,396371.96,DR,REF206783,NAB,Business
14-09-2025 22:33,NAB03312C8BAD744C6D9B07,082-900-001,44444444,MENULOG NAB,602.44,0,395769.52,DR,REF817646,NAB,Business
14-09-2025 22:38,NAB3EA0475EB483495891B0,082-900-001,44444444,PAY - SALARY NAB,0,4082.61,399852.13,CR,REF364211,NAB,Business
14-09-2025 22:49,NAB1DABADD86D554C2B90B0,082-900-001,44444444,DOMINO'S PIZZA NAB,560.11,0,399292.02,DR,REF420521,NAB,Business
14-09-2025 23:13,NAB7B91E76812194C72BFDC,082-900-001,44444444,FLIXBUS NAB,1127.47,0,398164.55,DR,REF533089,NAB,Business
14-09-2025 23:18,INT2C6951E4FB474BEDBD45,082-900-001,44444444,TRANSFER TO CBA 22222222,907.14,0,397257.41,DR,INT-29904,NAB,Business
14-09-2025 23:33,NAB65223A59AD5248099872,082-900-001,44444444,TAFE BOOKSHOP NAB,1479.35,0,395778.06,DR,REF219351,NAB,Business
15-09-2025 00:01,NAB68921239AC3A426BAF71,082-900-001,44444444,AMAZON AU NAB,445.75,0,395332.31,DR,REF188794,NAB,Business
15-09-2025 01:14,NABE9F0DC5D4FAD486F9569,082-900-001,44444444,WAGES CREDIT NAB,0,873.22,396205.53,CR,REF524738,NAB,Business
15-09-2025 01:24,NAB926203633B6B48D2A49B,082-900-001,44444444,SPOTIFY NAB,73.39,0,396132.14,DR,REF139595,NAB,Business
15-09-2025 02:03,NAB7CA796400E184ADAB3B9,082-900-001,44444444,WOOLWORTHS NAB,184.39,0,395947.75,DR,REF431519,NAB,Business
15-09-2025 02:33,NAB3729A08534F940748E73,082-900-001,44444444,AMAZON AU NAB,259.73,0,395688.02,DR,REF164792,NAB,Business
15-09-2025 02:34,NABA487E7A35AFD4F6CBA7A,082-900-001,44444444,PAYMENT GATEWAY NAB,1027.29,0,394660.73,DR,REF936099,NAB,Business
15-09-2025 02:44,NABBAADADCC0D924582AABD,082-900-001,44444444,BP NAB,127.47,0,394533.26,DR,REF135483,NAB,Business
15-09-2025 03:12,NABF3B240C096294FE5A574,082-900-001,44444444,FLIXBUS NAB,23.41,0,394509.85,DR,REF800197,NAB,Business
15-09-2025 04:18,NAB3DAAD7FE78D3460088C1,082-900-001,44444444,PAYPAL *NETFLIX NAB,77.33,0,394432.52,DR,REF386817,NAB,Business
15-09-2025 04:27,NABCD99551E97C9436BB206,082-900-001,44444444,FLIXBUS NAB,716.75,0,393715.77,DR,REF315266,NAB,Business
15-09-2025 05:02,NAB3819242D74CA451887AC,082-900-001,44444444,7-ELEVEN NAB,454.38,0,393261.39,DR,REF908306,NAB,Business
15-09-2025 05:15,NAB2DD763A629A041AF904E,082-900-001,44444444,CITYLINK NAB,118.33,0,393143.06,DR,REF802580,NAB,Business
15-09-2025 05:19,NAB1D236705A8434ECB9D5F,082-900-001,44444444,LIQUORLAND NAB,75.24,0,393067.82,DR,REF858588,NAB,Business
15-09-2025 05:20,NAB3B583A4A2BDE41689069,082-900-001,44444444,SPOTIFY NAB,145.73,0,392922.09,DR,REF258474,NAB,Business
15-09-2025 05:21,NABD6A0DDC466794D84965C,082-900-001,44444444,JB HI-FI NAB,115.44,0,392806.65,DR,REF837838,NAB,Business
15-09-2025 05:31,NABA81AC6F786214643A0C7,082-900-001,44444444,PAYMENT GATEWAY NAB,225.69,0,392580.96,DR,REF998047,NAB,Business
15-09-2025 05:39,NAB9A9950DB8583433A8FEB,082-900-001,44444444,ALDI NAB,333.45,0,392247.51,DR,REF905570,NAB,Business
15-09-2025 05:51,NAB26056D6107C548C7B064,082-900-001,44444444,BANK FEE NAB,950.5,0,391297.01,DR,REF692657,NAB,Business
15-09-2025 06:08,NAB79B0BFF26F054F939197,082-900-001,44444444,CITYLINK NAB,48.76,0,391248.25,DR,REF120817,NAB,Business
15-09-2025 06:35,NAB0C06A0CDE04149F6ABF9,082-900-001,44444444,SPOTIFY NAB,118,0,391130.25,DR,REF905471,NAB,Business
15-09-2025 07:08,NABD69E320D681A48A182A9,082-900-001,44444444,MCDONALDS NAB,112.76,0,391017.49,DR,REF104213,NAB,Business
15-09-2025 07:16,NAB2F31C47748114BE8BC97,082-900-001,44444444,JB HI-FI NAB,194.08,0,390823.41,DR,REF256764,NAB,Business
15-09-2025 07:36,NAB6A17DB0FCCAB4C5399A3,082-900-001,44444444,UBER EATS NAB,424.76,0,390398.65,DR,REF707537,NAB,Business
15-09-2025 07:49,INT0E1F6611CC2644548977,082-900-001,44444444,TRANSFER TO CBA 22222222,1237.57,0,389161.08,DR,INT-41715,NAB,Business
15-09-2025 08:02,NAB29DF3CA55608484CA75D,082-900-001,44444444,PAY - SALARY NAB,0,555.71,389716.79,CR,REF885928,NAB,Business
15-09-2025 08:06,NAB14A2F360D80141149F28,082-900-001,44444444,INTERNET TRANSFER NAB,253.29,0,389463.5,DR,REF406091,NAB,Business
15-09-2025 08:50,NABD6D5B6EBF4FF49F59C62,082-900-001,44444444,MCDONALDS NAB,194.76,0,389268.74,DR,REF355669,NAB,Business
15-09-2025 09:05,NAB3D4CE44A3B564382B436,082-900-001,44444444,APPLE NAB,620.36,0,388648.38,DR,REF473140,NAB,Business
15-09-2025 10:20,NAB5C61A441CA0D4DCEBD2D,082-900-001,44444444,UBER EATS NAB,313.45,0,388334.93,DR,REF479836,NAB,Business
15-09-2025 10:42,NABFC5A31AB3F8544CFB4CF,082-900-001,44444444,UBER EATS NAB,717.34,0,387617.59,DR,REF356202,NAB,Business
15-09-2025 10:58,INTBE5375A41B4F458DA234,082-900-001,44444444,TRANSFER TO CBA 33333333,1029.54,0,386588.05,DR,INT-95418,NAB,Business
15-09-2025 11:38,NAB8CD2D56A7F5D48D38D25,082-900-001,44444444,MENULOG NAB,87.89,0,386500.16,DR,REF397418,NAB,Business
15-09-2025 11:41,NABC1E43D00CB6C4FA8B0A3,082-900-001,44444444,HARVEY NORMAN NAB,315.77,0,386184.39,DR,REF195370,NAB,Business
15-09-2025 11:58,NAB596B1A146FAA49EEBF1D,082-900-001,44444444,KFC NAB,90.06,0,386094.33,DR,REF386455,NAB,Business
15-09-2025 12:00,NAB3EF91C065BCD4A50BFB8,082-900-001,44444444,SPOTIFY NAB,423.57,0,385670.76,DR,REF974748,NAB,Business
15-09-2025 12:07,NABDAA248785222451988D5,082-900-001,44444444,SHELL NAB,864.8,0,384805.96,DR,REF904956,NAB,Business
15-09-2025 12:13,NABAA9163A30DD2435E8A17,082-900-001,44444444,ALDI NAB,83.65,0,384722.31,DR,REF606422,NAB,Business
15-09-2025 12:19,NAB8968E7FB7C234470B75D,082-900-001,44444444,PAYMENT GATEWAY NAB,102.57,0,384619.74,DR,REF594856,NAB,Business
15-09-2025 12:41,NAB4445B0AD12E14C1F88C8,082-900-001,44444444,RAILWAY STATION NAB,288.29,0,384331.45,DR,REF491097,NAB,Business
15-09-2025 12:51,NAB5F1744239CAF4705BCAB,082-900-001,44444444,MENULOG NAB,461.26,0,383870.19,DR,REF969970,NAB,Business
15-09-2025 13:13,NAB10A60BF74E1B426BB89A,082-900-001,44444444,BWS NAB,264.84,0,383605.35,DR,REF413690,NAB,Business
15-09-2025 13:33,NAB0F8A5FC2BB034CB78179,082-900-001,44444444,BWS NAB,84.54,0,383520.81,DR,REF170726,NAB,Business
15-09-2025 13:36,NABA3FFFA7C75884D88A06E,082-900-001,44444444,JB HI-FI NAB,65.16,0,383455.65,DR,REF310487,NAB,Business
15-09-2025 13:39,NABEF1CA843C06D41009F54,082-900-001,44444444,BWS NAB,107.54,0,383348.11,DR,REF364453,NAB,Business
15-09-2025 14:04,NABBFDDC0F0B3474443AB32,082-900-001,44444444,BWS NAB,101.41,0,383246.7,DR,REF566870,NAB,Business
15-09-2025 14:06,NABFE460ABC4EFF49A0BCD7,082-900-001,44444444,COMPANY PAYROLL NAB,0,6675.5,389922.2,CR,REF204802,NAB,Business
15-09-2025 14:14,NAB876084B02DA144A19E16,082-900-001,44444444,COMPANY PAYROLL NAB,0,2173.36,392095.56,CR,REF401358,NAB,Business
15-09-2025 14:31,NAB599FD46A1DFC4329B3E1,082-900-001,44444444,PAYPAL *NETFLIX NAB,670.85,0,391424.71,DR,REF423557,NAB,Business
15-09-2025 14:59,NAB4731453B0DEB4FD4BFA5,082-900-001,44444444,ALDI NAB,74.6,0,391350.11,DR,REF556972,NAB,Business
15-09-2025 15:01,NABAA0731D74C2A437DA4E3,082-900-001,44444444,FLIXBUS NAB,305.05,0,391045.06,DR,REF980328,NAB,Business
15-09-2025 15:07,NABE81D62685EE2492EBF6F,082-900-001,44444444,RAILWAY STATION NAB,382.31,0,390662.75,DR,REF746371,NAB,Business
15-09-2025 15:49,NABC4E457579DD841EE964D,082-900-001,44444444,UBER EATS NAB,87.98,0,390574.77,DR,REF512644,NAB,Business
15-09-2025 16:03,NABF10F7F028D6D457C81C4,082-900-001,44444444,SHELL NAB,182.08,0,390392.69,DR,REF893495,NAB,Business
15-09-2025 16:20,NABF08142C193F04005A2B9,082-900-001,44444444,PAYROLL CREDIT NAB,0,6285.48,396678.17,CR,REF352326,NAB,Business
15-09-2025 16:23,NAB2BD3726518FA44CA98D4,082-900-001,44444444,BIGW NAB,418.82,0,396259.35,DR,REF816119,NAB,Business
15-09-2025 16:25,NABC90D04357A9B4A97BD6D,082-900-001,44444444,SPOTIFY NAB,291.77,0,395967.58,DR,REF673321,NAB,Business
15-09-2025 16:29,NAB16ED7922B9B8410DA6CE,082-900-001,44444444,SHELL NAB,420.4,0,395547.18,DR,REF586681,NAB,Business
15-09-2025 16:53,NAB40168D9AC96943619263,082-900-001,44444444,JB HI-FI NAB,147.41,0,395399.77,DR,REF862273,NAB,Business
15-09-2025 16:54,NABBDF925CF07DB49EB83A0,082-900-001,44444444,BANK FEE NAB,341.51,0,395058.26,DR,REF308757,NAB,Business
15-09-2025 17:01,NAB9975CC8630834E09914A,082-900-001,44444444,STARBUCKS NAB,529.96,0,394528.3,DR,REF301253,NAB,Business
15-09-2025 17:14,NAB60540F9501B542818DDD,082-900-001,44444444,SHELL NAB,776.67,0,393751.63,DR,REF174881,NAB,Business
15-09-2025 17:31,NAB8064A9811B62471BBA96,082-900-001,44444444,TAFE BOOKSHOP NAB,155.78,0,393595.85,DR,REF513879,NAB,Business
15-09-2025 17:55,NAB387D47B583D945FE9AED,082-900-001,44444444,APPLE NAB,175.09,0,393420.76,DR,REF330015,NAB,Business
15-09-2025 18:27,INTF05AF57E647847F38652,082-900-001,44444444,TRANSFER FROM ANZ 11111111,0,735.56,394156.32,CR,INT-96773,NAB,Business
15-09-2025 18:42,NAB9F53DF8ACEFE4384B011,082-900-001,44444444,KFC NAB,1358.99,0,392797.33,DR,REF780827,NAB,Business
15-09-2025 19:22,NABAEBBBC101CF249C38542,082-900-001,44444444,BIGW NAB,330.26,0,392467.07,DR,REF438038,NAB,Business
15-09-2025 19:44,NAB350D5AC563FA4672AF12,082-900-001,44444444,STARBUCKS NAB,759.32,0,391707.75,DR,REF829929,NAB,Business
15-09-2025 20:04,NAB5B398DB434204FEFA767,082-900-001,44444444,STARBUCKS NAB,58.77,0,391648.98,DR,REF668099,NAB,Business
15-09-2025 20:06,NAB1338E40326054CEBBA10,082-900-001,44444444,STARBUCKS NAB,59.93,0,391589.05,DR,REF627473,NAB,Business
15-09-2025 21:12,NABD98E3BF08927459C9B7E,082-900-001,44444444,PAYPAL *NETFLIX NAB,551.84,0,391037.21,DR,REF170113,NAB,Business
15-09-2025 21:18,NAB4F94E28DD2BD44D4B238,082-900-001,44444444,PAYMENT GATEWAY NAB,199.05,0,390838.16,DR,REF216765,NAB,Business
15-09-2025 21:21,NABE381A3B6D7FD485FBAD7,082-900-001,44444444,CITYLINK NAB,131.67,0,390706.49,DR,REF842133,NAB,Business
15-09-2025 21:41,NAB1449434AFFB6478089CA,082-900-001,44444444,MCDONALDS NAB,172.59,0,390533.9,DR,REF870911,NAB,Business
15-09-2025 21:49,NABD7AB256FEBF94A349AE3,082-900-001,44444444,LIQUORLAND NAB,605.62,0,389928.28,DR,REF295324,NAB,Business
15-09-2025 22:44,NAB8EA04CEBC2F042DA885C,082-900-001,44444444,ALDI NAB,151.57,0,389776.71,DR,REF810907,NAB,Business
15-09-2025 22:44,NAB754B09789C7F45BEA694,082-900-001,44444444,MENULOG NAB,132.08,0,389644.63,DR,REF729964,NAB,Business
15-09-2025 23:04,NAB8F25F2DCFDFE48EEB8DE,082-900-001,44444444,LIQUORLAND NAB,595.31,0,389049.32,DR,REF479000,NAB,Business
15-09-2025 23:12,NAB4B6C1B8B189249889251,082-900-001,44444444,COLES NAB,55.71,0,388993.61,DR,REF618822,NAB,Business
15-09-2025 23:17,NAB5E7BDBC1175344E7BAC1,082-900-001,44444444,JB HI-FI NAB,27.41,0,388966.2,DR,REF647994,NAB,Business
15-09-2025 23:21,NABBE5A659758C248509F97,082-900-001,44444444,WAGES CREDIT NAB,0,263.91,389230.11,CR,REF693293,NAB,Business
16-09-2025 00:02,NABF76272CF3A844C50941E,082-900-001,44444444,STARBUCKS NAB,107.35,0,389122.76,DR,REF563055,NAB,Business
16-09-2025 01:00,NAB9CFBEB06C99D4C54A639,082-900-001,44444444,INTERNET TRANSFER NAB,169.71,0,388953.05,DR,REF956893,NAB,Business
16-09-2025 01:36,NAB942FA44280FA4B189CBC,082-900-001,44444444,7-ELEVEN NAB,177.87,0,388775.18,DR,REF969483,NAB,Business
16-09-2025 01:55,NABCDE9AD5A95C849C1A123,082-900-001,44444444,TAFE BOOKSHOP NAB,141.36,0,388633.82,DR,REF814489,NAB,Business
16-09-2025 02:16,NAB411EC5BE8F3F4778A65A,082-900-001,44444444,PAYMENT GATEWAY NAB,26.76,0,388607.06,DR,REF642713,NAB,Business
16-09-2025 02:17,NAB1AB6217C4543414F914D,082-900-001,44444444,INTERNET TRANSFER NAB,239.01,0,388368.05,DR,REF704634,NAB,Business
16-09-2025 02:48,NAB56CE83C0C74D414FBB37,082-900-001,44444444,BWS NAB,1130.02,0,387238.03,DR,REF180717,NAB,Business
16-09-2025 03:15,NABA8AD1A7F8B76430FAC61,082-900-001,44444444,BWS NAB,429.38,0,386808.65,DR,REF602802,NAB,Business
16-09-2025 03:24,NABDF0E29AFE49245099AB7,082-900-001,44444444,ZOOM NAB,337.9,0,386470.75,DR,REF820302,NAB,Business
16-09-2025 03:26,NAB5F3CBE6682D54D86A33E,082-900-001,44444444,JB HI-FI NAB,147.73,0,386323.02,DR,REF304763,NAB,Business
16-09-2025 04:20,NAB763CA2327F2043369CC3,082-900-001,44444444,WOOLWORTHS NAB,820.07,0,385502.95,DR,REF264542,NAB,Business
16-09-2025 04:21,NAB6715DC206A44453B8969,082-900-001,44444444,7-ELEVEN NAB,162.91,0,385340.04,DR,REF634947,NAB,Business
16-09-2025 04:44,NAB88259F2000AF4E41A8F3,082-900-001,44444444,7-ELEVEN NAB,412.03,0,384928.01,DR,REF705157,NAB,Business
16-09-2025 04:58,NAB72B73057BED64A889F6A,082-900-001,44444444,COLES NAB,356.62,0,384571.39,DR,REF215841,NAB,Business
16-09-2025 05:06,NAB7C52F9D567D24FC88F02,082-900-001,44444444,APPLE NAB,609.28,0,383962.11,DR,REF880371,NAB,Business
16-09-2025 05:09,NABB2975A0EE3654739BB4E,082-900-001,44444444,COLES NAB,83.96,0,383878.15,DR,REF487421,NAB,Business
16-09-2025 05:11,NAB307F2A1D6DE54C31A9D9,082-900-001,44444444,CITYLINK NAB,56.41,0,383821.74,DR,REF281603,NAB,Business
16-09-2025 05:13,NAB764238C9E67A47CE8908,082-900-001,44444444,BIGW NAB,169.72,0,383652.02,DR,REF415208,NAB,Business
16-09-2025 05:23,INT60974ECE706A4FF4A9F0,082-900-001,44444444,TRANSFER TO CBA 33333333,137.09,0,383514.93,DR,INT-43361,NAB,Business
16-09-2025 05:52,NAB72052528D0B64DD898F7,082-900-001,44444444,PAYPAL *NETFLIX NAB,182.71,0,383332.22,DR,REF550565,NAB,Business
16-09-2025 06:15,NABC5D350041C934969B449,082-900-001,44444444,SHELL NAB,554.33,0,382777.89,DR,REF801552,NAB,Business
16-09-2025 06:22,NAB9A9CCD22BBD4427AAC77,082-900-001,44444444,7-ELEVEN NAB,1004.44,0,381773.45,DR,REF840025,NAB,Business
16-09-2025 06:24,NAB10398FA01A704D72A7DA,082-900-001,44444444,APPLE NAB,837.32,0,380936.13,DR,REF921671,NAB,Business
16-09-2025 07:11,INT6A240EB0F2AA4E71BE72,082-900-001,44444444,TRANSFER FROM CBA 22222222,0,704.45,381640.58,CR,INT-45067,NAB,Business
16-09-2025 07:28,NABAABC51B2BCAA466EBA6A,082-900-001,44444444,CITYLINK NAB,59.19,0,381581.39,DR,REF452052,NAB,Business
16-09-2025 07:34,NABF79EC44E227F4923BD23,082-900-001,44444444,WOOLWORTHS NAB,207.22,0,381374.17,DR,REF673326,NAB,Business
16-09-2025 08:13,NAB2E7B8780EBC4442EA877,082-900-001,44444444,WAGES CREDIT NAB,0,3227.02,384601.19,CR,REF738141,NAB,Business
16-09-2025 09:04,NABAB7FFE5D1FF44DB3B2B4,082-900-001,44444444,APPLE NAB,382.05,0,384219.14,DR,REF242806,NAB,Business
16-09-2025 09:11,NABB7F70F9CB2CE494D8D4F,082-900-001,44444444,SHELL NAB,49.64,0,384169.5,DR,REF274348,NAB,Business
16-09-2025 09:57,NABE136C772915C44B4B824,082-900-001,44444444,7-ELEVEN NAB,254.83,0,383914.67,DR,REF704574,NAB,Business
16-09-2025 10:06,NABA935AE62C2874774B9A3,082-900-001,44444444,FLIXBUS NAB,50.24,0,383864.43,DR,REF401704,NAB,Business
16-09-2025 10:11,NABFB63FD10E8834B109658,082-900-001,44444444,CITYLINK NAB,612.47,0,383251.96,DR,REF368408,NAB,Business
16-09-2025 10:29,NAB6672E11A7294478594FD,082-900-001,44444444,ALDI NAB,374.27,0,382877.69,DR,REF329689,NAB,Business
16-09-2025 10:44,NAB9C221EF6C25E4D7E9C03,082-900-001,44444444,RAILWAY STATION NAB,190.43,0,382687.26,DR,REF663324,NAB,Business
16-09-2025 10:46,NABB405177D6065487B8EF7,082-900-001,44444444,WOOLWORTHS NAB,208.82,0,382478.44,DR,REF274086,NAB,Business
16-09-2025 10:51,NAB5194DC46F87E47DEAF1E,082-900-001,44444444,SALARY PAYMENT NAB,0,7799.55,390277.99,CR,REF945707,NAB,Business
16-09-2025 11:09,NAB481CF5EB28564ECAAB20,082-900-001,44444444,DOMINO'S PIZZA NAB,153.43,0,390124.56,DR,REF715868,NAB,Business
16-09-2025 11:11,NAB5CEDC902E12E48C694EB,082-900-001,44444444,SPOTIFY NAB,110.33,0,390014.23,DR,REF875420,NAB,Business
16-09-2025 11:13,NAB7C0A77949F924073BB57,082-900-001,44444444,UBER EATS NAB,1305.4,0,388708.83,DR,REF581599,NAB,Business
16-09-2025 11:35,NAB59247F921E7A47C19F6E,082-900-001,44444444,CITYLINK NAB,219.59,0,388489.24,DR,REF374674,NAB,Business
16-09-2025 12:03,NABABB0F75FCDC04465A783,082-900-001,44444444,RAILWAY STATION NAB,592.64,0,387896.6,DR,REF691498,NAB,Business
16-09-2025 12:40,NABC644B697DD6647099721,082-900-001,44444444,PAYMENT GATEWAY NAB,376.26,0,387520.34,DR,REF576475,NAB,Business
16-09-2025 12:59,NAB4AC0CEAF486E4AA5B79B,082-900-001,44444444,7-ELEVEN NAB,128.11,0,387392.23,DR,REF276530,NAB,Business
16-09-2025 13:29,NAB906FDFE1B8EF4A05B9B4,082-900-001,44444444,BWS NAB,525.9,0,386866.33,DR,REF154429,NAB,Business
16-09-2025 13:38,NAB0AFF468C20304ED58850,082-900-001,44444444,MENULOG NAB,153.73,0,386712.6,DR,REF159231,NAB,Business
16-09-2025 13:51,NABAC10583C54E14B1F9989,082-900-001,44444444,SHELL NAB,235.12,0,386477.48,DR,REF405417,NAB,Business
16-09-2025 13:52,NAB15D04431C07D40FAAD53,082-900-001,44444444,SPOTIFY NAB,1643.66,0,384833.82,DR,REF539050,NAB,Business
16-09-2025 14:38,NABC646E02D8B20410E83B9,082-900-001,44444444,COMPANY PAYROLL NAB,0,7285.94,392119.76,CR,REF380684,NAB,Business
16-09-2025 15:38,NABBED89FB02913450C9FDE,082-900-001,44444444,KFC NAB,495.84,0,391623.92,DR,REF586527,NAB,Business
16-09-2025 16:06,NAB79DE83FD29E949F68558,082-900-001,44444444,UBER EATS NAB,269.97,0,391353.95,DR,REF775333,NAB,Business
16-09-2025 17:11,NAB9652A3A68C9E45278D0B,082-900-001,44444444,CITYLINK NAB,273.79,0,391080.16,DR,REF512103,NAB,Business
16-09-2025 17:53,NABF10DAE77E4014736B0C8,082-900-001,44444444,RAILWAY STATION NAB,141.91,0,390938.25,DR,REF399304,NAB,Business
16-09-2025 18:05,NAB958C959F0F494759BF7E,082-900-001,44444444,PAYROLL CREDIT NAB,0,2781.17,393719.42,CR,REF972969,NAB,Business
16-09-2025 18:12,NAB3FA27550D8AB42918C03,082-900-001,44444444,ZOOM NAB,646.03,0,393073.39,DR,REF948893,NAB,Business
16-09-2025 18:16,NAB3DEABE0CEDC849D1BBE6,082-900-001,44444444,BWS NAB,183.26,0,392890.13,DR,REF774031,NAB,Business
16-09-2025 18:18,INT0042D93632BA47728B0E,082-900-001,44444444,TRANSFER TO CBA 33333333,1337.7,0,391552.43,DR,INT-58689,NAB,Business
16-09-2025 18:28,NABD779611942F241DB97E6,082-900-001,44444444,FLIXBUS NAB,38.06,0,391514.37,DR,REF761376,NAB,Business
16-09-2025 18:38,NAB168C4C30DA6E4CBDA4E3,082-900-001,44444444,LIQUORLAND NAB,588.96,0,390925.41,DR,REF945837,NAB,Business
16-09-2025 18:41,NABC9885BEAD0BA4E9A8EB2,082-900-001,44444444,SPOTIFY NAB,215.66,0,390709.75,DR,REF749252,NAB,Business
16-09-2025 18:55,NAB2DEB66E9B0BF4C62A5B4,082-900-001,44444444,RAILWAY STATION NAB,159.02,0,390550.73,DR,REF951974,NAB,Business
16-09-2025 19:00,NABBFE074305C9441C9BA33,082-900-001,44444444,TAFE BOOKSHOP NAB,124.55,0,390426.18,DR,REF478480,NAB,Business
16-09-2025 19:01,NABF3420B95E7334BBE92EC,082-900-001,44444444,SHELL NAB,169.13,0,390257.05,DR,REF483348,NAB,Business
16-09-2025 19:33,NABC37583238DBB4E998889,082-900-001,44444444,HARVEY NORMAN NAB,94.44,0,390162.61,DR,REF131785,NAB,Business
16-09-2025 20:19,NAB740471773C874D729374,082-900-001,44444444,RAILWAY STATION NAB,38.53,0,390124.08,DR,REF295184,NAB,Business
16-09-2025 20:36,NAB44E154FC33734BCC9DD8,082-900-001,44444444,COLES NAB,327.82,0,389796.26,DR,REF602909,NAB,Business
16-09-2025 20:37,NAB782D18276E864C77B478,082-900-001,44444444,BIGW NAB,495.48,0,389300.78,DR,REF673203,NAB,Business
16-09-2025 21:06,NAB5037DF789B824DA2BF7E,082-900-001,44444444,INTERNET TRANSFER NAB,142.63,0,389158.15,DR,REF790169,NAB,Business
16-09-2025 21:10,INT8E31EDD70AA64CBC8ED5,082-900-001,44444444,TRANSFER FROM CBA 22222222,0,814.6,389972.75,CR,INT-58596,NAB,Business
16-09-2025 21:21,NAB5A0056DCC4F1467B8412,082-900-001,44444444,WOOLWORTHS NAB,976.79,0,388995.96,DR,REF371782,NAB,Business
16-09-2025 22:08,NABFB4A73D1B06348539AA7,082-900-001,44444444,PAY - SALARY NAB,0,7723.4,396719.36,CR,REF650700,NAB,Business
16-09-2025 22:33,NAB188FF1FE1926419B8078,082-900-001,44444444,WOOLWORTHS NAB,352.56,0,396366.8,DR,REF576367,NAB,Business
16-09-2025 23:20,NABBE428E26B2E44C73B7E7,082-900-001,44444444,SALARY PAYMENT NAB,0,4980.42,401347.22,CR,REF668710,NAB,Business
17-09-2025 00:57,INTC55C90AA5BCE4BE7A69A,082-900-001,44444444,TRANSFER FROM CBA 33333333,0,1338.94,402686.16,CR,INT-80824,NAB,Business
17-09-2025 01:26,NAB1D0A46976B69456C81D8,082-900-001,44444444,APPLE NAB,335.07,0,402351.09,DR,REF374523,NAB,Business
17-09-2025 01:44,NAB337766F49FBF45EDA89D,082-900-001,44444444,HARVEY NORMAN NAB,484,0,401867.09,DR,REF493986,NAB,Business
17-09-2025 01:45,NABA0F7323E0046405BBC65,082-900-001,44444444,MCDONALDS NAB,225.83,0,401641.26,DR,REF730656,NAB,Business
17-09-2025 02:04,NABF1CC7CA4A7BF431C89C3,082-900-001,44444444,INTERNET TRANSFER NAB,26.09,0,401615.17,DR,REF537263,NAB,Business
17-09-2025 02:13,NABF77E22CEEF4845AFA746,082-900-001,44444444,COLES NAB,272.15,0,401343.02,DR,REF155558,NAB,Business
17-09-2025 02:19,NABD85E0A204EE64D40BFA5,082-900-001,44444444,SHELL NAB,542.71,0,400800.31,DR,REF338390,NAB,Business
17-09-2025 02:35,NABF040DA20D1914B039B68,082-900-001,44444444,PAYMENT GATEWAY NAB,195.56,0,400604.75,DR,REF630507,NAB,Business
17-09-2025 02:42,NABC2B56B2465284831BDFB,082-900-001,44444444,ZOOM NAB,386.92,0,400217.83,DR,REF264741,NAB,Business
17-09-2025 03:01,NAB11AFBFCA13094313BD9C,082-900-001,44444444,SHELL NAB,211.74,0,400006.09,DR,REF874663,NAB,Business
17-09-2025 03:11,NAB47EDFD2C29F34E65B914,082-900-001,44444444,SHELL NAB,54.1,0,399951.99,DR,REF224472,NAB,Business
17-09-2025 03:22,NABB4CF7FA7EC5D43F8941F,082-900-001,44444444,WOOLWORTHS NAB,49.63,0,399902.36,DR,REF455375,NAB,Business
17-09-2025 03:26,NAB69C2F9A3D0684BECB8D4,082-900-001,44444444,UBER EATS NAB,134.34,0,399768.02,DR,REF102278,NAB,Business
17-09-2025 03:57,NAB1214BA1101EF423882D7,082-900-001,44444444,COLES NAB,310.38,0,399457.64,DR,REF583268,NAB,Business
17-09-2025 04:10,NAB3351AB16CBF745128031,082-900-001,44444444,JB HI-FI NAB,413.89,0,399043.75,DR,REF254852,NAB,Business
17-09-2025 04:11,NAB2EDC8CA44888432EA19A,082-900-001,44444444,COMPANY PAYROLL NAB,0,3448.99,402492.74,CR,REF948421,NAB,Business
17-09-2025 04:45,NAB1D505D692DDD487CB9A6,082-900-001,44444444,PAY - SALARY NAB,0,6372.06,408864.8,CR,REF500570,NAB,Business
17-09-2025 04:57,NAB4149ADCB070C4BB7B84E,082-900-001,44444444,BANK FEE NAB,11.37,0,408853.43,DR,REF526649,NAB,Business
17-09-2025 05:25,NABBC238CF46A1C4D72A5B7,082-900-001,44444444,KFC NAB,764.5,0,408088.93,DR,REF715120,NAB,Business
17-09-2025 06:03,NAB797E1148A1CC4F5B902E,082-900-001,44444444,INTERNET TRANSFER NAB,220.91,0,407868.02,DR,REF126193,NAB,Business
17-09-2025 06:05,NAB645B4C8A096E4C57BB4D,082-900-001,44444444,DOMINO'S PIZZA NAB,210.2,0,407657.82,DR,REF834659,NAB,Business
17-09-2025 06:13,NABA8BCAA68E8B842DEB32C,082-900-001,44444444,AMAZON AU NAB,350.36,0,407307.46,DR,REF536274,NAB,Business
17-09-2025 06:18,NAB029826F2F92948F3863E,082-900-001,44444444,TAFE BOOKSHOP NAB,700.33,0,406607.13,DR,REF282558,NAB,Business
17-09-2025 06:25,NABC08D3142500A40BDBBAA,082-900-001,44444444,PAYMENT GATEWAY NAB,86.89,0,406520.24,DR,REF264413,NAB,Business
17-09-2025 06:37,NABDE74FFD2FCB44635BCBE,082-900-001,44444444,DOMINO'S PIZZA NAB,156.33,0,406363.91,DR,REF126690,NAB,Business
17-09-2025 06:37,NAB909A7868FFF848CFBD2C,082-900-001,44444444,HARVEY NORMAN NAB,729.22,0,405634.69,DR,REF767619,NAB,Business
17-09-2025 06:45,NABABFF83E9BE944F4C9C73,082-900-001,44444444,WOOLWORTHS NAB,847.74,0,404786.95,DR,REF424349,NAB,Business
17-09-2025 07:18,NAB127A333E44D74B5AAB1A,082-900-001,44444444,UBER EATS NAB,422.91,0,404364.04,DR,REF538035,NAB,Business
17-09-2025 07:33,NAB5D033ACBD754444AA649,082-900-001,44444444,DOMINO'S PIZZA NAB,57.55,0,404306.49,DR,REF114335,NAB,Business
17-09-2025 07:36,NAB359FCAB5E477423DB60D,082-900-001,44444444,7-ELEVEN NAB,138.22,0,404168.27,DR,REF952694,NAB,Business
17-09-2025 07:41,NAB48477A69F33C4416B0B0,082-900-001,44444444,ALDI NAB,51.96,0,404116.31,DR,REF501764,NAB,Business
17-09-2025 07:48,NABEFF155C5C0A74BD99EB5,082-900-001,44444444,SALARY PAYMENT NAB,0,5021.15,409137.46,CR,REF222373,NAB,Business
17-09-2025 08:02,NABEB83FB0E17564E37BEB6,082-900-001,44444444,STARBUCKS NAB,449.74,0,408687.72,DR,REF611247,NAB,Business
17-09-2025 08:28,NABF1A256F9D52F4DEDA7B5,082-900-001,44444444,PAYPAL *NETFLIX NAB,146.98,0,408540.74,DR,REF568801,NAB,Business
17-09-2025 08:29,NABEA66D8D32FAD4E509078,082-900-001,44444444,BIGW NAB,66.59,0,408474.15,DR,REF208239,NAB,Business
17-09-2025 08:32,NAB31EC55A358294F79B202,082-900-001,44444444,BP NAB,90.58,0,408383.57,DR,REF962159,NAB,Business
17-09-2025 08:35,NABEA02B8CE4D1449419405,082-900-001,44444444,WOOLWORTHS NAB,50.42,0,408333.15,DR,REF628502,NAB,Business
17-09-2025 08:48,NAB2564DA52C4C44E04A9E6,082-900-001,44444444,ALDI NAB,28.32,0,408304.83,DR,REF972160,NAB,Business
17-09-2025 09:22,NAB8A59CE5912B24766B61E,082-900-001,44444444,AMAZON AU NAB,380.02,0,407924.81,DR,REF256472,NAB,Business
17-09-2025 09:50,NABE6598C767FD444C88520,082-900-001,44444444,APPLE NAB,543.99,0,407380.82,DR,REF859773,NAB,Business
17-09-2025 10:23,NAB17D2F0CC19D848D9BD24,082-900-001,44444444,KFC NAB,431.86,0,406948.96,DR,REF962880,NAB,Business
17-09-2025 11:02,NAB841124390C2F4A128408,082-900-001,44444444,WAGES CREDIT NAB,0,5929.83,412878.79,CR,REF629069,NAB,Business
17-09-2025 11:11,NABE4AF94FD376942CB9478,082-900-001,44444444,DOMINO'S PIZZA NAB,642.16,0,412236.63,DR,REF807526,NAB,Business
17-09-2025 11:30,NABF85A4F8B923342ACA6CF,082-900-001,44444444,LIQUORLAND NAB,320.18,0,411916.45,DR,REF907322,NAB,Business
17-09-2025 11:53,NAB8DB622D285C847759C5D,082-900-001,44444444,JB HI-FI NAB,531.84,0,411384.61,DR,REF559213,NAB,Business
17-09-2025 12:00,NAB436312861D104480AAA6,082-900-001,44444444,UBER EATS NAB,512.48,0,410872.13,DR,REF602956,NAB,Business
17-09-2025 12:26,NAB8A14D479C28C469A97CF,082-900-001,44444444,SHELL NAB,167.06,0,410705.07,DR,REF407591,NAB,Business
17-09-2025 12:47,NABC8DF29E59C8341B3A879,082-900-001,44444444,PAYROLL CREDIT NAB,0,2783.14,413488.21,CR,REF192387,NAB,Business
17-09-2025 12:48,NAB6254CD368F504E68843C,082-900-001,44444444,BANK FEE NAB,170.38,0,413317.83,DR,REF430452,NAB,Business
17-09-2025 13:24,INTF4CBA19820134C73AF96,082-900-001,44444444,TRANSFER TO CBA 22222222,1179.91,0,412137.92,DR,INT-80038,NAB,Business
17-09-2025 13:37,NABA5E714B689D34145AF97,082-900-001,44444444,PAYMENT GATEWAY NAB,102.01,0,412035.91,DR,REF244818,NAB,Business
17-09-2025 14:00,NABC0EE6D9A7482407A897F,082-900-001,44444444,BIGW NAB,574.84,0,411461.07,DR,REF286943,NAB,Business
17-09-2025 14:22,NABAA83F01AB9F844E881FC,082-900-001,44444444,SPOTIFY NAB,69.16,0,411391.91,DR,REF430607,NAB,Business
17-09-2025 14:24,NAB547D7AD21BC54D8C924C,082-900-001,44444444,7-ELEVEN NAB,89.5,0,411302.41,DR,REF493940,NAB,Business
17-09-2025 14:43,NAB4E445A00E2ED4933A3CD,082-900-001,44444444,SHELL NAB,187.99,0,411114.42,DR,REF929883,NAB,Business
17-09-2025 14:54,NAB07CC4C06404B4EBDA7FB,082-900-001,44444444,COLES NAB,248.28,0,410866.14,DR,REF977258,NAB,Business
17-09-2025 15:08,NABC5706A5500204371A7B7,082-900-001,44444444,APPLE NAB,162.95,0,410703.19,DR,REF101427,NAB,Business
17-09-2025 15:17,NABCD81868A534E4352A0E8,082-900-001,44444444,BP NAB,215.74,0,410487.45,DR,REF289362,NAB,Business
17-09-2025 15:18,NABBAEAC1B6B30C4846BC6C,082-900-001,44444444,MENULOG NAB,737.24,0,409750.21,DR,REF569479,NAB,Business
17-09-2025 15:51,INT41204A28C0064EE78213,082-900-001,44444444,TRANSFER TO CBA 22222222,725.57,0,409024.64,DR,INT-71285,NAB,Business
17-09-2025 15:56,NAB98F4256DCDB043529CAC,082-900-001,44444444,PAYPAL *NETFLIX NAB,139.84,0,408884.8,DR,REF950083,NAB,Business
17-09-2025 16:15,NAB62A87BA0E6084E448DEF,082-900-001,44444444,LIQUORLAND NAB,46.13,0,408838.67,DR,REF298034,NAB,Business
17-09-2025 16:28,NABB8B8826D24094224AA60,082-900-001,44444444,DOMINO'S PIZZA NAB,656.89,0,408181.78,DR,REF524573,NAB,Business
17-09-2025 16:45,NAB0F4573949C554456A36A,082-900-001,44444444,7-ELEVEN NAB,329.79,0,407851.99,DR,REF739980,NAB,Business
17-09-2025 17:05,NABB3B6FF87B41B483BB3CE,082-900-001,44444444,STARBUCKS NAB,1194.29,0,406657.7,DR,REF854445,NAB,Business
17-09-2025 17:10,NAB0C4E70AA58B841518D90,082-900-001,44444444,SALARY PAYMENT NAB,0,6277.84,412935.54,CR,REF404033,NAB,Business
17-09-2025 17:13,NABF63AE73B21CD4D3DBE9C,082-900-001,44444444,ZOOM NAB,74.18,0,412861.36,DR,REF464574,NAB,Business
17-09-2025 17:32,NAB3BDBB04542EE4B2AA14C,082-900-001,44444444,CITYLINK NAB,365.46,0,412495.9,DR,REF515441,NAB,Business
17-09-2025 18:02,NABDC7DDDC6D28B4805B064,082-900-001,44444444,HARVEY NORMAN NAB,333.71,0,412162.19,DR,REF449686,NAB,Business
17-09-2025 18:03,NAB80A3E61B2C3C4596ADE0,082-900-001,44444444,MCDONALDS NAB,310.09,0,411852.1,DR,REF927379,NAB,Business
17-09-2025 18:46,NABB85DA44B84674B92AF4B,082-900-001,44444444,CITYLINK NAB,1091.87,0,410760.23,DR,REF607359,NAB,Business
17-09-2025 19:50,NAB843591A10E38460C8990,082-900-001,44444444,RAILWAY STATION NAB,19.59,0,410740.64,DR,REF207079,NAB,Business
17-09-2025 19:53,NAB3DABDF4404904708A51A,082-900-001,44444444,MCDONALDS NAB,372.15,0,410368.49,DR,REF377060,NAB,Business
17-09-2025 19:58,NAB678AE7AB116E417EB48A,082-900-001,44444444,TAFE BOOKSHOP NAB,85.27,0,410283.22,DR,REF445830,NAB,Business
17-09-2025 20:00,NABA594859093B247F3A1BA,082-900-001,44444444,WAGES CREDIT NAB,0,4779.77,415062.99,CR,REF387395,NAB,Business
17-09-2025 20:12,NAB1D330DC3B0A444168573,082-900-001,44444444,SHELL NAB,834.26,0,414228.73,DR,REF709348,NAB,Business
17-09-2025 20:55,NABC84495D29D4A441EAFA3,082-900-001,44444444,SHELL NAB,228.71,0,414000.02,DR,REF887193,NAB,Business
17-09-2025 20:59,NABE27DBB24A9DB4BDEA590,082-900-001,44444444,BP NAB,242.31,0,413757.71,DR,REF165061,NAB,Business
17-09-2025 21:20,NABFBE7EFA5880F48D79022,082-900-001,44444444,CITYLINK NAB,174.6,0,413583.11,DR,REF227967,NAB,Business
17-09-2025 21:32,NAB6F5E546455DA4E7D945B,082-900-001,44444444,HARVEY NORMAN NAB,361.53,0,413221.58,DR,REF501345,NAB,Business
17-09-2025 21:35,NAB6069DE9FA6724194831E,082-900-001,44444444,MCDONALDS NAB,338.24,0,412883.34,DR,REF680280,NAB,Business
17-09-2025 21:48,INT24353613A477421CBCD5,082-900-001,44444444,TRANSFER TO CBA 22222222,705.15,0,412178.19,DR,INT-31385,NAB,Business
17-09-2025 22:03,NABB9CC2066471A49E1AAD2,082-900-001,44444444,PAYROLL CREDIT NAB,0,6445.44,418623.63,CR,REF801955,NAB,Business
17-09-2025 22:10,NAB5DA790EAAFD34B59BE86,082-900-001,44444444,APPLE NAB,243.74,0,418379.89,DR,REF373008,NAB,Business
17-09-2025 22:18,NAB0A5DA7BECE534339A852,082-900-001,44444444,AMAZON AU NAB,131.12,0,418248.77,DR,REF284273,NAB,Business
17-09-2025 22:29,NABF6003B2D63B44E3DB4C7,082-900-001,44444444,MENULOG NAB,91.21,0,418157.56,DR,REF999875,NAB,Business
17-09-2025 22:41,NAB0B7307C0750140E185FF,082-900-001,44444444,KFC NAB,149.98,0,418007.58,DR,REF513325,NAB,Business
17-09-2025 22:56,NAB68356FEE17E84A7798CC,082-900-001,44444444,WOOLWORTHS NAB,126.03,0,417881.55,DR,REF555463,NAB,Business
17-09-2025 23:10,NAB39736EB1AF7E45E58CE5,082-900-001,44444444,PAY - SALARY NAB,0,2989.88,420871.43,CR,REF975466,NAB,Business
17-09-2025 23:17,NAB5D6827BF846348EEB4A3,082-900-001,44444444,BANK FEE NAB,177.42,0,420694.01,DR,REF127383,NAB,Business
18-09-2025 00:00,NAB7F034B8EBB1946669455,082-900-001,44444444,CITYLINK NAB,173.31,0,420520.7,DR,REF622863,NAB,Business
18-09-2025 00:12,NABBC3CCBCA1BA64C969B29,082-900-001,44444444,AMAZON AU NAB,115.68,0,420405.02,DR,REF188928,NAB,Business
18-09-2025 00:39,NABDAB351A7C17748D7860E,082-900-001,44444444,STARBUCKS NAB,127.72,0,420277.3,DR,REF927657,NAB,Business
18-09-2025 00:46,NAB0614A04147BB481A80BD,082-900-001,44444444,BANK FEE NAB,1197.44,0,419079.86,DR,REF846676,NAB,Business
18-09-2025 01:02,NABAC43C5A0BDFA49D5B228,082-900-001,44444444,STARBUCKS NAB,626.98,0,418452.88,DR,REF445903,NAB,Business
18-09-2025 01:08,NABDC8FBB89AA9F425B8A1E,082-900-001,44444444,UBER EATS NAB,759.19,0,417693.69,DR,REF837666,NAB,Business
18-09-2025 01:22,NAB59D9DF06B8A840D18F4B,082-900-001,44444444,CITYLINK NAB,732.1,0,416961.59,DR,REF969791,NAB,Business
18-09-2025 01:43,INTA196DE36BEAA40379F42,082-900-001,44444444,TRANSFER TO ANZ 11111111,838.89,0,416122.7,DR,INT-76338,NAB,Business
18-09-2025 01:58,NABD6FCDE6007574EC7871A,082-900-001,44444444,COLES NAB,73.97,0,416048.73,DR,REF912197,NAB,Business
18-09-2025 01:59,NABA7FB5F75936F435E8285,082-900-001,44444444,COLES NAB,107.89,0,415940.84,DR,REF367060,NAB,Business
18-09-2025 02:10,NAB0A71DEC4D89D49C79E39,082-900-001,44444444,JB HI-FI NAB,174.92,0,415765.92,DR,REF919193,NAB,Business
18-09-2025 02:21,NABC10BF9CF3745436DA213,082-900-001,44444444,PAYROLL CREDIT NAB,0,6230.12,421996.04,CR,REF214464,NAB,Business
18-09-2025 02:29,NAB1E3714EA445D45B78E11,082-900-001,44444444,STARBUCKS NAB,532.41,0,421463.63,DR,REF384264,NAB,Business
18-09-2025 02:46,NABDD62BF0D3B524D8ABB8F,082-900-001,44444444,LIQUORLAND NAB,261.96,0,421201.67,DR,REF169322,NAB,Business
18-09-2025 02:52,NABFCC75E70ED594C65B339,082-900-001,44444444,MENULOG NAB,597.64,0,420604.03,DR,REF958789,NAB,Business
18-09-2025 03:07,NABC0621C67C59D487D936A,082-900-001,44444444,WOOLWORTHS NAB,150.53,0,420453.5,DR,REF432574,NAB,Business
18-09-2025 03:29,NAB6E44EF0CC7FA4C70985B,082-900-001,44444444,PAYPAL *NETFLIX NAB,84.18,0,420369.32,DR,REF602331,NAB,Business
18-09-2025 03:30,NABD735E79D72904C68B497,082-900-001,44444444,KFC NAB,571.33,0,419797.99,DR,REF677006,NAB,Business
18-09-2025 04:17,NAB170B94C74A804D2AAFD7,082-900-001,44444444,DOMINO'S PIZZA NAB,158.26,0,419639.73,DR,REF334325,NAB,Business
18-09-2025 04:30,NABDAF97D5C354C41F0913B,082-900-001,44444444,TAFE BOOKSHOP NAB,263.24,0,419376.49,DR,REF126381,NAB,Business
18-09-2025 05:59,NAB5CACFE13B3D341848177,082-900-001,44444444,LIQUORLAND NAB,132.19,0,419244.3,DR,REF332860,NAB,Business
18-09-2025 06:01,NABC6D2A477D98D462E8951,082-900-001,44444444,7-ELEVEN NAB,1737.63,0,417506.67,DR,REF895949,NAB,Business
18-09-2025 06:32,NAB7A0F2AF74FBD4C74A9D9,082-900-001,44444444,SPOTIFY NAB,241.9,0,417264.77,DR,REF751900,NAB,Business
18-09-2025 06:50,NAB771DF72D63CD4DF6843D,082-900-001,44444444,LIQUORLAND NAB,309.74,0,416955.03,DR,REF481703,NAB,Business
18-09-2025 07:45,NABCBD0568C075547B3889C,082-900-001,44444444,FLIXBUS NAB,399.35,0,416555.68,DR,REF556114,NAB,Business
18-09-2025 07:58,NABD7D0496EEE5343A4B201,082-900-001,44444444,RAILWAY STATION NAB,651.72,0,415903.96,DR,REF559149,NAB,Business
18-09-2025 08:38,NAB07F31BC5D76B4CC49312,082-900-001,44444444,DOMINO'S PIZZA NAB,177.73,0,415726.23,DR,REF463140,NAB,Business
18-09-2025 08:40,NAB7B5D6FA2D60D45D5A587,082-900-001,44444444,FLIXBUS NAB,1282.92,0,414443.31,DR,REF811287,NAB,Business
18-09-2025 08:43,NABE4EF1230667E4B89BC1A,082-900-001,44444444,LIQUORLAND NAB,273.52,0,414169.79,DR,REF247335,NAB,Business
18-09-2025 09:01,NAB1ED55C884D9D4C7D8818,082-900-001,44444444,AMAZON AU NAB,307.25,0,413862.54,DR,REF897733,NAB,Business
18-09-2025 09:36,NAB1928A961AA9345BA803D,082-900-001,44444444,ALDI NAB,133.46,0,413729.08,DR,REF983690,NAB,Business
18-09-2025 09:42,NAB7563FC77BADA40388B37,082-900-001,44444444,BP NAB,411.81,0,413317.27,DR,REF939107,NAB,Business
18-09-2025 09:44,NABD0C5795B100A406F8DB0,082-900-001,44444444,COMPANY PAYROLL NAB,0,1054.43,414371.7,CR,REF957354,NAB,Business
18-09-2025 10:15,NABE0B10BD1C90E430A98EB,082-900-001,44444444,ZOOM NAB,111.3,0,414260.4,DR,REF461283,NAB,Business
18-09-2025 12:02,NAB6585A778174A4BDE8A37,082-900-001,44444444,BWS NAB,481.5,0,413778.9,DR,REF857944,NAB,Business
18-09-2025 12:23,NABD0E8F9EC2D8D4A068797,082-900-001,44444444,BP NAB,90.27,0,413688.63,DR,REF826700,NAB,Business
18-09-2025 12:26,NABBB83B353C6C240439D91,082-900-001,44444444,PAYMENT GATEWAY NAB,136.78,0,413551.85,DR,REF636369,NAB,Business
18-09-2025 12:28,INT73E20D0FD9894922825A,082-900-001,44444444,TRANSFER FROM CBA 33333333,0,1244.59,414796.44,CR,INT-83857,NAB,Business
18-09-2025 13:14,NAB156E054703C4436D8294,082-900-001,44444444,DOMINO'S PIZZA NAB,287.57,0,414508.87,DR,REF387949,NAB,Business
18-09-2025 13:23,NAB02F7CEF9832548F19DF5,082-900-001,44444444,PAYROLL CREDIT NAB,0,5714.29,420223.16,CR,REF156943,NAB,Business
18-09-2025 13:44,NAB67B07B7FD7D0443D9343,082-900-001,44444444,LIQUORLAND NAB,154.06,0,420069.1,DR,REF751244,NAB,Business
18-09-2025 13:49,NAB88910003C96A42F9A331,082-900-001,44444444,HARVEY NORMAN NAB,1096.07,0,418973.03,DR,REF792605,NAB,Business
18-09-2025 14:02,NAB926B2BAF022048E5B511,082-900-001,44444444,STARBUCKS NAB,42.95,0,418930.08,DR,REF426011,NAB,Business
18-09-2025 14:28,NABC2CB3304D63D486FBBBE,082-900-001,44444444,COLES NAB,84.75,0,418845.33,DR,REF788988,NAB,Business
18-09-2025 14:33,NAB7B54F603213A4818A141,082-900-001,44444444,MCDONALDS NAB,484.84,0,418360.49,DR,REF696393,NAB,Business
18-09-2025 14:50,NAB43B90303E80646B597BD,082-900-001,44444444,CITYLINK NAB,107.57,0,418252.92,DR,REF265476,NAB,Business
18-09-2025 14:56,NABA5295854DDE741F9B537,082-900-001,44444444,7-ELEVEN NAB,90.22,0,418162.7,DR,REF393729,NAB,Business
18-09-2025 15:23,NAB22811FB1ECF9473A8D0B,082-900-001,44444444,PAYMENT GATEWAY NAB,857.34,0,417305.36,DR,REF820735,NAB,Business
18-09-2025 15:24,NAB6A3DEFF721F2426F88D4,082-900-001,44444444,SPOTIFY NAB,688.78,0,416616.58,DR,REF242371,NAB,Business
18-09-2025 15:32,NAB8808ED08E9184E0A8BB0,082-900-001,44444444,BIGW NAB,148.16,0,416468.42,DR,REF121932,NAB,Business
18-09-2025 16:29,NAB3E59A79689A74109920C,082-900-001,44444444,PAYPAL *NETFLIX NAB,1137.58,0,415330.84,DR,REF471334,NAB,Business
18-09-2025 16:29,NABC0AEF225319641CBA2DB,082-900-001,44444444,STARBUCKS NAB,186.1,0,415144.74,DR,REF870223,NAB,Business
18-09-2025 16:36,NAB89FE293AD54648F494E5,082-900-001,44444444,LIQUORLAND NAB,473.6,0,414671.14,DR,REF941934,NAB,Business
18-09-2025 16:37,NAB77020B7E598543BA8041,082-900-001,44444444,MENULOG NAB,653.01,0,414018.13,DR,REF195371,NAB,Business
18-09-2025 16:53,INTAAED2D3C29D842B29340,082-900-001,44444444,TRANSFER FROM CBA 33333333,0,651.88,414670.01,CR,INT-69499,NAB,Business
18-09-2025 16:56,NAB362C029E2E5A43CE980E,082-900-001,44444444,WOOLWORTHS NAB,177.36,0,414492.65,DR,REF502898,NAB,Business
18-09-2025 17:03,NABBB0E0F0F644D409E93CE,082-900-001,44444444,BANK FEE NAB,711.8,0,413780.85,DR,REF626510,NAB,Business
18-09-2025 17:43,NABB3A95E07A5BF42ACB705,082-900-001,44444444,ALDI NAB,39.22,0,413741.63,DR,REF690568,NAB,Business
18-09-2025 18:03,NABF0CEABA399F242C68080,082-900-001,44444444,APPLE NAB,69.32,0,413672.31,DR,REF181462,NAB,Business
18-09-2025 18:58,NABDA8007EEE7EB425FA22F,082-900-001,44444444,HARVEY NORMAN NAB,663.94,0,413008.37,DR,REF186008,NAB,Business
18-09-2025 19:26,NAB88250C9CE6AD4D91984F,082-900-001,44444444,HARVEY NORMAN NAB,200.25,0,412808.12,DR,REF483061,NAB,Business
18-09-2025 19:39,NAB798ED2F929F940738E26,082-900-001,44444444,UBER EATS NAB,207.66,0,412600.46,DR,REF906037,NAB,Business
18-09-2025 20:42,NAB7C2A3E29EA16424DB0E0,082-900-001,44444444,PAYPAL *NETFLIX NAB,87.84,0,412512.62,DR,REF427964,NAB,Business
18-09-2025 21:13,NABDA7CBBCE07D84B0AA343,082-900-001,44444444,UBER EATS NAB,235.74,0,412276.88,DR,REF112349,NAB,Business
18-09-2025 21:21,NAB64D8668D2C7D46FEA927,082-900-001,44444444,STARBUCKS NAB,305.1,0,411971.78,DR,REF726182,NAB,Business
18-09-2025 23:15,NAB11EA8901F5DF4ED4999A,082-900-001,44444444,SALARY PAYMENT NAB,0,5894.34,417866.12,CR,REF994224,NAB,Business
18-09-2025 23:32,NAB77EC6EAFBE6840A1BC5A,082-900-001,44444444,JB HI-FI NAB,53.48,0,417812.64,DR,REF468668,NAB,Business
18-09-2025 23:36,NAB934056A07E7F49CABDC3,082-900-001,44444444,ZOOM NAB,205.5,0,417607.14,DR,REF154089,NAB,Business
18-09-2025 23:43,NAB48AFBADCBEB845809DE9,082-900-001,44444444,TAFE BOOKSHOP NAB,392.98,0,417214.16,DR,REF199799,NAB,Business
18-09-2025 23:44,NABB739B1A41AA04C30A2C4,082-900-001,44444444,JB HI-FI NAB,766.48,0,416447.68,DR,REF459720,NAB,Business
18-09-2025 23:50,INTC520333583164CB78E7D,082-900-001,44444444,TRANSFER TO CBA 33333333,253.9,0,416193.78,DR,INT-55250,NAB,Business
19-09-2025 00:22,NAB9507817CBBCA4F80B9B5,082-900-001,44444444,HARVEY NORMAN NAB,308.31,0,415885.47,DR,REF470333,NAB,Business
19-09-2025 01:15,NAB5F6679300F664FC8A7C7,082-900-001,44444444,CITYLINK NAB,458.81,0,415426.66,DR,REF269521,NAB,Business
19-09-2025 01:38,INTD5DD628A01D74BEC8B4C,082-900-001,44444444,TRANSFER TO CBA 33333333,1389.23,0,414037.43,DR,INT-31426,NAB,Business
19-09-2025 01:46,NAB7E218B2E781B466E85EB,082-900-001,44444444,ALDI NAB,69.14,0,413968.29,DR,REF327934,NAB,Business
19-09-2025 02:54,NAB98E3B787BED048DC8511,082-900-001,44444444,ZOOM NAB,30.53,0,413937.76,DR,REF814143,NAB,Business
19-09-2025 03:30,NAB24A3D810011749EAB994,082-900-001,44444444,ALDI NAB,259.59,0,413678.17,DR,REF838008,NAB,Business
19-09-2025 03:54,INTBE865F717DD34770B8A8,082-900-001,44444444,TRANSFER TO ANZ 11111111,734.73,0,412943.44,DR,INT-19646,NAB,Business
19-09-2025 04:04,NAB4778081D6421431EAA87,082-900-001,44444444,ALDI NAB,234.62,0,412708.82,DR,REF894831,NAB,Business
19-09-2025 04:11,NABF99B196484534BB7BFC3,082-900-001,44444444,JB HI-FI NAB,820.06,0,411888.76,DR,REF396293,NAB,Business
19-09-2025 04:34,NABC61DFAFBD4C04DE48731,082-900-001,44444444,KFC NAB,43.71,0,411845.05,DR,REF728108,NAB,Business
19-09-2025 04:39,NAB7850754DBE3D476CBB74,082-900-001,44444444,COMPANY PAYROLL NAB,0,3447.56,415292.61,CR,REF460474,NAB,Business
19-09-2025 04:45,NAB9AD366A8FBC5468EA2B9,082-900-001,44444444,HARVEY NORMAN NAB,98.75,0,415193.86,DR,REF261667,NAB,Business
19-09-2025 05:06,NAB0B4F2150636645AB958A,082-900-001,44444444,BWS NAB,75.47,0,415118.39,DR,REF777065,NAB,Business
19-09-2025 05:09,INT0206545D241E4BA68A10,082-900-001,44444444,TRANSFER FROM CBA 22222222,0,148.21,415266.6,CR,INT-13645,NAB,Business
19-09-2025 05:20,NAB93546EE8A9B84F59ADFA,082-900-001,44444444,JB HI-FI NAB,1354.69,0,413911.91,DR,REF246700,NAB,Business
19-09-2025 05:21,NAB6CF6B8E848C24D23803B,082-900-001,44444444,UBER EATS NAB,207.51,0,413704.4,DR,REF858712,NAB,Business
19-09-2025 05:49,NAB3419B7C0128842CA8E38,082-900-001,44444444,INTERNET TRANSFER NAB,326.77,0,413377.63,DR,REF364127,NAB,Business
19-09-2025 05:55,NAB411FC90F11F1412D8121,082-900-001,44444444,BP NAB,211.06,0,413166.57,DR,REF929770,NAB,Business
19-09-2025 06:08,NABDAE54399C4974EB9922D,082-900-001,44444444,PAYROLL CREDIT NAB,0,2353.37,415519.94,CR,REF614586,NAB,Business
19-09-2025 06:08,NAB5BB3CB661A39467BAC86,082-900-001,44444444,COMPANY PAYROLL NAB,0,1766.75,417286.69,CR,REF264603,NAB,Business
19-09-2025 06:50,NABC742C14CB6E5469083A4,082-900-001,44444444,SALARY PAYMENT NAB,0,315.57,417602.26,CR,REF986795,NAB,Business
19-09-2025 06:59,INT1BB23E6701DD45D8825A,082-900-001,44444444,TRANSFER TO CBA 33333333,915.39,0,416686.87,DR,INT-59237,NAB,Business
19-09-2025 07:13,NAB54989723E9D74E6FBF37,082-900-001,44444444,ALDI NAB,547.16,0,416139.71,DR,REF954155,NAB,Business
19-09-2025 07:59,NAB7CED3D91168E4EC581DC,082-900-001,44444444,LIQUORLAND NAB,254.9,0,415884.81,DR,REF822579,NAB,Business
19-09-2025 08:00,NAB946B869482C8470E96F4,082-900-001,44444444,BWS NAB,461.33,0,415423.48,DR,REF261535,NAB,Business
19-09-2025 08:07,NAB2BC366FEBE374E24A970,082-900-001,44444444,AMAZON AU NAB,89.43,0,415334.05,DR,REF886585,NAB,Business
19-09-2025 08:09,NAB92F6A892B34748CBACED,082-900-001,44444444,MCDONALDS NAB,78.43,0,415255.62,DR,REF309148,NAB,Business
19-09-2025 08:13,NAB0DF208721584401B8257,082-900-001,44444444,KFC NAB,266.63,0,414988.99,DR,REF348862,NAB,Business
19-09-2025 08:22,NAB0DE7332180934DC3BACC,082-900-001,44444444,PAYMENT GATEWAY NAB,183.9,0,414805.09,DR,REF636071,NAB,Business
19-09-2025 09:34,NABA2E7E23472D84E3A8690,082-900-001,44444444,KFC NAB,166.64,0,414638.45,DR,REF731013,NAB,Business
19-09-2025 10:00,NAB7B79A4CADDB14682947F,082-900-001,44444444,SALARY PAYMENT NAB,0,1821.25,416459.7,CR,REF405532,NAB,Business
19-09-2025 10:02,NAB526F8C1D8AE9405CA8DA,082-900-001,44444444,WAGES CREDIT NAB,0,1681.82,418141.52,CR,REF457206,NAB,Business
19-09-2025 10:47,NAB6078435D101542538EB3,082-900-001,44444444,7-ELEVEN NAB,49.07,0,418092.45,DR,REF300960,NAB,Business
19-09-2025 10:50,NAB87E86587AC254638808F,082-900-001,44444444,JB HI-FI NAB,431.25,0,417661.2,DR,REF219148,NAB,Business
19-09-2025 11:36,NAB062BA76326214D34BC30,082-900-001,44444444,WAGES CREDIT NAB,0,5223.87,422885.07,CR,REF389504,NAB,Business
19-09-2025 12:01,NAB443270B050914F3996EC,082-900-001,44444444,BANK FEE NAB,161.2,0,422723.87,DR,REF210185,NAB,Business
19-09-2025 12:41,NABC085DD20167A459B931B,082-900-001,44444444,BP NAB,49.79,0,422674.08,DR,REF806873,NAB,Business
19-09-2025 12:55,NAB229D0E808C854A41A9F7,082-900-001,44444444,ZOOM NAB,112.39,0,422561.69,DR,REF713614,NAB,Business
19-09-2025 13:28,NAB5BDE323164F3450D888E,082-900-001,44444444,APPLE NAB,1004.71,0,421556.98,DR,REF224578,NAB,Business
19-09-2025 13:35,NAB893A694767514FB2AC22,082-900-001,44444444,COMPANY PAYROLL NAB,0,4656.17,426213.15,CR,REF874063,NAB,Business
19-09-2025 13:47,NABF30842C0145C469D83E0,082-900-001,44444444,FLIXBUS NAB,295.46,0,425917.69,DR,REF801893,NAB,Business
19-09-2025 13:52,NAB1C3816CDD44C49D68053,082-900-001,44444444,BP NAB,395.39,0,425522.3,DR,REF786219,NAB,Business
19-09-2025 13:56,NAB3C8AAFD611544914869F,082-900-001,44444444,PAYROLL CREDIT NAB,0,7277.59,432799.89,CR,REF400211,NAB,Business
19-09-2025 13:58,NAB9E59258610134956B664,082-900-001,44444444,LIQUORLAND NAB,52.94,0,432746.95,DR,REF567680,NAB,Business
19-09-2025 14:26,NABC4F79040C5BE4AFE8B6C,082-900-001,44444444,WOOLWORTHS NAB,218.03,0,432528.92,DR,REF258696,NAB,Business
19-09-2025 14:29,NAB8B53FCE5CD334BC1BECA,082-900-001,44444444,CITYLINK NAB,169.98,0,432358.94,DR,REF694913,NAB,Business
19-09-2025 14:33,NAB65F51E5C3D4A4BC09B06,082-900-001,44444444,UBER EATS NAB,209.95,0,432148.99,DR,REF551806,NAB,Business
19-09-2025 14:47,NAB9B0BAF198A724ED5B94B,082-900-001,44444444,PAYPAL *NETFLIX NAB,122.86,0,432026.13,DR,REF195783,NAB,Business
19-09-2025 14:52,NABA4A61E8775CC495DA902,082-900-001,44444444,HARVEY NORMAN NAB,96.38,0,431929.75,DR,REF360306,NAB,Business
19-09-2025 14:57,NAB322EB1E5868E4E17BDD4,082-900-001,44444444,PAYPAL *NETFLIX NAB,720.11,0,431209.64,DR,REF291181,NAB,Business
19-09-2025 15:14,NAB8759E73182E449D5B9E5,082-900-001,44444444,7-ELEVEN NAB,79.74,0,431129.9,DR,REF576808,NAB,Business
19-09-2025 15:51,NAB18C2672707C746C5972D,082-900-001,44444444,APPLE NAB,271.59,0,430858.31,DR,REF788619,NAB,Business
19-09-2025 16:13,NAB8A998D248C854CFB9F41,082-900-001,44444444,RAILWAY STATION NAB,183.58,0,430674.73,DR,REF986416,NAB,Business
19-09-2025 16:33,NAB97B80E0E0A144D22A491,082-900-001,44444444,DOMINO'S PIZZA NAB,686.05,0,429988.68,DR,REF258606,NAB,Business
19-09-2025 16:58,NAB4208F6358C364FD79CC7,082-900-001,44444444,PAYMENT GATEWAY NAB,362.19,0,429626.49,DR,REF135036,NAB,Business
19-09-2025 18:08,NAB5CBB1EC2212341C1BF8B,082-900-001,44444444,MCDONALDS NAB,30.18,0,429596.31,DR,REF471233,NAB,Business
19-09-2025 18:19,NAB17BDCBFDCEA24EADB5C1,082-900-001,44444444,ALDI NAB,200.42,0,429395.89,DR,REF616711,NAB,Business
19-09-2025 19:11,NAB161AEA2035294597873E,082-900-001,44444444,LIQUORLAND NAB,325.16,0,429070.73,DR,REF556827,NAB,Business
19-09-2025 19:34,NABB4CA44199B0E4BAFB2EF,082-900-001,44444444,MCDONALDS NAB,92.55,0,428978.18,DR,REF896646,NAB,Business
19-09-2025 20:06,NAB739A8C9B85B54B5F97DA,082-900-001,44444444,BP NAB,387.03,0,428591.15,DR,REF688030,NAB,Business
19-09-2025 20:22,NAB02697B3183F747E18B5F,082-900-001,44444444,MENULOG NAB,437.55,0,428153.6,DR,REF910448,NAB,Business
19-09-2025 20:30,NAB38B7C0AB81644BBF886D,082-900-001,44444444,INTERNET TRANSFER NAB,77.22,0,428076.38,DR,REF539947,NAB,Business
19-09-2025 20:49,NAB9DC8899A134044CD9F5B,082-900-001,44444444,BIGW NAB,135.79,0,427940.59,DR,REF618016,NAB,Business
19-09-2025 21:05,NABE7FAE8039D5942B09675,082-900-001,44444444,SHELL NAB,285.8,0,427654.79,DR,REF419023,NAB,Business
19-09-2025 21:58,NABBE237D17D3844FC6A6E8,082-900-001,44444444,INTERNET TRANSFER NAB,261.85,0,427392.94,DR,REF496666,NAB,Business
19-09-2025 22:11,NABF3B39DA4234549298DA2,082-900-001,44444444,FLIXBUS NAB,75.21,0,427317.73,DR,REF221403,NAB,Business
19-09-2025 22:31,NAB7923D436E4AE47D09B1E,082-900-001,44444444,SPOTIFY NAB,230.44,0,427087.29,DR,REF114290,NAB,Business
19-09-2025 22:31,NAB63ECFCC9BA4844D58EFE,082-900-001,44444444,COMPANY PAYROLL NAB,0,668.03,427755.32,CR,REF798649,NAB,Business
19-09-2025 22:41,NAB88C6504C89E149298716,082-900-001,44444444,PAYROLL CREDIT NAB,0,1002.39,428757.71,CR,REF800871,NAB,Business
19-09-2025 22:50,NAB8F21D177B08F423D94D1,082-900-001,44444444,INTERNET TRANSFER NAB,135.18,0,428622.53,DR,REF465238,NAB,Business
19-09-2025 23:05,NABA4587D60EF3C43EB91B4,082-900-001,44444444,CITYLINK NAB,298.25,0,428324.28,DR,REF295371,NAB,Business
19-09-2025 23:13,NABAD9976304BB74A8ABA4C,082-900-001,44444444,LIQUORLAND NAB,79.11,0,428245.17,DR,REF290848,NAB,Business
19-09-2025 23:21,NAB27C677FAF2AA4C38B711,082-900-001,44444444,AMAZON AU NAB,151.49,0,428093.68,DR,REF606574,NAB,Business
20-09-2025 00:03,NABBCFA596EB1DE44918426,082-900-001,44444444,UBER EATS NAB,159.5,0,427934.18,DR,REF539343,NAB,Business
20-09-2025 00:13,NAB6763D678691549CF89BD,082-900-001,44444444,STARBUCKS NAB,552.72,0,427381.46,DR,REF159344,NAB,Business
20-09-2025 00:21,NAB6A394782774F48D7A2A2,082-900-001,44444444,LIQUORLAND NAB,553.26,0,426828.2,DR,REF115156,NAB,Business
20-09-2025 00:31,NAB137DDECA9A9E4C75A7A4,082-900-001,44444444,CITYLINK NAB,110.58,0,426717.62,DR,REF894437,NAB,Business
20-09-2025 01:15,NAB4A62947237154E3EBDCC,082-900-001,44444444,WOOLWORTHS NAB,329.7,0,426387.92,DR,REF114346,NAB,Business
20-09-2025 01:21,NABEE171BB875D84721A930,082-900-001,44444444,BP NAB,522.88,0,425865.04,DR,REF412141,NAB,Business
20-09-2025 02:15,NAB21224AD28758454A9B00,082-900-001,44444444,UBER EATS NAB,873.54,0,424991.5,DR,REF192801,NAB,Business
20-09-2025 02:24,NAB4D21911ADBD34F8B9505,082-900-001,44444444,INTERNET TRANSFER NAB,289.97,0,424701.53,DR,REF901121,NAB,Business
20-09-2025 02:50,NAB39E8772669FF42A1BBE1,082-900-001,44444444,SPOTIFY NAB,126.81,0,424574.72,DR,REF233230,NAB,Business
20-09-2025 02:51,NABF8BE1F8FEE84412096B9,082-900-001,44444444,APPLE NAB,31.92,0,424542.8,DR,REF527468,NAB,Business
20-09-2025 03:19,INTF77D0DB9824441ECBA2C,082-900-001,44444444,TRANSFER TO ANZ 11111111,556.68,0,423986.12,DR,INT-56930,NAB,Business
20-09-2025 04:08,NAB218D451FC8ED46AD8990,082-900-001,44444444,SALARY PAYMENT NAB,0,5525.14,429511.26,CR,REF282233,NAB,Business
20-09-2025 04:59,NABE59AA808F4C84F8FB97C,082-900-001,44444444,INTERNET TRANSFER NAB,555.18,0,428956.08,DR,REF817979,NAB,Business
20-09-2025 05:00,NABE203A018B8CF44A2ACD4,082-900-001,44444444,FLIXBUS NAB,55.01,0,428901.07,DR,REF483756,NAB,Business
20-09-2025 05:03,NABAF415128CF7F484F846B,082-900-001,44444444,JB HI-FI NAB,523.76,0,428377.31,DR,REF361626,NAB,Business
20-09-2025 05:27,NAB700513DF447244A9ABB9,082-900-001,44444444,STARBUCKS NAB,656.9,0,427720.41,DR,REF655997,NAB,Business
20-09-2025 05:28,NAB6316234610AF4EA5B376,082-900-001,44444444,PAYROLL CREDIT NAB,0,765.94,428486.35,CR,REF864936,NAB,Business
20-09-2025 05:37,NAB9EF7FC53050D4F9EAB5C,082-900-001,44444444,RAILWAY STATION NAB,55.12,0,428431.23,DR,REF230682,NAB,Business
20-09-2025 05:41,NAB356BEDACAB074A9193A3,082-900-001,44444444,BP NAB,255.46,0,428175.77,DR,REF730227,NAB,Business
20-09-2025 06:38,NAB40AFDE33126843E19998,082-900-001,44444444,7-ELEVEN NAB,457.94,0,427717.83,DR,REF142579,NAB,Business
20-09-2025 06:39,NAB369D1CA279FC49FE9C49,082-900-001,44444444,7-ELEVEN NAB,230.4,0,427487.43,DR,REF186905,NAB,Business
20-09-2025 06:44,NABE07D09C75FC641778B64,082-900-001,44444444,MCDONALDS NAB,168.9,0,427318.53,DR,REF947031,NAB,Business
20-09-2025 07:31,NAB30587684BE4B422C9CB1,082-900-001,44444444,PAYPAL *NETFLIX NAB,180.08,0,427138.45,DR,REF182138,NAB,Business
20-09-2025 07:53,NAB537967872F4449979E55,082-900-001,44444444,MCDONALDS NAB,526.51,0,426611.94,DR,REF811090,NAB,Business
20-09-2025 07:53,NAB0FD6001B33DD447FB2D8,082-900-001,44444444,SHELL NAB,1453.76,0,425158.18,DR,REF185735,NAB,Business
20-09-2025 08:24,NAB35FA8A8559F94474BA86,082-900-001,44444444,MENULOG NAB,919.44,0,424238.74,DR,REF781712,NAB,Business
20-09-2025 08:48,NAB84641651E01F452F88CE,082-900-001,44444444,DOMINO'S PIZZA NAB,370.46,0,423868.28,DR,REF735942,NAB,Business
20-09-2025 08:58,NAB24CD7FED1EB64215A864,082-900-001,44444444,BIGW NAB,185.6,0,423682.68,DR,REF416182,NAB,Business
20-09-2025 09:10,NAB46759005FB66435984CB,082-900-001,44444444,SPOTIFY NAB,80.32,0,423602.36,DR,REF368253,NAB,Business
20-09-2025 09:27,NAB9907F867BD04426A9796,082-900-001,44444444,JB HI-FI NAB,542.85,0,423059.51,DR,REF624570,NAB,Business
20-09-2025 09:29,NABE81EC1992745405DB907,082-900-001,44444444,BWS NAB,275.43,0,422784.08,DR,REF158595,NAB,Business
20-09-2025 11:57,NABA0A37C3F43524626B454,082-900-001,44444444,COMPANY PAYROLL NAB,0,682.52,423466.6,CR,REF683137,NAB,Business
20-09-2025 12:09,NAB9CD356954C3E4500ADD3,082-900-001,44444444,PAYROLL CREDIT NAB,0,1048.16,424514.76,CR,REF765600,NAB,Business
20-09-2025 12:15,NAB63DB3D91D767473FB714,082-900-001,44444444,CITYLINK NAB,394.16,0,424120.6,DR,REF705567,NAB,Business
20-09-2025 12:21,NABE55B0A6D0D9F4631A752,082-900-001,44444444,RAILWAY STATION NAB,111.4,0,424009.2,DR,REF466432,NAB,Business
20-09-2025 12:32,NAB5ACAF2C75CA14369BFD1,082-900-001,44444444,RAILWAY STATION NAB,322.87,0,423686.33,DR,REF366084,NAB,Business
20-09-2025 12:32,NAB93334C7628B5444EA541,082-900-001,44444444,ZOOM NAB,74.37,0,423611.96,DR,REF590036,NAB,Business
20-09-2025 12:40,NAB4DFEB32D90F7495C9EA1,082-900-001,44444444,APPLE NAB,165.49,0,423446.47,DR,REF926070,NAB,Business
20-09-2025 13:30,NAB7C39941E2D4D4FB5BFB8,082-900-001,44444444,SPOTIFY NAB,318.17,0,423128.3,DR,REF305553,NAB,Business
20-09-2025 13:32,NAB3C3AE43B28F142F5B573,082-900-001,44444444,INTERNET TRANSFER NAB,50.79,0,423077.51,DR,REF202987,NAB,Business
20-09-2025 13:42,NAB7D7A0AC0DFE84D839A72,082-900-001,44444444,CITYLINK NAB,142.48,0,422935.03,DR,REF952130,NAB,Business
20-09-2025 13:59,NAB27BA795B71264B30A0FF,082-900-001,44444444,ALDI NAB,882.5,0,422052.53,DR,REF538298,NAB,Business
20-09-2025 14:23,NAB10C445E9D3564F45818E,082-900-001,44444444,PAYROLL CREDIT NAB,0,794.69,422847.22,CR,REF722143,NAB,Business
20-09-2025 14:36,NAB3ADE756AED1E44149B6F,082-900-001,44444444,AMAZON AU NAB,727.71,0,422119.51,DR,REF630815,NAB,Business
20-09-2025 14:51,NABF6700E1E034446178908,082-900-001,44444444,RAILWAY STATION NAB,474.42,0,421645.09,DR,REF341967,NAB,Business
20-09-2025 15:01,NAB9338F52ECE3647E684E0,082-900-001,44444444,SHELL NAB,169.7,0,421475.39,DR,REF229321,NAB,Business
20-09-2025 15:16,NABBC6C7C50A30D4A4B92AB,082-900-001,44444444,SHELL NAB,379.16,0,421096.23,DR,REF278286,NAB,Business
20-09-2025 15:34,NAB5A3D90542E9D4A468C85,082-900-001,44444444,WAGES CREDIT NAB,0,357.96,421454.19,CR,REF468788,NAB,Business
20-09-2025 15:45,NAB056EBEF2BCB342F9AB0C,082-900-001,44444444,ALDI NAB,208.11,0,421246.08,DR,REF129869,NAB,Business
20-09-2025 15:59,NAB51432A02681D4B97B606,082-900-001,44444444,FLIXBUS NAB,1224.77,0,420021.31,DR,REF928082,NAB,Business
20-09-2025 16:07,NAB4C8BD8D7EB0C4B00BF1C,082-900-001,44444444,ALDI NAB,131.36,0,419889.95,DR,REF799493,NAB,Business
20-09-2025 16:07,NAB7B3CC9295B514086B81C,082-900-001,44444444,LIQUORLAND NAB,81.49,0,419808.46,DR,REF487982,NAB,Business
20-09-2025 16:08,NAB488E865D50A74A7C8819,082-900-001,44444444,WOOLWORTHS NAB,62.11,0,419746.35,DR,REF458839,NAB,Business
20-09-2025 16:30,NABDC4ED1DBEE7942DF9288,082-900-001,44444444,SALARY PAYMENT NAB,0,393.52,420139.87,CR,REF293301,NAB,Business
20-09-2025 17:44,NAB5BAF2F41A3514527BD65,082-900-001,44444444,BP NAB,111.26,0,420028.61,DR,REF777958,NAB,Business
20-09-2025 18:51,NAB782999D17C554D378EA7,082-900-001,44444444,SPOTIFY NAB,656.74,0,419371.87,DR,REF876484,NAB,Business
20-09-2025 18:55,NABA215677DEA5D43D39645,082-900-001,44444444,CITYLINK NAB,760.3,0,418611.57,DR,REF596421,NAB,Business
20-09-2025 18:56,NABED7D1EA7CA0A42678D81,082-900-001,44444444,HARVEY NORMAN NAB,374.09,0,418237.48,DR,REF900283,NAB,Business
20-09-2025 19:04,NAB5664C0137549491DA57A,082-900-001,44444444,INTERNET TRANSFER NAB,305.48,0,417932,DR,REF739773,NAB,Business
20-09-2025 19:31,NABFC4AACF0010F46548360,082-900-001,44444444,APPLE NAB,400.3,0,417531.7,DR,REF579227,NAB,Business
20-09-2025 19:36,NAB9A49D02B6ED34B4A8D7D,082-900-001,44444444,MCDONALDS NAB,356.47,0,417175.23,DR,REF809420,NAB,Business
20-09-2025 20:10,INTE77CE77B1EED40FE90BB,082-900-001,44444444,TRANSFER FROM CBA 22222222,0,1196.29,418371.52,CR,INT-71294,NAB,Business
20-09-2025 20:21,NABB57CF4E0536B44769D08,082-900-001,44444444,PAYMENT GATEWAY NAB,572.82,0,417798.7,DR,REF325701,NAB,Business
20-09-2025 20:22,NAB42A99BAC7C4F4FF38E05,082-900-001,44444444,PAYMENT GATEWAY NAB,18.36,0,417780.34,DR,REF362155,NAB,Business
20-09-2025 20:59,NABE7234249CF914B62914A,082-900-001,44444444,MENULOG NAB,473.45,0,417306.89,DR,REF591045,NAB,Business
20-09-2025 21:02,NAB9E5838CDB2AF48728B53,082-900-001,44444444,BIGW NAB,348.38,0,416958.51,DR,REF613389,NAB,Business
20-09-2025 21:19,NAB64E74AD4EB3642759EBC,082-900-001,44444444,PAYMENT GATEWAY NAB,228.89,0,416729.62,DR,REF602082,NAB,Business
20-09-2025 22:03,NAB67C32264E0A34DAA9839,082-900-001,44444444,BP NAB,61.7,0,416667.92,DR,REF122187,NAB,Business
20-09-2025 22:04,NABE2669A440A8A447BA258,082-900-001,44444444,SALARY PAYMENT NAB,0,7399.78,424067.7,CR,REF966037,NAB,Business
20-09-2025 22:08,NAB427D0A6C0F9E498DA3DB,082-900-001,44444444,AMAZON AU NAB,62.54,0,424005.16,DR,REF866495,NAB,Business
20-09-2025 22:18,NAB34EE539607444056A45E,082-900-001,44444444,PAY - SALARY NAB,0,4183.64,428188.8,CR,REF628005,NAB,Business
20-09-2025 23:03,NAB07A3F05ECD0A4379AEF0,082-900-001,44444444,CITYLINK NAB,225.37,0,427963.43,DR,REF681326,NAB,Business
20-09-2025 23:54,NAB75AA49872D4D48279B15,082-900-001,44444444,INTERNET TRANSFER NAB,469.26,0,427494.17,DR,REF910057,NAB,Business
20-09-2025 23:55,INT4F70CD8D6442485BA299,082-900-001,44444444,TRANSFER TO ANZ 11111111,1510.35,0,425983.82,DR,INT-37780,NAB,Business
20-09-2025 23:57,NABD4A994F43CB446738D2A,082-900-001,44444444,INTERNET TRANSFER NAB,57.05,0,425926.77,DR,REF626940,NAB,Business
21-09-2025 00:03,NAB803192F7E0734D20984B,082-900-001,44444444,HARVEY NORMAN NAB,494.26,0,425432.51,DR,REF172180,NAB,Business
21-09-2025 00:26,NAB509B2BD7E7ED4D1CBCA5,082-900-001,44444444,CITYLINK NAB,849.37,0,424583.14,DR,REF269250,NAB,Business
21-09-2025 01:15,NABD447FB5B6DD646C2A1E0,082-900-001,44444444,SALARY PAYMENT NAB,0,954.55,425537.69,CR,REF941751,NAB,Business
21-09-2025 01:22,INT66166AAF4DAC4BCCA609,082-900-001,44444444,TRANSFER FROM CBA 22222222,0,1178.93,426716.62,CR,INT-62069,NAB,Business
21-09-2025 02:14,NABF6A87BA512184971B6D4,082-900-001,44444444,RAILWAY STATION NAB,798.7,0,425917.92,DR,REF892586,NAB,Business
21-09-2025 02:35,NABFB132644259F4A2F8F4B,082-900-001,44444444,SPOTIFY NAB,325.24,0,425592.68,DR,REF140110,NAB,Business
21-09-2025 02:44,NABB2A5C0D91DAB4EB8B510,082-900-001,44444444,COMPANY PAYROLL NAB,0,3324.72,428917.4,CR,REF285595,NAB,Business
21-09-2025 02:46,NAB9BE5387448AE41E89EDA,082-900-001,44444444,SHELL NAB,82.44,0,428834.96,DR,REF364701,NAB,Business
21-09-2025 02:51,NAB8249E885E0D142D58A59,082-900-001,44444444,PAYROLL CREDIT NAB,0,3969.18,432804.14,CR,REF871085,NAB,Business
21-09-2025 03:48,NABA67C6ADE8EA0460FA2DC,082-900-001,44444444,BP NAB,299.92,0,432504.22,DR,REF456735,NAB,Business
21-09-2025 03:50,NABFFA82B8B93894CE684F5,082-900-001,44444444,TAFE BOOKSHOP NAB,22.4,0,432481.82,DR,REF558435,NAB,Business
21-09-2025 04:06,NABBC42F7C4394E4AA1A0AB,082-900-001,44444444,INTERNET TRANSFER NAB,392.32,0,432089.5,DR,REF904118,NAB,Business
21-09-2025 04:13,NABEFE31D86BC584F9C827D,082-900-001,44444444,HARVEY NORMAN NAB,433.48,0,431656.02,DR,REF463884,NAB,Business
21-09-2025 04:33,NAB4B25208DB6AB495DA426,082-900-001,44444444,ALDI NAB,222.4,0,431433.62,DR,REF255345,NAB,Business
21-09-2025 05:00,NAB8F59C098E434468E88F7,082-900-001,44444444,BP NAB,696.25,0,430737.37,DR,REF663014,NAB,Business
21-09-2025 05:02,NAB09A66547B34349EE93F1,082-900-001,44444444,7-ELEVEN NAB,380.84,0,430356.53,DR,REF681612,NAB,Business
21-09-2025 05:43,NABC9122861E51C45F98817,082-900-001,44444444,COLES NAB,82.92,0,430273.61,DR,REF382843,NAB,Business
21-09-2025 05:52,NABA812B7F1E5544C4C8AFD,082-900-001,44444444,PAYMENT GATEWAY NAB,235.97,0,430037.64,DR,REF438512,NAB,Business
21-09-2025 06:05,NAB268FCA2BDC8E44D99929,082-900-001,44444444,RAILWAY STATION NAB,1256.78,0,428780.86,DR,REF579517,NAB,Business
21-09-2025 06:17,NAB81923A40A11A4A76B719,082-900-001,44444444,BANK FEE NAB,172.23,0,428608.63,DR,REF554138,NAB,Business
21-09-2025 06:39,NAB2AD285708B65424C8324,082-900-001,44444444,7-ELEVEN NAB,525.05,0,428083.58,DR,REF740355,NAB,Business
21-09-2025 06:43,NABE7134580B29E41FC98DA,082-900-001,44444444,CITYLINK NAB,40.79,0,428042.79,DR,REF395828,NAB,Business
21-09-2025 06:56,NAB55FCDDA9E11243F58B26,082-900-001,44444444,MENULOG NAB,664.96,0,427377.83,DR,REF709558,NAB,Business
21-09-2025 07:22,NAB81CC0510909C4601A898,082-900-001,44444444,SALARY PAYMENT NAB,0,506.82,427884.65,CR,REF406642,NAB,Business
21-09-2025 07:23,NAB38378082686F498BBD5E,082-900-001,44444444,INTERNET TRANSFER NAB,291.96,0,427592.69,DR,REF832701,NAB,Business
21-09-2025 07:34,NAB30B35C98A71D4EF2B1BC,082-900-001,44444444,UBER EATS NAB,19.14,0,427573.55,DR,REF219703,NAB,Business
21-09-2025 08:11,NABD8A4D4595FF641818DC0,082-900-001,44444444,7-ELEVEN NAB,434.59,0,427138.96,DR,REF660511,NAB,Business
21-09-2025 08:19,NAB0B454C15B2E84C44A04F,082-900-001,44444444,WOOLWORTHS NAB,286.47,0,426852.49,DR,REF117510,NAB,Business
21-09-2025 08:26,NAB08006C2ECDFA4D08963D,082-900-001,44444444,COLES NAB,124.16,0,426728.33,DR,REF816165,NAB,Business
21-09-2025 08:34,INTA52FF2B58BBD4CEEBF94,082-900-001,44444444,TRANSFER TO CBA 22222222,1338.69,0,425389.64,DR,INT-83464,NAB,Business
21-09-2025 08:38,NABB3C43C719551465BA4D3,082-900-001,44444444,MENULOG NAB,1079.16,0,424310.48,DR,REF183860,NAB,Business
21-09-2025 08:58,NAB7A8430E7D53A414AA980,082-900-001,44444444,UBER EATS NAB,63.1,0,424247.38,DR,REF414922,NAB,Business
21-09-2025 09:07,NAB2E621E59EE3847D38BAC,082-900-001,44444444,HARVEY NORMAN NAB,41.82,0,424205.56,DR,REF997134,NAB,Business
21-09-2025 09:40,NAB4D97E31E5103498A9785,082-900-001,44444444,COMPANY PAYROLL NAB,0,920.93,425126.49,CR,REF767728,NAB,Business
21-09-2025 09:45,NAB57269D103A504F62BE53,082-900-001,44444444,AMAZON AU NAB,336.3,0,424790.19,DR,REF125693,NAB,Business
21-09-2025 09:52,NAB1D6E7B70D1EA4FAEBFD2,082-900-001,44444444,PAYPAL *NETFLIX NAB,848.68,0,423941.51,DR,REF711010,NAB,Business
21-09-2025 09:59,NABE0996B31ADDF459A9C4E,082-900-001,44444444,COMPANY PAYROLL NAB,0,4816.58,428758.09,CR,REF928181,NAB,Business
21-09-2025 10:22,NAB5EB505E8C6C141158C8A,082-900-001,44444444,PAY - SALARY NAB,0,626.73,429384.82,CR,REF609004,NAB,Business
21-09-2025 10:27,NABAAC6040444B44A779DF3,082-900-001,44444444,JB HI-FI NAB,27.3,0,429357.52,DR,REF167153,NAB,Business
21-09-2025 11:03,NABEA13F70DF9A7467EB8E2,082-900-001,44444444,BWS NAB,279.87,0,429077.65,DR,REF138816,NAB,Business
21-09-2025 11:15,NABEFD36DA05B264826B923,082-900-001,44444444,INTERNET TRANSFER NAB,133.43,0,428944.22,DR,REF876255,NAB,Business
21-09-2025 11:41,NAB0CC75483B2C748F79786,082-900-001,44444444,COLES NAB,675.34,0,428268.88,DR,REF340867,NAB,Business
21-09-2025 11:44,NAB3BF356F64C8D44FC8AD3,082-900-001,44444444,PAYPAL *NETFLIX NAB,77.44,0,428191.44,DR,REF434745,NAB,Business
21-09-2025 12:22,NAB6F038C85B24D4F8D8130,082-900-001,44444444,UBER EATS NAB,515.46,0,427675.98,DR,REF808396,NAB,Business
21-09-2025 13:06,NAB9246723224704C2AAA5A,082-900-001,44444444,PAYPAL *NETFLIX NAB,407.68,0,427268.3,DR,REF442240,NAB,Business
21-09-2025 13:07,NABFC5E30F6A5D54779914A,082-900-001,44444444,AMAZON AU NAB,372.19,0,426896.11,DR,REF664029,NAB,Business
21-09-2025 13:25,INT454ADA5E0FB04F61AA4C,082-900-001,44444444,TRANSFER FROM CBA 22222222,0,1162.93,428059.04,CR,INT-35346,NAB,Business
21-09-2025 13:45,NAB09E08A8C8D9B4766B84A,082-900-001,44444444,ALDI NAB,57.23,0,428001.81,DR,REF887091,NAB,Business
21-09-2025 14:10,NAB571C646F40E440949A4D,082-900-001,44444444,MCDONALDS NAB,1267.62,0,426734.19,DR,REF366984,NAB,Business
21-09-2025 14:28,NAB14F79DA2871D4B10BE94,082-900-001,44444444,ZOOM NAB,54.17,0,426680.02,DR,REF692108,NAB,Business
21-09-2025 14:28,NABC95DF0EBD0D84471AC85,082-900-001,44444444,SHELL NAB,189.61,0,426490.41,DR,REF190709,NAB,Business
21-09-2025 14:50,NAB64160FA878324F928D0E,082-900-001,44444444,INTERNET TRANSFER NAB,298.8,0,426191.61,DR,REF358079,NAB,Business
21-09-2025 15:02,NAB51772E1763B94E199F8A,082-900-001,44444444,ZOOM NAB,145.55,0,426046.06,DR,REF544469,NAB,Business
21-09-2025 15:08,NAB12D75C0AD80B4163BAEC,082-900-001,44444444,7-ELEVEN NAB,51.29,0,425994.77,DR,REF614748,NAB,Business
21-09-2025 15:42,NABA0F82AD2727B4BB1844B,082-900-001,44444444,HARVEY NORMAN NAB,237.58,0,425757.19,DR,REF764291,NAB,Business
21-09-2025 16:15,NAB0C85FFAE6BC547D1BCCF,082-900-001,44444444,KFC NAB,234.35,0,425522.84,DR,REF561128,NAB,Business
21-09-2025 16:22,NAB2B0522A7267B43C2B740,082-900-001,44444444,SALARY PAYMENT NAB,0,6904.06,432426.9,CR,REF772485,NAB,Business
21-09-2025 16:26,NABE3ACA61BB6D5406B8236,082-900-001,44444444,COMPANY PAYROLL NAB,0,5184.58,437611.48,CR,REF507281,NAB,Business
21-09-2025 16:47,NAB4DAD25FD990044668807,082-900-001,44444444,SALARY PAYMENT NAB,0,1043,438654.48,CR,REF365553,NAB,Business
21-09-2025 16:52,NABD6BE1C87E2C74A86B5A0,082-900-001,44444444,BANK FEE NAB,929.97,0,437724.51,DR,REF948821,NAB,Business
21-09-2025 17:29,NABFF0D74FFF42E4CF99E42,082-900-001,44444444,PAYROLL CREDIT NAB,0,169.88,437894.39,CR,REF481599,NAB,Business
21-09-2025 17:58,NAB6CBDED62E6B845EC94CD,082-900-001,44444444,BIGW NAB,85.71,0,437808.68,DR,REF917115,NAB,Business
21-09-2025 18:18,NAB9F453E4BE7FF4BDD8FE3,082-900-001,44444444,AMAZON AU NAB,228.08,0,437580.6,DR,REF746826,NAB,Business
21-09-2025 18:40,NAB86A7D79AB11C420EBE25,082-900-001,44444444,FLIXBUS NAB,48.32,0,437532.28,DR,REF662028,NAB,Business
21-09-2025 19:38,NAB34D7278CA9734419BD15,082-900-001,44444444,COLES NAB,46.66,0,437485.62,DR,REF638855,NAB,Business
21-09-2025 19:57,NAB02708CA2D70D4586928E,082-900-001,44444444,AMAZON AU NAB,230.05,0,437255.57,DR,REF769767,NAB,Business
21-09-2025 20:00,NABF097E59098AB44F89E03,082-900-001,44444444,KFC NAB,142.27,0,437113.3,DR,REF530635,NAB,Business
21-09-2025 20:06,NABE83D41E9688D47D48F21,082-900-001,44444444,KFC NAB,76.53,0,437036.77,DR,REF235739,NAB,Business
21-09-2025 20:36,NABD95AE99E683A43ACAE2D,082-900-001,44444444,UBER EATS NAB,184.34,0,436852.43,DR,REF214390,NAB,Business
21-09-2025 20:42,NABECFD6762336044CC9584,082-900-001,44444444,PAY - SALARY NAB,0,4464.83,441317.26,CR,REF284065,NAB,Business
21-09-2025 21:12,NABDBCF23CA597B4D249F54,082-900-001,44444444,AMAZON AU NAB,71.58,0,441245.68,DR,REF403527,NAB,Business
21-09-2025 21:16,INT0AC2BF5D88CC433CB51E,082-900-001,44444444,TRANSFER TO CBA 33333333,977.26,0,440268.42,DR,INT-43513,NAB,Business
21-09-2025 21:18,NABD863F3CCA5634C24875D,082-900-001,44444444,BANK FEE NAB,23.46,0,440244.96,DR,REF852687,NAB,Business
21-09-2025 21:22,NAB668578E49E2C4B038543,082-900-001,44444444,ZOOM NAB,196.49,0,440048.47,DR,REF919249,NAB,Business
21-09-2025 21:45,NAB272FE637C0574766812D,082-900-001,44444444,STARBUCKS NAB,333.09,0,439715.38,DR,REF791974,NAB,Business
21-09-2025 21:54,NABFA7A79E0D0F74D79BCB8,082-900-001,44444444,WAGES CREDIT NAB,0,1155.19,440870.57,CR,REF406519,NAB,Business
21-09-2025 22:09,NAB08FCF4A9E03645F6881A,082-900-001,44444444,BIGW NAB,110.38,0,440760.19,DR,REF223856,NAB,Business
21-09-2025 22:18,NAB8B885B517FA84D759682,082-900-001,44444444,AMAZON AU NAB,133.53,0,440626.66,DR,REF722760,NAB,Business
21-09-2025 22:18,INT69A21F09C71D42FB93BB,082-900-001,44444444,TRANSFER FROM CBA 33333333,0,1294.55,441921.21,CR,INT-63534,NAB,Business
21-09-2025 22:20,NAB30DD4D967D864060B6EE,082-900-001,44444444,APPLE NAB,407.01,0,441514.2,DR,REF595004,NAB,Business
21-09-2025 22:52,NAB8189CAE183744EFEBDAA,082-900-001,44444444,LIQUORLAND NAB,577.72,0,440936.48,DR,REF199273,NAB,Business
21-09-2025 23:04,NABD3FA6A01C0C240FC9C81,082-900-001,44444444,PAY - SALARY NAB,0,933.38,441869.86,CR,REF268728,NAB,Business
21-09-2025 23:48,NABCA705DC684124773922F,082-900-001,44444444,COLES NAB,131.61,0,441738.25,DR,REF980504,NAB,Business
22-09-2025 00:06,NAB1E63A3B48A6D4C6D984C,082-900-001,44444444,APPLE NAB,211.85,0,441526.4,DR,REF882051,NAB,Business
22-09-2025 00:09,NAB57C1342B720B44CF946A,082-900-001,44444444,PAYROLL CREDIT NAB,0,567.09,442093.49,CR,REF193546,NAB,Business
22-09-2025 00:19,NAB24BFF1A18D924781925E,082-900-001,44444444,WOOLWORTHS NAB,304.91,0,441788.58,DR,REF490786,NAB,Business
22-09-2025 00:50,NAB2B7CAF141AF34139AFC6,082-900-001,44444444,PAYMENT GATEWAY NAB,682.41,0,441106.17,DR,REF357684,NAB,Business
22-09-2025 01:05,NAB52A6ACD1A5AA44C481B8,082-900-001,44444444,SHELL NAB,264.89,0,440841.28,DR,REF102116,NAB,Business
22-09-2025 01:08,NAB48CE49E95CD64FD4AFC4,082-900-001,44444444,ZOOM NAB,273.54,0,440567.74,DR,REF351539,NAB,Business
22-09-2025 01:15,NABA8A377EECC3E433EB9C2,082-900-001,44444444,7-ELEVEN NAB,347.21,0,440220.53,DR,REF528811,NAB,Business
22-09-2025 01:53,NABD1C87B9A51B746FE8EEE,082-900-001,44444444,HARVEY NORMAN NAB,1261.76,0,438958.77,DR,REF417048,NAB,Business
22-09-2025 02:31,NAB57B40A98FC224C49A86B,082-900-001,44444444,DOMINO'S PIZZA NAB,416.95,0,438541.82,DR,REF949731,NAB,Business
22-09-2025 03:08,NAB76A16CBE8BCB411D8A6D,082-900-001,44444444,MENULOG NAB,91.29,0,438450.53,DR,REF977196,NAB,Business
22-09-2025 03:26,NABF4DCC94C3542457EA0C8,082-900-001,44444444,LIQUORLAND NAB,476.57,0,437973.96,DR,REF143080,NAB,Business
22-09-2025 03:40,NAB16EFB87D98254DC18829,082-900-001,44444444,SPOTIFY NAB,203.77,0,437770.19,DR,REF458005,NAB,Business
22-09-2025 03:55,NAB48F9ADFC395D44E59FA4,082-900-001,44444444,FLIXBUS NAB,538.67,0,437231.52,DR,REF934629,NAB,Business
22-09-2025 04:06,NABAC0BAF6EF7124AA2BE5D,082-900-001,44444444,HARVEY NORMAN NAB,38.5,0,437193.02,DR,REF846670,NAB,Business
22-09-2025 04:07,NAB0AD49FD786354972B8A2,082-900-001,44444444,SHELL NAB,321.82,0,436871.2,DR,REF630582,NAB,Business
22-09-2025 04:17,NAB29BF4087FF76449BB4FD,082-900-001,44444444,PAY - SALARY NAB,0,856.84,437728.04,CR,REF710007,NAB,Business
22-09-2025 04:26,NABE3709A1BB34F4E2287BE,082-900-001,44444444,AMAZON AU NAB,155.9,0,437572.14,DR,REF128495,NAB,Business
22-09-2025 04:48,NAB289A7E18E5444F99A887,082-900-001,44444444,WAGES CREDIT NAB,0,862.97,438435.11,CR,REF992258,NAB,Business
22-09-2025 05:05,NAB1344C854065A4DCBA1D5,082-900-001,44444444,COMPANY PAYROLL NAB,0,99.25,438534.36,CR,REF585781,NAB,Business
22-09-2025 05:16,NAB778875F82F1A4F918753,082-900-001,44444444,DOMINO'S PIZZA NAB,679.9,0,437854.46,DR,REF465181,NAB,Business
22-09-2025 05:16,INTC3CB738F2D364A4D888B,082-900-001,44444444,TRANSFER TO CBA 33333333,1398.64,0,436455.82,DR,INT-51414,NAB,Business
22-09-2025 05:18,NAB4CB2F2A871F24FC9A1DA,082-900-001,44444444,SHELL NAB,128.05,0,436327.77,DR,REF598838,NAB,Business
22-09-2025 05:22,NAB5D9DF54E808D445CB539,082-900-001,44444444,WOOLWORTHS NAB,447.78,0,435879.99,DR,REF937667,NAB,Business
22-09-2025 05:30,INT663606B8EFF442F0A60F,082-900-001,44444444,TRANSFER FROM ANZ 11111111,0,768.66,436648.65,CR,INT-36755,NAB,Business
22-09-2025 06:50,NAB4E3E1A3B22544906A603,082-900-001,44444444,INTERNET TRANSFER NAB,41.83,0,436606.82,DR,REF549549,NAB,Business
22-09-2025 06:56,NAB7AA8F61E631247B789F1,082-900-001,44444444,DOMINO'S PIZZA NAB,424.54,0,436182.28,DR,REF850542,NAB,Business
22-09-2025 07:02,NAB60FB672107EA489189C1,082-900-001,44444444,INTERNET TRANSFER NAB,404.86,0,435777.42,DR,REF698067,NAB,Business
22-09-2025 09:27,NAB9402F5B00C784BB5A776,082-900-001,44444444,PAY - SALARY NAB,0,2579.76,438357.18,CR,REF639880,NAB,Business
22-09-2025 09:31,INTA92369D6B8584E12B9EF,082-900-001,44444444,TRANSFER FROM ANZ 11111111,0,1217.07,439574.25,CR,INT-44880,NAB,Business
22-09-2025 09:49,NAB66825D2B4E7A4003853D,082-900-001,44444444,JB HI-FI NAB,285.03,0,439289.22,DR,REF738662,NAB,Business
22-09-2025 09:56,NABCA88BE85A71542FA95B3,082-900-001,44444444,HARVEY NORMAN NAB,454.45,0,438834.77,DR,REF224244,NAB,Business
22-09-2025 10:38,NAB0E7A4678FA8548AB9A49,082-900-001,44444444,AMAZON AU NAB,1141.94,0,437692.83,DR,REF475621,NAB,Business
22-09-2025 10:44,NABE541966423494CBEA672,082-900-001,44444444,BWS NAB,455.33,0,437237.5,DR,REF721060,NAB,Business
22-09-2025 10:51,NAB2D5650B22D744D4E8061,082-900-001,44444444,SALARY PAYMENT NAB,0,4994.49,442231.99,CR,REF366192,NAB,Business
22-09-2025 12:08,NAB8B73039C28744C058BF1,082-900-001,44444444,UBER EATS NAB,869.05,0,441362.94,DR,REF953985,NAB,Business
22-09-2025 12:30,NAB5869C8DFAD41485A880A,082-900-001,44444444,SALARY PAYMENT NAB,0,1089.01,442451.95,CR,REF725536,NAB,Business
22-09-2025 12:32,NAB5F2364543DF64ECB912A,082-900-001,44444444,CITYLINK NAB,263.36,0,442188.59,DR,REF520173,NAB,Business
22-09-2025 13:11,NAB4BBE03BE088E4D15A42F,082-900-001,44444444,RAILWAY STATION NAB,151.09,0,442037.5,DR,REF425868,NAB,Business
22-09-2025 13:41,INTAFFD498165544AB7BA24,082-900-001,44444444,TRANSFER TO CBA 33333333,881.59,0,441155.91,DR,INT-45388,NAB,Business
22-09-2025 14:33,NAB3F3371E0AA854E46913D,082-900-001,44444444,MCDONALDS NAB,452.21,0,440703.7,DR,REF798659,NAB,Business
22-09-2025 14:34,NAB81C62899E1E14A629CF4,082-900-001,44444444,STARBUCKS NAB,701.68,0,440002.02,DR,REF843395,NAB,Business
22-09-2025 14:38,NAB413E77F6029944EEAFC4,082-900-001,44444444,PAYPAL *NETFLIX NAB,246.35,0,439755.67,DR,REF833082,NAB,Business
22-09-2025 14:40,NABFFF8207CE601406BAD7B,082-900-001,44444444,INTERNET TRANSFER NAB,140.26,0,439615.41,DR,REF490503,NAB,Business
22-09-2025 14:51,NAB227BCD54896F42129B30,082-900-001,44444444,APPLE NAB,367.6,0,439247.81,DR,REF164278,NAB,Business
22-09-2025 15:07,NAB00E77E896BF448B1BC1F,082-900-001,44444444,KFC NAB,568.96,0,438678.85,DR,REF489992,NAB,Business
22-09-2025 15:10,NAB78C6D6D1318F4F3AA684,082-900-001,44444444,FLIXBUS NAB,1637.38,0,437041.47,DR,REF580384,NAB,Business
22-09-2025 15:27,NABF7B46C77BE5046139CCC,082-900-001,44444444,AMAZON AU NAB,152.28,0,436889.19,DR,REF186005,NAB,Business
22-09-2025 15:31,NABFCE4A1B9AF074A6E8C49,082-900-001,44444444,STARBUCKS NAB,1926.44,0,434962.75,DR,REF111450,NAB,Business
22-09-2025 15:35,INT8BBB60A1E2D2455792F0,082-900-001,44444444,TRANSFER FROM ANZ 11111111,0,1741.48,436704.23,CR,INT-16502,NAB,Business
22-09-2025 16:07,NAB53DEF86531F345038A40,082-900-001,44444444,MENULOG NAB,126.81,0,436577.42,DR,REF547912,NAB,Business
22-09-2025 16:09,INT44B9A18E08BB4F16B617,082-900-001,44444444,TRANSFER TO CBA 22222222,538.09,0,436039.33,DR,INT-26911,NAB,Business
22-09-2025 16:16,NAB194402AEA1F94F8898EA,082-900-001,44444444,JB HI-FI NAB,747.04,0,435292.29,DR,REF315410,NAB,Business
22-09-2025 16:37,NAB2A59F266842E43A292ED,082-900-001,44444444,7-ELEVEN NAB,239.3,0,435052.99,DR,REF121039,NAB,Business
22-09-2025 16:39,NAB35D6C556CCD642DAB0AA,082-900-001,44444444,PAYPAL *NETFLIX NAB,78.76,0,434974.23,DR,REF615222,NAB,Business
22-09-2025 16:48,NABFFAB4B6AF3E64E7FB38F,082-900-001,44444444,APPLE NAB,45.72,0,434928.51,DR,REF873864,NAB,Business
22-09-2025 16:54,NAB63C79E87807042CFA23D,082-900-001,44444444,SHELL NAB,135.35,0,434793.16,DR,REF734804,NAB,Business
22-09-2025 16:55,NAB43BB86C1890C47EB9577,082-900-001,44444444,SPOTIFY NAB,703.77,0,434089.39,DR,REF270061,NAB,Business
22-09-2025 16:58,NAB1854F8629F3947449FCE,082-900-001,44444444,KFC NAB,670.74,0,433418.65,DR,REF175932,NAB,Business
22-09-2025 17:00,NAB176001455CDB45F38052,082-900-001,44444444,UBER EATS NAB,792.88,0,432625.77,DR,REF998464,NAB,Business
22-09-2025 18:35,NABFDA56E55515F46DCBF1A,082-900-001,44444444,CITYLINK NAB,142.71,0,432483.06,DR,REF958865,NAB,Business
22-09-2025 18:37,NAB233E0ED194D147E38379,082-900-001,44444444,SHELL NAB,910.79,0,431572.27,DR,REF592249,NAB,Business
22-09-2025 18:53,NABC10703119EED4EB18C7A,082-900-001,44444444,LIQUORLAND NAB,25.17,0,431547.1,DR,REF308173,NAB,Business
22-09-2025 18:56,NAB615ECC5EF92E4274A7F8,082-900-001,44444444,BANK FEE NAB,833.57,0,430713.53,DR,REF434894,NAB,Business
22-09-2025 18:58,NABE05B0FB3ABF94EC1A4EA,082-900-001,44444444,SALARY PAYMENT NAB,0,6068.59,436782.12,CR,REF694606,NAB,Business
22-09-2025 19:10,NAB406689F6734C48989A91,082-900-001,44444444,PAYROLL CREDIT NAB,0,5013.67,441795.79,CR,REF114435,NAB,Business
22-09-2025 19:35,NABC4D813AFE90A42FC95D4,082-900-001,44444444,STARBUCKS NAB,371.4,0,441424.39,DR,REF313901,NAB,Business
22-09-2025 19:57,INTF0FA509776C84ADF9F21,082-900-001,44444444,TRANSFER FROM ANZ 11111111,0,86.57,441510.96,CR,INT-12320,NAB,Business
22-09-2025 21:34,NAB489D3B2DAFC74DB6AD7D,082-900-001,44444444,PAYROLL CREDIT NAB,0,5869.96,447380.92,CR,REF758265,NAB,Business
22-09-2025 21:35,NAB333E7A3D226A4167A020,082-900-001,44444444,BWS NAB,424.26,0,446956.66,DR,REF775941,NAB,Business
22-09-2025 21:43,NABBE70FD2BC2174C529561,082-900-001,44444444,LIQUORLAND NAB,104.58,0,446852.08,DR,REF259652,NAB,Business
22-09-2025 21:53,NABCF39122EB0184379ADE2,082-900-001,44444444,ZOOM NAB,954.46,0,445897.62,DR,REF592087,NAB,Business
22-09-2025 21:54,NAB498DF01E029B4531A1E8,082-900-001,44444444,SHELL NAB,48.54,0,445849.08,DR,REF141243,NAB,Business
22-09-2025 21:56,NAB297AF8FDE65A45208E69,082-900-001,44444444,HARVEY NORMAN NAB,199.72,0,445649.36,DR,REF630592,NAB,Business
22-09-2025 21:56,NAB0FA945754DE84C028A7E,082-900-001,44444444,WOOLWORTHS NAB,128.86,0,445520.5,DR,REF139107,NAB,Business
22-09-2025 22:08,NABEEA0AE0807284AB19D75,082-900-001,44444444,MENULOG NAB,194.71,0,445325.79,DR,REF708020,NAB,Business
22-09-2025 22:53,NAB475421A108D241BA9AF9,082-900-001,44444444,WAGES CREDIT NAB,0,393.49,445719.28,CR,REF143471,NAB,Business
22-09-2025 22:53,NAB10EDF5FC80A14736838F,082-900-001,44444444,CITYLINK NAB,121.87,0,445597.41,DR,REF858906,NAB,Business
22-09-2025 22:57,NAB7F23F7661BD345B7A0C5,082-900-001,44444444,7-ELEVEN NAB,184.74,0,445412.67,DR,REF106242,NAB,Business
22-09-2025 23:33,NAB87BE72947D7642A3817F,082-900-001,44444444,PAY - SALARY NAB,0,44.56,445457.23,CR,REF450396,NAB,Business
22-09-2025 23:54,NAB05C445E72EAA4F8D9642,082-900-001,44444444,COLES NAB,533.83,0,444923.4,DR,REF723052,NAB,Business
23-09-2025 00:00,INT32B2803FF81841BF9A3C,082-900-001,44444444,TRANSFER FROM ANZ 11111111,0,776.69,445700.09,CR,INT-78036,NAB,Business
23-09-2025 00:01,NABFD93B848666E4BBAA96A,082-900-001,44444444,STARBUCKS NAB,152.89,0,445547.2,DR,REF241525,NAB,Business
23-09-2025 00:16,NAB52942EE4F88C43A3A507,082-900-001,44444444,RAILWAY STATION NAB,196.43,0,445350.77,DR,REF275973,NAB,Business
23-09-2025 00:36,NAB6D0AFAB0EA52498BA109,082-900-001,44444444,WAGES CREDIT NAB,0,3800.12,449150.89,CR,REF543348,NAB,Business
23-09-2025 00:38,NAB37D4E9E35AD64C6D8E70,082-900-001,44444444,DOMINO'S PIZZA NAB,87.65,0,449063.24,DR,REF477426,NAB,Business
23-09-2025 00:44,NAB965C5C3016BA40A4B57E,082-900-001,44444444,FLIXBUS NAB,242.53,0,448820.71,DR,REF197526,NAB,Business
23-09-2025 01:00,NAB1FEE236D368B475DA28D,082-900-001,44444444,ALDI NAB,214.62,0,448606.09,DR,REF956611,NAB,Business
23-09-2025 01:01,NAB3736AA3264534FDF86D8,082-900-001,44444444,BP NAB,121.71,0,448484.38,DR,REF476865,NAB,Business
23-09-2025 01:13,NAB3985F3A5CDF8463A8C60,082-900-001,44444444,MENULOG NAB,656.79,0,447827.59,DR,REF478874,NAB,Business
23-09-2025 01:33,NABB671DF2A2CE0480CAD48,082-900-001,44444444,DOMINO'S PIZZA NAB,230.17,0,447597.42,DR,REF617019,NAB,Business
23-09-2025 01:47,NAB6AA94C90771A4084B0E9,082-900-001,44444444,RAILWAY STATION NAB,108.95,0,447488.47,DR,REF270673,NAB,Business
23-09-2025 02:00,NAB82E8D45C69B74010A31D,082-900-001,44444444,HARVEY NORMAN NAB,452.88,0,447035.59,DR,REF848662,NAB,Business
23-09-2025 02:35,NAB47AFE2EBE29A4BCB8653,082-900-001,44444444,PAYPAL *NETFLIX NAB,107.98,0,446927.61,DR,REF142903,NAB,Business
23-09-2025 02:47,NAB1E6E70405AE34ED48375,082-900-001,44444444,7-ELEVEN NAB,255.46,0,446672.15,DR,REF995331,NAB,Business
23-09-2025 02:59,NABCCED8002A33D4D9F9B22,082-900-001,44444444,MENULOG NAB,574.45,0,446097.7,DR,REF145828,NAB,Business
23-09-2025 03:20,NAB2973DA7647164FE8A381,082-900-001,44444444,ZOOM NAB,633.96,0,445463.74,DR,REF289345,NAB,Business
23-09-2025 03:20,NAB949FF2EC68E74B779D17,082-900-001,44444444,KFC NAB,322.42,0,445141.32,DR,REF290765,NAB,Business
23-09-2025 03:26,NAB0B281A6B6423483D9E6C,082-900-001,44444444,KFC NAB,595.73,0,444545.59,DR,REF747560,NAB,Business
23-09-2025 03:36,NAB9B319AD590974815AAA5,082-900-001,44444444,APPLE NAB,82.4,0,444463.19,DR,REF541654,NAB,Business
23-09-2025 03:42,NAB6C33589597E340F0BF22,082-900-001,44444444,MENULOG NAB,220.47,0,444242.72,DR,REF588981,NAB,Business
23-09-2025 03:56,NAB16F044FB864D4EDF8103,082-900-001,44444444,WOOLWORTHS NAB,234.86,0,444007.86,DR,REF390316,NAB,Business
23-09-2025 04:03,NAB1450202481A649659C07,082-900-001,44444444,DOMINO'S PIZZA NAB,464.15,0,443543.71,DR,REF261572,NAB,Business
23-09-2025 04:19,NAB46624080AE384BEE8EA0,082-900-001,44444444,UBER EATS NAB,53.77,0,443489.94,DR,REF299651,NAB,Business
23-09-2025 04:27,NAB98906256F1EE410B8873,082-900-001,44444444,MCDONALDS NAB,245.1,0,443244.84,DR,REF152066,NAB,Business
23-09-2025 04:44,NAB7C0861C79D074FC68E32,082-900-001,44444444,ALDI NAB,315.84,0,442929,DR,REF743997,NAB,Business
23-09-2025 05:20,NABAC53507B11B24CA1A8D8,082-900-001,44444444,RAILWAY STATION NAB,889.77,0,442039.23,DR,REF840208,NAB,Business
23-09-2025 05:37,NABEA9DFE0405D74029BEED,082-900-001,44444444,SPOTIFY NAB,388.15,0,441651.08,DR,REF533619,NAB,Business
23-09-2025 06:50,NABB39569A20F97479F8DC3,082-900-001,44444444,AMAZON AU NAB,58.7,0,441592.38,DR,REF782382,NAB,Business
23-09-2025 06:51,NAB6B6DC4FDC7244F5AA0F0,082-900-001,44444444,SALARY PAYMENT NAB,0,3793,445385.38,CR,REF138277,NAB,Business
23-09-2025 07:01,NABAA92971149C64449818E,082-900-001,44444444,SALARY PAYMENT NAB,0,1845.7,447231.08,CR,REF816447,NAB,Business
23-09-2025 07:21,NAB6F5AC08B7623497A985C,082-900-001,44444444,UBER EATS NAB,566.77,0,446664.31,DR,REF157072,NAB,Business
23-09-2025 07:40,NABCE7D91E6DFE643AEBB89,082-900-001,44444444,UBER EATS NAB,624.46,0,446039.85,DR,REF649152,NAB,Business
23-09-2025 07:41,NAB0A3D841A8F3944A2B2F4,082-900-001,44444444,APPLE NAB,362.13,0,445677.72,DR,REF430851,NAB,Business
23-09-2025 08:16,NABFD9314D798D845FC9490,082-900-001,44444444,ALDI NAB,436.72,0,445241,DR,REF996392,NAB,Business
23-09-2025 08:17,NAB9C0FFB694ABA4209842D,082-900-001,44444444,PAYROLL CREDIT NAB,0,286.56,445527.56,CR,REF672407,NAB,Business
23-09-2025 08:26,NABB8C71F547C5B41D9A3EC,082-900-001,44444444,UBER EATS NAB,484.63,0,445042.93,DR,REF434654,NAB,Business
23-09-2025 09:04,NABA21BC681915848B2ABC8,082-900-001,44444444,KFC NAB,362.45,0,444680.48,DR,REF480353,NAB,Business
23-09-2025 09:23,NAB2ABACC380CC04C9798A6,082-900-001,44444444,KFC NAB,86.74,0,444593.74,DR,REF443167,NAB,Business
23-09-2025 09:23,NABB65C57B159E1472FAFDF,082-900-001,44444444,PAYROLL CREDIT NAB,0,5985.96,450579.7,CR,REF407359,NAB,Business
23-09-2025 09:27,NAB389026A6C67E426F8477,082-900-001,44444444,JB HI-FI NAB,362.39,0,450217.31,DR,REF506074,NAB,Business
23-09-2025 10:43,NAB451A9809E40E4991A89C,082-900-001,44444444,HARVEY NORMAN NAB,131.8,0,450085.51,DR,REF586048,NAB,Business
23-09-2025 10:52,NABE38325FB2D794693A6B0,082-900-001,44444444,7-ELEVEN NAB,190.14,0,449895.37,DR,REF557120,NAB,Business
23-09-2025 10:55,NAB80E7B9FAD4364FEEB358,082-900-001,44444444,AMAZON AU NAB,749.25,0,449146.12,DR,REF385911,NAB,Business
23-09-2025 11:01,INTBBDD611D4F634FE789B2,082-900-001,44444444,TRANSFER TO CBA 22222222,1642.57,0,447503.55,DR,INT-96053,NAB,Business
23-09-2025 11:18,NAB5DE1134FFA0542C18F32,082-900-001,44444444,PAYMENT GATEWAY NAB,1370.25,0,446133.3,DR,REF798178,NAB,Business
23-09-2025 11:27,NAB9BD8459DB86E443780BD,082-900-001,44444444,FLIXBUS NAB,28.96,0,446104.34,DR,REF155783,NAB,Business
23-09-2025 11:35,NAB67F1787B5D754BF384F9,082-900-001,44444444,7-ELEVEN NAB,725.76,0,445378.58,DR,REF242618,NAB,Business
23-09-2025 11:41,NAB00997453F74C476F8776,082-900-001,44444444,LIQUORLAND NAB,478.01,0,444900.57,DR,REF141412,NAB,Business
23-09-2025 12:03,NABD8128594AD8B4BC59BED,082-900-001,44444444,BWS NAB,193.22,0,444707.35,DR,REF259564,NAB,Business
23-09-2025 12:09,INTAE0E573BCCC9401F811C,082-900-001,44444444,TRANSFER FROM ANZ 11111111,0,1246.95,445954.3,CR,INT-52565,NAB,Business
23-09-2025 12:10,NABAE373FD1C9EA43F881AF,082-900-001,44444444,CITYLINK NAB,192.23,0,445762.07,DR,REF791323,NAB,Business
23-09-2025 12:38,NABC7052D32581B4335BE26,082-900-001,44444444,RAILWAY STATION NAB,88.51,0,445673.56,DR,REF862855,NAB,Business
23-09-2025 12:50,NABCEEE6F6D4F2A4F9D9368,082-900-001,44444444,STARBUCKS NAB,492.7,0,445180.86,DR,REF279236,NAB,Business
23-09-2025 12:54,NAB3FB5C014AF9841C9A550,082-900-001,44444444,TAFE BOOKSHOP NAB,246.44,0,444934.42,DR,REF606997,NAB,Business
23-09-2025 12:54,NAB26A696BB40C049AFA566,082-900-001,44444444,CITYLINK NAB,403.18,0,444531.24,DR,REF494216,NAB,Business
23-09-2025 13:13,NAB86CE0EF2E2C642BD9D01,082-900-001,44444444,ALDI NAB,209.02,0,444322.22,DR,REF501704,NAB,Business
23-09-2025 13:14,NABEA3A02C93EC049BE9AD6,082-900-001,44444444,BIGW NAB,169.1,0,444153.12,DR,REF847131,NAB,Business
23-09-2025 13:17,NABA1D040ADAFD040A9ADF5,082-900-001,44444444,RAILWAY STATION NAB,884.62,0,443268.5,DR,REF638053,NAB,Business
23-09-2025 13:58,NAB967A152B334342409148,082-900-001,44444444,PAYPAL *NETFLIX NAB,322.47,0,442946.03,DR,REF833616,NAB,Business
23-09-2025 14:32,NAB85A9693158B0412BBAE5,082-900-001,44444444,WAGES CREDIT NAB,0,449.38,443395.41,CR,REF900762,NAB,Business
23-09-2025 15:03,NAB7675582F3E8743D1AB0D,082-900-001,44444444,SHELL NAB,802.44,0,442592.97,DR,REF475725,NAB,Business
23-09-2025 16:25,NABD58B1BE6F06949F48589,082-900-001,44444444,PAY - SALARY NAB,0,4801.45,447394.42,CR,REF896229,NAB,Business
23-09-2025 16:29,NABACFF59453F66429194EA,082-900-001,44444444,RAILWAY STATION NAB,184.8,0,447209.62,DR,REF550894,NAB,Business
23-09-2025 16:46,NABAAD531EB9C58433AAD76,082-900-001,44444444,COMPANY PAYROLL NAB,0,4042.15,451251.77,CR,REF805311,NAB,Business
23-09-2025 16:54,NAB3437A4D2CDFE462FBF68,082-900-001,44444444,UBER EATS NAB,284.23,0,450967.54,DR,REF774799,NAB,Business
23-09-2025 17:14,NAB021AF158F91C42C18B98,082-900-001,44444444,INTERNET TRANSFER NAB,431.98,0,450535.56,DR,REF872389,NAB,Business
23-09-2025 17:16,NAB27775D629FF647C38EAB,082-900-001,44444444,COLES NAB,56.57,0,450478.99,DR,REF170328,NAB,Business
23-09-2025 17:43,NABEC7F69D60CBD4078A320,082-900-001,44444444,MENULOG NAB,75.48,0,450403.51,DR,REF174009,NAB,Business
23-09-2025 18:21,NAB9CBC7390D4E24734AF61,082-900-001,44444444,FLIXBUS NAB,809.27,0,449594.24,DR,REF947978,NAB,Business
23-09-2025 19:52,NAB78A627C790B345D1AA64,082-900-001,44444444,UBER EATS NAB,432.71,0,449161.53,DR,REF730321,NAB,Business
23-09-2025 19:58,NAB0150DA017E894E97BB3E,082-900-001,44444444,SPOTIFY NAB,191,0,448970.53,DR,REF161143,NAB,Business
23-09-2025 20:05,NABE1B5B11E837B43269468,082-900-001,44444444,MCDONALDS NAB,585.92,0,448384.61,DR,REF469874,NAB,Business
23-09-2025 20:24,NAB572002906C7C4F18B60B,082-900-001,44444444,BIGW NAB,749.87,0,447634.74,DR,REF280336,NAB,Business
23-09-2025 20:52,NAB0CC7FA7265FD44CE97D5,082-900-001,44444444,DOMINO'S PIZZA NAB,81.89,0,447552.85,DR,REF838536,NAB,Business
23-09-2025 21:16,NABD0BE2F03165645688F54,082-900-001,44444444,PAYMENT GATEWAY NAB,39.8,0,447513.05,DR,REF778035,NAB,Business
23-09-2025 21:17,NAB0E5D51EBA9EA4D1DB3DF,082-900-001,44444444,RAILWAY STATION NAB,159.73,0,447353.32,DR,REF980965,NAB,Business
23-09-2025 21:23,NAB47EA16085EB14DF4A164,082-900-001,44444444,RAILWAY STATION NAB,883.37,0,446469.95,DR,REF999576,NAB,Business
23-09-2025 21:26,NAB84B320A9C45B485B853B,082-900-001,44444444,INTERNET TRANSFER NAB,448.63,0,446021.32,DR,REF903699,NAB,Business
23-09-2025 21:52,NAB55C843712B78425081EA,082-900-001,44444444,JB HI-FI NAB,223.3,0,445798.02,DR,REF932881,NAB,Business
23-09-2025 21:59,NAB90D009604D174F49869A,082-900-001,44444444,INTERNET TRANSFER NAB,602.54,0,445195.48,DR,REF329653,NAB,Business
23-09-2025 22:15,NABFA06687585DF4BE88FA4,082-900-001,44444444,PAYMENT GATEWAY NAB,336.1,0,444859.38,DR,REF420950,NAB,Business
23-09-2025 22:21,NAB3BBC414CCA7C4662B638,082-900-001,44444444,BP NAB,161.71,0,444697.67,DR,REF863752,NAB,Business
24-09-2025 00:11,NABEE3A5FCA2AFF4E118844,082-900-001,44444444,WAGES CREDIT NAB,0,18.79,444716.46,CR,REF266729,NAB,Business
24-09-2025 00:13,NABEDF53758459B4636A163,082-900-001,44444444,COMPANY PAYROLL NAB,0,789.02,445505.48,CR,REF876101,NAB,Business
24-09-2025 00:22,NAB7740ABB8D6C74988A01E,082-900-001,44444444,APPLE NAB,131.29,0,445374.19,DR,REF907968,NAB,Business
24-09-2025 00:29,NAB5AFCE909798D41B4BEC6,082-900-001,44444444,MCDONALDS NAB,125.13,0,445249.06,DR,REF683692,NAB,Business
24-09-2025 00:35,INTBD14CDBD8856434A8947,082-900-001,44444444,TRANSFER TO ANZ 11111111,1745.73,0,443503.33,DR,INT-71876,NAB,Business
24-09-2025 00:44,NAB5E9D445FB8034E44B0A8,082-900-001,44444444,STARBUCKS NAB,107.63,0,443395.7,DR,REF459140,NAB,Business
24-09-2025 00:45,NAB3C67040F2F994ACB8CC1,082-900-001,44444444,APPLE NAB,354.2,0,443041.5,DR,REF145036,NAB,Business
24-09-2025 01:28,NAB26B588EF157848CF8315,082-900-001,44444444,JB HI-FI NAB,941.53,0,442099.97,DR,REF624487,NAB,Business
24-09-2025 01:33,NAB07C6E6A4453B402BA357,082-900-001,44444444,PAYPAL *NETFLIX NAB,467.02,0,441632.95,DR,REF838886,NAB,Business
24-09-2025 01:39,NAB403918D03FDF49B591A5,082-900-001,44444444,CITYLINK NAB,94.48,0,441538.47,DR,REF628115,NAB,Business
24-09-2025 01:45,INTA69A2F808112443AADB7,082-900-001,44444444,TRANSFER FROM CBA 33333333,0,378.28,441916.75,CR,INT-91661,NAB,Business
24-09-2025 02:47,NABADC9CD7D593E44FCB173,082-900-001,44444444,HARVEY NORMAN NAB,131.85,0,441784.9,DR,REF228301,NAB,Business
24-09-2025 03:02,NABA2EE8607DFF143AAA0CD,082-900-001,44444444,7-ELEVEN NAB,438.54,0,441346.36,DR,REF149066,NAB,Business
24-09-2025 03:15,NAB9BD32E97102B49FA8AFC,082-900-001,44444444,PAYROLL CREDIT NAB,0,4445.72,445792.08,CR,REF637558,NAB,Business
24-09-2025 03:26,NAB63DE603F448E4ABB9A4C,082-900-001,44444444,DOMINO'S PIZZA NAB,81.43,0,445710.65,DR,REF759006,NAB,Business
24-09-2025 03:37,NABE6A7308B09BA4632A74F,082-900-001,44444444,HARVEY NORMAN NAB,538.51,0,445172.14,DR,REF855651,NAB,Business
24-09-2025 04:20,NAB1DFA662C0828473D8E43,082-900-001,44444444,JB HI-FI NAB,1196.1,0,443976.04,DR,REF764505,NAB,Business
24-09-2025 04:52,NAB8E0B85844552464A93AF,082-900-001,44444444,DOMINO'S PIZZA NAB,149.17,0,443826.87,DR,REF594927,NAB,Business
24-09-2025 05:32,NAB22F4BDC53E94414F9B98,082-900-001,44444444,BANK FEE NAB,458.93,0,443367.94,DR,REF473991,NAB,Business
24-09-2025 06:07,NAB7346E58355324524A07A,082-900-001,44444444,INTERNET TRANSFER NAB,116.38,0,443251.56,DR,REF306034,NAB,Business
24-09-2025 06:13,NAB5397970EBEE24AB88FA1,082-900-001,44444444,BWS NAB,1014.74,0,442236.82,DR,REF497449,NAB,Business
24-09-2025 07:01,NAB218B96B1ADE74BE7A2CB,082-900-001,44444444,PAYPAL *NETFLIX NAB,100.76,0,442136.06,DR,REF173422,NAB,Business
24-09-2025 07:28,NAB9D99B4AB63F74A1180AE,082-900-001,44444444,RAILWAY STATION NAB,373.11,0,441762.95,DR,REF300415,NAB,Business
24-09-2025 07:45,NAB2A440AFE93614261ABC8,082-900-001,44444444,TAFE BOOKSHOP NAB,87.39,0,441675.56,DR,REF591939,NAB,Business
24-09-2025 07:47,NAB449D5905B0C843DD8622,082-900-001,44444444,BP NAB,83.85,0,441591.71,DR,REF207724,NAB,Business
24-09-2025 07:53,NABD557A251585945618612,082-900-001,44444444,PAYROLL CREDIT NAB,0,6683.53,448275.24,CR,REF825338,NAB,Business
24-09-2025 08:38,NAB7C6A2B9F4BE04D98B907,082-900-001,44444444,KFC NAB,76.71,0,448198.53,DR,REF198066,NAB,Business
24-09-2025 08:53,NAB9E9D39CABF6340BF8EA3,082-900-001,44444444,MENULOG NAB,272.29,0,447926.24,DR,REF419893,NAB,Business
24-09-2025 08:58,NAB8BBBEB2C2D9C435ABD2D,082-900-001,44444444,PAYPAL *NETFLIX NAB,104.01,0,447822.23,DR,REF697513,NAB,Business
24-09-2025 09:09,NABD26FB0B319CB467D9A2F,082-900-001,44444444,STARBUCKS NAB,194.23,0,447628,DR,REF477309,NAB,Business
24-09-2025 09:10,NABBAA1C74FCD8149D8A1B8,082-900-001,44444444,STARBUCKS NAB,337.31,0,447290.69,DR,REF529268,NAB,Business
24-09-2025 09:37,NAB898D441320E0413E872E,082-900-001,44444444,WOOLWORTHS NAB,221.06,0,447069.63,DR,REF443360,NAB,Business
24-09-2025 09:58,NABDC8D28A4E0F744F2B8FB,082-900-001,44444444,PAY - SALARY NAB,0,4637.37,451707,CR,REF185251,NAB,Business
24-09-2025 10:10,NABC38204931A414DC8B14D,082-900-001,44444444,LIQUORLAND NAB,344.79,0,451362.21,DR,REF469213,NAB,Business
24-09-2025 10:17,NAB4B000EAD3F944F80B2FD,082-900-001,44444444,7-ELEVEN NAB,372.84,0,450989.37,DR,REF441700,NAB,Business
24-09-2025 11:36,NAB5C0FC9D1365D403C8DF1,082-900-001,44444444,PAY - SALARY NAB,0,2538.94,453528.31,CR,REF648492,NAB,Business
24-09-2025 11:50,NABB2191FBD2BB24DC5A555,082-900-001,44444444,RAILWAY STATION NAB,110.03,0,453418.28,DR,REF201277,NAB,Business
24-09-2025 12:26,NABD4354B9D89D64033A262,082-900-001,44444444,COLES NAB,249.63,0,453168.65,DR,REF264271,NAB,Business
24-09-2025 12:48,NAB3906D295369F49668FC4,082-900-001,44444444,COMPANY PAYROLL NAB,0,3351.79,456520.44,CR,REF404892,NAB,Business
24-09-2025 12:52,NAB91A4E81F5BF44150940F,082-900-001,44444444,JB HI-FI NAB,796.16,0,455724.28,DR,REF179966,NAB,Business
24-09-2025 13:02,NABD1062CF20A46446888AF,082-900-001,44444444,AMAZON AU NAB,111.59,0,455612.69,DR,REF897971,NAB,Business
24-09-2025 13:13,NABF23567E69D504A399C15,082-900-001,44444444,LIQUORLAND NAB,636.31,0,454976.38,DR,REF352898,NAB,Business
24-09-2025 13:24,NAB854D5C5DDB1648EFBE9F,082-900-001,44444444,TAFE BOOKSHOP NAB,101.56,0,454874.82,DR,REF896814,NAB,Business
24-09-2025 14:01,NABC32F4813D15B43D2AC26,082-900-001,44444444,LIQUORLAND NAB,648.45,0,454226.37,DR,REF664306,NAB,Business
24-09-2025 14:42,NABF96502ACCECC4682875C,082-900-001,44444444,WAGES CREDIT NAB,0,325.47,454551.84,CR,REF792670,NAB,Business
24-09-2025 14:51,NAB18D20045ED804D2CBBC5,082-900-001,44444444,INTERNET TRANSFER NAB,347.26,0,454204.58,DR,REF200801,NAB,Business
24-09-2025 14:58,NAB0265795848BD47DA8422,082-900-001,44444444,BWS NAB,101.89,0,454102.69,DR,REF178332,NAB,Business
24-09-2025 15:13,NABD0723B3DE0E44E7EA4C5,082-900-001,44444444,AMAZON AU NAB,626.15,0,453476.54,DR,REF990513,NAB,Business
24-09-2025 15:23,NAB5E469C1D298E44039BD1,082-900-001,44444444,BIGW NAB,2320.6,0,451155.94,DR,REF739422,NAB,Business
24-09-2025 16:15,NAB80468F9B2C8B47A5AF31,082-900-001,44444444,BP NAB,496.76,0,450659.18,DR,REF328064,NAB,Business
24-09-2025 16:33,NAB310B6E9B208E4FDB8E43,082-900-001,44444444,BANK FEE NAB,489.42,0,450169.76,DR,REF593164,NAB,Business
24-09-2025 17:10,NAB1E370E1A64FA427E9F0C,082-900-001,44444444,UBER EATS NAB,184.29,0,449985.47,DR,REF662955,NAB,Business
24-09-2025 17:16,NABB1986D2990724DD88DA9,082-900-001,44444444,PAYPAL *NETFLIX NAB,93.17,0,449892.3,DR,REF261229,NAB,Business
24-09-2025 17:25,NAB3676B81A18CA4AEEAFAA,082-900-001,44444444,SALARY PAYMENT NAB,0,81.59,449973.89,CR,REF373819,NAB,Business
24-09-2025 17:59,NAB82DC3CD3FD824B59893D,082-900-001,44444444,BP NAB,165.39,0,449808.5,DR,REF919923,NAB,Business
24-09-2025 18:24,NAB8770B9A38A6E4C149795,082-900-001,44444444,BP NAB,691.49,0,449117.01,DR,REF778957,NAB,Business
24-09-2025 18:43,NAB8731AB82AFA445ACB995,082-900-001,44444444,STARBUCKS NAB,78.24,0,449038.77,DR,REF563488,NAB,Business
24-09-2025 18:43,NABC8D9E9607390428781B6,082-900-001,44444444,MENULOG NAB,94.31,0,448944.46,DR,REF148035,NAB,Business
24-09-2025 18:45,NAB9820E28E33BE4F79BECC,082-900-001,44444444,CITYLINK NAB,921.41,0,448023.05,DR,REF870263,NAB,Business
24-09-2025 19:37,NAB8BBAFD628CCC4382A601,082-900-001,44444444,ALDI NAB,156.51,0,447866.54,DR,REF312162,NAB,Business
24-09-2025 19:50,NAB851018F6D0454178BA03,082-900-001,44444444,APPLE NAB,330.4,0,447536.14,DR,REF393567,NAB,Business
24-09-2025 20:07,NABA178DF38F6AA4FE59E7E,082-900-001,44444444,BANK FEE NAB,245.67,0,447290.47,DR,REF924165,NAB,Business
24-09-2025 20:23,NAB6589F46461374DC89961,082-900-001,44444444,APPLE NAB,111.16,0,447179.31,DR,REF462451,NAB,Business
24-09-2025 20:31,NAB0CC0B4B8BE274DA7A690,082-900-001,44444444,SHELL NAB,237.39,0,446941.92,DR,REF258516,NAB,Business
24-09-2025 20:46,NABF9224BF5BEB54B809C1D,082-900-001,44444444,FLIXBUS NAB,556.11,0,446385.81,DR,REF685051,NAB,Business
24-09-2025 20:47,NAB33A50509479E478F95E2,082-900-001,44444444,MENULOG NAB,305.75,0,446080.06,DR,REF618123,NAB,Business
24-09-2025 20:48,NAB5D995F7B3CB94B30A90F,082-900-001,44444444,MCDONALDS NAB,525.78,0,445554.28,DR,REF466422,NAB,Business
24-09-2025 20:59,NAB961F5B92764647768BFC,082-900-001,44444444,JB HI-FI NAB,358.79,0,445195.49,DR,REF787885,NAB,Business
24-09-2025 21:16,NABF0FDD0F1463840A48302,082-900-001,44444444,ALDI NAB,179.64,0,445015.85,DR,REF869913,NAB,Business
24-09-2025 21:22,NABBA9F43DF9DDF4FECB46B,082-900-001,44444444,COMPANY PAYROLL NAB,0,5946.09,450961.94,CR,REF151709,NAB,Business
24-09-2025 21:58,NABEF43FC1386404E54BD5D,082-900-001,44444444,FLIXBUS NAB,308.07,0,450653.87,DR,REF636519,NAB,Business
24-09-2025 22:00,NABB0605E3E0D4D41C591BD,082-900-001,44444444,WOOLWORTHS NAB,59.03,0,450594.84,DR,REF364684,NAB,Business
24-09-2025 22:14,NABEE9FA18FB22E42108328,082-900-001,44444444,MENULOG NAB,48.8,0,450546.04,DR,REF510005,NAB,Business
24-09-2025 22:17,NAB1956C168B31A47A1B622,082-900-001,44444444,UBER EATS NAB,57.77,0,450488.27,DR,REF156804,NAB,Business
24-09-2025 22:43,NABFA35ACBA22874754AFE4,082-900-001,44444444,ZOOM NAB,212.6,0,450275.67,DR,REF282479,NAB,Business
24-09-2025 23:24,NAB2FFCC5FFED614070A6B7,082-900-001,44444444,WAGES CREDIT NAB,0,152.87,450428.54,CR,REF477782,NAB,Business
24-09-2025 23:29,NAB0076AA258C7B4118AEB4,082-900-001,44444444,AMAZON AU NAB,279.65,0,450148.89,DR,REF579253,NAB,Business
24-09-2025 23:53,NAB210A03558A1D4E1884EE,082-900-001,44444444,DOMINO'S PIZZA NAB,265.53,0,449883.36,DR,REF779158,NAB,Business
25-09-2025 00:16,NABDC72B281ED4A4C149F83,082-900-001,44444444,PAY - SALARY NAB,0,3643.66,453527.02,CR,REF490167,NAB,Business
25-09-2025 00:19,NAB12E785531E8A44DD838E,082-900-001,44444444,LIQUORLAND NAB,156.95,0,453370.07,DR,REF243152,NAB,Business
25-09-2025 00:22,NABFC5F37AE6E974195B54E,082-900-001,44444444,COLES NAB,301.05,0,453069.02,DR,REF852941,NAB,Business
25-09-2025 00:31,NABE755A70B0DAC41EBB963,082-900-001,44444444,TAFE BOOKSHOP NAB,79.36,0,452989.66,DR,REF659265,NAB,Business
25-09-2025 00:43,NAB875741CE0C9A4E0DA4D5,082-900-001,44444444,UBER EATS NAB,512.47,0,452477.19,DR,REF417450,NAB,Business
25-09-2025 01:14,NAB542F0C0070B6424D8372,082-900-001,44444444,WOOLWORTHS NAB,45.54,0,452431.65,DR,REF214665,NAB,Business
25-09-2025 01:22,NABC9DAED6525584A6791B9,082-900-001,44444444,FLIXBUS NAB,141.83,0,452289.82,DR,REF352090,NAB,Business
25-09-2025 01:33,NAB695BEDDE99954CDC990C,082-900-001,44444444,RAILWAY STATION NAB,162.95,0,452126.87,DR,REF958934,NAB,Business
25-09-2025 02:10,INT4C4429D928C745F9B5A6,082-900-001,44444444,TRANSFER TO ANZ 11111111,735.62,0,451391.25,DR,INT-12189,NAB,Business
25-09-2025 02:17,NABDB9BF0B6CD304C0888B1,082-900-001,44444444,KFC NAB,697.82,0,450693.43,DR,REF501561,NAB,Business
25-09-2025 02:27,INT652581941461406DBD62,082-900-001,44444444,TRANSFER TO CBA 22222222,167.59,0,450525.84,DR,INT-52840,NAB,Business
25-09-2025 04:22,NAB6502C81C54F84034AF25,082-900-001,44444444,HARVEY NORMAN NAB,159.74,0,450366.1,DR,REF910320,NAB,Business
25-09-2025 04:26,NAB4CD7A992C51C438AAF39,082-900-001,44444444,HARVEY NORMAN NAB,137.29,0,450228.81,DR,REF194200,NAB,Business
25-09-2025 04:39,NAB07875C2DFE444A0FA926,082-900-001,44444444,WAGES CREDIT NAB,0,4058.43,454287.24,CR,REF109857,NAB,Business
25-09-2025 05:04,INT0F62A41CC9BC44FEB520,082-900-001,44444444,TRANSFER TO CBA 22222222,1055.13,0,453232.11,DR,INT-36644,NAB,Business
25-09-2025 05:24,NAB3FD33EF5087448728DF0,082-900-001,44444444,SALARY PAYMENT NAB,0,7882.33,461114.44,CR,REF570584,NAB,Business
25-09-2025 05:31,NAB032E82EED8CB4689BCF0,082-900-001,44444444,SHELL NAB,122.44,0,460992,DR,REF459670,NAB,Business
25-09-2025 05:38,NAB4ACA4B6D16F84A35A8CD,082-900-001,44444444,PAYMENT GATEWAY NAB,587.37,0,460404.63,DR,REF801130,NAB,Business
25-09-2025 05:42,NAB3EEA4E32629C49B29029,082-900-001,44444444,DOMINO'S PIZZA NAB,480.62,0,459924.01,DR,REF208596,NAB,Business
25-09-2025 05:46,NAB39D1BE40C04C4238931E,082-900-001,44444444,KFC NAB,716.24,0,459207.77,DR,REF965712,NAB,Business
25-09-2025 05:53,NAB0378CE808EBC489AB4AA,082-900-001,44444444,BWS NAB,107.65,0,459100.12,DR,REF115263,NAB,Business
25-09-2025 06:36,NAB6F638792D6A14F65BC3A,082-900-001,44444444,PAYPAL *NETFLIX NAB,208.6,0,458891.52,DR,REF862886,NAB,Business
25-09-2025 06:43,NAB783F4A0441724521A892,082-900-001,44444444,COMPANY PAYROLL NAB,0,3288.38,462179.9,CR,REF535242,NAB,Business
25-09-2025 07:18,NABA07F058454F3467DA4E9,082-900-001,44444444,COLES NAB,353.88,0,461826.02,DR,REF683479,NAB,Business
25-09-2025 07:22,NABF8EE09CE7798443AA004,082-900-001,44444444,BWS NAB,1051.75,0,460774.27,DR,REF654611,NAB,Business
25-09-2025 07:42,NAB277CB8BB39314D7BA032,082-900-001,44444444,UBER EATS NAB,483.08,0,460291.19,DR,REF458982,NAB,Business
25-09-2025 07:48,NAB9AE35B5F89CB40DD8A29,082-900-001,44444444,RAILWAY STATION NAB,33.87,0,460257.32,DR,REF361425,NAB,Business
25-09-2025 08:02,NAB7025B2762BFF46CDB538,082-900-001,44444444,LIQUORLAND NAB,171.98,0,460085.34,DR,REF116612,NAB,Business
25-09-2025 08:41,NABD1808DBC5E08486F8991,082-900-001,44444444,BANK FEE NAB,25.66,0,460059.68,DR,REF104795,NAB,Business
25-09-2025 09:01,NAB369C001932334547AC64,082-900-001,44444444,LIQUORLAND NAB,30.63,0,460029.05,DR,REF674713,NAB,Business
25-09-2025 09:02,NAB8C5E2FF443AA44CB93B5,082-900-001,44444444,7-ELEVEN NAB,198.82,0,459830.23,DR,REF872696,NAB,Business
25-09-2025 09:19,NAB0CDE198DA20D427A8293,082-900-001,44444444,RAILWAY STATION NAB,128.24,0,459701.99,DR,REF446313,NAB,Business
25-09-2025 10:20,NABAB2ACA86C96B47FDA253,082-900-001,44444444,WOOLWORTHS NAB,1563.61,0,458138.38,DR,REF778446,NAB,Business
25-09-2025 10:30,NAB2697F27A17984930A709,082-900-001,44444444,UBER EATS NAB,208.1,0,457930.28,DR,REF207037,NAB,Business
25-09-2025 11:33,NABF1C5D6174A8A4311896D,082-900-001,44444444,SPOTIFY NAB,118.74,0,457811.54,DR,REF369544,NAB,Business
25-09-2025 11:53,NAB50CB63DE976B4889B399,082-900-001,44444444,CITYLINK NAB,210.32,0,457601.22,DR,REF447126,NAB,Business
25-09-2025 12:10,NAB78E5FA965C634B2EA758,082-900-001,44444444,SHELL NAB,674,0,456927.22,DR,REF529997,NAB,Business
25-09-2025 12:11,NAB23142FA0A02B455699C8,082-900-001,44444444,SPOTIFY NAB,265.24,0,456661.98,DR,REF149214,NAB,Business
25-09-2025 12:11,NAB57F24D7526594F00B2F1,082-900-001,44444444,CITYLINK NAB,262.58,0,456399.4,DR,REF702140,NAB,Business
25-09-2025 12:49,NABB868041099384078A3F4,082-900-001,44444444,BANK FEE NAB,261.69,0,456137.71,DR,REF405725,NAB,Business
25-09-2025 12:58,NAB3310079F299B4CE990C7,082-900-001,44444444,SALARY PAYMENT NAB,0,7256.41,463394.12,CR,REF507509,NAB,Business
25-09-2025 13:13,NAB84B80AD2AC0B43F6B29C,082-900-001,44444444,7-ELEVEN NAB,279.85,0,463114.27,DR,REF147363,NAB,Business
25-09-2025 13:27,NAB66D7AA24DF28431B9969,082-900-001,44444444,APPLE NAB,437.81,0,462676.46,DR,REF617690,NAB,Business
25-09-2025 13:28,INTBCCABC624E4342269923,082-900-001,44444444,TRANSFER FROM ANZ 11111111,0,1235.14,463911.6,CR,INT-77393,NAB,Business
25-09-2025 13:36,NABDF4D70FD2E9F4BECA523,082-900-001,44444444,BANK FEE NAB,367.28,0,463544.32,DR,REF324355,NAB,Business
25-09-2025 13:44,NAB0FACBC42189E4DBB8682,082-900-001,44444444,HARVEY NORMAN NAB,591.76,0,462952.56,DR,REF902257,NAB,Business
25-09-2025 13:58,NABFBF8C831290A4D5195BA,082-900-001,44444444,AMAZON AU NAB,300.63,0,462651.93,DR,REF792076,NAB,Business
25-09-2025 14:06,NABBA089CDA2E8A4B7CBA34,082-900-001,44444444,PAYMENT GATEWAY NAB,32.64,0,462619.29,DR,REF141911,NAB,Business
25-09-2025 14:21,NAB2C94917FFD0141B1B999,082-900-001,44444444,FLIXBUS NAB,250.06,0,462369.23,DR,REF950358,NAB,Business
25-09-2025 14:33,NAB97E356A663C147AEA8B5,082-900-001,44444444,ZOOM NAB,340.25,0,462028.98,DR,REF365985,NAB,Business
25-09-2025 15:18,NAB2C03894004494D5F9F58,082-900-001,44444444,MCDONALDS NAB,1123.33,0,460905.65,DR,REF932355,NAB,Business
25-09-2025 15:30,NAB7AE3D105B47D44419416,082-900-001,44444444,ALDI NAB,630.11,0,460275.54,DR,REF306040,NAB,Business
25-09-2025 16:18,NAB96014B896D5544DB8BCE,082-900-001,44444444,MENULOG NAB,803.64,0,459471.9,DR,REF239277,NAB,Business
25-09-2025 16:47,NAB5825E3B30DCC4E50A78F,082-900-001,44444444,DOMINO'S PIZZA NAB,417.05,0,459054.85,DR,REF876557,NAB,Business
25-09-2025 17:40,NAB3D8981FE82EB4984A444,082-900-001,44444444,BWS NAB,141.13,0,458913.72,DR,REF496903,NAB,Business
25-09-2025 18:11,NAB266FF4352BC144CCAC23,082-900-001,44444444,MCDONALDS NAB,810.26,0,458103.46,DR,REF725165,NAB,Business
25-09-2025 18:45,NAB4C4CC68B01284291A769,082-900-001,44444444,ZOOM NAB,496.17,0,457607.29,DR,REF199629,NAB,Business
25-09-2025 20:12,NABEF7C99B2059A4465A607,082-900-001,44444444,CITYLINK NAB,129.84,0,457477.45,DR,REF569424,NAB,Business
25-09-2025 20:31,NAB5915B6388447450AA528,082-900-001,44444444,COMPANY PAYROLL NAB,0,695.6,458173.05,CR,REF571981,NAB,Business
25-09-2025 21:15,NABAB9E5320302540EA873B,082-900-001,44444444,CITYLINK NAB,205.58,0,457967.47,DR,REF926005,NAB,Business
25-09-2025 21:33,NABA759CB259CD54B20AA50,082-900-001,44444444,COLES NAB,176.56,0,457790.91,DR,REF226557,NAB,Business
25-09-2025 21:34,NABFD5E2D765C8F4466A290,082-900-001,44444444,MCDONALDS NAB,779.37,0,457011.54,DR,REF996982,NAB,Business
25-09-2025 22:26,NABEF58D05609E044D893ED,082-900-001,44444444,BANK FEE NAB,1033.59,0,455977.95,DR,REF310024,NAB,Business
25-09-2025 22:30,INT1AD6DBEC7F0A47EB9A93,082-900-001,44444444,TRANSFER FROM CBA 33333333,0,1084.23,457062.18,CR,INT-94684,NAB,Business
25-09-2025 22:33,NAB90C329CC0CE247278AF9,082-900-001,44444444,WOOLWORTHS NAB,818.71,0,456243.47,DR,REF561376,NAB,Business
25-09-2025 22:45,NABC2ECF99538624204A2DF,082-900-001,44444444,CITYLINK NAB,335.59,0,455907.88,DR,REF602181,NAB,Business
25-09-2025 22:56,NAB90007DA627C540AB8E13,082-900-001,44444444,MCDONALDS NAB,52.51,0,455855.37,DR,REF282898,NAB,Business
25-09-2025 23:07,NABB37CA05FED4540779A32,082-900-001,44444444,WOOLWORTHS NAB,136,0,455719.37,DR,REF580124,NAB,Business
25-09-2025 23:12,NAB122BBC5EDBB84EE6B61A,082-900-001,44444444,ZOOM NAB,559.17,0,455160.2,DR,REF107759,NAB,Business
25-09-2025 23:26,NAB2ABE666DF9434DC1A48E,082-900-001,44444444,ALDI NAB,818.29,0,454341.91,DR,REF547836,NAB,Business
25-09-2025 23:29,NAB150FC2C9AEB84EB38CEC,082-900-001,44444444,SHELL NAB,880.01,0,453461.9,DR,REF131427,NAB,Business
25-09-2025 23:33,NABEDF6D555CF754D2DA537,082-900-001,44444444,BANK FEE NAB,324.17,0,453137.73,DR,REF720571,NAB,Business
26-09-2025 00:05,NABBEE7E6E9A85D4B399A70,082-900-001,44444444,RAILWAY STATION NAB,98.77,0,453038.96,DR,REF510420,NAB,Business
26-09-2025 01:48,NABB90746B366A342E5B7AB,082-900-001,44444444,APPLE NAB,434.33,0,452604.63,DR,REF664833,NAB,Business
26-09-2025 02:24,NABAF3A54838BE34B0D8379,082-900-001,44444444,KFC NAB,1011.96,0,451592.67,DR,REF818521,NAB,Business
26-09-2025 02:25,NAB2149600846DB4D929EAC,082-900-001,44444444,RAILWAY STATION NAB,185.12,0,451407.55,DR,REF634523,NAB,Business
26-09-2025 02:28,NABFAE915EC28C74E5FA2E4,082-900-001,44444444,STARBUCKS NAB,268.85,0,451138.7,DR,REF631801,NAB,Business
26-09-2025 02:54,NAB47B94B3D475C45F39D45,082-900-001,44444444,WOOLWORTHS NAB,69.78,0,451068.92,DR,REF453110,NAB,Business
26-09-2025 03:12,NABA4C994020E8D4DE188CB,082-900-001,44444444,BWS NAB,80.19,0,450988.73,DR,REF619453,NAB,Business
26-09-2025 03:28,NABFD007245F4EA4E26943E,082-900-001,44444444,ZOOM NAB,827.72,0,450161.01,DR,REF102533,NAB,Business
26-09-2025 04:13,NAB177FDDD9E38843698E4B,082-900-001,44444444,RAILWAY STATION NAB,88.65,0,450072.36,DR,REF973319,NAB,Business
26-09-2025 04:17,NAB2342CAF74B4E42CFAECD,082-900-001,44444444,APPLE NAB,631.73,0,449440.63,DR,REF779770,NAB,Business
26-09-2025 04:40,NAB1260247671004DA0AEA1,082-900-001,44444444,DOMINO'S PIZZA NAB,254.35,0,449186.28,DR,REF541887,NAB,Business
26-09-2025 04:46,NAB1F89BA6253E741B4B6DB,082-900-001,44444444,STARBUCKS NAB,58.21,0,449128.07,DR,REF873227,NAB,Business
26-09-2025 04:56,NAB30D899FAADBB4107B385,082-900-001,44444444,COMPANY PAYROLL NAB,0,6486.92,455614.99,CR,REF197785,NAB,Business
26-09-2025 05:34,NABE51B89A29CEC47AB9CF4,082-900-001,44444444,WAGES CREDIT NAB,0,7584.34,463199.33,CR,REF176890,NAB,Business
26-09-2025 05:42,NABFAD4D62AFB654B909AF2,082-900-001,44444444,STARBUCKS NAB,31.36,0,463167.97,DR,REF507210,NAB,Business
26-09-2025 05:46,NAB1B6E0A8CCDA14B988EBF,082-900-001,44444444,BIGW NAB,270.02,0,462897.95,DR,REF719513,NAB,Business
26-09-2025 05:59,NABE3E378E205C44A598875,082-900-001,44444444,TAFE BOOKSHOP NAB,518.37,0,462379.58,DR,REF151878,NAB,Business
26-09-2025 06:02,NAB0F1B5C2472C64043A0CD,082-900-001,44444444,KFC NAB,46,0,462333.58,DR,REF389832,NAB,Business
26-09-2025 06:38,NAB3CDF790677CE4F4AACBA,082-900-001,44444444,MENULOG NAB,612.68,0,461720.9,DR,REF817400,NAB,Business
26-09-2025 06:47,NAB90F70078E38F4A8AA163,082-900-001,44444444,LIQUORLAND NAB,1039.41,0,460681.49,DR,REF901040,NAB,Business
26-09-2025 06:51,NAB93463E20B5CA470B8DF8,082-900-001,44444444,APPLE NAB,246.64,0,460434.85,DR,REF311621,NAB,Business
26-09-2025 06:59,NABA010F9187A3848CAAAAC,082-900-001,44444444,AMAZON AU NAB,490.65,0,459944.2,DR,REF201475,NAB,Business
26-09-2025 07:00,NABD09E967CA1E84F1D8778,082-900-001,44444444,SPOTIFY NAB,537.34,0,459406.86,DR,REF271727,NAB,Business
26-09-2025 07:01,INT67F2214F9D654CE1A0CC,082-900-001,44444444,TRANSFER FROM ANZ 11111111,0,1189.43,460596.29,CR,INT-61889,NAB,Business
26-09-2025 07:05,NAB30DA0B82862748E2A9A2,082-900-001,44444444,ZOOM NAB,67.26,0,460529.03,DR,REF154066,NAB,Business
26-09-2025 09:06,NABE03ADA84CED3461D9425,082-900-001,44444444,JB HI-FI NAB,577.58,0,459951.45,DR,REF195244,NAB,Business
26-09-2025 09:35,NABDE41390978504149983B,082-900-001,44444444,SALARY PAYMENT NAB,0,378.13,460329.58,CR,REF352263,NAB,Business
26-09-2025 09:37,NABE58EE0CB32504155AAAA,082-900-001,44444444,TAFE BOOKSHOP NAB,692.34,0,459637.24,DR,REF117549,NAB,Business
26-09-2025 09:44,NAB7C9412B7B049492CAE7A,082-900-001,44444444,ZOOM NAB,26.11,0,459611.13,DR,REF584595,NAB,Business
26-09-2025 09:54,NAB8C27EA6F69274CCA81F5,082-900-001,44444444,KFC NAB,63.62,0,459547.51,DR,REF694605,NAB,Business
26-09-2025 10:09,NAB75CAF2373AA944E7976A,082-900-001,44444444,CITYLINK NAB,157.34,0,459390.17,DR,REF941680,NAB,Business
26-09-2025 10:50,NABF71D8080A3CA4486A55E,082-900-001,44444444,BANK FEE NAB,183.4,0,459206.77,DR,REF327294,NAB,Business
26-09-2025 10:57,NABEFDA5A11CAE0469D89ED,082-900-001,44444444,ALDI NAB,1279.44,0,457927.33,DR,REF798896,NAB,Business
26-09-2025 11:00,NABC4AAAA20544947ADB34C,082-900-001,44444444,RAILWAY STATION NAB,45.3,0,457882.03,DR,REF348790,NAB,Business
26-09-2025 11:01,NAB75F13D8F12124786AE78,082-900-001,44444444,LIQUORLAND NAB,281.28,0,457600.75,DR,REF170752,NAB,Business
26-09-2025 11:02,NAB11ADD18C3B134E63B3F5,082-900-001,44444444,APPLE NAB,649.81,0,456950.94,DR,REF869265,NAB,Business
26-09-2025 11:04,NAB87C97C13FE9A47C3AFED,082-900-001,44444444,MENULOG NAB,146.43,0,456804.51,DR,REF899483,NAB,Business
26-09-2025 11:35,NAB7C29EC759E2D452CA5BD,082-900-001,44444444,UBER EATS NAB,538,0,456266.51,DR,REF588794,NAB,Business
26-09-2025 11:36,NABED6BB6A0BA9F41819A61,082-900-001,44444444,WAGES CREDIT NAB,0,6358.56,462625.07,CR,REF243763,NAB,Business
26-09-2025 12:28,NAB9B025D6D8A3048F9B2E8,082-900-001,44444444,RAILWAY STATION NAB,296.21,0,462328.86,DR,REF981432,NAB,Business
26-09-2025 12:30,NAB121272DEA06E4D549CD0,082-900-001,44444444,SPOTIFY NAB,296.36,0,462032.5,DR,REF248335,NAB,Business
26-09-2025 12:33,NABCA4074195EF84BEDB2EE,082-900-001,44444444,PAY - SALARY NAB,0,4761.02,466793.52,CR,REF723280,NAB,Business
26-09-2025 12:39,NAB540CD0B2192A48CEA8C9,082-900-001,44444444,FLIXBUS NAB,37.42,0,466756.1,DR,REF320613,NAB,Business
26-09-2025 13:08,NAB69E108089BA547D49626,082-900-001,44444444,LIQUORLAND NAB,327.4,0,466428.7,DR,REF908142,NAB,Business
26-09-2025 13:14,NAB55D163FA5BB24F0A8BC6,082-900-001,44444444,MENULOG NAB,401.28,0,466027.42,DR,REF709618,NAB,Business
26-09-2025 13:21,NAB4E8EF317C03F4BB7B72D,082-900-001,44444444,CITYLINK NAB,348.56,0,465678.86,DR,REF646622,NAB,Business
26-09-2025 14:02,NAB827A734D7AD84A8288F2,082-900-001,44444444,PAYROLL CREDIT NAB,0,568.74,466247.6,CR,REF242116,NAB,Business
26-09-2025 14:06,NAB2B75E1ABEC9A4EB8A7E5,082-900-001,44444444,CITYLINK NAB,189.17,0,466058.43,DR,REF232390,NAB,Business
26-09-2025 14:50,NAB948A775558494BCE91AE,082-900-001,44444444,PAYROLL CREDIT NAB,0,1751.15,467809.58,CR,REF490861,NAB,Business
26-09-2025 15:13,NAB43FB91FA39E64134BD03,082-900-001,44444444,SPOTIFY NAB,173.78,0,467635.8,DR,REF949850,NAB,Business
26-09-2025 15:14,NAB1824D0E488BC4C7E8E8A,082-900-001,44444444,MENULOG NAB,186.67,0,467449.13,DR,REF774533,NAB,Business
26-09-2025 15:20,NABBA24DB9BB522476BA616,082-900-001,44444444,7-ELEVEN NAB,67.43,0,467381.7,DR,REF182744,NAB,Business
26-09-2025 15:22,NABCAF0D4F2EC284BC69386,082-900-001,44444444,BP NAB,91.81,0,467289.89,DR,REF257927,NAB,Business
26-09-2025 15:54,INT6107F6D3DC4849D88E3D,082-900-001,44444444,TRANSFER TO CBA 33333333,1433.23,0,465856.66,DR,INT-21262,NAB,Business
26-09-2025 16:45,NAB119AC966B03A4968A152,082-900-001,44444444,PAYMENT GATEWAY NAB,133.84,0,465722.82,DR,REF390302,NAB,Business
26-09-2025 16:51,NABCE9E86281C224B49B929,082-900-001,44444444,SALARY PAYMENT NAB,0,6722.66,472445.48,CR,REF187761,NAB,Business
26-09-2025 17:35,NAB53A66B24B04A450D9CC3,082-900-001,44444444,DOMINO'S PIZZA NAB,101.78,0,472343.7,DR,REF779542,NAB,Business
26-09-2025 17:37,NAB8E1E21B289B84B208103,082-900-001,44444444,RAILWAY STATION NAB,80.01,0,472263.69,DR,REF415381,NAB,Business
26-09-2025 18:00,NAB7E2CAF0ADB3D42F2A1F8,082-900-001,44444444,PAYPAL *NETFLIX NAB,96.96,0,472166.73,DR,REF186097,NAB,Business
26-09-2025 19:37,NAB24F2113D78FC4940A508,082-900-001,44444444,RAILWAY STATION NAB,206.13,0,471960.6,DR,REF703860,NAB,Business
26-09-2025 19:38,NAB9511CC6C1B2549D88A47,082-900-001,44444444,SHELL NAB,405.71,0,471554.89,DR,REF498495,NAB,Business
26-09-2025 19:42,NAB80610FB0686C4076A5BD,082-900-001,44444444,BWS NAB,133.69,0,471421.2,DR,REF727890,NAB,Business
26-09-2025 19:46,NABA8E9EA07DDCF4B91BC38,082-900-001,44444444,PAYMENT GATEWAY NAB,344.72,0,471076.48,DR,REF162791,NAB,Business
26-09-2025 20:13,NAB3908B454A58647708760,082-900-001,44444444,APPLE NAB,175.26,0,470901.22,DR,REF523429,NAB,Business
26-09-2025 20:15,NABE67991E1DB314082AC7C,082-900-001,44444444,MCDONALDS NAB,571.01,0,470330.21,DR,REF249175,NAB,Business
26-09-2025 20:37,NABD984ED54420B45BB96EE,082-900-001,44444444,HARVEY NORMAN NAB,194.06,0,470136.15,DR,REF942854,NAB,Business
26-09-2025 21:12,NAB2350D9B119D3498E834B,082-900-001,44444444,COMPANY PAYROLL NAB,0,1034.74,471170.89,CR,REF804891,NAB,Business
26-09-2025 21:19,NAB1AB8C1E24BAE4902B05F,082-900-001,44444444,TAFE BOOKSHOP NAB,534.33,0,470636.56,DR,REF705972,NAB,Business
26-09-2025 21:29,NABFCF9B8A64DD547F8BCFE,082-900-001,44444444,BIGW NAB,194.67,0,470441.89,DR,REF565577,NAB,Business
26-09-2025 22:05,NAB0B898EEEC9A64A8EBA66,082-900-001,44444444,WOOLWORTHS NAB,201.22,0,470240.67,DR,REF782790,NAB,Business
26-09-2025 22:16,NAB872BED895A3044D18F18,082-900-001,44444444,MCDONALDS NAB,139.66,0,470101.01,DR,REF935896,NAB,Business
26-09-2025 23:05,NAB7343D76951E5478A8418,082-900-001,44444444,MCDONALDS NAB,75.68,0,470025.33,DR,REF676900,NAB,Business
26-09-2025 23:08,NAB70B3D3D9A7BC40CEA66C,082-900-001,44444444,ALDI NAB,119.85,0,469905.48,DR,REF825961,NAB,Business
26-09-2025 23:25,NAB818D995BCC2C4F8AACE8,082-900-001,44444444,MCDONALDS NAB,482.59,0,469422.89,DR,REF395696,NAB,Business
27-09-2025 00:04,NABFEB03D20391F4FF8B993,082-900-001,44444444,PAYMENT GATEWAY NAB,73.44,0,469349.45,DR,REF848461,NAB,Business
27-09-2025 00:43,NAB9649E7631EC44F888D81,082-900-001,44444444,SHELL NAB,186.24,0,469163.21,DR,REF626409,NAB,Business
27-09-2025 00:57,NABB82685B1A7294199AC62,082-900-001,44444444,BIGW NAB,864.67,0,468298.54,DR,REF430807,NAB,Business
27-09-2025 01:06,NABB093A7B61A2D4CDCB63A,082-900-001,44444444,CITYLINK NAB,595.22,0,467703.32,DR,REF371093,NAB,Business
27-09-2025 01:17,NAB3A83A85DF005468084AD,082-900-001,44444444,RAILWAY STATION NAB,166.05,0,467537.27,DR,REF902576,NAB,Business
27-09-2025 01:57,NAB36874B9278B74F4D8785,082-900-001,44444444,BP NAB,220.97,0,467316.3,DR,REF169781,NAB,Business
27-09-2025 02:21,NABDD594463D441429A9434,082-900-001,44444444,JB HI-FI NAB,310.92,0,467005.38,DR,REF931050,NAB,Business
27-09-2025 02:55,NABF9746469939B4A1D9438,082-900-001,44444444,APPLE NAB,1392.36,0,465613.02,DR,REF991726,NAB,Business
27-09-2025 02:58,NAB47AA4A4F55114BA49A31,082-900-001,44444444,UBER EATS NAB,262.36,0,465350.66,DR,REF548801,NAB,Business
27-09-2025 03:03,NAB720D8F3D53E24AE6AB54,082-900-001,44444444,FLIXBUS NAB,58.05,0,465292.61,DR,REF214123,NAB,Business
27-09-2025 03:29,NAB3D4EC3F0242440A7BD20,082-900-001,44444444,JB HI-FI NAB,68.26,0,465224.35,DR,REF923757,NAB,Business
27-09-2025 03:32,NAB8E00389ECE6A4FA9B5B3,082-900-001,44444444,UBER EATS NAB,254.22,0,464970.13,DR,REF843162,NAB,Business
27-09-2025 04:18,NAB04211EAFBF5E44B3AE61,082-900-001,44444444,MENULOG NAB,61.61,0,464908.52,DR,REF675399,NAB,Business
27-09-2025 04:44,NAB6C451DBC10454B86AB20,082-900-001,44444444,LIQUORLAND NAB,310.7,0,464597.82,DR,REF664128,NAB,Business
27-09-2025 04:48,NABF4C358B6341147F0980B,082-900-001,44444444,UBER EATS NAB,275.82,0,464322,DR,REF529752,NAB,Business
27-09-2025 05:15,NAB8333A743BBDB472E8F7D,082-900-001,44444444,FLIXBUS NAB,2004.23,0,462317.77,DR,REF706613,NAB,Business
27-09-2025 05:34,NABA42088B971FD42D79951,082-900-001,44444444,ZOOM NAB,58.95,0,462258.82,DR,REF859250,NAB,Business
27-09-2025 05:45,NAB6FCAF2F456D44FA1A4F3,082-900-001,44444444,WOOLWORTHS NAB,104.95,0,462153.87,DR,REF984775,NAB,Business
27-09-2025 05:50,NAB6229C5224EDD4910B05D,082-900-001,44444444,TAFE BOOKSHOP NAB,719.93,0,461433.94,DR,REF264685,NAB,Business
27-09-2025 06:07,NAB34E36817F4E140C59B10,082-900-001,44444444,WOOLWORTHS NAB,1080.29,0,460353.65,DR,REF717392,NAB,Business
27-09-2025 06:09,NAB7531071DD6AB48D5A200,082-900-001,44444444,7-ELEVEN NAB,160.79,0,460192.86,DR,REF778091,NAB,Business
27-09-2025 06:11,NAB6528FB89CE5941719B77,082-900-001,44444444,FLIXBUS NAB,228.13,0,459964.73,DR,REF583269,NAB,Business
27-09-2025 06:19,NAB0BB46380DA634E7D8600,082-900-001,44444444,KFC NAB,321.33,0,459643.4,DR,REF190330,NAB,Business
27-09-2025 06:33,INT8CE5B887841941929211,082-900-001,44444444,TRANSFER TO CBA 33333333,1012.02,0,458631.38,DR,INT-77797,NAB,Business
27-09-2025 06:37,NAB726FDB8CFBCE44FF947D,082-900-001,44444444,JB HI-FI NAB,108.59,0,458522.79,DR,REF471952,NAB,Business
27-09-2025 08:45,NABC1008526D2FA463A84C8,082-900-001,44444444,COLES NAB,20.84,0,458501.95,DR,REF570539,NAB,Business
27-09-2025 09:39,INTFB3BCD4F087A40ACB94F,082-900-001,44444444,TRANSFER TO CBA 22222222,363.06,0,458138.89,DR,INT-49008,NAB,Business
27-09-2025 09:58,NABD3403FD2FC0A4460B6D9,082-900-001,44444444,7-ELEVEN NAB,336.81,0,457802.08,DR,REF745258,NAB,Business
27-09-2025 10:08,NABE39D794FDC7A4C199FA8,082-900-001,44444444,TAFE BOOKSHOP NAB,91.07,0,457711.01,DR,REF687680,NAB,Business
27-09-2025 10:13,NAB7DA72BE29B474C58A42E,082-900-001,44444444,PAYROLL CREDIT NAB,0,7818.87,465529.88,CR,REF262205,NAB,Business
27-09-2025 10:16,NAB6BCF8F632C964EF8BA97,082-900-001,44444444,JB HI-FI NAB,88.4,0,465441.48,DR,REF719358,NAB,Business
27-09-2025 10:33,NAB2230A17AACD248F5ABAC,082-900-001,44444444,INTERNET TRANSFER NAB,110.53,0,465330.95,DR,REF300063,NAB,Business
27-09-2025 10:42,NAB60042E5FD6E94626A297,082-900-001,44444444,PAYPAL *NETFLIX NAB,60.56,0,465270.39,DR,REF418037,NAB,Business
27-09-2025 10:59,NAB95B58E743DE944599391,082-900-001,44444444,BWS NAB,229.7,0,465040.69,DR,REF714447,NAB,Business
27-09-2025 11:11,NAB645FD060792A42738787,082-900-001,44444444,RAILWAY STATION NAB,1105.86,0,463934.83,DR,REF153804,NAB,Business
27-09-2025 11:22,NABDEE189BFC6D94CD89661,082-900-001,44444444,INTERNET TRANSFER NAB,77.77,0,463857.06,DR,REF528869,NAB,Business
27-09-2025 11:57,NABE4F46FD717A943BA9482,082-900-001,44444444,AMAZON AU NAB,276.78,0,463580.28,DR,REF217150,NAB,Business
27-09-2025 11:58,NAB4F8DB27FDEDD449BA4D3,082-900-001,44444444,RAILWAY STATION NAB,19.83,0,463560.45,DR,REF226602,NAB,Business
27-09-2025 12:26,NAB143D30A98F2C4A8AAB2D,082-900-001,44444444,ZOOM NAB,275.21,0,463285.24,DR,REF660547,NAB,Business
27-09-2025 12:43,NAB8EF5EEC7A46D4F24BB50,082-900-001,44444444,ZOOM NAB,236.87,0,463048.37,DR,REF536596,NAB,Business
27-09-2025 12:57,NABCF83555FCC6A4CA6960C,082-900-001,44444444,TAFE BOOKSHOP NAB,564.06,0,462484.31,DR,REF302727,NAB,Business
27-09-2025 13:13,NABB721DA8B939448CB9A4E,082-900-001,44444444,RAILWAY STATION NAB,396.43,0,462087.88,DR,REF222161,NAB,Business
27-09-2025 13:20,NAB25B8EBE13DAF4A6B9905,082-900-001,44444444,MCDONALDS NAB,154.48,0,461933.4,DR,REF585046,NAB,Business
27-09-2025 13:23,NAB840C2F209E01499ABB99,082-900-001,44444444,MCDONALDS NAB,85.91,0,461847.49,DR,REF183226,NAB,Business
27-09-2025 13:25,NABA39A697B98734A71AB78,082-900-001,44444444,INTERNET TRANSFER NAB,810.48,0,461037.01,DR,REF797261,NAB,Business
27-09-2025 14:16,NAB6CC9E1F4FCB24C37A658,082-900-001,44444444,BIGW NAB,399.18,0,460637.83,DR,REF226259,NAB,Business
27-09-2025 14:21,NAB372367CEFBB74A6E8129,082-900-001,44444444,MENULOG NAB,444.47,0,460193.36,DR,REF433541,NAB,Business
27-09-2025 14:51,NAB3B9ED57C0C9F42CFA3DB,082-900-001,44444444,KFC NAB,339.42,0,459853.94,DR,REF990179,NAB,Business
27-09-2025 15:08,NAB0F083A39CA7A477D9E43,082-900-001,44444444,COLES NAB,68.56,0,459785.38,DR,REF232779,NAB,Business
27-09-2025 15:15,NAB7F236619E42C4BF79A2F,082-900-001,44444444,CITYLINK NAB,73.61,0,459711.77,DR,REF150089,NAB,Business
27-09-2025 15:54,NABCA1BD5C43EF54D6EB17F,082-900-001,44444444,ZOOM NAB,407.46,0,459304.31,DR,REF927014,NAB,Business
27-09-2025 15:59,NAB1C41EC8BE9A2483AA2FA,082-900-001,44444444,LIQUORLAND NAB,1007.58,0,458296.73,DR,REF133237,NAB,Business
27-09-2025 16:03,NAB8DD881D612824649A0F1,082-900-001,44444444,MENULOG NAB,198.62,0,458098.11,DR,REF450401,NAB,Business
27-09-2025 16:28,NABBF85F316448E414F97FA,082-900-001,44444444,SPOTIFY NAB,81.61,0,458016.5,DR,REF182496,NAB,Business
27-09-2025 16:57,INT04F2AE0E353C4DBDAC1A,082-900-001,44444444,TRANSFER TO CBA 33333333,993.38,0,457023.12,DR,INT-91035,NAB,Business
27-09-2025 17:03,NAB816B55BD57124C57A2E5,082-900-001,44444444,DOMINO'S PIZZA NAB,181.16,0,456841.96,DR,REF916367,NAB,Business
27-09-2025 17:11,NABD8F82ADEC5F1409DADB0,082-900-001,44444444,SHELL NAB,1085.01,0,455756.95,DR,REF373410,NAB,Business
27-09-2025 17:12,NABB7EF792F0D2A41B48BB1,082-900-001,44444444,SALARY PAYMENT NAB,0,6451.45,462208.4,CR,REF398138,NAB,Business
27-09-2025 17:20,NABE72845BA38DE470E879E,082-900-001,44444444,WAGES CREDIT NAB,0,1149.94,463358.34,CR,REF419323,NAB,Business
27-09-2025 17:23,NABDB38219E79B04675B6B5,082-900-001,44444444,7-ELEVEN NAB,140.73,0,463217.61,DR,REF910086,NAB,Business
27-09-2025 17:40,NABCFC1716196474B2D8641,082-900-001,44444444,WOOLWORTHS NAB,453.15,0,462764.46,DR,REF143595,NAB,Business
27-09-2025 18:21,NAB2B8610897FB24E90AA10,082-900-001,44444444,KFC NAB,156.15,0,462608.31,DR,REF337977,NAB,Business
27-09-2025 19:24,NABD65072D7DED94F6FACAC,082-900-001,44444444,BP NAB,191.17,0,462417.14,DR,REF105275,NAB,Business
27-09-2025 19:39,NAB3ECD0C026C9D4D1FBBD5,082-900-001,44444444,7-ELEVEN NAB,735.69,0,461681.45,DR,REF765692,NAB,Business
27-09-2025 20:27,NABCA3873F75882404FAE0C,082-900-001,44444444,BP NAB,414.95,0,461266.5,DR,REF225654,NAB,Business
27-09-2025 20:43,NABBCAB36D7AF5245F99343,082-900-001,44444444,PAYMENT GATEWAY NAB,136.04,0,461130.46,DR,REF349606,NAB,Business
27-09-2025 20:59,NAB23EDB1C42E4D4788A61F,082-900-001,44444444,TAFE BOOKSHOP NAB,102.09,0,461028.37,DR,REF342980,NAB,Business
27-09-2025 21:32,NAB91FA18A016B140278D54,082-900-001,44444444,BP NAB,462.69,0,460565.68,DR,REF610582,NAB,Business
27-09-2025 21:56,NAB4F63279BB18A456E8388,082-900-001,44444444,LIQUORLAND NAB,762.78,0,459802.9,DR,REF997288,NAB,Business
27-09-2025 22:08,NABDDF75CD1B12D48E2A30E,082-900-001,44444444,UBER EATS NAB,258.1,0,459544.8,DR,REF214806,NAB,Business
27-09-2025 22:53,INT7F0817EF4AE643DC84EF,082-900-001,44444444,TRANSFER FROM CBA 33333333,0,305.55,459850.35,CR,INT-32226,NAB,Business
27-09-2025 23:19,NABFAF6674C8F6E441794F3,082-900-001,44444444,PAYPAL *NETFLIX NAB,160.99,0,459689.36,DR,REF126831,NAB,Business
27-09-2025 23:29,NABD1CF7F01889640E39D95,082-900-001,44444444,PAYROLL CREDIT NAB,0,1161.87,460851.23,CR,REF158483,NAB,Business
27-09-2025 23:42,NAB604FC7A90F0B492DB764,082-900-001,44444444,DOMINO'S PIZZA NAB,41.63,0,460809.6,DR,REF993411,NAB,Business
27-09-2025 23:52,NABA1639B25DECC47DC87BF,082-900-001,44444444,PAY - SALARY NAB,0,4633.42,465443.02,CR,REF612059,NAB,Business
28-09-2025 00:17,NAB54DB61911B9646C0B422,082-900-001,44444444,STARBUCKS NAB,537.46,0,464905.56,DR,REF290758,NAB,Business
28-09-2025 00:37,NAB4F794494017A45E89A6B,082-900-001,44444444,ZOOM NAB,200.19,0,464705.37,DR,REF644340,NAB,Business
28-09-2025 00:41,INTC5407450094C491EACB7,082-900-001,44444444,TRANSFER TO CBA 22222222,693.89,0,464011.48,DR,INT-54504,NAB,Business
28-09-2025 01:09,NABA241CB3264254F3982DC,082-900-001,44444444,BIGW NAB,729.91,0,463281.57,DR,REF712152,NAB,Business
28-09-2025 01:42,NAB75A7316DE47B41EB8BC1,082-900-001,44444444,FLIXBUS NAB,298.47,0,462983.1,DR,REF617424,NAB,Business
28-09-2025 01:56,NAB6FFA69B3413246918FA6,082-900-001,44444444,BIGW NAB,136.36,0,462846.74,DR,REF447105,NAB,Business
28-09-2025 01:59,NABE2F404C360354829B1E0,082-900-001,44444444,SHELL NAB,655.29,0,462191.45,DR,REF775495,NAB,Business
28-09-2025 02:01,NAB06A880B58F0F4E42BC37,082-900-001,44444444,WOOLWORTHS NAB,393.14,0,461798.31,DR,REF775482,NAB,Business
28-09-2025 02:12,NAB3309B8DAD4E54F519131,082-900-001,44444444,APPLE NAB,288.93,0,461509.38,DR,REF470442,NAB,Business
28-09-2025 02:24,NAB023E4843E92D4697AA19,082-900-001,44444444,JB HI-FI NAB,847.17,0,460662.21,DR,REF453782,NAB,Business
28-09-2025 02:29,NAB8CF1A439B23D41059EA3,082-900-001,44444444,WAGES CREDIT NAB,0,843.37,461505.58,CR,REF337727,NAB,Business
28-09-2025 02:35,NAB44C1EEB05F6F49818287,082-900-001,44444444,SPOTIFY NAB,239.36,0,461266.22,DR,REF445831,NAB,Business
28-09-2025 02:39,NAB3700634DACD5465D800C,082-900-001,44444444,PAYPAL *NETFLIX NAB,289.06,0,460977.16,DR,REF379072,NAB,Business
28-09-2025 03:03,NAB5833CED5802F482FA9FB,082-900-001,44444444,MENULOG NAB,49.15,0,460928.01,DR,REF862153,NAB,Business
28-09-2025 03:23,NABB7C712BFD64D4EDD81FB,082-900-001,44444444,STARBUCKS NAB,625.42,0,460302.59,DR,REF701649,NAB,Business
28-09-2025 03:35,NAB499ED0AC08784F18AE10,082-900-001,44444444,SALARY PAYMENT NAB,0,5007.23,465309.82,CR,REF872239,NAB,Business
28-09-2025 03:41,NAB06D70F298B09462C9B71,082-900-001,44444444,RAILWAY STATION NAB,169.37,0,465140.45,DR,REF407640,NAB,Business
28-09-2025 03:50,NABE3BECA2B6CCA4EBAB7ED,082-900-001,44444444,ZOOM NAB,1127.94,0,464012.51,DR,REF476223,NAB,Business
28-09-2025 04:01,NABA7A3D5B53BD94828ACE8,082-900-001,44444444,MENULOG NAB,219.94,0,463792.57,DR,REF592004,NAB,Business
28-09-2025 04:18,NAB35A67CCD282D4E139ADF,082-900-001,44444444,JB HI-FI NAB,603.85,0,463188.72,DR,REF510270,NAB,Business
28-09-2025 04:22,NAB921145F5619D4C76869E,082-900-001,44444444,BWS NAB,146.17,0,463042.55,DR,REF595323,NAB,Business
28-09-2025 04:26,NAB9DF7C731FED74616BDEC,082-900-001,44444444,LIQUORLAND NAB,70.76,0,462971.79,DR,REF230331,NAB,Business
28-09-2025 04:27,NAB9A10358FBC89421AB422,082-900-001,44444444,COMPANY PAYROLL NAB,0,2342.51,465314.3,CR,REF676266,NAB,Business
28-09-2025 04:39,NABA1870353776A433598C2,082-900-001,44444444,KFC NAB,97.72,0,465216.58,DR,REF609854,NAB,Business
28-09-2025 04:42,NABF96BE110AE65491295B4,082-900-001,44444444,JB HI-FI NAB,132.22,0,465084.36,DR,REF186500,NAB,Business
28-09-2025 05:19,NAB797B9849BBA54E0F8F11,082-900-001,44444444,ALDI NAB,313.93,0,464770.43,DR,REF479991,NAB,Business
28-09-2025 05:36,NAB85D33820E5444421B168,082-900-001,44444444,INTERNET TRANSFER NAB,916.1,0,463854.33,DR,REF317862,NAB,Business
28-09-2025 05:48,NAB02534AB989744097A9FC,082-900-001,44444444,DOMINO'S PIZZA NAB,258.31,0,463596.02,DR,REF115979,NAB,Business
28-09-2025 05:53,NAB53ED8D80D4E54289BB35,082-900-001,44444444,DOMINO'S PIZZA NAB,293.23,0,463302.79,DR,REF187856,NAB,Business
28-09-2025 05:55,NABA34CB87C4B6C4F42A0F4,082-900-001,44444444,SALARY PAYMENT NAB,0,601.16,463903.95,CR,REF992913,NAB,Business
28-09-2025 05:56,NAB78ECEB1759E24069A3BB,082-900-001,44444444,AMAZON AU NAB,231.68,0,463672.27,DR,REF752246,NAB,Business
28-09-2025 06:03,NAB3810534AA0054ECD90C7,082-900-001,44444444,HARVEY NORMAN NAB,135.94,0,463536.33,DR,REF835821,NAB,Business
28-09-2025 06:06,NAB6E5BEAC405B54903BE70,082-900-001,44444444,KFC NAB,60.8,0,463475.53,DR,REF513999,NAB,Business
28-09-2025 06:19,NABDAF168D653664B48B968,082-900-001,44444444,FLIXBUS NAB,161.46,0,463314.07,DR,REF238123,NAB,Business
28-09-2025 06:23,NABBD2596B9267647D5A143,082-900-001,44444444,FLIXBUS NAB,73.58,0,463240.49,DR,REF414447,NAB,Business
28-09-2025 06:27,NAB4E8B45885CE541FD86D9,082-900-001,44444444,PAYMENT GATEWAY NAB,831.98,0,462408.51,DR,REF345312,NAB,Business
28-09-2025 06:28,NAB0E1F01C4024742918E38,082-900-001,44444444,7-ELEVEN NAB,99.61,0,462308.9,DR,REF132477,NAB,Business
28-09-2025 06:30,NAB1EF75B117F414683901E,082-900-001,44444444,BANK FEE NAB,479.91,0,461828.99,DR,REF563515,NAB,Business
28-09-2025 06:55,NAB3A816C1DA07F4A83832D,082-900-001,44444444,RAILWAY STATION NAB,593.2,0,461235.79,DR,REF383694,NAB,Business
28-09-2025 07:07,NAB2258D4481C874288A93A,082-900-001,44444444,SALARY PAYMENT NAB,0,7189.52,468425.31,CR,REF576250,NAB,Business
28-09-2025 07:29,NABC65CBDB618DC4762A95F,082-900-001,44444444,7-ELEVEN NAB,1008.48,0,467416.83,DR,REF457012,NAB,Business
28-09-2025 07:44,NAB95867BE3767840F787F6,082-900-001,44444444,AMAZON AU NAB,697.16,0,466719.67,DR,REF753994,NAB,Business
28-09-2025 08:32,NAB178FCDA47C1540709BE2,082-900-001,44444444,FLIXBUS NAB,73.43,0,466646.24,DR,REF517457,NAB,Business
28-09-2025 08:45,NAB335DC12C61F141DBBF34,082-900-001,44444444,PAYMENT GATEWAY NAB,48.34,0,466597.9,DR,REF447654,NAB,Business
28-09-2025 08:55,NABD5E18D1DAE2C4EBEAA97,082-900-001,44444444,HARVEY NORMAN NAB,75.47,0,466522.43,DR,REF184819,NAB,Business
28-09-2025 09:09,NABA73E9B9B806C490FB6A8,082-900-001,44444444,MENULOG NAB,128.2,0,466394.23,DR,REF639515,NAB,Business
28-09-2025 09:14,NABDA0DBCE591AA4FC2AC88,082-900-001,44444444,BIGW NAB,97.36,0,466296.87,DR,REF783600,NAB,Business
28-09-2025 09:32,NAB8D5A4500F4BC45259FEF,082-900-001,44444444,CITYLINK NAB,517,0,465779.87,DR,REF988249,NAB,Business
28-09-2025 10:02,NAB96C76ACCBD2A4CE3933D,082-900-001,44444444,JB HI-FI NAB,280.68,0,465499.19,DR,REF386641,NAB,Business
28-09-2025 10:26,NAB4D15FAE23D834E14B79A,082-900-001,44444444,BANK FEE NAB,169.27,0,465329.92,DR,REF953481,NAB,Business
28-09-2025 10:31,NAB5FB3B1BAD7194E4AAF0C,082-900-001,44444444,KFC NAB,51.11,0,465278.81,DR,REF549533,NAB,Business
28-09-2025 11:36,NAB0F7F2F07C0D54D8EB2EC,082-900-001,44444444,PAYPAL *NETFLIX NAB,136.14,0,465142.67,DR,REF596387,NAB,Business
28-09-2025 11:53,NAB002DE8A1119B4A6A9892,082-900-001,44444444,APPLE NAB,135.88,0,465006.79,DR,REF672067,NAB,Business
28-09-2025 12:09,NAB72C9A7CDF3284CF6BBA6,082-900-001,44444444,RAILWAY STATION NAB,113.11,0,464893.68,DR,REF775942,NAB,Business
28-09-2025 12:10,NAB9F3D01F75D3E409E9866,082-900-001,44444444,HARVEY NORMAN NAB,924.71,0,463968.97,DR,REF678685,NAB,Business
28-09-2025 12:11,NABC1F64D19EE234D9FA968,082-900-001,44444444,ALDI NAB,216.04,0,463752.93,DR,REF778520,NAB,Business
28-09-2025 12:14,NAB2E59FDACBE8748E19D0F,082-900-001,44444444,BANK FEE NAB,396.52,0,463356.41,DR,REF697134,NAB,Business
28-09-2025 12:29,NABCA74F39238AC445FA9DD,082-900-001,44444444,ALDI NAB,117.62,0,463238.79,DR,REF837926,NAB,Business
28-09-2025 12:32,NAB65ACF72949A94C248812,082-900-001,44444444,JB HI-FI NAB,518.75,0,462720.04,DR,REF421040,NAB,Business
28-09-2025 12:33,NAB3563E75841634641A99C,082-900-001,44444444,ZOOM NAB,60.24,0,462659.8,DR,REF461465,NAB,Business
28-09-2025 12:44,NAB34B75F8B22B1417980CF,082-900-001,44444444,SHELL NAB,808.79,0,461851.01,DR,REF465316,NAB,Business
28-09-2025 12:53,NAB62943D368A83493D99E3,082-900-001,44444444,ZOOM NAB,294.71,0,461556.3,DR,REF275339,NAB,Business
28-09-2025 12:55,NAB373583E62CA94271989D,082-900-001,44444444,7-ELEVEN NAB,446.67,0,461109.63,DR,REF143051,NAB,Business
28-09-2025 13:28,NAB19B853B4765340CA825D,082-900-001,44444444,MENULOG NAB,194.49,0,460915.14,DR,REF795003,NAB,Business
28-09-2025 13:38,NAB71B84908FEB44B8EBCF1,082-900-001,44444444,CITYLINK NAB,1042.48,0,459872.66,DR,REF250391,NAB,Business
28-09-2025 14:17,NABD1DCC9E79296492BBCB9,082-900-001,44444444,BIGW NAB,232.47,0,459640.19,DR,REF178419,NAB,Business
28-09-2025 14:28,NABE6D8AF7E48C544C5BEC6,082-900-001,44444444,INTERNET TRANSFER NAB,502.7,0,459137.49,DR,REF604658,NAB,Business
28-09-2025 14:58,NAB8D38C54D35AC4F5AA335,082-900-001,44444444,WOOLWORTHS NAB,190.3,0,458947.19,DR,REF346642,NAB,Business
28-09-2025 15:14,INT75E48E6428AB44AF8CC7,082-900-001,44444444,TRANSFER TO CBA 33333333,1663.96,0,457283.23,DR,INT-99437,NAB,Business
28-09-2025 15:55,NABA45C561D15D44979A6B9,082-900-001,44444444,MENULOG NAB,98.69,0,457184.54,DR,REF442093,NAB,Business
28-09-2025 16:21,NABFB31B98C326A4E079A25,082-900-001,44444444,RAILWAY STATION NAB,99.51,0,457085.03,DR,REF848002,NAB,Business
28-09-2025 16:44,NAB9C1E8C36516744FBAE3F,082-900-001,44444444,MCDONALDS NAB,109.2,0,456975.83,DR,REF553542,NAB,Business
28-09-2025 16:54,NAB9458760CD3414AE49407,082-900-001,44444444,ZOOM NAB,32.33,0,456943.5,DR,REF155690,NAB,Business
28-09-2025 16:59,NAB6C0D8EF91C794AEEA1B2,082-900-001,44444444,BIGW NAB,335.39,0,456608.11,DR,REF860293,NAB,Business
28-09-2025 17:39,NABE8FF26811DA043FEAAB6,082-900-001,44444444,UBER EATS NAB,38.38,0,456569.73,DR,REF943341,NAB,Business
28-09-2025 18:12,INT0E1068F167C143718247,082-900-001,44444444,TRANSFER TO CBA 22222222,1661.61,0,454908.12,DR,INT-21927,NAB,Business
28-09-2025 18:37,NABE5CBF460EDBB460FB5F7,082-900-001,44444444,KFC NAB,122.23,0,454785.89,DR,REF780809,NAB,Business
28-09-2025 18:46,NAB4885485297CB4833BC63,082-900-001,44444444,TAFE BOOKSHOP NAB,165.18,0,454620.71,DR,REF824691,NAB,Business
28-09-2025 18:53,NAB5B2C94B693BD475C9995,082-900-001,44444444,BP NAB,595.99,0,454024.72,DR,REF670474,NAB,Business
28-09-2025 18:53,NABEF4777F144AB46D0BA1C,082-900-001,44444444,HARVEY NORMAN NAB,202.91,0,453821.81,DR,REF936221,NAB,Business
28-09-2025 20:09,NAB2126465A36A64A91977B,082-900-001,44444444,BWS NAB,89.87,0,453731.94,DR,REF649638,NAB,Business
28-09-2025 20:21,NAB128965593E7A41989DDD,082-900-001,44444444,BIGW NAB,133.79,0,453598.15,DR,REF753710,NAB,Business
28-09-2025 20:29,NAB3B4F6A4F02644AD49EED,082-900-001,44444444,DOMINO'S PIZZA NAB,206.63,0,453391.52,DR,REF519897,NAB,Business
28-09-2025 20:34,NAB7906E4B747A74ECDABED,082-900-001,44444444,MENULOG NAB,214.15,0,453177.37,DR,REF712377,NAB,Business
28-09-2025 20:46,NAB6446CEA142F64855BC77,082-900-001,44444444,PAYROLL CREDIT NAB,0,2130.4,455307.77,CR,REF796085,NAB,Business
28-09-2025 21:21,NAB37B17C277CE34325A2EC,082-900-001,44444444,AMAZON AU NAB,392.51,0,454915.26,DR,REF366801,NAB,Business
28-09-2025 21:27,NABD4347C0C48764AF7BA0D,082-900-001,44444444,KFC NAB,540.36,0,454374.9,DR,REF699890,NAB,Business
28-09-2025 21:29,INT3443771F4E434F83A322,082-900-001,44444444,TRANSFER TO CBA 22222222,842.96,0,453531.94,DR,INT-25622,NAB,Business
28-09-2025 21:36,NAB6073C00ECEE34AC0B52F,082-900-001,44444444,PAYROLL CREDIT NAB,0,4025.6,457557.54,CR,REF202962,NAB,Business
28-09-2025 22:00,NABE44456CE3F12405CA159,082-900-001,44444444,SALARY PAYMENT NAB,0,1197.04,458754.58,CR,REF765533,NAB,Business
28-09-2025 22:13,NAB53BDECADE0E5407089ED,082-900-001,44444444,RAILWAY STATION NAB,875.65,0,457878.93,DR,REF101010,NAB,Business
28-09-2025 22:53,NAB08831DB8A10048FD9250,082-900-001,44444444,ALDI NAB,265.87,0,457613.06,DR,REF408045,NAB,Business
28-09-2025 23:13,NAB4E30AEDF97184F188FAE,082-900-001,44444444,RAILWAY STATION NAB,127.71,0,457485.35,DR,REF912309,NAB,Business
28-09-2025 23:39,NABC2A4C6CBA3274F8798BE,082-900-001,44444444,LIQUORLAND NAB,108.24,0,457377.11,DR,REF925105,NAB,Business
28-09-2025 23:40,NABC6A81A897A0B4C31A1D1,082-900-001,44444444,BIGW NAB,389.61,0,456987.5,DR,REF559567,NAB,Business
28-09-2025 23:42,NAB8904ECA857CE4E39A1B3,082-900-001,44444444,SPOTIFY NAB,115.71,0,456871.79,DR,REF532898,NAB,Business
29-09-2025 00:13,NAB2292526086F74F8A8A20,082-900-001,44444444,PAYPAL *NETFLIX NAB,425.07,0,456446.72,DR,REF359582,NAB,Business
29-09-2025 00:40,NAB35227ECED10E4069BB56,082-900-001,44444444,BWS NAB,33.96,0,456412.76,DR,REF366864,NAB,Business
29-09-2025 01:02,NABDE7BADA6CFD1428BAAA1,082-900-001,44444444,COMPANY PAYROLL NAB,0,7661.37,464074.13,CR,REF303030,NAB,Business
29-09-2025 01:17,NAB7089BB594FB448368D32,082-900-001,44444444,PAYPAL *NETFLIX NAB,67.95,0,464006.18,DR,REF866216,NAB,Business
29-09-2025 01:23,NABC77B25B38B134C9F8F5A,082-900-001,44444444,TAFE BOOKSHOP NAB,657.04,0,463349.14,DR,REF678279,NAB,Business
29-09-2025 01:58,NAB15AD6E40F15943C587F7,082-900-001,44444444,WOOLWORTHS NAB,40.11,0,463309.03,DR,REF459710,NAB,Business
29-09-2025 02:46,NAB13FDDBA9333A40439737,082-900-001,44444444,DOMINO'S PIZZA NAB,198.45,0,463110.58,DR,REF958244,NAB,Business
29-09-2025 03:19,INTA3975A1117064377A35C,082-900-001,44444444,TRANSFER TO CBA 22222222,901.96,0,462208.62,DR,INT-66155,NAB,Business
29-09-2025 03:26,NAB015BA7A983C147D8AE8F,082-900-001,44444444,COLES NAB,60.44,0,462148.18,DR,REF720666,NAB,Business
29-09-2025 03:35,NABDDA304FDE5764DACB64D,082-900-001,44444444,AMAZON AU NAB,63.28,0,462084.9,DR,REF758942,NAB,Business
29-09-2025 03:50,NABF2D9B5995A6941758AF9,082-900-001,44444444,PAY - SALARY NAB,0,4753.15,466838.05,CR,REF730545,NAB,Business
29-09-2025 04:00,NAB1F4833A45D454AD5883B,082-900-001,44444444,ZOOM NAB,98.69,0,466739.36,DR,REF368829,NAB,Business
29-09-2025 04:15,NAB4694BBF9564C4BB89475,082-900-001,44444444,TAFE BOOKSHOP NAB,188.4,0,466550.96,DR,REF847847,NAB,Business
29-09-2025 04:15,NABEA8F4B70C542438D8C86,082-900-001,44444444,BWS NAB,50.05,0,466500.91,DR,REF570493,NAB,Business
29-09-2025 04:56,NABAF01E77C3AF2466B9ED6,082-900-001,44444444,WOOLWORTHS NAB,574.72,0,465926.19,DR,REF887275,NAB,Business
29-09-2025 05:11,NABAEC59E42D96140D6BF68,082-900-001,44444444,HARVEY NORMAN NAB,49.82,0,465876.37,DR,REF122328,NAB,Business
29-09-2025 05:16,NAB6876CC8001564F4EB6B8,082-900-001,44444444,BIGW NAB,463.99,0,465412.38,DR,REF654662,NAB,Business
29-09-2025 05:24,NAB48A44FA3088E4A98ADA5,082-900-001,44444444,7-ELEVEN NAB,527.18,0,464885.2,DR,REF162730,NAB,Business
29-09-2025 05:56,NAB233CC25228854C4DA42B,082-900-001,44444444,WAGES CREDIT NAB,0,414.79,465299.99,CR,REF987676,NAB,Business
29-09-2025 06:10,NAB6E90633E1BBF4040B9A9,082-900-001,44444444,LIQUORLAND NAB,665,0,464634.99,DR,REF882983,NAB,Business
29-09-2025 06:53,NABD91AC50FCF444C9AA469,082-900-001,44444444,ZOOM NAB,151.18,0,464483.81,DR,REF291838,NAB,Business
29-09-2025 07:20,NABF0D0126BCD3344889EA7,082-900-001,44444444,BWS NAB,166.91,0,464316.9,DR,REF841653,NAB,Business
29-09-2025 07:36,NAB8F8E357669244F62AC8F,082-900-001,44444444,ZOOM NAB,488.66,0,463828.24,DR,REF834871,NAB,Business
29-09-2025 07:42,NAB06676895D9174EC98CD0,082-900-001,44444444,BANK FEE NAB,79.42,0,463748.82,DR,REF777694,NAB,Business
29-09-2025 08:01,NABE1B19E994CA74D88AD56,082-900-001,44444444,LIQUORLAND NAB,667.13,0,463081.69,DR,REF607728,NAB,Business
29-09-2025 08:16,NAB6A463F1248A843B5A27D,082-900-001,44444444,RAILWAY STATION NAB,152.34,0,462929.35,DR,REF230568,NAB,Business
29-09-2025 08:22,NABB027B6B37C3A4A39A709,082-900-001,44444444,INTERNET TRANSFER NAB,174.78,0,462754.57,DR,REF318049,NAB,Business
29-09-2025 08:34,NABC98298A66417426894F1,082-900-001,44444444,7-ELEVEN NAB,283.42,0,462471.15,DR,REF433045,NAB,Business
29-09-2025 08:56,NABFE7DB05F29B94FABABA4,082-900-001,44444444,SHELL NAB,658.68,0,461812.47,DR,REF717622,NAB,Business
29-09-2025 09:16,NABF891DEF5A48C4DC78AF0,082-900-001,44444444,TAFE BOOKSHOP NAB,115.22,0,461697.25,DR,REF658898,NAB,Business
29-09-2025 10:13,NAB3C7CEC9CC99241F686AC,082-900-001,44444444,ALDI NAB,329.94,0,461367.31,DR,REF574224,NAB,Business
29-09-2025 10:18,NABE38FA45721F946679AA8,082-900-001,44444444,ALDI NAB,601.73,0,460765.58,DR,REF546773,NAB,Business
29-09-2025 10:24,NABC2B9B7EC31CB4C778AAF,082-900-001,44444444,AMAZON AU NAB,110.31,0,460655.27,DR,REF859877,NAB,Business
29-09-2025 11:46,INTA7B5EA8C44C949FDA730,082-900-001,44444444,TRANSFER TO CBA 33333333,1258.58,0,459396.69,DR,INT-85865,NAB,Business
29-09-2025 11:57,NAB832191477EDE45478322,082-900-001,44444444,LIQUORLAND NAB,74.55,0,459322.14,DR,REF765013,NAB,Business
29-09-2025 12:08,NAB938A27E501C24E8286F8,082-900-001,44444444,PAY - SALARY NAB,0,7873.07,467195.21,CR,REF135002,NAB,Business
29-09-2025 12:15,NAB869372DCC84449249FCF,082-900-001,44444444,SHELL NAB,73.71,0,467121.5,DR,REF479945,NAB,Business
29-09-2025 12:22,NAB2A87A1DAD0864441AD41,082-900-001,44444444,WOOLWORTHS NAB,277.25,0,466844.25,DR,REF369178,NAB,Business
29-09-2025 12:26,NAB65CCF5477712479AACEB,082-900-001,44444444,HARVEY NORMAN NAB,150.06,0,466694.19,DR,REF611043,NAB,Business
29-09-2025 12:27,NAB95360D196E8C4011861C,082-900-001,44444444,PAYPAL *NETFLIX NAB,427.48,0,466266.71,DR,REF172157,NAB,Business
29-09-2025 12:56,NAB05A395403B89499D98B2,082-900-001,44444444,INTERNET TRANSFER NAB,263.01,0,466003.7,DR,REF279503,NAB,Business
29-09-2025 12:58,NABE13A5426BF004F429B8E,082-900-001,44444444,CITYLINK NAB,195.2,0,465808.5,DR,REF111403,NAB,Business
29-09-2025 13:06,NABF502FB776A774C288DF7,082-900-001,44444444,WOOLWORTHS NAB,132.21,0,465676.29,DR,REF933215,NAB,Business
29-09-2025 13:18,NABC376373A0A884D8AA443,082-900-001,44444444,ALDI NAB,132.3,0,465543.99,DR,REF949540,NAB,Business
29-09-2025 13:34,NAB90C49E67852749D595B7,082-900-001,44444444,SPOTIFY NAB,106.97,0,465437.02,DR,REF447890,NAB,Business
29-09-2025 13:47,NABCFD20FF3ADA24FB699E3,082-900-001,44444444,7-ELEVEN NAB,480.58,0,464956.44,DR,REF657271,NAB,Business
29-09-2025 14:00,NAB6825169822B848ECB0B6,082-900-001,44444444,APPLE NAB,261.14,0,464695.3,DR,REF601351,NAB,Business
29-09-2025 14:14,NAB8B1A5AABDA354B29B6C0,082-900-001,44444444,TAFE BOOKSHOP NAB,127.18,0,464568.12,DR,REF217513,NAB,Business
29-09-2025 14:28,NAB8C720D63D4624CFEA2B4,082-900-001,44444444,CITYLINK NAB,17.3,0,464550.82,DR,REF937824,NAB,Business
29-09-2025 14:32,NAB79BD867C26184FB19377,082-900-001,44444444,RAILWAY STATION NAB,267.12,0,464283.7,DR,REF118412,NAB,Business
29-09-2025 14:36,NABB864F570BF3C4B2DBF3A,082-900-001,44444444,COLES NAB,330.96,0,463952.74,DR,REF386364,NAB,Business
29-09-2025 14:44,NABB0420C8C52C74AAB9090,082-900-001,44444444,SHELL NAB,767.6,0,463185.14,DR,REF646018,NAB,Business
29-09-2025 14:58,NAB88AB8B00CB0F4BD98144,082-900-001,44444444,COLES NAB,760.8,0,462424.34,DR,REF725366,NAB,Business
29-09-2025 15:11,NABF994240B1FF2405D95FC,082-900-001,44444444,PAYROLL CREDIT NAB,0,3870.38,466294.72,CR,REF229194,NAB,Business
29-09-2025 15:43,NAB742EA050E85641D9B8D6,082-900-001,44444444,JB HI-FI NAB,24.77,0,466269.95,DR,REF272044,NAB,Business
29-09-2025 15:49,NAB807A5A286D364163B081,082-900-001,44444444,RAILWAY STATION NAB,78.38,0,466191.57,DR,REF595626,NAB,Business
29-09-2025 15:57,NABE4C8D90576014137958B,082-900-001,44444444,BIGW NAB,138.54,0,466053.03,DR,REF824656,NAB,Business
29-09-2025 15:57,NABF3E9E888F9464EB8A351,082-900-001,44444444,WAGES CREDIT NAB,0,7016.36,473069.39,CR,REF131039,NAB,Business
29-09-2025 15:57,NABC04F32D2B1F943A18018,082-900-001,44444444,INTERNET TRANSFER NAB,282.12,0,472787.27,DR,REF558572,NAB,Business
29-09-2025 16:04,NAB95D84877C19C4AF7B6C9,082-900-001,44444444,SHELL NAB,129.84,0,472657.43,DR,REF880720,NAB,Business
29-09-2025 16:14,INT2A3886850FCF4407883D,082-900-001,44444444,TRANSFER FROM CBA 33333333,0,240.19,472897.62,CR,INT-71030,NAB,Business
29-09-2025 16:32,NAB7CD50D22A1944C76AFE4,082-900-001,44444444,APPLE NAB,154.22,0,472743.4,DR,REF502343,NAB,Business
29-09-2025 16:42,NABB20111E96F894000B904,082-900-001,44444444,PAYMENT GATEWAY NAB,229.43,0,472513.97,DR,REF471288,NAB,Business
29-09-2025 16:53,NAB2E58E5C7D9094E198197,082-900-001,44444444,BWS NAB,79.17,0,472434.8,DR,REF676929,NAB,Business
29-09-2025 16:53,NAB0BD0116AD2834E469525,082-900-001,44444444,INTERNET TRANSFER NAB,94,0,472340.8,DR,REF743988,NAB,Business
29-09-2025 16:57,NAB120CA2D911784951B439,082-900-001,44444444,FLIXBUS NAB,1097.91,0,471242.89,DR,REF641612,NAB,Business
29-09-2025 17:20,NAB41990EC8688546CFAE3E,082-900-001,44444444,MCDONALDS NAB,187.38,0,471055.51,DR,REF565848,NAB,Business
29-09-2025 17:34,NAB083CE02AE1C54576A744,082-900-001,44444444,FLIXBUS NAB,851.37,0,470204.14,DR,REF348558,NAB,Business
29-09-2025 18:07,NABB8BC3AB231214E7F87BA,082-900-001,44444444,LIQUORLAND NAB,77.68,0,470126.46,DR,REF810672,NAB,Business
29-09-2025 19:09,NAB8873F445837F4499BFBF,082-900-001,44444444,BIGW NAB,371.62,0,469754.84,DR,REF866801,NAB,Business
29-09-2025 19:24,NAB2E8E0D716F5A4EBC9756,082-900-001,44444444,MENULOG NAB,201.08,0,469553.76,DR,REF652425,NAB,Business
29-09-2025 19:54,NABA29A0504AAD04841954B,082-900-001,44444444,7-ELEVEN NAB,69.43,0,469484.33,DR,REF404457,NAB,Business
29-09-2025 20:08,NAB84C591B0C01E4A4AB525,082-900-001,44444444,APPLE NAB,151.57,0,469332.76,DR,REF289386,NAB,Business
29-09-2025 20:37,NAB7566669CB7584CCC9885,082-900-001,44444444,TAFE BOOKSHOP NAB,527.02,0,468805.74,DR,REF911703,NAB,Business
29-09-2025 20:54,NAB4013D008D9A9497C85C0,082-900-001,44444444,MENULOG NAB,191.2,0,468614.54,DR,REF358710,NAB,Business
29-09-2025 21:02,NABB5F05F15DCC740869E98,082-900-001,44444444,ALDI NAB,284.69,0,468329.85,DR,REF602907,NAB,Business
29-09-2025 21:55,NABC0DBDC1B532243C2ADBF,082-900-001,44444444,BP NAB,306.87,0,468022.98,DR,REF512913,NAB,Business
29-09-2025 22:04,NAB1AC749C28F0145708A3A,082-900-001,44444444,BIGW NAB,592.46,0,467430.52,DR,REF162800,NAB,Business
29-09-2025 22:13,NABAE3748D2D3E44946BFEA,082-900-001,44444444,BANK FEE NAB,88.76,0,467341.76,DR,REF975511,NAB,Business
29-09-2025 22:39,NABAEF5118EA8664E2C99D3,082-900-001,44444444,RAILWAY STATION NAB,145.32,0,467196.44,DR,REF101402,NAB,Business
29-09-2025 23:25,NAB7952A592BFB14A92BF09,082-900-001,44444444,BANK FEE NAB,235.41,0,466961.03,DR,REF658542,NAB,Business
29-09-2025 23:40,NAB97F63A494F094A58AD70,082-900-001,44444444,PAYMENT GATEWAY NAB,17.61,0,466943.42,DR,REF781053,NAB,Business
29-09-2025 23:43,NABF8F78E71793344FFB4EC,082-900-001,44444444,BP NAB,172.32,0,466771.1,DR,REF255679,NAB,Business
29-09-2025 23:59,NAB995397854A18421F86E8,082-900-001,44444444,BWS NAB,1282.06,0,465489.04,DR,REF168405,NAB,Business
30-09-2025 00:18,NAB4295F535D987439AA29B,082-900-001,44444444,APPLE NAB,58.73,0,465430.31,DR,REF149229,NAB,Business
30-09-2025 01:29,NABBACCC52F929749D0B93E,082-900-001,44444444,AMAZON AU NAB,1225.6,0,464204.71,DR,REF142505,NAB,Business
30-09-2025 02:06,NAB8B8CEE1DCDF7430EAA50,082-900-001,44444444,APPLE NAB,223.82,0,463980.89,DR,REF761178,NAB,Business
30-09-2025 02:18,NAB350230C57AAE4DD8BE72,082-900-001,44444444,MCDONALDS NAB,27.26,0,463953.63,DR,REF995199,NAB,Business
30-09-2025 02:46,NAB0D317A3083B9410C9E70,082-900-001,44444444,BP NAB,55.8,0,463897.83,DR,REF373610,NAB,Business
30-09-2025 02:54,NAB554921000C8146A2AF47,082-900-001,44444444,SHELL NAB,25.14,0,463872.69,DR,REF390567,NAB,Business
30-09-2025 03:26,NAB0D18381D23DE49B2A507,082-900-001,44444444,HARVEY NORMAN NAB,320.42,0,463552.27,DR,REF968864,NAB,Business
30-09-2025 03:29,NAB6941903AE98148EC91D3,082-900-001,44444444,AMAZON AU NAB,180.57,0,463371.7,DR,REF213638,NAB,Business
30-09-2025 03:41,NAB80A03A004F9C443BB471,082-900-001,44444444,HARVEY NORMAN NAB,42.21,0,463329.49,DR,REF470872,NAB,Business
30-09-2025 03:46,NABE97B3B200F664DA590B1,082-900-001,44444444,BANK FEE NAB,503.46,0,462826.03,DR,REF315587,NAB,Business
30-09-2025 04:56,NABB77CEEC267AE40CCAF6D,082-900-001,44444444,PAYROLL CREDIT NAB,0,153.15,462979.18,CR,REF310263,NAB,Business
30-09-2025 06:08,NABEFABDD244A9840F09509,082-900-001,44444444,FLIXBUS NAB,182.59,0,462796.59,DR,REF906909,NAB,Business
30-09-2025 06:09,NAB90A57F8AB3C14D26A7F6,082-900-001,44444444,SHELL NAB,1283.88,0,461512.71,DR,REF402737,NAB,Business
30-09-2025 06:10,NABD58C5505D3344AEE9BE5,082-900-001,44444444,PAYMENT GATEWAY NAB,13.96,0,461498.75,DR,REF973050,NAB,Business
30-09-2025 06:32,NABF51A7B95B8CA443287D1,082-900-001,44444444,AMAZON AU NAB,29.97,0,461468.78,DR,REF750078,NAB,Business
30-09-2025 06:54,NABC6014C008E314A9A8D4D,082-900-001,44444444,COLES NAB,105.57,0,461363.21,DR,REF522618,NAB,Business
30-09-2025 06:58,NABFA597EE3D703451491B6,082-900-001,44444444,MENULOG NAB,18.6,0,461344.61,DR,REF973966,NAB,Business
30-09-2025 07:08,NABB59D6F50FA09460EB4C6,082-900-001,44444444,SPOTIFY NAB,929.11,0,460415.5,DR,REF355043,NAB,Business
30-09-2025 07:14,NAB5EDD6D7DA4144F6D9459,082-900-001,44444444,7-ELEVEN NAB,73.95,0,460341.55,DR,REF976881,NAB,Business
30-09-2025 07:17,INTF491FA29288542078D74,082-900-001,44444444,TRANSFER TO CBA 33333333,1059.1,0,459282.45,DR,INT-28217,NAB,Business
30-09-2025 07:18,NAB28C82A40149D4FB18A70,082-900-001,44444444,SHELL NAB,425.83,0,458856.62,DR,REF721548,NAB,Business
30-09-2025 07:24,NAB58A0C713274F468B943E,082-900-001,44444444,AMAZON AU NAB,1186.84,0,457669.78,DR,REF194611,NAB,Business
30-09-2025 07:29,INT2FFCC89D39E3489A9A96,082-900-001,44444444,TRANSFER FROM ANZ 11111111,0,1057.84,458727.62,CR,INT-63145,NAB,Business
30-09-2025 07:42,NAB2D9741C939184A7E936F,082-900-001,44444444,APPLE NAB,48.75,0,458678.87,DR,REF151029,NAB,Business
30-09-2025 08:36,NABF0A0556D66E540BB84BE,082-900-001,44444444,WAGES CREDIT NAB,0,6279.72,464958.59,CR,REF584831,NAB,Business
30-09-2025 08:39,NAB31850CE63C5144CF9851,082-900-001,44444444,FLIXBUS NAB,49.93,0,464908.66,DR,REF568191,NAB,Business
30-09-2025 08:56,NAB48249EE9C9274257896F,082-900-001,44444444,INTERNET TRANSFER NAB,57.07,0,464851.59,DR,REF521570,NAB,Business
30-09-2025 09:03,NABABC2F0BB124E47D291AD,082-900-001,44444444,MCDONALDS NAB,41.24,0,464810.35,DR,REF344015,NAB,Business
30-09-2025 09:14,NAB9B74F5AF1392446CA8CE,082-900-001,44444444,PAYROLL CREDIT NAB,0,4775.79,469586.14,CR,REF777301,NAB,Business
30-09-2025 09:43,NABBD9E16A3DFDA49998640,082-900-001,44444444,FLIXBUS NAB,167.18,0,469418.96,DR,REF760498,NAB,Business
30-09-2025 10:07,NAB3912DFBF87874B098588,082-900-001,44444444,DOMINO'S PIZZA NAB,28.85,0,469390.11,DR,REF147656,NAB,Business
30-09-2025 10:16,NABEB36DA0CF6874816BE72,082-900-001,44444444,ZOOM NAB,448.95,0,468941.16,DR,REF290744,NAB,Business
30-09-2025 11:16,NAB1654A69176F64E16AC80,082-900-001,44444444,BWS NAB,378.56,0,468562.6,DR,REF446441,NAB,Business
30-09-2025 11:34,NABD17E2A241EFF464297E5,082-900-001,44444444,PAYPAL *NETFLIX NAB,554.66,0,468007.94,DR,REF198809,NAB,Business
30-09-2025 13:08,NAB635928442EA742E8953A,082-900-001,44444444,BWS NAB,221.8,0,467786.14,DR,REF103787,NAB,Business
30-09-2025 13:14,NABA6E606F7EB814BD69583,082-900-001,44444444,UBER EATS NAB,215.96,0,467570.18,DR,REF377004,NAB,Business
30-09-2025 13:26,NAB4DA5729364C34573929D,082-900-001,44444444,SHELL NAB,268.07,0,467302.11,DR,REF433521,NAB,Business
30-09-2025 13:31,NAB59F3AD8F82D2487FB9D1,082-900-001,44444444,STARBUCKS NAB,612.56,0,466689.55,DR,REF351637,NAB,Business
30-09-2025 13:35,NABB41E06690B5F4BBD871F,082-900-001,44444444,ALDI NAB,229.59,0,466459.96,DR,REF962084,NAB,Business
30-09-2025 13:42,NAB7D35B77634B547F78675,082-900-001,44444444,BWS NAB,950.49,0,465509.47,DR,REF542435,NAB,Business
30-09-2025 13:56,NABE7E6B5733FF540E08981,082-900-001,44444444,FLIXBUS NAB,80.97,0,465428.5,DR,REF629939,NAB,Business
30-09-2025 14:08,INT8FE6654765AC4E0096EC,082-900-001,44444444,TRANSFER TO ANZ 11111111,634.24,0,464794.26,DR,INT-77620,NAB,Business
30-09-2025 14:37,NAB3A6E17914809499FB4ED,082-900-001,44444444,7-ELEVEN NAB,666.02,0,464128.24,DR,REF148254,NAB,Business
30-09-2025 14:42,NABE58391BCA02E4CDFBCE9,082-900-001,44444444,FLIXBUS NAB,22.42,0,464105.82,DR,REF536580,NAB,Business
30-09-2025 14:44,NAB0ACE53B67E2841378778,082-900-001,44444444,COMPANY PAYROLL NAB,0,4572.17,468677.99,CR,REF425092,NAB,Business
30-09-2025 15:11,INTBBD5F315BD2C47CD8939,082-900-001,44444444,TRANSFER FROM CBA 33333333,0,107.17,468785.16,CR,INT-26728,NAB,Business
30-09-2025 16:23,NABD395AA5F6D924DB19B00,082-900-001,44444444,INTERNET TRANSFER NAB,119.06,0,468666.1,DR,REF195413,NAB,Business
30-09-2025 16:23,NAB24F68EACEDF3433396DE,082-900-001,44444444,HARVEY NORMAN NAB,56.26,0,468609.84,DR,REF412141,NAB,Business
30-09-2025 17:04,NAB41585C7C5747448EB8DA,082-900-001,44444444,TAFE BOOKSHOP NAB,465.83,0,468144.01,DR,REF482167,NAB,Business
30-09-2025 17:05,NAB4648632703B340ACBB63,082-900-001,44444444,PAYPAL *NETFLIX NAB,909.4,0,467234.61,DR,REF359231,NAB,Business
30-09-2025 17:08,NAB251B19E1987C48A89F49,082-900-001,44444444,UBER EATS NAB,577.2,0,466657.41,DR,REF137691,NAB,Business
30-09-2025 17:32,NAB4385548A5982435C8373,082-900-001,44444444,COMPANY PAYROLL NAB,0,596.12,467253.53,CR,REF451834,NAB,Business
30-09-2025 18:50,NABED24A00C41094EC08A33,082-900-001,44444444,MENULOG NAB,458.33,0,466795.2,DR,REF146124,NAB,Business
30-09-2025 19:22,NAB924A906243184EFA9629,082-900-001,44444444,APPLE NAB,838.03,0,465957.17,DR,REF734116,NAB,Business
30-09-2025 19:44,NABAB4C7DFCD7634470AE75,082-900-001,44444444,KFC NAB,181.11,0,465776.06,DR,REF705992,NAB,Business
30-09-2025 19:44,NAB1A323D74A3034B628237,082-900-001,44444444,PAYROLL CREDIT NAB,0,3746.54,469522.6,CR,REF438186,NAB,Business
30-09-2025 20:03,NABC4C469157A8E4007A648,082-900-001,44444444,AMAZON AU NAB,474.52,0,469048.08,DR,REF710811,NAB,Business
30-09-2025 20:46,NAB427CE69FA8A94A7DA362,082-900-001,44444444,SPOTIFY NAB,33.32,0,469014.76,DR,REF314851,NAB,Business
30-09-2025 21:44,NAB93AEC858B4DC47DF9281,082-900-001,44444444,LIQUORLAND NAB,350.78,0,468663.98,DR,REF797972,NAB,Business
30-09-2025 22:34,NAB3068D70DE8324CCBB921,082-900-001,44444444,MCDONALDS NAB,121.19,0,468542.79,DR,REF612530,NAB,Business
30-09-2025 23:17,NAB544E1B38FCD247AE8926,082-900-001,44444444,JB HI-FI NAB,767.36,0,467775.43,DR,REF345711,NAB,Business
30-09-2025 23:43,NABF023F49C05FF4887B9F9,082-900-001,44444444,INTERNET TRANSFER NAB,699.65,0,467075.78,DR,REF441846,NAB,Business
30-09-2025 23:56,NAB98DCBDDC188D4B488979,082-900-001,44444444,INTERNET TRANSFER NAB,541.45,0,466534.33,DR,REF593497,NAB,Business
